year2,state,fage4,Firms,Estabs,Emp,Denom,Estabs_Entry,Estabs_Entry_Rate,Estabs_Exit,Estabs_Exit_Rate,Job_Creation,Job_Creation_Births,Job_Creation_Continuers,Job_Creation_Rate_Births,Job_Creation_Rate,Job_Destruction,Job_Destruction_Deaths,Job_Destruction_Continuers,Job_Destruction_Rate_Deaths,Job_Destruction_Rate,Net_Job_Creation,Net_Job_Creation_Rate,Reallocation_Rate,d_flag,firmdeath_firms,firmdeath_estabs,firmdeath_emp
1977,01,a) 0,8822,9494,56774,28737,9295,195.8,0,0,56075,56075,0,195.1,195.1,0,0,0,0,0,56075,195.1,0,0,,,
1977,01,l) Left Censored,43548,53357,900657,905297,1340,2.4,8058,14.1,135467,33808,101659,3.7,15,144746,58893,85853,6.5,16,-9279,-1,30,0,5623,5641,36602
1977,02,a) 0,1570,1709,12495,6306,1678,196.4,0,0,12378,12378,0,196.3,196.3,0,0,0,0,0,12378,196.3,0,0,,,
1977,02,l) Left Censored,4910,6016,94678,101832,350,5.3,1564,23.5,25174,6881,18293,6.8,24.7,39481,13504,25977,13.3,38.8,-14307,-14.1,49.4,0,1035,1039,6757
1977,04,a) 0,7748,8419,51174,25948,8258,196.2,0,0,50452,50452,0,194.4,194.4,0,0,0,0,0,50452,194.4,0,0,,,
1977,04,l) Left Censored,28725,35690,553356,563435,1121,2.9,6229,16.2,96973,20193,76780,3.6,17.2,117132,45073,72059,8,20.8,-20159,-3.6,34.4,0,4333,4358,29117
1977,05,a) 0,6308,6616,31758,16121,6478,195.8,0,0,31274,31274,0,194,194,0,0,0,0,0,31274,194,0,0,,,
1977,05,l) Left Censored,29193,34088,519532,513795,813,2.2,5455,14.9,88454,13253,75201,2.6,17.2,76979,32531,44448,6.3,15,11475,2.2,30,0,3970,3994,19678
1977,06,a) 0,72183,79060,519520,263663,77668,196.5,0,0,511715,511715,0,194.1,194.1,0,0,0,0,0,511715,194.1,0,0,,,
1977,06,l) Left Censored,290710,359713,6294259,6221728,10520,2.7,60588,15.7,1227682,267453,960229,4.3,19.7,1082620,488440,594180,7.9,17.4,145062,2.3,34.8,0,39703,39942,276775
1977,08,a) 0,10666,11384,63114,31789,11243,197.5,0,0,62650,62650,0,197.1,197.1,0,0,0,0,0,62650,197.1,0,0,,,
1977,08,l) Left Censored,40977,48804,750952,754692,1631,3.1,8248,15.8,135579,30620,104959,4.1,18,143059,62313,80746,8.3,19,-7480,-1,36,0,5674,5695,37139
1977,09,a) 0,7483,8030,45800,22967,8022,199.8,0,0,45667,45667,0,198.8,198.8,0,0,0,0,0,45667,198.8,0,0,,,
1977,09,l) Left Censored,46391,53374,1057834,1036854,1131,2,6634,11.8,169176,24190,144986,2.3,16.3,127215,47273,79942,4.6,12.3,41961,4,24.6,0,4248,4263,24208
1977,10,a) 0,1580,1746,9769,4970,1695,194.2,0,0,9599,9599,0,193.1,193.1,0,0,0,0,0,9599,193.1,0,0,,,
1977,10,l) Left Censored,8337,9717,213353,215874,259,2.5,1250,12.2,25220,4661,20559,2.2,11.7,30261,9058,21203,4.2,14,-5041,-2.3,23.4,0,807,810,5417
1977,11,a) 0,1735,1897,14793,7479,1857,195.8,0,0,14629,14629,0,195.6,195.6,0,0,0,0,0,14629,195.6,0,0,,,
1977,11,l) Left Censored,11300,13153,282357,288885,405,2.9,1856,13.3,44810,13201,31609,4.6,15.5,57865,20615,37250,7.1,20,-13055,-4.5,31,0,1132,1136,9914
1977,12,a) 0,30847,33088,228639,116143,32459,196.2,0,0,224993,224993,0,193.7,193.7,0,0,0,0,0,224993,193.7,0,0,,,
1977,12,l) Left Censored,121120,149000,2189774,2200060,4359,2.7,27047,16.8,397829,95000,302829,4.3,18.1,418400,191990,226410,8.7,19,-20571,-0.9,36.2,0,19133,19237,120776
1977,13,a) 0,13866,14887,83397,42200,14608,196.3,0,0,82395,82395,0,195.2,195.2,0,0,0,0,0,82395,195.2,0,0,,,
1977,13,l) Left Censored,64584,81023,1409258,1410019,2965,3.4,13166,15.2,237530,64367,173163,4.6,16.8,239052,97339,141713,6.9,17,-1522,-0.2,33.6,0,8878,8912,56649
1977,15,a) 0,2494,2851,20045,10159,2794,196,0,0,19773,19773,0,194.6,194.6,0,0,0,0,0,19773,194.6,0,0,,,
1977,15,l) Left Censored,12290,15062,241060,243222,511,3.2,2150,13.5,35810,7817,27993,3.2,14.7,40134,19811,20323,8.1,16.5,-4324,-1.8,29.4,0,1422,1438,10556
1977,16,a) 0,3133,3309,16796,8478,3259,197,0,0,16637,16637,0,196.2,196.2,0,0,0,0,0,16637,196.2,0,0,,,
1977,16,l) Left Censored,12970,15479,242314,222931,470,2.8,2500,15.1,75475,7722,67753,3.5,33.9,36709,15378,21331,6.9,16.5,38766,17.4,33,0,1738,1749,9788
1977,17,a) 0,24561,26718,181710,91977,26203,196.1,0,0,179466,179466,0,195.1,195.1,0,0,0,0,0,179466,195.1,0,0,,,
1977,17,l) Left Censored,151003,178225,3737064,3719370,4577,2.4,25528,13.5,566382,113546,452836,3.1,15.2,530993,202061,328932,5.4,14.3,35389,0.9,28.6,0,16752,16872,107233
1977,18,a) 0,11471,12583,82122,41800,12359,196.4,0,0,80645,80645,0,192.9,192.9,0,0,0,0,0,80645,192.9,0,0,,,
1977,18,l) Left Censored,67554,82601,1626332,1627625,2066,2.4,11453,13.1,218128,41372,176756,2.5,13.4,220714,81201,139513,5,13.6,-2586,-0.2,26.8,0,7442,7503,50334
1977,19,a) 0,8294,8923,48866,24653,8801,197.3,0,0,48426,48426,0,196.4,196.4,0,0,0,0,0,48426,196.4,0,0,,,
1977,19,l) Left Censored,46454,55112,788784,784366,1351,2.3,7960,13.6,120661,19700,100961,2.5,15.4,111824,50723,61101,6.5,14.3,8837,1.1,28.6,0,5274,5295,31820
1977,20,a) 0,6993,7476,63602,32200,7355,196.8,0,0,62804,62804,0,195,195,0,0,0,0,0,62804,195,0,0,,,
1977,20,l) Left Censored,37472,44306,620232,623366,1179,2.5,6944,14.7,97111,24030,73081,3.9,15.6,103378,44771,58607,7.2,16.6,-6267,-1,31.2,0,4710,4733,26898
1977,21,a) 0,7954,8497,45876,23180,8338,196.3,0,0,45392,45392,0,195.8,195.8,0,0,0,0,0,45392,195.8,0,0,,,
1977,21,l) Left Censored,42233,50080,872079,863261,1376,2.6,7697,14.4,148345,28315,120030,3.3,17.2,130708,52001,78707,6,15.1,17637,2.1,30.2,0,5217,5229,31095
1977,22,a) 0,9638,10312,62447,31757,10107,196,0,0,61381,61381,0,193.3,193.3,0,0,0,0,0,61381,193.3,0,0,,,
1977,22,l) Left Censored,49311,59715,959562,960552,1697,2.7,8218,13,161942,35029,126913,3.6,16.9,163922,61764,102158,6.4,17.1,-1980,-0.2,33.8,0,5822,5855,37749
1977,23,a) 0,2922,3149,17769,9027,3104,197.1,0,0,17485,17485,0,193.7,193.7,0,0,0,0,0,17485,193.7,0,0,,,
1977,23,l) Left Censored,16008,18525,274794,274860,338,1.7,2749,13.9,42404,9544,32860,3.5,15.4,42536,16956,25580,6.2,15.5,-132,-0.1,30.8,0,1756,1762,9457
1977,24,a) 0,8703,9431,55695,28265,9265,196.5,0,0,54860,54860,0,194.1,194.1,0,0,0,0,0,54860,194.1,0,0,,,
1977,24,l) Left Censored,48849,59232,1070525,1084228,1742,2.8,8104,13,167846,32520,135326,3,15.5,195252,65771,129481,6.1,18,-27406,-2.5,31,0,5204,5225,33912
1977,25,a) 0,11738,12758,103260,52075,12521,196.3,0,0,102371,102371,0,196.6,196.6,0,0,0,0,0,102371,196.6,0,0,,,
1977,25,l) Left Censored,81970,95960,1847514,1829964,2169,2.1,12040,11.9,286925,54123,232802,3,15.7,251825,104360,147465,5.7,13.8,35100,1.9,27.6,0,7822,7851,55401
1977,26,a) 0,18247,20121,126638,64021,19763,196.4,0,0,125234,125234,0,195.6,195.6,0,0,0,0,0,125234,195.6,0,0,,,
1977,26,l) Left Censored,104582,126913,2591230,2556503,3408,2.5,18175,13.5,407384,73454,333930,2.9,15.9,337929,129485,208444,5.1,13.2,69455,2.7,26.4,0,11447,11520,71244
1977,27,a) 0,9840,10674,71703,36376,10506,196.9,0,0,70654,70654,0,194.2,194.2,0,0,0,0,0,70654,194.2,0,0,,,
1977,27,l) Left Censored,55652,66290,1211010,1194450,1730,2.5,8976,12.8,211802,37944,173858,3.2,17.7,178682,73196,105486,6.1,15,33120,2.7,30,0,5779,5833,43594
1977,28,a) 0,5770,6133,33709,17111,6003,195.8,0,0,33197,33197,0,194,194,0,0,0,0,0,33197,194,0,0,,,
1977,28,l) Left Censored,28998,34567,547204,542934,878,2.4,5252,14.2,89571,14928,74643,2.7,16.5,81031,34706,46325,6.4,14.9,8540,1.6,29.8,0,3729,3755,22470
1977,29,a) 0,12356,13221,77401,39175,12991,196.5,0,0,76453,76453,0,195.2,195.2,0,0,0,0,0,76453,195.2,0,0,,,
1977,29,l) Left Censored,67513,81554,1432110,1429891,2104,2.4,12458,14.3,221384,38015,183369,2.7,15.5,216945,89645,127300,6.3,15.2,4439,0.3,30.4,0,8283,8323,47580
1977,30,a) 0,3210,3376,16237,8250,3323,196.9,0,0,15975,15975,0,193.6,193.6,0,0,0,0,0,15975,193.6,0,0,,,
1977,30,l) Left Censored,13424,15548,174773,170343,347,2.1,2397,14.4,37835,7036,30799,4.1,22.2,28975,13322,15653,7.8,17,8860,5.2,34,0,1670,1675,9899
1977,31,a) 0,4751,5051,26320,13264,4975,197,0,0,26113,26113,0,196.9,196.9,0,0,0,0,0,26113,196.9,0,0,,,
1977,31,l) Left Censored,26644,31044,447166,438354,769,2.3,4373,13.3,89922,12395,77527,2.8,20.5,72298,29255,43043,6.7,16.5,17624,4,33,0,2973,2988,19674
1977,32,a) 0,2730,2907,17877,8991,2867,197.2,0,0,17773,17773,0,197.7,197.7,0,0,0,0,0,17773,197.7,0,0,,,
1977,32,l) Left Censored,10142,11775,217512,215277,391,3.1,2044,16.2,39409,7010,32399,3.3,18.3,34938,15357,19581,7.1,16.2,4471,2.1,32.4,0,1465,1469,9485
1977,33,a) 0,2765,2929,14657,7388,2882,196.8,0,0,14538,14538,0,196.8,196.8,0,0,0,0,0,14538,196.8,0,0,,,
1977,33,l) Left Censored,13790,15523,247532,246449,322,2,2063,12.6,36665,5608,31057,2.3,14.9,34499,14599,19900,5.9,14,2166,0.9,28,0,1401,1408,8624
1977,34,a) 0,17462,18294,101319,52733,17884,195.5,0,0,97173,97173,0,184.3,184.3,0,0,0,0,0,97173,184.3,0,0,,,
1977,34,l) Left Censored,107170,123338,2199872,2207252,2792,2.1,17343,13.2,331993,81058,250935,3.7,15,346754,131638,215116,6,15.7,-14761,-0.7,30,0,11019,11062,64379
1977,35,a) 0,4141,4375,23129,11696,4287,196,0,0,22867,22867,0,195.5,195.5,0,0,0,0,0,22867,195.5,0,0,,,
1977,35,l) Left Censored,16762,19800,251085,254717,602,2.8,3459,16.2,44234,10407,33827,4.1,17.4,51497,22137,29360,8.7,20.2,-7263,-2.8,34.8,0,2422,2430,13635
1977,36,a) 0,41120,43694,252036,128161,42731,195.6,0,0,247751,247751,0,193.3,193.3,0,0,0,0,0,247751,193.3,0,0,,,
1977,36,l) Left Censored,271128,309611,5286374,5308736,5336,1.6,44902,13.6,797070,154421,642649,2.9,15,841794,323829,517965,6.1,15.9,-44724,-0.9,30,0,31297,31405,181850
1977,37,a) 0,13574,14606,83762,43018,14330,196.2,0,0,81489,81489,0,189.4,189.4,0,0,0,0,0,81489,189.4,0,0,,,
1977,37,l) Left Censored,70934,87912,1666734,1676146,2404,2.6,12387,13.3,225121,51023,174098,3,13.4,243947,88082,155865,5.3,14.6,-18826,-1.2,26.8,0,8389,8417,51874
1977,38,a) 0,2106,2192,11054,5571,2162,197.3,0,0,10967,10967,0,196.9,196.9,0,0,0,0,0,10967,196.9,0,0,,,
1977,38,l) Left Censored,11069,12722,138122,140985,272,2,1871,13.8,18585,3269,15316,2.3,13.2,24311,10832,13479,7.7,17.2,-5726,-4,26.4,0,1170,1175,7566
1977,39,a) 0,20801,23051,141632,71738,22619,196.3,0,0,139788,139788,0,194.9,194.9,0,0,0,0,0,139788,194.9,0,0,,,
1977,39,l) Left Censored,131225,166021,3399206,3363814,4952,2.8,21856,12.5,522370,115629,406741,3.4,15.5,451585,171079,280506,5.1,13.4,70785,2.1,26.8,0,13731,13817,90224
1977,40,a) 0,8988,9473,55116,27892,9312,196.6,0,0,54449,54449,0,195.2,195.2,0,0,0,0,0,54449,195.2,0,0,,,
1977,40,l) Left Censored,41350,49000,691404,693782,1216,2.3,7817,14.9,110579,23889,86690,3.4,15.9,115335,50346,64989,7.3,16.6,-4756,-0.7,31.8,0,5627,5653,32516
1977,41,a) 0,9095,9741,53606,27152,9617,197.5,0,0,52909,52909,0,194.9,194.9,0,0,0,0,0,52909,194.9,0,0,,,
1977,41,l) Left Censored,37466,44255,641982,644771,1351,2.8,7492,15.8,102679,18852,83827,2.9,15.9,108257,50465,57792,7.8,16.8,-5578,-0.9,31.8,0,4972,4997,30325
1977,42,a) 0,22349,24337,154916,78802,23837,195.9,0,0,152228,152228,0,193.2,193.2,0,0,0,0,0,152228,193.2,0,0,,,
1977,42,l) Left Censored,152142,184366,3695336,3668583,4648,2.4,22690,11.7,557876,121993,435883,3.3,15.2,504371,183651,320720,5,13.7,53505,1.5,27.4,0,14434,14527,94368
1977,44,a) 0,2326,2437,12162,6085,2435,199.8,0,0,12155,12155,0,199.8,199.8,0,0,0,0,0,12155,199.8,0,0,,,
1977,44,l) Left Censored,15247,17022,345864,318333,335,1.9,2227,12.4,94157,6131,88026,1.9,29.6,39094,14848,24246,4.7,12.3,55063,17.3,24.6,0,1452,1462,7106
1977,45,a) 0,7019,7465,36236,18401,7308,195.8,0,0,35671,35671,0,193.9,193.9,0,0,0,0,0,35671,193.9,0,0,,,
1977,45,l) Left Censored,35328,42706,803199,809528,1130,2.5,6095,13.5,101273,24027,77246,3,12.5,113930,41950,71980,5.2,14.1,-12657,-1.6,25,0,4206,4231,23924
1977,46,a) 0,2162,2286,11499,5819,2242,196.2,0,0,11360,11360,0,195.2,195.2,0,0,0,0,0,11360,195.2,0,0,,,
1977,46,l) Left Censored,11717,13316,183799,166151,259,1.8,2014,14.1,60425,14502,45923,8.7,36.4,25128,10551,14577,6.4,15.1,35297,21.3,30.2,0,1255,1255,6637
1977,47,a) 0,11280,12153,86977,43958,11915,196.1,0,0,86038,86038,0,195.7,195.7,0,0,0,0,0,86038,195.7,0,0,,,
1977,47,l) Left Censored,54338,66189,1226438,1229914,1843,2.6,10116,14.3,181566,35485,146081,2.9,14.8,188518,74324,114194,6,15.3,-6952,-0.5,29.6,0,6942,6972,44067
1977,48,a) 0,40078,43511,265046,134487,42724,196.4,0,0,261118,261118,0,194.2,194.2,0,0,0,0,0,261118,194.2,0,0,,,
1977,48,l) Left Censored,174427,220244,3724768,3710978,7077,3,34099,14.5,679512,172983,506529,4.7,18.3,651932,264037,387895,7.1,17.6,27580,0.7,35.2,0,23579,23754,157881
1977,49,a) 0,4261,4512,23990,12113,4430,196.4,0,0,23754,23754,0,196.1,196.1,0,0,0,0,0,23754,196.1,0,0,,,
1977,49,l) Left Censored,17007,20041,332348,327545,643,3,3306,15.4,68941,14979,53962,4.6,21,59334,26058,33276,8,18.1,9607,2.9,36.2,0,2148,2168,15845
1977,50,a) 0,1688,1792,8603,4318,1771,197.7,0,0,8570,8570,0,198.5,198.5,0,0,0,0,0,8570,198.5,0,0,,,
1977,50,l) Left Censored,8795,9815,136454,134677,143,1.4,1347,12.9,22739,5156,17583,3.8,16.9,19185,8799,10386,6.5,14.2,3554,2.7,28.4,0,910,913,4689
1977,51,a) 0,11418,12255,72875,36894,12056,196.8,0,0,71963,71963,0,195.1,195.1,0,0,0,0,0,71963,195.1,0,0,,,
1977,51,l) Left Censored,61121,75886,1318231,1323421,2354,2.9,10722,13.4,210800,55306,155494,4.2,15.9,221180,79450,141730,6,16.7,-10380,-0.8,31.8,0,6990,7032,43037
1977,53,a) 0,12903,13916,76862,38941,13669,196.5,0,0,75842,75842,0,194.8,194.8,0,0,0,0,0,75842,194.8,0,0,,,
1977,53,l) Left Censored,53320,63936,950762,943246,1901,2.8,10117,14.8,166855,36486,130369,3.9,17.7,151823,65408,86415,6.9,16.1,15032,1.6,32.2,0,6567,6597,39560
1977,54,a) 0,3976,4243,23893,12091,4134,194.9,0,0,23604,23604,0,195.2,195.2,0,0,0,0,0,23604,195.2,0,0,,,
1977,54,l) Left Censored,22576,26646,448041,447185,647,2.3,3800,13.4,75013,17847,57166,4,16.8,73301,31646,41655,7.1,16.4,1712,0.4,32.8,0,2463,2478,13568
1977,55,a) 0,10684,11626,66706,33982,11439,196.8,0,0,65449,65449,0,192.6,192.6,0,0,0,0,0,65449,192.6,0,0,,,
1977,55,l) Left Censored,65170,76034,1368455,1367169,1691,2.1,9808,12.2,173253,31245,142008,2.3,12.7,170681,69961,100720,5.1,12.5,2572,0.2,25,0,6219,6269,38462
1977,56,a) 0,1911,2015,10765,5429,1983,196.8,0,0,10673,10673,0,196.6,196.6,0,0,0,0,0,10673,196.6,0,0,,,
1977,56,l) Left Censored,7746,8744,98524,97556,277,3,1373,14.7,20822,4709,16113,4.8,21.3,18886,8866,10020,9.1,19.4,1936,1.9,38.8,0,926,928,6309
1978,01,a) 0,8301,8505,46786,23510,8413,197.8,0,0,46552,46552,0,198,198,0,0,0,0,0,46552,198,0,0,,,
1978,01,b) 1,6471,7192,57471,57028,119,1.4,2331,28,17987,1256,16731,2.2,31.5,17101,11444,5657,20.1,30,886,1.5,60,0,1779,1785,7770
1978,01,l) Left Censored,39398,49408,928126,914329,1738,3.4,5671,11,148637,24371,124266,2.7,16.3,121043,43786,77257,4.8,13.2,27594,3.1,26.4,0,3890,3905,23176
1978,02,a) 0,1436,1447,7305,3668,1433,198.1,0,0,7275,7275,0,198.3,198.3,0,0,0,0,0,7275,198.3,0,0,,,
1978,02,b) 1,1093,1235,15914,14145,25,1.7,492,33.4,7591,374,7217,2.6,53.7,4053,2786,1267,19.7,28.7,3538,25,57.4,0,323,323,1674
1978,02,l) Left Censored,4229,5324,86987,90794,337,5.9,992,17.5,21091,5379,15712,5.9,23.2,28705,12296,16409,13.5,31.6,-7614,-8.4,46.4,0,514,519,5313
1978,04,a) 0,6361,6420,38143,19073,6419,200,0,0,38140,38140,0,200,200,0,0,0,0,0,38140,200,0,0,,,
1978,04,b) 1,4942,5606,48703,49644,95,1.4,2752,39.3,17093,944,16149,1.9,34.4,18975,13654,5321,27.5,38.2,-1882,-3.8,68.8,0,1741,1762,7714
1978,04,l) Left Censored,23838,30989,570885,561341,1227,3.7,5596,16.8,107473,20864,86609,3.7,19.1,88385,43210,45175,7.7,15.7,19088,3.4,31.4,0,3145,3170,20594
1978,05,a) 0,5056,5073,24121,12061,5073,200,0,0,24121,24121,0,200,200,0,0,0,0,0,24121,200,0,0,,,
1978,05,b) 1,4008,4313,28370,29804,37,0.7,2198,40.2,7698,476,7222,1.6,25.8,10565,7999,2566,26.8,35.4,-2867,-9.6,51.6,0,1465,1465,5179
1978,05,l) Left Censored,24635,29542,511223,514722,820,2.6,5010,15.7,75805,11525,64280,2.2,14.7,82802,39660,43142,7.7,16.1,-6997,-1.4,29.4,0,2954,2969,16496
1978,06,a) 0,66388,66987,381016,191839,66295,197.9,0,0,378354,378354,0,197.2,197.2,0,0,0,0,0,378354,197.2,0,0,,,
1978,06,b) 1,52509,59576,498913,507455,937,1.4,19770,28.5,157304,11138,146166,2.2,31,174387,93129,81258,18.4,34.4,-17083,-3.4,62,0,13685,13737,61119
1978,06,l) Left Censored,256124,326098,6362259,6323489,13812,4,47137,13.7,1146355,206844,939511,3.3,18.1,1068814,435380,633434,6.9,16.9,77541,1.2,33.8,0,27769,27992,186916
1978,08,a) 0,8826,8873,47380,23690,8873,200,0,0,47380,47380,0,200,200,0,0,0,0,0,47380,200,0,0,,,
1978,08,b) 1,7063,7857,62256,62418,153,1.6,3479,36.2,20783,1524,19259,2.4,33.3,21106,15298,5808,24.5,33.8,-323,-0.5,66.6,0,2295,2295,9181
1978,08,l) Left Censored,34324,42470,767109,757585,1753,3.8,7634,16.7,144761,24315,120446,3.2,19.1,125713,59637,66076,7.9,16.6,19048,2.5,33.2,0,4411,4445,29244
1978,09,a) 0,6499,6518,29995,15051,6477,198.7,0,0,29889,29889,0,198.6,198.6,0,0,0,0,0,29889,198.6,0,0,,,
1978,09,b) 1,5867,6438,48147,46976,73,1,1613,22.3,13141,1474,11667,3.1,28,10798,6372,4426,13.6,23,2343,5,46,0,1133,1134,4305
1978,09,l) Left Censored,43121,50243,1061665,1059612,1529,3,4659,9,150100,21582,128518,2,14.2,145994,57335,88659,5.4,13.8,4106,0.4,27.6,0,3158,3174,27983
1978,10,a) 0,1156,1164,5896,2964,1149,197.4,0,0,5864,5864,0,197.8,197.8,0,0,0,0,0,5864,197.8,0,0,,,
1978,10,b) 1,1080,1253,9334,9543,23,1.5,506,33.8,2880,649,2231,6.8,30.2,3297,2574,723,27,34.5,-417,-4.3,60.4,0,404,404,1719
1978,10,l) Left Censored,7465,8875,207651,210472,288,3.1,1127,12.1,50180,2808,47372,1.3,23.8,55821,38264,17557,18.2,26.5,-5641,-2.7,47.6,0,827,828,32505
1978,11,a) 0,1443,1447,8640,4342,1433,198.1,0,0,8596,8596,0,198,198,0,0,0,0,0,8596,198,0,0,,,
1978,11,b) 1,1389,1557,28612,28439,53,3.1,385,22.3,5230,1270,3960,4.5,18.4,4883,2658,2225,9.3,17.2,347,1.2,34.4,0,237,239,1527
1978,11,l) Left Censored,10409,12257,280367,274590,472,3.7,1370,10.8,48779,6893,41886,2.5,17.8,37225,14067,23158,5.1,13.6,11554,4.2,27.2,0,885,899,6622
1978,12,a) 0,29048,29243,163469,82268,28899,197.6,0,0,162403,162403,0,197.4,197.4,0,0,0,0,0,162403,197.4,0,0,,,
1978,12,b) 1,22527,24885,200209,213752,365,1.3,8309,28.7,63793,4785,59008,2.2,29.8,90879,40165,50714,18.8,42.5,-27086,-12.7,59.6,0,6444,6459,29598
1978,12,l) Left Censored,108133,136642,2199177,2194343,5790,4.1,18018,12.6,393088,73257,319831,3.3,17.9,383419,150687,232732,6.9,17.5,9669,0.4,35,0,12442,12559,81184
1978,13,a) 0,12470,12539,64601,32522,12381,197.5,0,0,64158,64158,0,197.3,197.3,0,0,0,0,0,64158,197.3,0,0,,,
1978,13,b) 1,10056,11128,85169,84488,177,1.4,3823,29.4,26198,2400,23798,2.8,31,24835,16525,8310,19.6,29.4,1363,1.6,58.8,0,2936,2944,11627
1978,13,l) Left Censored,58499,75225,1464987,1436808,2993,3.8,8706,11.1,249433,48832,200601,3.4,17.4,193076,76527,116549,5.3,13.4,56357,4,26.8,0,5774,5804,40598
1978,15,a) 0,2305,2322,14808,7447,2298,197.9,0,0,14722,14722,0,197.7,197.7,0,0,0,0,0,14722,197.7,0,0,,,
1978,15,b) 1,1857,2262,20179,20071,76,3,636,24.9,5736,592,5144,2.9,28.6,5519,3238,2281,16.1,27.5,217,1.1,55,0,459,459,1774
1978,15,l) Left Censored,11220,13971,240625,240837,458,3.2,1554,10.7,36002,7125,28877,3,14.9,36425,16900,19525,7,15.1,-423,-0.2,29.8,0,946,960,5808
1978,16,a) 0,2602,2606,12976,6488,2606,200,0,0,12976,12976,0,200,200,0,0,0,0,0,12976,200,0,0,,,
1978,16,b) 1,2057,2233,14856,15729,36,1.3,1043,37.7,4462,267,4195,1.7,28.4,6207,4509,1698,28.7,39.5,-1745,-11.1,56.8,0,673,674,2666
1978,16,l) Left Censored,10971,13489,202048,221716,420,2.9,2245,15.5,37736,8497,29239,3.8,17,77071,16260,60811,7.3,34.8,-39335,-17.8,34,0,1239,1247,7330
1978,17,a) 0,21535,21750,121304,61119,21479,197.5,0,0,120371,120371,0,196.9,196.9,0,0,0,0,0,120371,196.9,0,0,,,
1978,17,b) 1,18997,21287,182196,181630,342,1.4,5611,23.4,47075,4564,42511,2.5,25.9,45942,27294,18648,15,25.3,1133,0.6,50.6,0,4110,4122,17740
1978,17,l) Left Censored,138023,165447,3774224,3755009,5640,3.3,18384,10.7,545600,95287,450313,2.5,14.5,507170,174152,333018,4.6,13.5,38430,1,27,0,12278,12407,80779
1978,18,a) 0,10392,10491,54467,27347,10394,198.2,0,0,54241,54241,0,198.3,198.3,0,0,0,0,0,54241,198.3,0,0,,,
1978,18,b) 1,8699,9832,80588,81219,163,1.5,2827,25.2,20198,1714,18484,2.1,24.9,21459,13036,8423,16.1,26.4,-1261,-1.5,49.8,0,2036,2040,8941
1978,18,l) Left Censored,61928,77155,1694292,1660127,2530,3.2,7902,9.9,253695,34100,219595,2.1,15.3,185364,64465,120899,3.9,11.2,68331,4.1,22.4,0,5284,5321,31969
1978,19,a) 0,7310,7349,37063,18618,7277,198,0,0,36890,36890,0,198.1,198.1,0,0,0,0,0,36890,198.1,0,0,,,
1978,19,b) 1,6416,7072,49416,49059,87,1.1,1896,23.7,12294,642,11652,1.3,25.1,11580,6759,4821,13.8,23.6,714,1.5,47.2,0,1409,1412,4895
1978,19,l) Left Censored,42289,51153,789566,789025,1638,3.1,5531,10.4,109577,17356,92221,2.2,13.9,108494,34931,73563,4.4,13.8,1083,0.1,27.6,0,3930,3952,20573
1978,20,a) 0,6298,6325,32574,16371,6261,198,0,0,32406,32406,0,197.9,197.9,0,0,0,0,0,32406,197.9,0,0,,,
1978,20,b) 1,5323,5869,41309,52459,113,1.7,1663,24.9,11134,1455,9679,2.8,21.2,33434,7671,25763,14.6,63.7,-22300,-42.5,42.4,0,1269,1271,5980
1978,20,l) Left Censored,34107,41144,627420,623206,1489,3.5,4601,10.8,96769,17696,79073,2.8,15.5,88340,33895,54445,5.4,14.2,8429,1.3,28.4,0,3149,3160,17895
1978,21,a) 0,7121,7151,37641,18900,7081,198,0,0,37482,37482,0,198.3,198.3,0,0,0,0,0,37482,198.3,0,0,,,
1978,21,b) 1,5820,6366,43764,44537,77,1,2122,28.6,11920,792,11128,1.8,26.8,13465,8673,4792,19.5,30.2,-1545,-3.4,53.6,0,1617,1617,6398
1978,21,l) Left Censored,38471,46678,876891,874525,1930,4,5286,10.9,135067,22283,112784,2.5,15.4,130335,51438,78897,5.9,14.9,4732,0.5,29.8,0,3616,3628,18658
1978,22,a) 0,7825,7852,45231,22616,7852,200,0,0,45231,45231,0,200,200,0,0,0,0,0,45231,200,0,0,,,
1978,22,b) 1,6483,7215,61090,61466,93,1.1,3001,34.2,20327,1151,19176,1.9,33.1,21079,13016,8063,21.2,34.3,-752,-1.2,66.2,0,1985,1987,8990
1978,22,l) Left Censored,42396,52981,1002328,978911,1518,2.7,7690,13.6,188216,28541,159675,2.9,19.2,141382,60171,81211,6.1,14.4,46834,4.8,28.8,0,4360,4384,27259
1978,23,a) 0,2794,2806,11993,6020,2788,198.7,0,0,11946,11946,0,198.4,198.4,0,0,0,0,0,11946,198.4,0,0,,,
1978,23,b) 1,2255,2490,17738,17731,24,0.9,661,23.5,4078,576,3502,3.2,23,4064,2189,1875,12.3,22.9,14,0.1,45.8,0,480,480,1658
1978,23,l) Left Censored,14608,17205,279662,273391,604,3.4,1870,10.5,46143,6570,39573,2.4,16.9,33600,12272,21328,4.5,12.3,12543,4.6,24.6,0,1327,1332,6671
1978,24,a) 0,7434,7515,37353,18761,7430,197.7,0,0,37184,37184,0,198.2,198.2,0,0,0,0,0,37184,198.2,0,0,,,
1978,24,b) 1,6671,7409,58965,57151,111,1.3,2093,24.9,18646,1307,17339,2.3,32.6,15017,9305,5712,16.3,26.3,3629,6.3,52.6,0,1499,1503,5842
1978,24,l) Left Censored,44911,55486,1078601,1074263,2066,3.6,5780,10.1,165522,30717,134805,2.9,15.4,156845,53683,103162,5,14.6,8677,0.8,29.2,0,3723,3741,23430
1978,25,a) 0,10419,10532,58580,29505,10389,197.3,0,0,58151,58151,0,197.1,197.1,0,0,0,0,0,58151,197.1,0,0,,,
1978,25,b) 1,9212,10337,111526,106917,207,1.8,2531,21.9,32735,4519,28216,4.2,30.6,23517,13971,9546,13.1,22,9218,8.6,44,0,1814,1815,9609
1978,25,l) Left Censored,75804,89642,1926604,1887129,2627,2.8,8918,9.6,308513,53052,255461,2.8,16.3,229562,96761,132801,5.1,12.2,78951,4.1,24.4,0,5804,5857,38898
1978,26,a) 0,16521,16657,91519,46008,16483,197.9,0,0,91022,91022,0,197.8,197.8,0,0,0,0,0,91022,197.8,0,0,,,
1978,26,b) 1,14063,15914,130725,128246,228,1.3,4273,23.7,36048,2847,33201,2.2,28.1,31090,19477,11613,15.2,24.2,4958,3.9,48.4,0,2946,2960,13268
1978,26,l) Left Censored,95356,118057,2664978,2619376,4387,3.6,13165,10.7,393890,74091,319799,2.8,15,302686,119550,183136,4.6,11.6,91204,3.4,23.2,0,8635,8677,55896
1978,27,a) 0,8978,9033,49614,24963,8944,198,0,0,49302,49302,0,197.5,197.5,0,0,0,0,0,49302,197.5,0,0,,,
1978,27,b) 1,7749,8626,73306,72243,130,1.3,2098,21.8,20742,1124,19618,1.6,28.7,18615,10176,8439,14.1,25.8,2127,2.9,51.6,0,1509,1517,6880
1978,27,l) Left Censored,51050,61896,1250092,1230590,2032,3.2,6397,10,215547,33361,182186,2.7,17.5,176543,57520,119023,4.7,14.3,39004,3.2,28.6,0,4363,4385,27442
1978,28,a) 0,5017,5035,26844,13498,4960,197,0,0,26692,26692,0,197.7,197.7,0,0,0,0,0,26692,197.7,0,0,,,
1978,28,b) 1,4146,4579,34031,33572,104,1.9,1590,29.7,10235,1410,8825,4.2,30.5,9316,5814,3502,17.3,27.7,919,2.8,55.4,0,1163,1165,4209
1978,28,l) Left Censored,25902,31579,546459,547090,1112,3.4,4104,12.4,82948,14693,68255,2.7,15.2,84209,28166,56043,5.1,15.4,-1261,-0.2,30.4,0,2637,2646,13774
1978,29,a) 0,11124,11175,58869,29517,11087,198.4,0,0,58705,58705,0,198.9,198.9,0,0,0,0,0,58705,198.9,0,0,,,
1978,29,b) 1,9157,10114,78489,77658,194,1.7,3198,27.4,21548,2081,19467,2.7,27.7,19886,12385,7501,15.9,25.6,1662,2.1,51.2,0,2428,2436,8639
1978,29,l) Left Censored,61066,75423,1455571,1443943,2770,3.5,8820,11.2,229516,38225,191291,2.6,15.9,206260,80972,125288,5.6,14.3,23256,1.6,28.6,0,5842,5863,32271
1978,30,a) 0,2461,2468,13441,6722,2466,199.8,0,0,13438,13438,0,199.9,199.9,0,0,0,0,0,13438,199.9,0,0,,,
1978,30,b) 1,2107,2294,14299,15092,30,1.1,1033,36.5,4066,135,3931,0.9,26.9,5651,4250,1401,28.2,37.4,-1585,-10.5,53.8,0,638,638,2579
1978,30,l) Left Censored,11390,13563,169184,171624,395,2.7,2234,15.3,29260,2494,26766,1.5,17,34139,15374,18765,9,19.9,-4879,-2.9,34,0,1278,1282,7181
1978,31,a) 0,4029,4055,20244,10215,4008,197.7,0,0,20058,20058,0,196.4,196.4,0,0,0,0,0,20058,196.4,0,0,,,
1978,31,b) 1,3616,3954,25143,25614,59,1.3,1091,24.3,6373,757,5616,3,24.9,7314,4521,2793,17.7,28.6,-941,-3.7,49.8,0,798,812,3595
1978,31,l) Left Censored,24386,28881,435999,441485,929,3.1,3066,10.2,71899,9386,62513,2.1,16.3,82871,28715,54156,6.5,18.8,-10972,-2.5,32.6,0,2153,2163,11553
1978,32,a) 0,2345,2400,16335,8169,2399,199.9,0,0,16333,16333,0,199.9,199.9,0,0,0,0,0,16333,199.9,0,0,,,
1978,32,b) 1,1797,1980,20582,19157,25,1,895,36.6,8097,184,7913,1,42.3,5247,3841,1406,20.1,27.4,2850,14.9,54.8,0,556,556,2375
1978,32,l) Left Censored,8430,10088,231353,223887,417,3.8,1980,18.1,48265,8439,39826,3.8,21.6,33333,19445,13888,8.7,14.9,14932,6.7,29.8,0,1077,1081,9013
1978,33,a) 0,2629,2636,12464,6256,2612,198.2,0,0,12416,12416,0,198.5,198.5,0,0,0,0,0,12416,198.5,0,0,,,
1978,33,b) 1,2095,2281,16191,15427,48,1.8,679,26.1,5402,1264,4138,8.2,35,3873,2635,1238,17.1,25.1,1529,9.9,50.2,0,506,510,1928
1978,33,l) Left Censored,12714,14520,266999,257123,481,3.2,1463,9.7,47868,11793,36075,4.6,18.6,28116,10529,17587,4.1,10.9,19752,7.7,21.8,0,1022,1024,5286
1978,34,a) 0,14915,15001,68692,34607,14788,197.2,0,0,68170,68170,0,197,197,0,0,0,0,0,68170,197,0,0,,,
1978,34,b) 1,13349,14249,100167,100691,140,0.9,4048,24.9,26819,1064,25755,1.1,26.6,27867,17048,10819,16.9,27.7,-1048,-1.1,53.2,0,2840,2841,11084
1978,34,l) Left Censored,98806,115203,2233054,2213723,4124,3.5,12234,10.3,350174,68312,281862,3.1,15.8,311512,122850,188662,5.5,14.1,38662,1.7,28.2,0,7936,7976,47320
1978,35,a) 0,3126,3144,17424,8718,3143,199.9,0,0,17412,17412,0,199.7,199.7,0,0,0,0,0,17412,199.7,0,0,,,
1978,35,b) 1,2705,2965,21080,21995,56,1.5,1377,37.5,6487,493,5994,2.2,29.5,8316,6160,2156,28,37.8,-1829,-8.3,59,0,930,932,3843
1978,35,l) Left Censored,13991,17135,255086,252334,623,3.4,3042,16.5,49809,7766,42043,3.1,19.7,44304,23620,20684,9.4,17.6,5505,2.1,35.2,0,1785,1787,13673
1978,36,a) 0,35845,36049,177840,89392,35613,197.6,0,0,176896,176896,0,197.9,197.9,0,0,0,0,0,176896,197.9,0,0,,,
1978,36,b) 1,31359,34034,263646,257333,352,0.9,9704,25,82418,10000,72418,3.9,32,69792,40402,29390,15.7,27.1,12626,4.9,54.2,0,7207,7213,28312
1978,36,l) Left Censored,245868,283683,5328924,5317719,7768,2.6,33676,11.4,844518,128859,715659,2.4,15.9,822107,313329,508778,5.9,15.5,22411,0.4,31,0,23628,23723,143769
1978,37,a) 0,12707,12814,61963,31122,12681,197.9,0,0,61682,61682,0,198.2,198.2,0,0,0,0,0,61682,198.2,0,0,,,
1978,37,b) 1,9972,11035,82994,83435,133,1,3599,28.1,21093,1501,19592,1.8,25.3,21975,15113,6862,18.1,26.3,-882,-1,50.6,0,2793,2794,10727
1978,37,l) Left Censored,64961,82237,1709133,1685053,2924,3.4,8533,10,242871,45275,197596,2.7,14.4,194711,76435,118276,4.5,11.6,48160,2.8,23.2,0,5733,5768,33132
1978,38,a) 0,1829,1832,8276,4150,1817,198.4,0,0,8253,8253,0,198.9,198.9,0,0,0,0,0,8253,198.9,0,0,,,
1978,38,b) 1,1589,1680,11274,11112,19,1,508,26.3,3141,209,2932,1.9,28.3,2817,1928,889,17.4,25.4,324,2.9,50.8,0,364,364,1385
1978,38,l) Left Censored,10182,11862,143227,140678,361,2.9,1201,9.8,21715,2722,18993,1.9,15.4,16616,6196,10420,4.4,11.8,5099,3.6,23.6,0,825,829,3942
1978,39,a) 0,18358,18468,95358,47935,18265,197.8,0,0,94846,94846,0,197.9,197.9,0,0,0,0,0,94846,197.9,0,0,,,
1978,39,b) 1,15878,18198,139688,140353,303,1.5,4967,24.1,36323,3356,32967,2.4,25.9,37652,24083,13569,17.2,26.8,-1329,-0.9,51.8,0,3592,3609,15200
1978,39,l) Left Censored,120647,156180,3430816,3413124,5857,3.6,15704,9.7,483252,78939,404313,2.3,14.2,447870,139478,308392,4.1,13.1,35382,1.1,26.2,0,10017,10057,56054
1978,40,a) 0,7195,7243,38502,19252,7242,200,0,0,38501,38501,0,200,200,0,0,0,0,0,38501,200,0,0,,,
1978,40,b) 1,5785,6343,49730,52130,126,1.6,3051,38.6,13364,944,12420,1.8,25.6,18163,13102,5061,25.1,34.8,-4799,-9.2,51.2,0,2049,2057,8359
1978,40,l) Left Censored,34618,42400,687241,688060,1383,3,7492,16.4,111268,20145,91123,2.9,16.2,112905,58248,54657,8.5,16.4,-1637,-0.2,32.4,0,4297,4305,28269
1978,41,a) 0,8982,9032,45597,22916,8938,197.9,0,0,45363,45363,0,198,198,0,0,0,0,0,45363,198,0,0,,,
1978,41,b) 1,6678,7364,61942,57657,110,1.3,2410,28.2,22987,2070,20917,3.6,39.9,14416,9738,4678,16.9,25,8571,14.9,50,0,1736,1737,6153
1978,41,l) Left Censored,33451,40490,691354,666442,1711,4,5417,12.8,136363,21661,114702,3.3,20.5,86538,42241,44297,6.3,13,49825,7.5,26,0,3548,3565,21702
1978,42,a) 0,19380,19538,101466,50938,19335,197.9,0,0,101056,101056,0,198.4,198.4,0,0,0,0,0,101056,198.4,0,0,,,
1978,42,b) 1,17515,19571,154999,154618,338,1.5,4918,22.4,40971,4124,36847,2.7,26.5,40209,23874,16335,15.4,26,762,0.5,52,0,3424,3443,14537
1978,42,l) Left Censored,140048,172506,3662455,3674067,5640,3.2,17439,9.8,552691,93889,458802,2.6,15,575914,211878,364036,5.8,15.7,-23223,-0.7,30,0,11352,11418,104517
1978,44,a) 0,1972,1979,12311,6166,1965,198.6,0,0,12290,12290,0,199.3,199.3,0,0,0,0,0,12290,199.3,0,0,,,
1978,44,b) 1,1789,1892,12480,12252,19,0.9,537,24.8,4037,389,3648,3.2,32.9,3581,2429,1152,19.8,29.2,456,3.7,58.4,0,383,384,1751
1978,44,l) Left Censored,14133,15970,308758,327283,513,3.1,1551,9.4,51286,8013,43273,2.4,15.7,88336,16055,72281,4.9,27,-37050,-11.3,31.4,0,1055,1056,6237
1978,45,a) 0,6460,6499,32806,16476,6425,197.7,0,0,32660,32660,0,198.2,198.2,0,0,0,0,0,32660,198.2,0,0,,,
1978,45,b) 1,5153,5616,37560,36944,88,1.3,1870,28.6,11430,1137,10293,3.1,30.9,10198,6706,3492,18.2,27.6,1232,3.3,55.2,0,1446,1448,4704
1978,45,l) Left Censored,32260,40005,843131,822558,1530,3.7,4228,10.2,129018,31205,97813,3.8,15.7,87871,32945,54926,4,10.7,41147,5,21.4,0,2946,2955,13889
1978,46,a) 0,1992,1996,9291,4675,1981,198.5,0,0,9232,9232,0,197.5,197.5,0,0,0,0,0,9232,197.5,0,0,,,
1978,46,b) 1,1597,1726,11540,11467,17,0.8,558,27.9,3308,137,3171,1.2,28.8,3161,2085,1076,18.2,27.6,147,1.2,55.2,0,391,391,1504
1978,46,l) Left Censored,10774,12406,150379,166886,420,3.3,1308,10.2,24897,3528,21369,2.1,14.9,57910,7025,50885,4.2,34.7,-33013,-19.8,29.8,0,914,915,4161
1978,47,a) 0,9874,9926,52597,26426,9817,197.8,0,0,52342,52342,0,198.1,198.1,0,0,0,0,0,52342,198.1,0,0,,,
1978,47,b) 1,8227,9123,73593,79923,135,1.3,3057,28.8,22448,1743,20705,2.2,28.1,35108,14336,20772,17.9,43.9,-12660,-15.8,56.2,0,2322,2327,10687
1978,47,l) Left Censored,49370,61380,1261083,1244697,2133,3.3,6910,10.8,197235,33820,163415,2.7,15.8,164463,64334,100129,5.2,13.2,32772,2.6,26.4,0,4629,4646,27765
1978,48,a) 0,32509,32917,191489,95752,32915,200,0,0,191475,191475,0,200,200,0,0,0,0,0,191475,200,0,0,,,
1978,48,b) 1,26019,29597,247308,254162,557,1.5,13485,36.9,77286,5906,71380,2.3,30.4,90993,65685,25308,25.8,35.8,-13707,-5.4,60.8,0,8649,8710,40972
1978,48,l) Left Censored,145484,191894,3770786,3739427,7085,3.4,32944,16,688349,129066,559283,3.5,18.4,625631,291809,333822,7.8,16.7,62718,1.7,33.4,0,17909,17992,133459
1978,49,a) 0,3371,3390,19839,9920,3390,200,0,0,19839,19839,0,200,200,0,0,0,0,0,19839,200,0,0,,,
1978,49,b) 1,2760,3028,22109,22671,51,1.4,1439,38.2,7146,427,6719,1.9,31.5,8270,6366,1904,28.1,36.5,-1124,-5,63,0,852,852,3815
1978,49,l) Left Censored,14489,17593,334538,332723,680,3.6,2916,15.5,58390,11595,46795,3.5,17.5,54760,24652,30108,7.4,16.5,3630,1,33,0,1549,1558,11055
1978,50,a) 0,1652,1657,10136,5082,1640,197.9,0,0,10109,10109,0,198.9,198.9,0,0,0,0,0,10109,198.9,0,0,,,
1978,50,b) 1,1351,1455,9636,9117,10,0.6,337,20.8,2867,38,2829,0.4,31.4,1829,885,944,9.7,20.1,1038,11.3,40.2,0,254,256,689
1978,50,l) Left Censored,8072,9111,137777,136934,262,2.8,951,10.1,22955,3729,19226,2.7,16.8,21268,11359,9909,8.3,15.5,1687,1.3,31,0,707,712,4284
1978,51,a) 0,10741,10820,53691,26953,10724,198.2,0,0,53477,53477,0,198.4,198.4,0,0,0,0,0,53477,198.4,0,0,,,
1978,51,b) 1,8663,9565,77005,74948,170,1.6,2775,25.4,23713,3057,20656,4.1,31.6,19598,11477,8121,15.3,26.1,4115,5.5,52.2,0,2096,2097,7545
1978,51,l) Left Censored,56134,71297,1345671,1331406,2747,3.7,7286,9.9,208690,37415,171275,2.8,15.7,180160,70808,109352,5.3,13.5,28530,2.2,27,0,4783,4809,34793
1978,53,a) 0,12420,12497,72978,36635,12365,197.9,0,0,72686,72686,0,198.4,198.4,0,0,0,0,0,72686,198.4,0,0,,,
1978,53,b) 1,9452,10505,86292,81306,154,1.3,3421,28.1,31845,1663,30182,2,39.2,21873,14133,7740,17.4,26.9,9972,12.3,53.8,0,2406,2409,9739
1978,53,l) Left Censored,47682,58667,1039894,995019,2501,4.1,7717,12.6,224800,30210,194590,3,22.6,135050,59472,75578,6,13.6,89750,9,27.2,0,4628,4649,31001
1978,54,a) 0,3357,3379,15219,7697,3325,196.8,0,0,15045,15045,0,195.5,195.5,0,0,0,0,0,15045,195.5,0,0,,,
1978,54,b) 1,2932,3190,22594,23238,32,0.9,1050,28.3,5401,269,5132,1.2,23.2,6688,3874,2814,16.7,28.8,-1287,-5.6,46.4,0,753,755,2465
1978,54,l) Left Censored,20633,24738,415698,431310,829,3.2,2706,10.5,52198,8379,43819,1.9,12.1,83423,20146,63277,4.7,19.3,-31225,-7.2,24.2,0,1725,1729,8815
1978,55,a) 0,10103,10223,54079,27140,10128,198.1,0,0,53878,53878,0,198.5,198.5,0,0,0,0,0,53878,198.5,0,0,,,
1978,55,b) 1,8493,9485,70048,67782,147,1.4,2177,20.7,18804,881,17923,1.3,27.7,14271,8888,5383,13.1,21.1,4533,6.6,42.2,0,1571,1572,5778
1978,55,l) Left Censored,60252,71329,1421462,1394422,2260,3.1,6945,9.4,198508,29178,169330,2.1,14.2,144430,58641,85789,4.2,10.4,54078,3.8,20.8,0,4790,4817,28983
1978,56,a) 0,1655,1658,8820,4411,1657,199.9,0,0,8819,8819,0,199.9,199.9,0,0,0,0,0,8819,199.9,0,0,,,
1978,56,b) 1,1282,1385,11129,10910,16,0.9,602,35.4,3880,387,3493,3.5,35.6,3442,2341,1101,21.5,31.5,438,4.1,63,0,394,394,1401
1978,56,l) Left Censored,6530,7588,104398,101185,310,3.8,1369,16.8,24498,4697,19801,4.6,24.2,18072,9924,8148,9.8,17.9,6426,6.3,35.8,0,785,787,4669
1979,01,a) 0,7378,7444,47054,23607,7391,198.6,0,0,46894,46894,0,198.6,198.6,0,0,0,0,0,46894,198.6,0,0,,,
1979,01,b) 1,5990,6249,45255,45886,59,0.8,2154,29.2,13662,901,12761,2,29.8,14923,8990,5933,19.6,32.5,-1261,-2.7,59.6,0,1788,1788,7701
1979,01,c) 2,5344,6098,54593,55897,302,4.5,1306,19.6,12560,2764,9796,4.9,22.5,15167,6885,8282,12.3,27.1,-2607,-4.6,45,0,993,997,5094
1979,01,l) Left Censored,36024,46170,935734,930364,1683,3.5,4646,9.7,145898,24313,121585,2.6,15.7,135158,48857,86301,5.3,14.5,10740,1.2,29,0,3118,3129,22936
1979,02,a) 0,1351,1372,7555,3783,1366,199.1,0,0,7544,7544,0,199.4,199.4,0,0,0,0,0,7544,199.4,0,0,,,
1979,02,b) 1,929,945,6267,6726,9,0.8,462,38.6,2176,101,2075,1.5,32.4,3093,2013,1080,29.9,46,-917,-13.6,64.8,0,354,354,1639
1979,02,c) 2,920,1060,12021,13936,87,7.6,243,21.2,2859,667,2192,4.8,20.5,6689,1514,5175,10.9,48,-3830,-27.5,41,0,163,163,1091
1979,02,l) Left Censored,3857,4923,82084,84403,346,6.8,694,13.5,16419,3463,12956,4.1,19.5,21057,8554,12503,10.1,24.9,-4638,-5.4,39,0,387,390,2830
1979,04,a) 0,7703,7795,50843,25956,7620,195.5,0,0,49774,49774,0,191.8,191.8,0,0,0,0,0,49774,191.8,0,0,,,
1979,04,b) 1,5553,5621,45673,43208,25,0.4,832,13.8,15185,237,14948,0.5,35.1,10255,4453,5802,10.3,23.7,4930,11.4,47.4,0,38,38,537
1979,04,c) 2,4473,5160,51522,49961,258,4.8,722,13.4,14483,2215,12268,4.4,29,11361,4562,6799,9.1,22.7,3122,6.3,45.4,0,21,25,478
1979,04,l) Left Censored,22584,30144,619422,594532,1320,4.3,2330,7.6,121802,23160,98642,3.9,20.5,72023,22153,49870,3.7,12.1,49779,8.4,24.2,0,59,69,437
1979,05,a) 0,5464,5532,30148,15285,5403,195.3,0,0,29726,29726,0,194.5,194.5,0,0,0,0,0,29726,194.5,0,0,,,
1979,05,b) 1,4349,4381,25318,25118,12,0.3,716,15.1,6709,140,6569,0.6,26.7,6309,2416,3893,9.6,25.1,400,1.6,50.2,1,10,11,
1979,05,c) 2,3585,3885,27612,28101,161,3.9,597,14.6,5596,962,4634,3.4,19.9,6573,2900,3673,10.3,23.4,-977,-3.5,39.8,1,3,3,
1979,05,l) Left Censored,23239,28186,519778,515210,861,3,2345,8.1,71879,12675,59204,2.5,14,62743,17285,45458,3.4,12.2,9136,1.8,24.4,0,54,60,2130
1979,06,a) 0,67068,67902,407192,204196,67539,198.9,0,0,405993,405993,0,198.8,198.8,0,0,0,0,0,405993,198.8,0,0,,,
1979,06,b) 1,49264,50174,367254,372964,345,0.6,15880,27.1,119926,3939,115987,1.1,32.2,131345,77846,53499,20.9,35.2,-11419,-3,64.4,0,12431,12447,64813
1979,06,c) 2,45099,52035,499845,499059,3872,6.9,10675,19.1,136736,29357,107379,5.9,27.4,135163,65673,69490,13.2,27.1,1573,0.3,54.2,0,7556,7578,42609
1979,06,l) Left Censored,236478,308569,6635163,6492470,18197,5.7,34072,10.7,1194088,280725,913363,4.3,18.4,908702,332087,576615,5.1,14,285386,4.4,28,0,21918,22068,150185
1979,08,a) 0,10320,10399,60241,30508,10211,196.4,0,0,59467,59467,0,194.9,194.9,0,0,0,0,0,59467,194.9,0,0,,,
1979,08,b) 1,7539,7603,52533,50531,27,0.3,1317,16,16439,1009,15430,2,32.5,12435,5605,6830,11.1,24.6,4004,7.9,49.2,0,25,27,458
1979,08,c) 2,6271,7035,63074,62709,276,3.7,1116,15,15622,2170,13452,3.5,24.9,14891,6759,8132,10.8,23.7,731,1.2,47.4,0,20,30,276
1979,08,l) Left Censored,32314,40622,810603,788938,1594,3.8,3615,8.7,143942,27722,116220,3.5,18.2,100612,35351,65261,4.5,12.8,43330,5.4,25.6,0,61,66,2690
1979,09,a) 0,6160,6204,31484,15751,6191,199.6,0,0,31467,31467,0,199.8,199.8,0,0,0,0,0,31467,199.8,0,0,,,
1979,09,b) 1,5162,5239,32558,32113,22,0.4,1241,21,9615,179,9436,0.6,29.9,8724,4069,4655,12.7,27.2,891,2.7,54.4,0,976,977,3352
1979,09,c) 2,5227,5807,47528,47559,286,4.7,851,13.9,10410,1765,8645,3.7,21.9,10472,4726,5746,9.9,22,-62,-0.1,43.8,0,601,601,2396
1979,09,l) Left Censored,40413,47589,1098797,1079081,1477,3,3937,8.1,148298,29590,118708,2.7,13.7,108865,36812,72053,3.4,10.1,39433,3.6,20.2,0,2584,2590,16260
1979,10,a) 0,1152,1163,6711,3362,1157,199,0,0,6699,6699,0,199.3,199.3,0,0,0,0,0,6699,199.3,0,0,,,
1979,10,b) 1,906,916,5775,5819,5,0.5,239,23,1767,39,1728,0.7,30.4,1854,1070,784,18.4,31.9,-87,-1.5,60.8,0,183,183,824
1979,10,c) 2,927,1085,9151,9208,44,3.8,194,16.6,1973,175,1798,1.9,21.4,2086,874,1212,9.5,22.7,-113,-1.3,42.8,0,143,150,684
1979,10,l) Left Censored,6944,8405,182960,195081,344,4,771,8.9,21189,4648,16541,2.4,10.9,45431,6228,39203,3.2,23.3,-24242,-12.4,21.8,0,483,487,2470
1979,11,a) 0,1373,1388,9438,4720,1387,199.9,0,0,9437,9437,0,199.9,199.9,0,0,0,0,0,9437,199.9,0,0,,,
1979,11,b) 1,1141,1151,11834,10227,13,1,292,22.5,5382,154,5228,1.5,52.6,2168,1155,1013,11.3,21.2,3214,31.4,42.4,0,228,228,946
1979,11,c) 2,1217,1375,29092,27490,78,5.3,234,16,6561,875,5686,3.2,23.9,3356,1347,2009,4.9,12.2,3205,11.7,24.4,0,155,155,789
1979,11,l) Left Censored,9656,11531,294445,288559,401,3.4,1080,9.1,43679,4832,38847,1.7,15.1,31906,12527,19379,4.3,11.1,11773,4,22.2,0,670,671,4810
1979,12,a) 0,28782,28995,167648,84149,28813,198.7,0,0,166999,166999,0,198.5,198.5,0,0,0,0,0,166999,198.5,0,0,,,
1979,12,b) 1,21579,21892,158395,159832,145,0.6,6938,27.1,51617,2257,49360,1.4,32.3,54490,32013,22477,20,34.1,-2873,-1.8,64.6,0,5732,5733,27383
1979,12,c) 2,18795,21118,189132,193753,1112,4.8,4576,19.9,46422,8175,38247,4.2,24,55663,28739,26924,14.8,28.7,-9241,-4.7,48,0,3494,3498,20888
1979,12,l) Left Censored,98271,128105,2268503,2232852,5907,4.5,13842,10.5,393289,88408,304881,4,17.6,321987,122083,199904,5.5,14.4,71302,3.2,28.8,0,9495,9597,66384
1979,13,a) 0,11492,11628,63774,32031,11527,198.3,0,0,63487,63487,0,198.2,198.2,0,0,0,0,0,63487,198.2,0,0,,,
1979,13,b) 1,9045,9194,61573,62968,80,0.7,3226,29.7,18210,1004,17206,1.6,28.9,20999,12689,8310,20.2,33.3,-2789,-4.4,57.8,0,2713,2713,10870
1979,13,c) 2,8403,9494,84020,84214,528,5.1,2018,19.6,20616,4521,16095,5.4,24.5,21004,10074,10930,12,24.9,-388,-0.4,49,0,1581,1584,7449
1979,13,l) Left Censored,53613,71084,1487550,1476420,3194,4.4,7007,9.6,225830,56322,169508,3.8,15.3,203569,66937,136632,4.5,13.8,22261,1.5,27.6,0,4483,4500,28450
1979,15,a) 0,2389,2424,15175,7614,2409,198.8,0,0,15122,15122,0,198.6,198.6,0,0,0,0,0,15122,198.6,0,0,,,
1979,15,b) 1,1814,1844,16141,15957,13,0.6,453,21.7,4307,140,4167,0.9,27,3939,1860,2079,11.7,24.7,368,2.3,49.4,0,357,357,1583
1979,15,c) 2,1615,2028,18949,19514,130,6.1,338,15.8,4017,821,3196,4.2,20.6,5146,2309,2837,11.8,26.4,-1129,-5.8,41.2,0,231,231,1172
1979,15,l) Left Censored,10358,13255,249277,244827,605,4.4,1261,9.3,40591,8124,32467,3.3,16.6,31690,11447,20243,4.7,12.9,8901,3.7,25.8,0,810,819,5820
1979,16,a) 0,2802,2825,16029,8207,2748,194.5,0,0,15644,,,,190.6,0,0,0,0,0,15644,190.6,0,1,,,
1979,16,b) 1,2173,2184,14277,14619,6,0.3,432,18,3144,,,,21.5,3827,1508,2319,10.3,26.2,-683,-4.7,43,1,9,9,23
1979,16,c) 2,1807,2000,14246,14517,77,3.6,315,14.9,3300,703,2597,4.8,22.7,3841,1561,2280,10.8,26.5,-541,-3.8,45.4,0,6,6,26
1979,16,l) Left Censored,10418,12995,228612,215237,426,3.2,981,7.4,56805,32126,24679,14.9,26.4,30055,8725,21330,4.1,14,26750,12.4,28,0,18,19,320
1979,17,a) 0,19822,20000,122729,61591,19871,198.7,0,0,122276,122276,0,198.5,198.5,0,0,0,0,0,122276,198.5,0,0,,,
1979,17,b) 1,16692,16992,118057,119340,86,0.4,4486,23.1,31540,1748,29792,1.5,26.4,34106,17126,16980,14.4,28.6,-2566,-2.2,52.8,0,3587,3588,14096
1979,17,c) 2,16253,18476,173363,177212,839,4.2,3396,17.1,34151,6552,27599,3.7,19.3,41848,19047,22801,10.7,23.6,-7697,-4.3,38.6,0,2411,2412,12005
1979,17,l) Left Censored,126709,154834,3842116,3805761,5651,3.5,15486,9.7,561600,103569,458031,2.7,14.8,488891,176653,312238,4.6,12.8,72709,2,25.6,0,10192,10243,73119
1979,18,a) 0,9646,9728,50773,25453,9662,198.6,0,0,50641,50641,0,199,199,0,0,0,0,0,50641,199,0,0,,,
1979,18,b) 1,7924,8093,56947,55727,54,0.6,2321,24.9,18278,1326,16952,2.4,32.8,15837,8303,7534,14.9,28.4,2441,4.4,56.8,0,1888,1896,6846
1979,18,c) 2,7449,8578,76824,77521,423,4.6,1553,16.9,16780,2820,13960,3.6,21.6,18174,8810,9364,11.4,23.4,-1394,-1.8,43.2,0,1173,1181,6354
1979,18,l) Left Censored,56888,72549,1705273,1699521,2478,3.3,6742,9,220958,40234,180724,2.4,13,209454,62460,146994,3.7,12.3,11504,0.7,24.6,0,4507,4524,28385
1979,19,a) 0,6252,6387,34494,17298,6345,198.7,0,0,34393,34393,0,198.8,198.8,0,0,0,0,0,34393,198.8,0,0,,,
1979,19,b) 1,5570,5642,34787,35765,39,0.6,1634,25.2,8840,474,8366,1.3,24.7,10795,5853,4942,16.4,30.2,-1955,-5.5,49.4,0,1315,1315,4769
1979,19,c) 2,5432,6091,45870,47616,248,3.8,1147,17.4,8645,1603,7042,3.4,18.2,12137,6169,5968,13,25.5,-3492,-7.3,36.4,0,889,890,4312
1979,19,l) Left Censored,38564,47422,802100,795230,1303,2.6,4818,9.8,106654,15937,90717,2,13.4,92913,33573,59340,4.2,11.7,13741,1.7,23.4,0,3282,3342,17759
1979,20,a) 0,5674,5710,29999,15068,5661,198.3,0,0,29863,29863,0,198.2,198.2,0,0,0,0,0,29863,198.2,0,0,,,
1979,20,b) 1,4744,4788,28461,30375,17,0.3,1460,26.3,7490,99,7391,0.3,24.7,11318,5784,5534,19,37.3,-3828,-12.6,49.4,0,1200,1200,4931
1979,20,c) 2,4456,4976,39004,39542,212,3.9,1011,18.7,9149,2208,6941,5.6,23.1,10225,4986,5239,12.6,25.9,-1076,-2.8,46.2,0,736,737,3312
1979,20,l) Left Censored,31391,38573,648371,637841,1322,3.3,3749,9.4,98543,14258,84285,2.2,15.4,77482,29126,48356,4.6,12.1,21061,3.3,24.2,0,2512,2523,13778
1979,21,a) 0,6631,6693,38524,19293,6664,199.1,0,0,38462,38462,0,199.4,199.4,0,0,0,0,0,38462,199.4,0,0,,,
1979,21,b) 1,5278,5334,36737,37336,31,0.5,1737,27.8,10320,292,10028,0.8,27.6,11517,6585,4932,17.6,30.8,-1197,-3.2,55.2,0,1465,1465,5534
1979,21,c) 2,4929,5515,44352,43864,281,4.7,1051,17.7,11651,3400,8251,7.8,26.6,10675,5395,5280,12.3,24.3,976,2.3,48.6,0,819,819,3847
1979,21,l) Left Censored,35412,43858,893214,884345,1622,3.6,4218,9.3,136218,25282,110936,2.9,15.4,118479,39875,78604,4.5,13.4,17739,2,26.8,0,2867,2880,19656
1979,22,a) 0,9312,9401,59560,30136,9214,196,0,0,58849,58849,0,195.3,195.3,0,0,0,0,0,58849,195.3,0,0,,,
1979,22,b) 1,6890,6925,58387,53899,15,0.2,973,13.1,21859,242,21617,0.4,40.6,12882,4707,8175,8.7,23.9,8977,16.7,47.8,1,5,5,
1979,22,c) 2,5856,6544,62541,61916,257,3.7,918,13.4,16707,3466,13241,5.6,27,15456,6949,8507,11.2,25,1251,2,50,1,17,18,
1979,22,l) Left Censored,40305,51378,1035341,1019514,1730,3.3,3622,6.9,163210,26751,136459,2.6,16,131555,39026,92529,3.8,12.9,31655,3.1,25.8,0,35,53,1109
1979,23,a) 0,2382,2398,11486,5755,2386,199,0,0,11462,11462,0,199.2,199.2,0,0,0,0,0,11462,199.2,0,0,,,
1979,23,b) 1,2123,2149,11742,11838,15,0.6,623,25.1,3266,212,3054,1.8,27.6,3457,1921,1536,16.2,29.2,-191,-1.6,55.2,0,486,486,1550
1979,23,c) 2,1912,2140,17421,17515,86,3.7,395,17.1,3115,728,2387,4.2,17.8,3303,1423,1880,8.1,18.9,-188,-1.1,35.6,0,275,275,856
1979,23,l) Left Censored,13457,16116,276273,277818,565,3.4,1573,9.4,35737,6974,28763,2.5,12.9,38826,11763,27063,4.2,14,-3089,-1.1,25.8,0,1083,1089,6174
1979,24,a) 0,7179,7255,38831,19531,7215,198.9,0,0,38600,38600,0,197.6,197.6,0,0,0,0,0,38600,197.6,0,0,,,
1979,24,b) 1,5634,5738,42565,40668,47,0.7,1698,25.6,15516,674,14842,1.7,38.2,11721,6743,4978,16.6,28.8,3795,9.4,57.6,0,1330,1332,5146
1979,24,c) 2,5726,6467,56400,57292,352,5.1,1228,17.7,13031,2316,10715,4,22.7,14815,6481,8334,11.3,25.9,-1784,-3.2,45.4,0,876,878,4157
1979,24,l) Left Censored,41490,52441,1091541,1083877,2138,4,4955,9.2,155535,31805,123730,2.9,14.3,140207,52102,88105,4.8,12.9,15328,1.4,25.8,0,3239,3270,20646
1979,25,a) 0,9976,10071,57286,28699,10011,198.8,0,0,57174,57174,0,199.2,199.2,0,0,0,0,0,57174,199.2,0,0,,,
1979,25,b) 1,8257,8434,64469,61325,79,0.8,2013,21.2,21230,2024,19206,3.3,34.6,14942,8281,6661,13.5,24.4,6288,10.2,48.8,0,1598,1599,6199
1979,25,c) 2,7963,9112,106890,109028,447,4.6,1564,16.1,22056,3405,18651,3.1,20.2,26332,9815,16517,9,24.2,-4276,-4,40.4,0,1133,1135,4902
1979,25,l) Left Censored,70711,84714,1976897,1950983,2715,3.1,7340,8.4,286086,53058,233028,2.7,14.7,234259,70402,163857,3.6,12,51827,2.7,24,0,4775,4799,34622
1979,26,a) 0,15260,15423,85917,43073,15324,198.7,0,0,85688,85688,0,198.9,198.9,0,0,0,0,0,85688,198.9,0,0,,,
1979,26,b) 1,12875,13096,118141,117027,74,0.5,3405,22.9,27598,1045,26553,0.9,23.6,25369,13814,11555,11.8,21.7,2229,1.9,43.4,0,2663,2663,11226
1979,26,c) 2,12228,14032,129760,129331,704,4.7,2402,16.1,29260,4595,24665,3.6,22.6,28401,13089,15312,10.1,22,859,0.6,44,0,1722,1727,7958
1979,26,l) Left Censored,87609,110743,2730204,2695848,4092,3.6,10871,9.5,367558,70060,297498,2.6,13.6,298846,99557,199289,3.7,11.1,68712,2.5,22.2,0,7126,7180,49965
1979,27,a) 0,8571,8685,54804,28125,8622,198.5,0,0,53358,53358,0,189.7,189.7,0,0,0,0,0,53358,189.7,0,0,,,
1979,27,b) 1,7116,7218,52609,51344,50,0.6,1719,21.1,16040,1623,14417,3.2,31.2,13509,7120,6389,13.9,26.3,2531,4.9,52.6,0,1326,1326,5663
1979,27,c) 2,6629,7494,70142,71702,271,3.4,1324,16.4,14941,2238,12703,3.1,20.8,18061,8265,9796,11.5,25.2,-3120,-4.4,41.6,0,991,994,4768
1979,27,l) Left Censored,47067,58103,1295790,1271907,1889,3.1,5455,9.1,199754,34819,164935,2.7,15.7,151990,50668,101322,4,11.9,47764,3.8,23.8,0,3603,3620,22972
1979,28,a) 0,5042,5083,28065,14082,5032,198,0,0,27966,27966,0,198.6,198.6,0,0,0,0,0,27966,198.6,0,0,,,
1979,28,b) 1,3678,3707,24775,26142,17,0.4,1251,28.6,6010,158,5852,0.6,23,8743,5086,3657,19.5,33.4,-2733,-10.4,46,0,1047,1047,4353
1979,28,c) 2,3562,4034,33501,33623,293,6.8,763,17.7,7809,1862,5947,5.5,23.2,8052,3402,4650,10.1,23.9,-243,-0.7,46.4,0,580,580,2539
1979,28,l) Left Censored,23906,29741,560021,552819,1304,4.3,2978,9.7,88914,15373,73541,2.8,16.1,74509,26004,48505,4.7,13.5,14405,2.6,27,0,2107,2118,12653
1979,29,a) 0,10328,10421,57008,28581,10364,198.9,0,0,56854,56854,0,198.9,198.9,0,0,0,0,0,56854,198.9,0,0,,,
1979,29,b) 1,8297,8386,56101,58050,42,0.4,2671,27.3,15763,657,15106,1.1,27.2,19661,12639,7022,21.8,33.9,-3898,-6.7,54.4,0,2196,2196,11147
1979,29,c) 2,7832,8776,73580,75830,407,4.3,1644,17.4,15131,2923,12208,3.9,20,19630,9788,9842,12.9,25.9,-4499,-5.9,40,0,1226,1228,6160
1979,29,l) Left Censored,56034,70595,1495135,1473248,2528,3.5,7025,9.6,218422,34745,183677,2.4,14.8,174648,59152,115496,4,11.9,43774,2.9,23.8,0,4557,4616,25779
1979,30,a) 0,2868,2893,15012,7619,2819,194.9,0,0,14786,14786,0,194.1,194.1,0,0,0,0,0,14786,194.1,0,0,,,
1979,30,b) 1,2109,2127,13757,13937,12,0.5,358,15.6,3368,39,3329,0.3,24.2,3728,1467,2261,10.5,26.7,-360,-2.5,48.4,1,2,2,
1979,30,c) 2,1896,2087,14401,14353,98,4.5,305,13.9,3319,378,2941,2.6,23.1,3223,1317,1906,9.2,22.5,96,0.6,45,1,4,4,
1979,30,l) Left Censored,10798,12982,185126,177033,383,2.9,1026,7.7,36859,4109,32750,2.3,20.8,20673,5972,14701,3.4,11.7,16186,9.1,23.4,0,15,15,199
1979,31,a) 0,3755,3791,19166,9597,3779,199.4,0,0,19138,19138,0,199.4,199.4,0,0,0,0,0,19138,199.4,0,0,,,
1979,31,b) 1,3103,3143,20687,20476,17,0.5,861,23.9,5640,598,5042,2.9,27.5,5217,2977,2240,14.5,25.5,423,2,51,0,674,674,2259
1979,31,c) 2,3068,3388,24088,24486,139,3.8,655,17.9,4943,794,4149,3.2,20.2,5738,3111,2627,12.7,23.4,-795,-3.2,40.4,0,468,468,2028
1979,31,l) Left Censored,22403,26912,436657,436020,676,2.4,2532,9.1,62638,6984,55654,1.6,14.4,61363,16708,44655,3.8,14.1,1275,0.3,28.2,0,1654,1660,8265
1979,32,a) 0,2972,2987,22314,11246,2920,195.5,0,0,22137,22137,0,196.8,196.8,0,0,0,0,0,22137,196.8,0,0,,,
1979,32,b) 1,2014,2066,20638,19434,6,0.3,339,15.2,7414,32,7382,0.2,38.1,5006,1944,3062,10,25.8,2408,12.3,51.6,0,22,22,172
1979,32,c) 2,1619,1815,22244,21889,80,4.2,249,13.1,5072,665,4407,3,23.2,4362,1612,2750,7.4,19.9,710,3.3,39.8,0,13,13,106
1979,32,l) Left Censored,8070,9923,256538,242922,547,5.5,777,7.8,55346,14864,40482,6.1,22.8,28113,9444,18669,3.9,11.6,27233,11.2,23.2,0,55,56,564
1979,33,a) 0,2339,2359,12449,6235,2347,199,0,0,12428,12428,0,199.3,199.3,0,0,0,0,0,12428,199.3,0,0,,,
1979,33,b) 1,1993,2009,12364,12378,12,0.5,594,25.6,3532,206,3326,1.7,28.5,3559,1931,1628,15.6,28.8,-27,-0.3,57,0,456,456,1516
1979,33,c) 2,1817,2005,16706,16459,88,4.1,340,15.9,3770,536,3234,3.3,22.9,3276,1590,1686,9.7,19.9,494,3,39.8,0,252,252,1107
1979,33,l) Left Censored,11778,13685,279327,272953,493,3.5,1263,9,43812,6338,37474,2.3,16.1,31063,10495,20568,3.8,11.4,12749,4.7,22.8,0,870,876,4828
1979,34,a) 0,14957,15050,71935,36100,14954,198.7,0,0,71671,71671,0,198.5,198.5,0,0,0,0,0,71671,198.5,0,0,,,
1979,34,b) 1,11623,11754,71330,69733,53,0.4,3037,22.7,23251,1261,21990,1.8,33.3,20057,10524,9533,15.1,28.8,3194,4.5,57.6,0,2310,2311,8299
1979,34,c) 2,11697,12544,98022,98460,666,5,2157,16.1,22195,3770,18425,3.8,22.5,23070,10806,12264,11,23.4,-875,-0.9,45,0,1596,1599,7848
1979,34,l) Left Censored,91931,108707,2264962,2248416,3884,3.5,9897,8.8,331957,73755,258202,3.3,14.8,298866,100135,198731,4.5,13.3,33091,1.5,26.6,0,6390,6413,40719
1979,35,a) 0,3711,3761,22475,11372,3680,195.7,0,0,22207,22207,0,195.3,195.3,0,0,0,0,0,22207,195.3,0,0,,,
1979,35,b) 1,2689,2712,18304,17995,10,0.3,442,15.1,5642,188,5454,1,31.4,5024,1897,3127,10.5,27.9,618,3.5,55.8,1,13,13,
1979,35,c) 2,2399,2659,20290,20715,113,4,421,15,4626,633,3993,3.1,22.3,5475,2177,3298,10.5,26.4,-849,-4.1,44.6,1,3,3,
1979,35,l) Left Censored,13211,16446,266672,261205,656,3.9,1446,8.6,45917,8730,37187,3.3,17.6,34983,12669,22314,4.9,13.4,10934,4.2,26.8,0,20,25,745
1979,36,a) 0,33953,34132,174374,87789,33932,198.8,0,0,173171,173171,0,197.3,197.3,0,0,0,0,0,173171,197.3,0,0,,,
1979,36,b) 1,28180,28513,181299,180003,137,0.4,7139,22.1,57626,4386,53240,2.4,32,55033,25931,29102,14.4,30.6,2593,1.4,61.2,0,5706,5706,20124
1979,36,c) 2,26930,29620,249193,254897,1331,4.2,5372,16.9,55325,9560,45765,3.8,21.7,66733,27685,39048,10.9,26.2,-11408,-4.5,43.4,0,4144,4157,20300
1979,36,l) Left Censored,225353,263220,5294144,5307784,7614,2.8,27073,9.9,731316,128178,603138,2.4,13.8,758596,255209,503387,4.8,14.3,-27280,-0.5,27.6,0,19105,19206,122181
1979,37,a) 0,11711,11801,60550,30344,11730,198.8,0,0,60413,60413,0,199.1,199.1,0,0,0,0,0,60413,199.1,0,0,,,
1979,37,b) 1,9394,9547,59548,60804,65,0.6,3115,27.8,17583,1154,16429,1.9,28.9,20095,12315,7780,20.3,33,-2512,-4.1,57.8,0,2543,2543,10045
1979,37,c) 2,8441,9474,81188,82103,406,4,1831,17.9,16420,1836,14584,2.2,20,18249,9737,8512,11.9,22.2,-1829,-2.2,40,0,1408,1408,6580
1979,37,l) Left Censored,59819,77784,1767908,1737266,2862,3.6,6963,8.7,244688,51446,193242,3,14.1,183404,63935,119469,3.7,10.6,61284,3.5,21.2,0,4665,4685,28139
1979,38,a) 0,1822,1837,9630,4847,1829,199.1,0,0,9567,9567,0,197.4,197.4,0,0,0,0,0,9567,197.4,0,0,,,
1979,38,b) 1,1375,1383,7713,7930,6,0.4,411,25.6,1860,59,1801,0.7,23.5,2293,1264,1029,15.9,28.9,-433,-5.4,47,0,320,320,1082
1979,38,c) 2,1359,1440,10033,10572,64,4.1,286,18.4,1999,357,1642,3.4,18.9,3077,1660,1417,15.7,29.1,-1078,-10.2,37.8,0,202,202,885
1979,38,l) Left Censored,9411,11116,150116,146587,359,3.1,1034,9,25639,4368,21271,3,17.5,18580,6499,12081,4.4,12.7,7059,4.8,25.4,0,725,726,4626
1979,39,a) 0,17538,17708,100993,50687,17602,198.8,0,0,100612,100612,0,198.5,198.5,0,0,0,0,0,100612,198.5,0,0,,,
1979,39,b) 1,14105,14326,97515,96344,100,0.6,3951,24.1,29889,1675,28214,1.7,31,27547,16637,10910,17.3,28.6,2342,2.4,57.2,0,3138,3139,13180
1979,39,c) 2,13795,16135,139526,139574,746,4.3,2662,15.5,29688,5553,24135,4,21.3,29783,14230,15553,10.2,21.3,-95,0,42.6,0,1891,1892,9041
1979,39,l) Left Censored,111421,147469,3497814,3462011,5516,3.6,13603,9,465330,91343,373987,2.6,13.4,393724,137143,256581,4,11.4,71606,2,22.8,0,8321,8371,53287
1979,40,a) 0,8346,8423,48370,24418,8272,196.4,0,0,47904,47904,0,196.2,196.2,0,0,0,0,0,47904,196.2,0,0,,,
1979,40,b) 1,6215,6278,43105,42714,19,0.3,1010,14.9,11652,175,11477,0.4,27.3,10870,4681,6189,11,25.4,782,1.9,50.8,0,18,18,368
1979,40,c) 2,5190,5778,48616,49216,286,4.7,877,14.5,10454,1550,8904,3.1,21.2,11654,5403,6251,11,23.7,-1200,-2.5,42.4,0,9,9,91
1979,40,l) Left Censored,32821,40926,726598,705758,1415,3.4,3104,7.5,126517,21715,104802,3.1,17.9,84836,26893,57943,3.8,12,41681,5.9,24,0,64,71,776
1979,41,a) 0,8408,8476,44925,22505,8434,199,0,0,44840,44840,0,199.2,199.2,0,0,0,0,0,44840,199.2,0,0,,,
1979,41,b) 1,6468,6529,41864,43483,23,0.3,2349,30.2,11940,390,11550,0.9,27.5,15178,8773,6405,20.2,34.9,-3238,-7.4,55,0,1876,1876,7106
1979,41,c) 2,5613,6293,53682,57520,409,6,1388,20.3,11822,2728,9094,4.7,20.6,19498,7729,11769,13.4,33.9,-7676,-13.3,41.2,0,1018,1022,5284
1979,41,l) Left Censored,30647,37989,730778,710173,1878,4.8,4136,10.5,144320,24072,120248,3.4,20.3,103110,36350,66760,5.1,14.5,41210,5.8,29,0,2787,2791,17713
1979,42,a) 0,18390,18636,100153,50257,18516,198.7,0,0,99793,99793,0,198.6,198.6,0,0,0,0,0,99793,198.6,0,0,,,
1979,42,b) 1,15270,15508,109428,107401,113,0.6,3846,21.9,32386,1760,30626,1.6,30.2,28331,14104,14227,13.1,26.4,4055,3.8,52.8,0,3015,3018,10816
1979,42,c) 2,15273,17340,152952,153245,845,4.6,2833,15.4,32442,6262,26180,4.1,21.2,33028,14358,18670,9.4,21.6,-586,-0.4,42.4,0,2016,2020,9222
1979,42,l) Left Censored,129675,162897,3644664,3649971,5331,3.2,14320,8.5,473737,81397,392340,2.2,13,484353,146699,337654,4,13.3,-10616,-0.3,26,0,9363,9427,58871
1979,44,a) 0,1887,1899,10148,5078,1892,199.3,0,0,10140,10140,0,199.7,199.7,0,0,0,0,0,10140,199.7,0,0,,,
1979,44,b) 1,1541,1557,11932,12236,11,0.6,402,22.7,3663,74,3589,0.6,29.9,4270,1733,2537,14.2,34.9,-607,-5,59.8,0,322,322,1342
1979,44,c) 2,1563,1661,13182,12861,73,4.1,288,16.2,3326,805,2521,6.3,25.9,2683,1127,1556,8.8,20.9,643,5,41.8,0,210,210,806
1979,44,l) Left Censored,13285,15163,306896,307529,478,3.1,1228,7.9,40972,7767,33205,2.5,13.3,42237,11505,30732,3.7,13.7,-1265,-0.4,26.6,0,808,810,5222
1979,45,a) 0,5726,5780,30341,15247,5734,198.4,0,0,30188,30188,0,198,198,0,0,0,0,0,30188,198,0,0,,,
1979,45,b) 1,4750,4804,34231,34640,20,0.4,1591,28.1,9364,274,9090,0.8,27,10181,6084,4097,17.6,29.4,-817,-2.4,54,0,1298,1298,4761
1979,45,c) 2,4248,4697,33409,35303,218,4.2,1058,20.5,6799,1249,5550,3.5,19.3,10587,5417,5170,15.3,30,-3788,-10.7,38.6,0,809,822,4067
1979,45,l) Left Censored,29634,37745,866133,854036,1416,3.6,3506,9,117889,20744,97145,2.4,13.8,93694,26782,66912,3.1,11,24195,2.8,22,0,2416,2437,13367
1979,46,a) 0,1765,1782,9630,4831,1769,198.5,0,0,9599,9599,0,198.7,198.7,0,0,0,0,0,9599,198.7,0,0,,,
1979,46,b) 1,1525,1537,8735,9022,6,0.3,442,25,2391,49,2342,0.5,26.5,2965,1576,1389,17.5,32.9,-574,-6.4,53,0,340,340,1331
1979,46,c) 2,1356,1484,10523,10972,69,4.3,287,17.9,2345,362,1983,3.3,21.4,3242,1913,1329,17.4,29.5,-897,-8.1,42.8,0,221,221,918
1979,46,l) Left Censored,9908,11609,156715,153367,410,3.4,1139,9.5,25157,4788,20369,3.1,16.4,18461,6412,12049,4.2,12,6696,4.4,24,0,766,767,3890
1979,47,a) 0,9335,9429,51828,25997,9382,199,0,0,51663,51663,0,198.7,198.7,0,0,0,0,0,51663,198.7,0,0,,,
1979,47,b) 1,7157,7250,50591,51319,53,0.6,2559,29.8,15963,695,15268,1.4,31.1,17419,10473,6946,20.4,33.9,-1456,-2.8,62.2,0,2130,2130,9058
1979,47,c) 2,6839,7763,76748,75079,397,4.7,1649,19.5,23313,3383,19930,4.5,31.1,19975,8665,11310,11.5,26.6,3338,4.5,53.2,0,1230,1230,5946
1979,47,l) Left Censored,44992,57362,1279616,1269477,2165,3.6,5895,9.9,184060,41073,142987,3.2,14.5,163782,53669,110113,4.2,12.9,20278,1.6,25.8,0,3827,3839,23241
1979,48,a) 0,38634,39251,250206,126830,38408,195.7,0,0,246753,246753,0,194.6,194.6,0,0,0,0,0,246753,194.6,0,0,,,
1979,48,b) 1,28123,28674,216464,210213,179,0.6,4562,14.8,67153,2894,64259,1.4,31.9,54650,23142,31508,11,26,12503,5.9,52,0,48,49,740
1979,48,c) 2,23618,27281,248415,248334,1235,4.3,3682,13,59893,10722,49171,4.3,24.1,59730,24019,35711,9.7,24.1,163,0,48.2,0,42,46,737
1979,48,l) Left Censored,138199,186845,3962100,3865905,7768,4.1,13984,7.4,716428,158508,557920,4.1,18.5,524038,152386,371652,3.9,13.6,192390,4.9,27.2,0,218,286,7965
1979,49,a) 0,3790,3834,23335,11784,3764,196.3,0,0,23102,23102,0,196,196,0,0,0,0,0,23102,196,0,0,,,
1979,49,b) 1,2912,2935,22069,21889,12,0.4,472,14.9,6471,280,6191,1.3,29.6,6110,2152,3958,9.8,27.9,361,1.7,55.8,0,8,10,122
1979,49,c) 2,2525,2787,22098,22202,122,4.2,378,13,5599,1377,4222,6.2,25.2,5807,2016,3791,9.1,26.2,-208,-1,50.4,0,6,6,41
1979,49,l) Left Censored,13878,17175,345260,339215,676,3.9,1176,6.8,56742,12380,44362,3.6,16.7,44651,13557,31094,4,13.2,12091,3.5,26.4,0,24,27,489
1979,50,a) 0,1449,1460,6882,3452,1450,198.6,0,0,6861,,,,198.8,0,0,0,0,0,6861,198.8,0,1,,,
1979,50,b) 1,1289,1295,7755,8860,3,0.2,340,23.1,2090,,,,23.6,4299,1192,3107,13.5,48.5,-2209,-24.9,47.2,1,271,271,892
1979,50,c) 2,1177,1292,9307,9453,63,4.6,217,15.8,1837,358,1479,3.8,19.4,2129,875,1254,9.3,22.5,-292,-3.1,38.8,0,168,168,626
1979,50,l) Left Censored,7428,8511,140409,139077,241,2.7,803,9.1,19483,3150,16333,2.3,14,16818,6110,10708,4.4,12.1,2665,1.9,24.2,0,601,607,3879
1979,51,a) 0,9979,10060,54296,27206,10010,199,0,0,54180,54180,0,199.1,199.1,0,0,0,0,0,54180,199.1,0,0,,,
1979,51,b) 1,8021,8172,55671,54567,75,0.8,2584,27.2,18879,708,18171,1.3,34.6,16670,10151,6519,18.6,30.5,2209,4.1,61,0,2109,2109,8595
1979,51,c) 2,7341,8301,77014,78575,430,4.8,1571,17.6,17446,3106,14340,4,22.2,20569,8994,11575,11.4,26.2,-3123,-4,44.4,0,1207,1207,5532
1979,51,l) Left Censored,51742,67416,1363662,1352189,2591,3.7,6223,9,196763,41438,155325,3.1,14.6,173819,54558,119261,4,12.9,22944,1.7,25.8,0,4084,4107,23257
1979,53,a) 0,11622,11707,64741,32430,11647,199,0,0,64623,64623,0,199.3,199.3,0,0,0,0,0,64623,199.3,0,0,,,
1979,53,b) 1,9046,9163,62258,67853,53,0.5,3095,28.6,19878,914,18964,1.3,29.3,31068,11413,19655,16.8,45.8,-11190,-16.5,58.6,0,2365,2365,9065
1979,53,c) 2,8109,9153,75630,80607,610,6.2,1834,18.6,18040,3623,14417,4.5,22.4,27993,9529,18464,11.8,34.7,-9953,-12.3,44.8,0,1287,1290,6299
1979,53,l) Left Censored,44194,55377,1015292,1026145,3018,5.3,5962,10.5,184994,35635,149359,3.5,18,206700,77898,128802,7.6,20.1,-21706,-2.1,36,0,3829,3858,25115
1979,54,a) 0,3287,3310,16335,8195,3284,198.4,0,0,16280,16280,0,198.7,198.7,0,0,0,0,0,16280,198.7,0,0,,,
1979,54,b) 1,2450,2479,16561,15861,15,0.5,847,28.9,5951,403,5548,2.5,37.5,4551,2664,1887,16.8,28.7,1400,8.8,57.4,0,681,681,2158
1979,54,c) 2,2500,2765,23363,22943,150,5,525,17.6,5852,735,5117,3.2,25.5,5012,2580,2432,11.2,21.8,840,3.7,43.6,0,408,411,1632
1979,54,l) Left Censored,19054,23291,471318,442951,915,3.8,2207,9.2,104742,11826,92916,2.7,23.6,48008,15602,32406,3.5,10.8,56734,12.8,21.6,0,1440,1444,7098
1979,55,a) 0,8844,8919,47435,23767,8874,199,0,0,47336,47336,0,199.2,199.2,0,0,0,0,0,47336,199.2,0,0,,,
1979,55,b) 1,8004,8141,54866,55533,31,0.3,1979,21.5,13054,532,12522,1,23.5,14387,7629,6758,13.7,25.9,-1333,-2.4,47,0,1524,1525,6040
1979,55,c) 2,7380,8378,68233,69041,375,4.2,1410,15.8,14111,2851,11260,4.1,20.4,15726,7739,7987,11.2,22.8,-1615,-2.4,40.8,0,981,987,4963
1979,55,l) Left Censored,55940,67338,1451179,1435119,2089,3,5811,8.4,185118,31696,153422,2.2,12.9,152999,48298,104701,3.4,10.7,32119,2.2,21.4,0,3939,3951,22298
1979,56,a) 0,1872,1889,10759,5437,1854,196.3,0,0,10644,10644,0,195.8,195.8,0,0,0,0,0,10644,195.8,0,0,,,
1979,56,b) 1,1429,1435,9956,9755,4,0.3,232,15,2987,50,2937,0.5,30.6,2584,921,1663,9.4,26.5,403,4.1,53,0,4,4,28
1979,56,c) 2,1147,1252,10989,11075,46,3.5,182,13.8,2532,391,2141,3.5,22.9,2703,1040,1663,9.4,24.4,-171,-1.5,45.8,0,5,6,109
1979,56,l) Left Censored,6203,7339,107662,105782,322,4.3,601,8.1,19730,4407,15323,4.2,18.7,15969,4584,11385,4.3,15.1,3761,3.6,30.2,0,16,16,135
1980,01,a) 0,6688,6757,36160,18214,6681,197.8,0,0,35892,35892,0,197.1,197.1,0,0,0,0,0,35892,197.1,0,0,,,
1980,01,b) 1,5349,5470,43090,45040,33,0.5,1892,29.2,10519,811,9708,1.8,23.4,14419,7745,6674,17.2,32,-3900,-8.6,46.8,0,1562,1565,6496
1980,01,c) 2,4907,5177,42673,43750,220,3.9,1230,21.6,10600,1328,9272,3,24.2,12753,6093,6660,13.9,29.1,-2153,-4.9,48.4,0,1008,1009,4981
1980,01,d) 3,4572,5313,46864,50334,249,4.4,994,17.4,8249,2088,6161,4.1,16.4,15189,6905,8284,13.7,30.2,-6940,-13.8,32.8,0,711,711,3874
1980,01,l) Left Censored,32999,43151,911893,923361,1462,3.3,4312,9.7,114334,21242,93092,2.3,12.4,137272,37316,99956,4,14.9,-22938,-2.5,24.8,0,2791,2801,18404
1980,02,a) 0,1152,1158,5751,2892,1147,198.1,0,0,5719,5719,0,197.8,197.8,0,0,0,0,0,5719,197.8,0,0,,,
1980,02,b) 1,957,986,6472,6876,15,1.3,346,29.4,2192,118,2074,1.7,31.9,2999,1547,1452,22.5,43.6,-807,-11.7,63.8,0,262,262,1278
1980,02,c) 2,771,791,5425,5841,46,5.3,196,22.6,1209,171,1038,2.9,20.7,2040,934,1106,16,34.9,-831,-14.2,41.4,0,157,157,800
1980,02,d) 3,752,887,12480,12236,48,4.9,207,21.2,2992,484,2508,4,24.5,2503,973,1530,8,20.5,489,4,41,0,127,130,581
1980,02,l) Left Censored,3448,4506,78236,80072,225,4.8,597,12.7,12322,2571,9751,3.2,15.4,15993,4434,11559,5.5,20,-3671,-4.6,30.8,0,340,343,1947
1980,04,a) 0,7682,7722,44664,22494,7674,198.8,0,0,44340,44340,0,197.1,197.1,0,0,0,0,0,44340,197.1,0,0,,,
1980,04,b) 1,5778,5889,44834,47808,47,0.7,1813,26.5,12787,533,12254,1.1,26.7,18734,9376,9358,19.6,39.2,-5947,-12.5,53.4,0,1507,1508,8041
1980,04,c) 2,4512,4570,36919,40809,148,2.9,1112,21.8,7557,1047,6510,2.6,18.5,15337,7316,8021,17.9,37.6,-7780,-19.1,37,0,903,903,5615
1980,04,d) 3,3790,4476,45644,48303,199,4.1,843,17.5,8537,1720,6817,3.6,17.7,13854,5433,8421,11.2,28.7,-5317,-11,35.4,0,597,599,3739
1980,04,l) Left Censored,20600,28473,629915,624680,1309,4.5,2892,9.9,99572,24807,74765,4,15.9,89102,26541,62561,4.2,14.3,10470,1.6,28.6,0,1758,1767,11379
1980,05,a) 0,4673,4716,24857,12498,4675,198.3,0,0,24718,24718,0,197.8,197.8,0,0,0,0,0,24718,197.8,0,0,,,
1980,05,b) 1,4025,4109,26658,28162,31,0.6,1361,28.2,6282,737,5545,2.6,22.3,9289,4507,4782,16,33,-3007,-10.7,44.6,0,1117,1117,3899
1980,05,c) 2,3530,3575,22117,23673,106,2.7,857,21.6,4311,351,3960,1.5,18.2,7423,3722,3701,15.7,31.4,-3112,-13.2,36.4,0,697,699,3086
1980,05,d) 3,3067,3360,25480,26570,113,3.1,633,17.5,4420,578,3842,2.2,16.6,6600,2999,3601,11.3,24.8,-2180,-8.2,33.2,0,460,460,1872
1980,05,l) Left Censored,21320,26193,520989,520288,698,2.6,2606,9.6,72727,9861,62866,1.9,14,71324,20676,50648,4,13.7,1403,0.3,27.4,0,1697,1705,8889
1980,06,a) 0,64672,65354,378002,189804,64822,198.4,0,0,376396,376396,0,198.3,198.3,0,0,0,0,0,376396,198.3,0,0,,,
1980,06,b) 1,50311,51367,375143,390517,333,0.6,15532,26,113356,5530,107826,1.4,29,144104,77120,66984,19.7,36.9,-30748,-7.9,58,0,12263,12287,62653
1980,06,c) 2,41026,42035,345048,354486,2057,4.5,9711,21.1,95109,28531,66578,8,26.8,113985,56421,57564,15.9,32.2,-18876,-5.4,53.6,0,7701,7709,46110
1980,06,d) 3,38911,45542,489077,493943,2344,4.8,8518,17.5,125325,21009,104316,4.3,25.4,135057,58477,76580,11.8,27.3,-9732,-1.9,50.8,0,5551,5617,35570
1980,06,l) Left Censored,216399,289873,6658099,6643323,12310,4.1,30125,10.1,1016508,232481,784027,3.5,15.3,986955,317935,669020,4.8,14.9,29553,0.4,29.8,0,18865,18980,137335
1980,08,a) 0,9725,9797,53917,27156,9718,198.4,0,0,53523,53523,0,197.1,197.1,0,0,0,0,0,53523,197.1,0,0,,,
1980,08,b) 1,7608,7721,55705,57444,55,0.6,2489,27.5,16303,744,15559,1.3,28.4,19781,11049,8732,19.2,34.4,-3478,-6,56.8,0,2031,2033,9168
1980,08,c) 2,6050,6128,46394,49154,179,2.6,1541,22.5,10199,1041,9158,2.1,20.7,15718,8076,7642,16.4,32,-5519,-11.3,41.4,0,1253,1253,6549
1980,08,d) 3,5263,6034,55798,59255,268,4.1,1250,19.1,11088,1920,9168,3.2,18.7,18001,8765,9236,14.8,30.4,-6913,-11.7,37.4,0,888,893,5487
1980,08,l) Left Censored,29651,38044,808963,808744,1601,4.1,4032,10.3,119501,27415,92086,3.4,14.8,119063,44989,74074,5.6,14.7,438,0.1,29.4,0,2414,2431,21122
1980,09,a) 0,5917,5975,30469,15258,5946,199,0,0,30422,30422,0,199.4,199.4,0,0,0,0,0,30422,199.4,0,0,,,
1980,09,b) 1,4891,4945,31739,31424,19,0.3,1173,21,8941,,,,28.5,8310,4259,4051,13.6,26.4,631,2.1,52.8,1,899,899,3364
1980,09,c) 2,4436,4524,29730,31133,150,3.1,816,16.7,5145,585,4560,1.9,16.5,7951,3086,4865,9.9,25.5,-2806,-9,33,0,646,646,2513
1980,09,d) 3,4612,5168,46809,47154,189,3.4,799,14.6,9376,,,,19.9,10065,3864,6201,8.2,21.3,-689,-1.4,39.8,1,558,559,2464
1980,09,l) Left Censored,37757,45045,1113776,1105297,1280,2.8,3750,8.1,139120,27556,111564,2.5,12.6,122161,36827,85334,3.3,11.1,16959,1.5,22.2,0,2452,2492,15229
1980,10,a) 0,1031,1045,5675,2844,1038,198.7,0,0,5662,5662,0,199.1,199.1,0,0,0,0,0,5662,199.1,0,0,,,
1980,10,b) 1,909,928,6154,6424,9,0.9,233,22.2,1681,89,1592,1.4,26.2,2221,1332,889,20.7,34.6,-540,-8.4,52.4,0,184,184,1067
1980,10,c) 2,744,756,4769,5256,22,2.6,170,20.4,803,87,716,1.7,15.3,1777,787,990,15,33.8,-974,-18.5,30.6,0,137,137,667
1980,10,d) 3,821,965,8673,8894,32,3.1,144,14.1,1454,174,1280,2,16.3,1896,696,1200,7.8,21.3,-442,-5,32.6,0,94,94,385
1980,10,l) Left Censored,6452,7859,185617,184247,234,2.9,769,9.5,21569,4734,16835,2.6,11.7,18828,6391,12437,3.5,10.2,2741,1.5,20.4,0,472,497,2527
1980,11,a) 0,1385,1396,9692,4877,1382,198,0,0,9631,9631,0,197.5,197.5,0,0,0,0,0,9631,197.5,0,0,,,
1980,11,b) 1,1093,1112,9078,9222,13,1,277,22.2,2959,118,2841,1.3,32.1,3247,1692,1555,18.3,35.2,-288,-3.1,64.2,0,220,220,1427
1980,11,c) 2,1006,1024,11830,11833,47,4.3,166,15.3,2809,266,2543,2.2,23.7,2814,1108,1706,9.4,23.8,-5,-0.1,47.4,0,131,131,756
1980,11,d) 3,1072,1219,27518,28278,61,4.7,214,16.5,3346,428,2918,1.5,11.8,4865,1357,3508,4.8,17.2,-1519,-5.4,23.6,0,139,139,709
1980,11,l) Left Censored,9030,10869,298505,296038,377,3.4,1025,9.2,57948,6505,51443,2.2,19.6,53014,26002,27012,8.8,17.9,4934,1.7,35.8,0,605,609,4496
1980,12,a) 0,29483,29736,160189,80722,29458,198.1,0,0,158934,158934,0,196.9,196.9,0,0,0,0,0,158934,196.9,0,0,,,
1980,12,b) 1,21418,21773,159734,164679,97,0.4,6871,27,44358,1446,42912,0.9,26.9,54247,31643,22604,19.2,32.9,-9889,-6,53.8,0,5749,5754,26302
1980,12,c) 2,18018,18400,140019,148647,827,4.1,4136,20.5,30770,4558,26212,3.1,20.7,48025,23960,24065,16.1,32.3,-17255,-11.6,41.4,0,3442,3445,20685
1980,12,d) 3,16388,18731,182621,185473,943,4.7,3265,16.4,40089,6158,33931,3.3,21.6,45793,20206,25587,10.9,24.7,-5704,-3.1,43.2,0,2392,2403,13891
1980,12,l) Left Censored,90149,120685,2325064,2296966,4992,4,12074,9.7,380012,109553,270459,4.8,16.5,323816,112119,211697,4.9,14.1,56196,2.4,28.2,0,7917,7963,55364
1980,13,a) 0,10793,10890,60769,30504,10789,198.1,0,0,60530,60530,0,198.4,198.4,0,0,0,0,0,60530,198.4,0,0,,,
1980,13,b) 1,8523,8715,58770,60958,47,0.5,2794,27.4,16440,610,15830,1,27,20816,12065,8751,19.8,34.1,-4376,-7.1,54,0,2372,2372,10225
1980,13,c) 2,7449,7614,55002,57852,289,3.4,1770,21.1,11910,1435,10475,2.5,20.6,17610,9483,8127,16.4,30.4,-5700,-9.8,41.2,0,1462,1462,8213
1980,13,d) 3,7251,8297,83535,83342,348,3.9,1484,16.7,22285,2568,19717,3.1,26.7,21899,10175,11724,12.2,26.3,386,0.4,52.6,0,1042,1044,5515
1980,13,l) Left Censored,49519,67142,1480279,1484764,2676,3.9,6463,9.4,194091,48204,145887,3.2,13.1,203060,62376,140684,4.2,13.7,-8969,-0.6,26.2,0,3954,3994,23798
1980,15,a) 0,2439,2467,14826,7474,2446,198.3,0,0,14705,14705,0,196.7,196.7,0,0,0,0,0,14705,196.7,0,0,,,
1980,15,b) 1,1848,1893,15855,16095,18,0.8,511,23.6,4526,381,4145,2.4,28.1,5005,2458,2547,15.3,31.1,-479,-3,56.2,0,413,414,2055
1980,15,c) 2,1553,1583,13106,14018,57,3.3,302,17.6,2566,262,2304,1.9,18.3,4390,2746,1644,19.6,31.3,-1824,-13,36.6,0,239,239,2234
1980,15,d) 3,1435,1815,17579,18183,87,4.5,287,15,2858,642,2216,3.5,15.7,4066,1689,2377,9.3,22.4,-1208,-6.7,31.4,0,184,186,945
1980,15,l) Left Censored,9654,12670,242996,245900,524,4,1078,8.3,29841,7219,22622,2.9,12.1,35648,10123,25525,4.1,14.5,-5807,-2.4,24.2,0,624,635,4466
1980,16,a) 0,2556,2571,13721,6900,2539,197.5,0,0,13643,13643,0,197.7,197.7,0,0,0,0,0,13643,197.7,0,0,,,
1980,16,b) 1,2025,2054,13115,14446,7,0.3,703,28.8,2868,73,2795,0.5,19.9,5530,3118,2412,21.6,38.3,-2662,-18.4,39.8,0,570,572,2555
1980,16,c) 2,1731,1751,11871,12987,60,3.1,452,23,1893,189,1704,1.5,14.6,4125,1831,2294,14.1,31.8,-2232,-17.2,29.2,0,365,365,1563
1980,16,d) 3,1528,1717,12349,13292,58,3.1,335,18,2082,303,1779,2.3,15.7,3967,1826,2141,13.7,29.8,-1885,-14.1,31.4,0,244,246,1306
1980,16,l) Left Censored,9467,12060,196939,212777,370,3,1260,10.1,28107,4140,23967,1.9,13.2,59783,10618,49165,5,28.1,-31676,-14.9,26.4,0,780,784,4545
1980,17,a) 0,18927,19114,110198,55382,18920,198,0,0,109632,109632,0,198,198,0,0,0,0,0,109632,198,0,0,,,
1980,17,b) 1,15413,15651,112424,117479,81,0.5,4090,22.9,26675,968,25707,0.8,22.7,36785,17775,19010,15.1,31.3,-10110,-8.6,45.4,0,3261,3264,13817
1980,17,c) 2,14118,14425,101519,109038,537,3.4,3010,19.2,19069,3026,16043,2.8,17.5,34107,16000,18107,14.7,31.3,-15038,-13.8,35,0,2376,2401,12199
1980,17,d) 3,14137,16309,157595,165257,681,3.9,2783,16,25515,4526,20989,2.7,15.4,40839,17866,22973,10.8,24.7,-15324,-9.3,30.8,0,1923,1932,11219
1980,17,l) Left Censored,117309,145598,3701461,3771241,4749,3.2,13697,9.1,403853,96300,307553,2.6,10.7,543413,147307,396106,3.9,14.4,-139560,-3.7,21.4,0,8884,8933,57659
1980,18,a) 0,8716,8780,47485,23833,8696,198.1,0,0,47305,47305,0,198.5,198.5,0,0,0,0,0,47305,198.5,0,0,,,
1980,18,b) 1,7392,7500,47016,48679,37,0.4,2085,24.2,12381,747,11634,1.5,25.4,15706,7761,7945,15.9,32.3,-3325,-6.9,50.8,0,1696,1696,6559
1980,18,c) 2,6590,6784,47592,51194,269,3.6,1481,19.9,9599,2083,7516,4.1,18.8,16803,7684,9119,15,32.8,-7204,-14,37.6,0,1187,1190,6208
1980,18,d) 3,6480,7569,70186,73283,307,3.8,1268,15.7,11338,1965,9373,2.7,15.5,17531,6817,10714,9.3,23.9,-6193,-8.4,31,0,882,891,4265
1980,18,l) Left Censored,52708,68517,1622681,1664037,2229,3.2,6109,8.7,171208,41213,129995,2.5,10.3,253920,59203,194717,3.6,15.3,-82712,-5,20.6,0,3879,3902,22239
1980,19,a) 0,5982,6008,30416,15300,5966,198.6,0,0,30232,30232,0,197.6,197.6,0,0,0,0,0,30232,197.6,0,0,,,
1980,19,b) 1,4795,4948,30810,32303,38,0.7,1336,23.6,7040,513,6527,1.6,21.8,10025,5355,4670,16.6,31,-2985,-9.2,43.6,0,1095,1095,4587
1980,19,c) 2,4694,4791,30412,32537,175,3.4,955,18.3,5384,1002,4382,3.1,16.5,9633,4197,5436,12.9,29.6,-4249,-13.1,33,0,792,792,3360
1980,19,d) 3,4670,5329,41180,43398,201,3.5,905,15.9,6187,1268,4919,2.9,14.3,10622,4892,5730,11.3,24.5,-4435,-10.2,28.6,0,672,674,3009
1980,19,l) Left Censored,35596,44574,777696,789454,1222,2.7,3982,8.7,86338,16455,69883,2.1,10.9,109854,33624,76230,4.3,13.9,-23516,-3,21.8,0,2756,2767,17401
1980,20,a) 0,5130,5171,27554,13856,5133,198.5,0,0,27397,27397,0,197.7,197.7,0,0,0,0,0,27397,197.7,0,0,,,
1980,20,b) 1,4266,4317,26097,27877,27,0.5,1298,25.9,6300,324,5976,1.2,22.6,9860,5267,4593,18.9,35.4,-3560,-12.8,45.2,0,1041,1042,4419
1980,20,c) 2,3917,3962,24243,26239,145,3.3,923,21.1,4619,564,4055,2.1,17.6,8611,4880,3731,18.6,32.8,-3992,-15.2,35.2,0,760,760,4125
1980,20,d) 3,3933,4463,36662,37892,192,4.1,697,14.8,6827,1430,5397,3.8,18,9286,3479,5807,9.2,24.5,-2459,-6.5,36,0,514,515,2323
1980,20,l) Left Censored,29013,36174,640244,643900,1104,3,3420,9.2,78653,14617,64036,2.3,12.2,85965,21893,64072,3.4,13.4,-7312,-1.2,24.4,0,2218,2227,11678
1980,21,a) 0,5640,5711,32665,16417,5653,198,0,0,32496,32496,0,197.9,197.9,0,0,0,0,0,32496,197.9,0,0,,,
1980,21,b) 1,4931,5002,35530,36866,28,0.5,1596,27.3,8514,416,8098,1.1,23.1,11185,6264,4921,17,30.3,-2671,-7.2,46.2,0,1315,1320,5367
1980,21,c) 2,4316,4388,30976,33764,165,3.4,1053,21.7,5150,717,4433,2.1,15.3,10726,4930,5796,14.6,31.8,-5576,-16.5,30.6,0,886,886,4324
1980,21,d) 3,4224,4778,39206,41290,185,3.6,876,17.1,7022,1316,5706,3.2,17,11190,4937,6253,12,27.1,-4168,-10.1,34,0,631,632,3409
1980,21,l) Left Censored,32688,41295,868195,880780,1322,3.1,3803,8.9,102823,19644,83179,2.2,11.7,127992,30896,97096,3.5,14.5,-25169,-2.8,23.4,0,2525,2535,14306
1980,22,a) 0,8594,8680,54206,27196,8617,198.5,0,0,54021,54021,0,198.6,198.6,0,0,0,0,0,54021,198.6,0,0,,,
1980,22,b) 1,7098,7237,56942,58210,58,0.7,2057,24.7,16521,2491,14030,4.3,28.4,19057,9673,9384,16.6,32.7,-2536,-4.3,56.8,0,1699,1699,7873
1980,22,c) 2,5636,5707,52911,55467,175,2.8,1285,20.3,10866,958,9908,1.7,19.6,15978,8077,7901,14.6,28.8,-5112,-9.2,39.2,0,1060,1060,5673
1980,22,d) 3,5075,5783,59392,60971,199,3.2,938,15.2,11349,1657,9692,2.7,18.6,14507,5445,9062,8.9,23.8,-3158,-5.2,37.2,0,693,698,3668
1980,22,l) Left Censored,37140,48348,1025849,1029742,1573,3.2,4491,9,152487,26637,125850,2.6,14.8,160272,44369,115903,4.3,15.6,-7785,-0.8,29.6,0,2868,2895,22408
1980,23,a) 0,2182,2197,11453,5749,2175,198,0,0,11409,11409,0,198.5,198.5,0,0,0,0,0,11409,198.5,0,0,,,
1980,23,b) 1,1844,1860,10929,11401,2,0.1,493,23.2,2192,,,,19.2,3135,1549,1586,13.6,27.5,-943,-8.3,38.4,1,372,374,1241
1980,23,c) 2,1757,1786,10423,11013,53,2.7,380,19.3,1925,201,1724,1.8,17.5,3105,1328,1777,12.1,28.2,-1180,-10.7,35,0,292,292,1135
1980,23,d) 3,1656,1905,15295,16390,86,4.2,302,14.9,2142,,,,13.1,4331,1520,2811,9.3,26.4,-2189,-13.3,26.2,1,209,213,884
1980,23,l) Left Censored,12317,14986,270565,272884,444,2.9,1493,9.6,32323,4771,27552,1.7,11.8,36960,12344,24616,4.5,13.5,-4637,-1.7,23.6,0,974,979,5276
1980,24,a) 0,6899,6971,38442,19339,6897,197.9,0,0,38206,38206,0,197.6,197.6,0,0,0,0,0,38206,197.6,0,0,,,
1980,24,b) 1,5579,5675,40145,39915,33,0.5,1509,23.3,12056,,,,30.2,11595,5536,6059,13.9,29,461,1.2,58,1,1204,1206,4341
1980,24,c) 2,4826,4941,37818,40161,217,4.1,982,18.4,7896,1604,6292,4,19.7,12582,5982,6600,14.9,31.3,-4686,-11.6,39.4,0,794,795,5100
1980,24,d) 3,5041,5797,83052,69642,277,4.5,918,15,38829,,,,55.8,12009,4887,7122,7,17.2,26820,38.6,34.4,1,623,623,3157
1980,24,l) Left Censored,38481,49440,1097804,1095577,1704,3.3,4617,9.1,154474,32018,122456,2.9,14.1,150020,44235,105785,4,13.7,4454,0.4,27.4,0,2796,2828,19290
1980,25,a) 0,9551,9611,54932,27571,9524,198.2,0,0,54722,54722,0,198.5,198.5,0,0,0,0,0,54722,198.5,0,0,,,
1980,25,b) 1,7980,8113,58988,58064,58,0.6,1832,20.1,18298,1757,16541,3,31.5,16450,9280,7170,16,28.3,1848,3.2,56.6,0,1421,1421,7633
1980,25,c) 2,7091,7281,61722,62695,276,3.5,1344,17.1,14825,1891,12934,3,23.6,16771,7604,9167,12.1,26.8,-1946,-3.2,47.2,0,1049,1049,6180
1980,25,d) 3,7090,8219,108514,107484,354,4.1,1188,13.7,20566,3540,17026,3.3,19.1,18506,6599,11907,6.1,17.2,2060,1.9,34.4,0,799,802,4116
1980,25,l) Left Censored,66052,80139,1992364,1984973,2246,2.7,6701,8.1,265687,46804,218883,2.4,13.4,250906,77144,173762,3.9,12.6,14781,0.8,25.2,0,4248,4297,30782
1980,26,a) 0,13944,14079,77916,39157,13940,198,0,0,77519,77519,0,198,198,0,0,0,0,0,77519,198,0,0,,,
1980,26,b) 1,11879,12099,109423,109433,80,0.6,3109,22.6,25056,1276,23780,1.2,22.9,25075,12173,12902,11.1,22.9,-19,0,45.8,0,2384,2385,9452
1980,26,c) 2,10762,11021,78967,85767,401,3.3,2328,19.3,14155,2193,11962,2.6,16.5,27755,10847,16908,12.6,32.4,-13600,-15.9,33,0,1815,1815,8608
1980,26,d) 3,10534,12327,111631,120404,508,3.9,2142,16.3,18516,3558,14958,3,15.4,36061,14204,21857,11.8,30,-17545,-14.6,30.8,0,1472,1475,8173
1980,26,l) Left Censored,80623,104210,2506402,2616035,3652,3.4,9876,9.2,239808,59909,179899,2.3,9.2,459074,104471,354603,4,17.5,-219266,-8.3,18.4,0,6350,6387,41103
1980,27,a) 0,7832,7892,45690,22897,7855,199.1,0,0,45586,45586,0,199.1,199.1,0,0,0,0,0,45586,199.1,0,0,,,
1980,27,b) 1,6796,6928,51585,53336,43,0.6,1674,21.4,13648,3177,10471,6,25.6,17150,8917,8233,16.7,32.2,-3502,-6.6,51.2,0,1311,1313,7229
1980,27,c) 2,6019,6170,48020,50680,223,3.3,1207,18,9455,2198,7257,4.3,18.7,14774,6550,8224,12.9,29.2,-5319,-10.5,37.4,0,966,966,5093
1980,27,d) 3,5839,6701,65701,67246,268,3.8,1029,14.5,11671,2221,9450,3.3,17.4,14761,6358,8403,9.5,22,-3090,-4.6,34.8,0,712,713,3782
1980,27,l) Left Censored,43803,54963,1287490,1291204,1583,2.8,4630,8.2,163786,30603,133183,2.4,12.7,171214,50537,120677,3.9,13.3,-7428,-0.6,25.4,0,2954,2990,22918
1980,28,a) 0,4598,4644,24186,12156,4602,198.2,0,0,24061,24061,0,197.9,197.9,0,0,0,0,0,24061,197.9,0,0,,,
1980,28,b) 1,3687,3740,24049,25969,20,0.5,1239,28.1,5516,100,5416,0.4,21.2,9356,5810,3546,22.4,36,-3840,-14.8,42.4,0,1027,1027,4787
1980,28,c) 2,3020,3060,22464,23540,111,3.3,727,21.5,4371,490,3881,2.1,18.6,6522,3492,3030,14.8,27.7,-2151,-9.1,37.2,0,589,589,2611
1980,28,d) 3,3117,3569,30104,31846,156,4.1,610,16,4796,934,3862,2.9,15.1,8279,3406,4873,10.7,26,-3483,-10.9,30.2,0,423,429,2260
1980,28,l) Left Censored,22093,28011,543622,551738,909,3.1,2586,9,65640,13562,52078,2.5,11.9,81871,21924,59947,4,14.8,-16231,-2.9,23.8,0,1734,1751,10150
1980,29,a) 0,9311,9425,50481,25393,9325,197.9,0,0,50177,50177,0,197.6,197.6,0,0,0,0,0,50177,197.6,0,0,,,
1980,29,b) 1,7813,7926,50889,53804,39,0.4,2299,25.1,12168,670,11498,1.2,22.6,17997,9447,8550,17.6,33.4,-5829,-10.8,45.2,0,1874,1876,7732
1980,29,c) 2,6858,6963,48681,52273,250,3.3,1577,20.6,9120,1430,7690,2.7,17.4,16304,7489,8815,14.3,31.2,-7184,-13.8,34.8,0,1282,1284,6447
1980,29,d) 3,6722,7639,67787,70106,300,3.7,1365,16.6,11997,2667,9330,3.8,17.1,16635,7489,9146,10.7,23.7,-4638,-6.6,34.2,0,957,962,4646
1980,29,l) Left Censored,51648,66158,1454540,1474392,2052,3,6306,9.2,170902,35085,135817,2.4,11.6,210606,59758,150848,4.1,14.3,-39704,-2.7,23.2,0,4041,4055,23072
1980,30,a) 0,2442,2448,12297,6171,2423,198,0,0,12253,12253,0,198.6,198.6,0,0,0,0,0,12253,198.6,0,0,,,
1980,30,b) 1,2123,2156,12376,13653,9,0.4,681,27,2670,110,2560,0.8,19.6,5223,2660,2563,19.5,38.3,-2553,-18.7,39.2,0,535,535,2103
1980,30,c) 2,1703,1727,11406,12521,54,2.8,418,21.7,2079,249,1830,2,16.6,4308,2066,2242,16.5,34.4,-2229,-17.8,33.2,0,320,320,1669
1980,30,d) 3,1628,1809,11836,13065,64,3.3,325,16.7,1823,325,1498,2.5,14,4281,1621,2660,12.4,32.8,-2458,-18.8,28,0,218,219,939
1980,30,l) Left Censored,9825,11991,170805,178013,340,2.7,1280,10.3,19112,3580,15532,2,10.7,33527,8404,25123,4.7,18.8,-14415,-8.1,21.4,0,798,803,4625
1980,31,a) 0,3444,3461,17617,8825,3445,199.1,0,0,17585,17585,0,199.3,199.3,0,0,0,0,0,17585,199.3,0,0,,,
1980,31,b) 1,2888,2919,16267,17656,12,0.4,820,24.4,3127,84,3043,0.5,17.7,5904,3363,2541,19,33.4,-2777,-15.7,35.4,0,653,653,2845
1980,31,c) 2,2626,2678,18183,19288,101,3.5,537,18.5,3516,561,2955,2.9,18.2,5725,2960,2765,15.3,29.7,-2209,-11.5,36.4,0,427,427,2633
1980,31,d) 3,2673,2992,21723,22906,128,4,502,15.7,3341,579,2762,2.5,14.6,5707,2531,3176,11,24.9,-2366,-10.3,29.2,0,346,346,1540
1980,31,l) Left Censored,20768,25312,438739,437382,755,2.9,2294,8.8,58318,10661,47657,2.4,13.3,55603,14431,41172,3.3,12.7,2715,0.6,25.4,0,1549,1558,7798
1980,32,a) 0,2774,2793,19940,10030,2763,197.9,0,0,19820,19820,0,197.6,197.6,0,0,0,0,0,19820,197.6,0,0,,,
1980,32,b) 1,2175,2197,20160,21137,10,0.4,744,28.7,5863,121,5742,0.6,27.7,7816,4458,3358,21.1,37,-1953,-9.3,55.4,0,600,600,3614
1980,32,c) 2,1594,1642,15635,18011,64,3.5,455,24.6,2720,381,2339,2.1,15.1,7471,3314,4157,18.4,41.5,-4751,-26.4,30.2,0,361,363,2759
1980,32,d) 3,1388,1595,21056,21612,83,4.9,296,17.4,3989,764,3225,3.5,18.5,5100,1569,3531,7.3,23.6,-1111,-5.1,37,0,214,214,1223
1980,32,l) Left Censored,7419,9399,262835,259170,502,5.2,981,10.2,46228,11651,34577,4.5,17.8,38897,13618,25279,5.3,15,7331,2.8,30,0,619,624,9062
1980,33,a) 0,2057,2063,9959,5019,2032,197,0,0,9880,9880,0,196.9,196.9,0,0,0,0,0,9880,196.9,0,0,,,
1980,33,b) 1,1817,1837,11886,12127,6,0.3,478,22.8,3243,141,3102,1.2,26.7,3724,1911,1813,15.8,30.7,-481,-4,53.4,0,370,370,1595
1980,33,c) 2,1671,1693,11032,11650,70,3.8,365,19.7,2222,346,1876,3,19.1,3458,1752,1706,15,29.7,-1236,-10.6,38.2,0,297,297,1479
1980,33,d) 3,1575,1756,16439,16494,71,3.8,304,16.2,3411,537,2874,3.3,20.7,3521,1463,2058,8.9,21.3,-110,-0.6,41.4,0,211,214,967
1980,33,l) Left Censored,10887,12818,278768,279021,374,2.8,1188,9,36572,7425,29147,2.7,13.1,37077,12419,24658,4.5,13.3,-505,-0.2,26.2,0,796,800,5558
1980,34,a) 0,14392,14471,69394,34950,14307,197.7,0,0,68888,68888,0,197.1,197.1,0,0,0,0,0,68888,197.1,0,0,,,
1980,34,b) 1,11676,11802,71170,71237,61,0.5,3015,22.5,21166,1518,19648,2.1,29.7,21299,10638,10661,14.9,29.9,-133,-0.2,59.4,0,2279,2282,8218
1980,34,c) 2,9978,10124,62518,66559,374,3.4,1913,17.5,12774,1577,11197,2.4,19.2,20855,8642,12213,13,31.3,-8081,-12.1,38.4,0,1469,1469,6602
1980,34,d) 3,10450,11312,93716,95800,477,4,1690,14.2,17161,3185,13976,3.3,17.9,21328,7781,13547,8.1,22.3,-4167,-4.4,35.8,0,1209,1210,5566
1980,34,l) Left Censored,85715,102626,2247534,2256425,2968,2.8,8913,8.4,290719,61105,229614,2.7,12.9,308500,91711,216789,4.1,13.7,-17781,-0.8,25.8,0,5918,5955,37168
1980,35,a) 0,3474,3499,20436,10255,3472,198.5,0,0,20363,20363,0,198.6,198.6,0,0,0,0,0,20363,198.6,0,0,,,
1980,35,b) 1,2767,2835,20252,21181,19,0.6,858,26,5745,520,5225,2.5,27.1,7602,4015,3587,19,35.9,-1857,-8.8,54.2,0,709,709,3496
1980,35,c) 2,2162,2192,15370,16699,68,2.8,520,21.2,3436,418,3018,2.5,20.6,6094,3152,2942,18.9,36.5,-2658,-15.9,41.2,0,410,410,2616
1980,35,d) 3,1988,2233,17620,18919,92,3.8,489,20,3114,453,2661,2.4,16.5,5711,2855,2856,15.1,30.2,-2597,-13.7,33,0,352,353,2146
1980,35,l) Left Censored,12014,15266,256036,261115,594,3.7,1686,10.6,35137,7810,27327,3,13.5,45295,14470,30825,5.5,17.3,-10158,-3.8,27,0,1054,1057,6415
1980,36,a) 0,32487,32682,165804,83391,32346,197.9,0,0,164827,164827,0,197.7,197.7,0,0,0,0,0,164827,197.7,0,0,,,
1980,36,b) 1,26688,26937,172463,176574,103,0.3,6780,22.2,46366,1869,44497,1.1,26.3,54588,28528,26060,16.2,30.9,-8222,-4.6,52.6,0,5399,5400,22785
1980,36,c) 2,24100,24468,162378,171283,800,3,4705,17.8,35187,4671,30516,2.7,20.5,52996,23536,29460,13.7,30.9,-17809,-10.4,41,0,3869,3869,19558
1980,36,d) 3,23525,26123,239015,243774,928,3.3,4306,15.5,43505,6768,36737,2.8,17.8,53022,23233,29789,9.5,21.8,-9517,-4,35.6,0,3168,3171,14837
1980,36,l) Left Censored,207977,245564,5230009,5244220,6213,2.4,23434,9.2,679039,137035,542004,2.6,12.9,707461,224455,483006,4.3,13.5,-28422,-0.6,25.8,0,16385,16453,101780
1980,37,a) 0,10607,10719,56027,28107,10628,198.3,0,0,55840,55840,0,198.7,198.7,0,0,0,0,0,55840,198.7,0,0,,,
1980,37,b) 1,8690,8835,58937,59408,51,0.5,2803,27.1,16749,1850,14899,3.1,28.2,17691,9340,8351,15.7,29.8,-942,-1.6,56.4,0,2308,2308,7861
1980,37,c) 2,7754,7934,51739,55371,312,3.6,1833,21,10499,1897,8602,3.4,19,17763,8688,9075,15.7,32.1,-7264,-13.1,38,0,1493,1497,7138
1980,37,d) 3,7342,8403,78331,79552,355,4,1378,15.4,14661,4476,10185,5.6,18.4,17102,6908,10194,8.7,21.5,-2441,-3.1,36.8,0,965,970,4679
1980,37,l) Left Censored,55486,73608,1755130,1766004,2471,3.3,6437,8.5,197280,35741,161539,2,11.2,219028,61730,157298,3.5,12.4,-21748,-1.2,22.4,0,4124,4153,29554
1980,38,a) 0,1612,1619,8590,4299,1613,199.3,0,0,8582,8582,0,199.6,199.6,0,0,0,0,0,8582,199.6,0,0,,,
1980,38,b) 1,1404,1424,8535,9012,10,0.6,386,23.7,1681,45,1636,0.5,18.7,2634,1328,1306,14.7,29.2,-953,-10.5,37.4,0,299,299,1026
1980,38,c) 2,1152,1163,7334,7500,39,3.1,255,20,1678,114,1564,1.5,22.4,2010,948,1062,12.6,26.8,-332,-4.4,44.8,0,202,202,781
1980,38,d) 3,1176,1255,8810,9370,64,4.8,237,17.6,1512,265,1247,2.8,16.1,2632,1164,1468,12.4,28.1,-1120,-12,32.2,0,174,174,877
1980,38,l) Left Censored,8738,10520,149867,149916,344,3.2,918,8.5,20323,4503,15820,3,13.6,20420,6424,13996,4.3,13.6,-97,0,27.2,0,603,604,3902
1980,39,a) 0,15963,16182,89930,45178,16038,198.2,0,0,89505,89505,0,198.1,198.1,0,0,0,0,0,89505,198.1,0,0,,,
1980,39,b) 1,13578,13797,98321,99669,76,0.5,3655,23.2,27509,1481,26028,1.5,27.6,30204,13190,17014,13.2,30.3,-2695,-2.7,55.2,0,2893,2895,10562
1980,39,c) 2,11860,12160,85680,91397,481,3.6,2503,18.9,17038,3157,13881,3.5,18.6,28472,13013,15459,14.2,31.2,-11434,-12.6,37.2,0,1938,1938,10555
1980,39,d) 3,12030,14361,131274,134789,651,4.3,2332,15.3,24646,5352,19294,4,18.3,31675,13590,18085,10.1,23.5,-7029,-5.2,36.6,0,1546,1561,7809
1980,39,l) Left Censored,103379,139543,3370982,3433326,4458,3.1,12000,8.4,362591,81170,281421,2.4,10.6,487278,123409,363869,3.6,14.2,-124687,-3.6,21.2,0,7361,7434,46398
1980,40,a) 0,7983,8053,45271,22768,7974,198,0,0,45007,45007,0,197.7,197.7,0,0,0,0,0,45007,197.7,0,0,,,
1980,40,b) 1,6188,6300,44319,46260,47,0.6,2010,27.3,11589,528,11061,1.1,25.1,15471,9303,6168,20.1,33.4,-3882,-8.3,50.2,0,1692,1692,7765
1980,40,c) 2,4978,5047,37850,40082,155,2.7,1296,22.9,7454,826,6628,2.1,18.6,11918,5747,6171,14.3,29.7,-4464,-11.1,37.2,0,1074,1075,4836
1980,40,d) 3,4491,5069,45869,47225,186,3.4,882,16.3,8670,1161,7509,2.5,18.4,11381,5254,6127,11.1,24.1,-2711,-5.7,36.8,0,645,649,3402
1980,40,l) Left Censored,29998,38220,733260,728878,1199,3,3776,9.5,116175,28791,87384,4,15.9,107411,29732,77679,4.1,14.7,8764,1.2,29.4,0,2471,2493,14201
1980,41,a) 0,8041,8079,41960,21081,8004,198.1,0,0,41759,41759,0,198.1,198.1,0,0,0,0,0,41759,198.1,0,0,,,
1980,41,b) 1,6001,6069,39191,41906,24,0.3,2255,31,10365,198,10167,0.5,24.7,15795,9311,6484,22.2,37.7,-5430,-13,49.4,0,1795,1795,7799
1980,41,c) 2,5190,5281,36114,38885,253,4.3,1438,24.4,8245,1303,6942,3.4,21.2,13786,7027,6759,18.1,35.5,-5541,-14.3,42.4,0,1135,1135,5525
1980,41,d) 3,4779,5430,51113,52335,260,4.4,1101,18.8,11361,3866,7495,7.4,21.7,13804,6090,7714,11.6,26.4,-2443,-4.7,43.4,0,729,734,3822
1980,41,l) Left Censored,27972,35485,685800,707934,1406,3.8,3808,10.4,91391,20634,70757,2.9,12.9,135658,34296,101362,4.8,19.2,-44267,-6.3,25.8,0,2453,2479,16089
1980,42,a) 0,16891,17034,95580,47984,16902,198.5,0,0,95192,95192,0,198.4,198.4,0,0,0,0,0,95192,198.4,0,0,,,
1980,42,b) 1,14462,14799,99660,100077,75,0.4,3618,21.6,26824,1285,25539,1.3,26.8,27658,12582,15076,12.6,27.6,-834,-0.8,53.6,0,2848,2851,9896
1980,42,c) 2,12931,13207,93271,99489,458,3.2,2605,18.2,17451,2435,15016,2.4,17.5,29887,12732,17155,12.8,30,-12436,-12.5,35,0,2086,2086,10723
1980,42,d) 3,13464,15557,144611,148970,682,4.1,2335,14.2,23746,5002,18744,3.4,15.9,32464,13409,19055,9,21.8,-8718,-5.9,31.8,0,1624,1627,8102
1980,42,l) Left Censored,120300,153546,3600282,3626410,4581,2.9,13518,8.5,416217,90120,326097,2.5,11.5,468473,148362,320111,4.1,12.9,-52256,-1.4,23,0,8659,8717,58081
1980,44,a) 0,1763,1767,8555,4303,1755,198.6,0,0,8505,8505,0,197.7,197.7,0,0,0,0,0,8505,197.7,0,0,,,
1980,44,b) 1,1478,1491,9810,9938,6,0.4,376,22.2,2863,,,,28.8,3119,1371,1748,13.8,31.4,-256,-2.6,57.6,1,299,299,1141
1980,44,c) 2,1306,1317,10938,11390,37,2.6,267,18.6,2117,209,1908,1.8,18.6,3020,1024,1996,9,26.5,-903,-7.9,37.2,0,199,199,767
1980,44,d) 3,1386,1481,12233,12674,47,3,213,13.6,1686,,,,13.3,2567,875,1692,6.9,20.3,-881,-7,26.6,1,151,151,583
1980,44,l) Left Censored,12387,14247,299140,302457,335,2.3,1234,8.4,32721,6214,26507,2.1,10.8,39354,10469,28885,3.5,13,-6633,-2.2,21.6,0,810,811,4916
1980,45,a) 0,5497,5582,30295,15200,5527,198,0,0,30190,30190,0,198.6,198.6,0,0,0,0,0,30190,198.6,0,0,,,
1980,45,b) 1,4268,4367,31402,31981,34,0.7,1377,27,7812,795,7017,2.5,24.4,8969,4974,3995,15.6,28,-1157,-3.6,48.8,0,1167,1167,4040
1980,45,c) 2,3953,4023,28205,29962,173,3.9,906,20.6,5600,654,4946,2.2,18.7,9113,4535,4578,15.1,30.4,-3513,-11.7,37.4,0,717,717,3663
1980,45,d) 3,3682,4115,31671,32468,177,4,723,16.4,5885,1066,4819,3.3,18.1,7479,2967,4512,9.1,23,-1594,-4.9,36.2,0,518,518,1906
1980,45,l) Left Censored,27428,35579,849594,857564,1278,3.5,3316,9,94438,19533,74905,2.3,11,110377,30294,80083,3.5,12.9,-15939,-1.9,22,0,2104,2121,11448
1980,46,a) 0,1638,1654,7881,3970,1643,198.7,0,0,7822,7822,0,197,197,0,0,0,0,0,7822,197,0,0,,,
1980,46,b) 1,1352,1374,8246,8893,9,0.6,385,24.4,1680,77,1603,0.9,18.9,2974,1450,1524,16.3,33.4,-1294,-14.5,37.8,0,302,302,1237
1980,46,c) 2,1282,1297,7360,8097,47,3.3,276,19.5,1166,207,959,2.6,14.4,2639,1171,1468,14.5,32.6,-1473,-18.2,28.8,0,228,229,979
1980,46,d) 3,1180,1296,8914,9702,49,3.5,225,16.2,1161,119,1042,1.2,12,2736,965,1771,9.9,28.2,-1575,-16.2,24,0,163,163,719
1980,46,l) Left Censored,9189,10902,154407,155466,300,2.7,975,8.7,19259,4645,14614,3,12.4,21376,6868,14508,4.4,13.7,-2117,-1.3,24.8,0,671,674,3839
1980,47,a) 0,8411,8492,47705,23934,8418,198.3,0,0,47542,47542,0,198.6,198.6,0,0,0,0,0,47542,198.6,0,0,,,
1980,47,b) 1,6803,6941,48700,50170,35,0.4,2368,28.9,14514,644,13870,1.3,28.9,17453,10362,7091,20.7,34.8,-2939,-5.9,57.8,0,1934,1934,8092
1980,47,c) 2,5852,5965,42609,46358,229,3.5,1440,21.8,8967,1923,7044,4.1,19.3,16465,7738,8727,16.7,35.5,-7498,-16.2,38.6,0,1183,1183,6258
1980,47,d) 3,5885,6766,63814,70087,323,4.4,1269,17.5,13866,2300,11566,3.3,19.8,26411,9847,16564,14,37.7,-12545,-17.9,39.6,0,869,872,4813
1980,47,l) Left Censored,41697,54228,1232728,1255741,2076,3.7,5087,9.1,139616,33072,106544,2.6,11.1,185642,49296,136346,3.9,14.8,-46026,-3.7,22.2,0,3251,3263,20658
1980,48,a) 0,19115,19541,116012,58426,19254,197.1,0,0,115173,115173,0,197.1,197.1,0,0,0,0,0,115173,197.1,0,0,,,
1980,48,b) 1,15568,16243,134892,157259,155,0.6,11759,42.4,36875,2047,34828,1.3,23.4,81609,61528,20081,39.1,51.9,-44734,-28.5,46.8,0,10119,10127,52612
1980,48,c) 2,17841,18458,150600,166901,593,2.5,6584,28,33060,3947,29113,2.4,19.8,65662,40536,25126,24.3,39.3,-32602,-19.5,39.6,0,5580,5591,35301
1980,48,d) 3,20015,23484,233412,240533,846,3.3,4458,17.6,48228,5924,42304,2.5,20.1,62469,27980,34489,11.6,26,-14241,-5.9,40.2,0,3134,3177,18145
1980,48,l) Left Censored,125140,175167,4007436,3980970,7288,4,18247,10.1,665365,145477,519888,3.7,16.7,612432,195613,416819,4.9,15.4,52933,1.3,30.8,0,11576,11687,86932
1980,49,a) 0,3419,3453,20541,10323,3426,198.4,0,0,20437,20437,0,198,198,0,0,0,0,0,20437,198,0,0,,,
1980,49,b) 1,2742,2807,20463,21777,28,0.8,969,29.2,5345,412,4933,1.9,24.5,7973,4620,3353,21.2,36.6,-2628,-12.1,49,0,783,790,3883
1980,49,c) 2,2262,2296,18647,20274,71,2.7,652,24.9,4341,666,3675,3.3,21.4,7594,3368,4226,16.6,37.5,-3253,-16.1,42.8,0,523,523,2806
1980,49,d) 3,2059,2303,19290,20698,79,3.1,535,21,4079,381,3698,1.8,19.7,6894,3004,3890,14.5,33.3,-2815,-13.6,39.4,0,373,373,1908
1980,49,l) Left Censored,12669,16058,342206,343221,608,3.7,1651,9.9,47352,11063,36289,3.2,13.8,49382,16372,33010,4.8,14.4,-2030,-0.6,27.6,0,1000,1009,7049
1980,50,a) 0,1374,1375,6199,3104,1367,198.8,0,0,6190,6190,0,199.4,199.4,0,0,0,0,0,6190,199.4,0,0,,,
1980,50,b) 1,1136,1147,6554,6686,2,0.2,283,21.7,1640,,,,24.5,1903,970,933,14.5,28.5,-263,-4,49,1,237,237,840
1980,50,c) 2,1096,1112,6565,7140,42,3.5,213,17.7,1085,179,906,2.5,15.2,2235,913,1322,12.8,31.3,-1150,-16.1,30.4,0,183,183,784
1980,50,d) 3,1019,1131,8920,9126,38,3.1,189,15.6,1429,,,,15.7,1840,809,1031,8.9,20.2,-411,-4.5,31.4,1,144,144,563
1980,50,l) Left Censored,6890,7993,141409,140901,208,2.5,712,8.6,18627,2578,16049,1.8,13.2,17611,4531,13080,3.2,12.5,1016,0.7,25,0,492,494,2362
1980,51,a) 0,9597,9657,48960,24571,9575,198.3,0,0,48779,48779,0,198.5,198.5,0,0,0,0,0,48779,198.5,0,0,,,
1980,51,b) 1,7568,7697,54839,54403,52,0.6,2262,25.5,16545,695,15850,1.3,30.4,15673,8200,7473,15.1,28.8,872,1.6,57.6,0,1831,1831,6433
1980,51,c) 2,6625,6815,49570,52313,270,3.6,1521,20.3,10599,1561,9038,3,20.3,16084,6998,9086,13.4,30.7,-5485,-10.4,40.6,0,1252,1252,5922
1980,51,d) 3,6347,7335,70714,72970,335,4.3,1241,15.9,12635,3752,8883,5.1,17.3,17146,7013,10133,9.6,23.5,-4511,-6.2,34.6,0,888,894,4638
1980,51,l) Left Censored,47781,63658,1366254,1365194,2226,3.4,5800,8.9,172078,37723,134355,2.8,12.6,169959,48409,121550,3.5,12.4,2119,0.2,24.8,0,3603,3628,20659
1980,53,a) 0,10806,10881,54354,27295,10788,198.3,0,0,54119,54119,0,198.3,198.3,0,0,0,0,0,54119,198.3,0,0,,,
1980,53,b) 1,8351,8459,59141,61533,54,0.5,2997,29.7,16071,1202,14869,2,26.1,20854,11998,8856,19.5,33.9,-4783,-7.8,52.2,0,2352,2352,9927
1980,53,c) 2,7318,7473,53486,57660,366,4.4,1952,23.5,11776,1702,10074,3,20.4,20124,9196,10928,15.9,34.9,-8348,-14.5,40.8,0,1492,1492,7370
1980,53,d) 3,6894,7898,78354,76995,395,4.6,1580,18.5,22580,5737,16843,7.5,29.3,19864,8912,10952,11.6,25.8,2716,3.5,51.6,0,1044,1049,5260
1980,53,l) Left Censored,40599,52061,1012753,1013196,2052,3.8,5133,9.6,153682,31135,122547,3.1,15.2,154568,44996,109572,4.4,15.3,-886,-0.1,30.4,0,3210,3233,20786
1980,54,a) 0,2893,2918,14513,7310,2869,196.6,0,0,14407,14407,0,197.1,197.1,0,0,0,0,0,14407,197.1,0,0,,,
1980,54,b) 1,2407,2438,15739,15932,9,0.3,794,27.6,4536,52,4484,0.3,28.5,4921,2766,2155,17.4,30.9,-385,-2.4,57,0,653,653,2348
1980,54,c) 2,2043,2081,13761,14951,80,3.5,449,19.7,2736,450,2286,3,18.3,5115,2259,2856,15.1,34.2,-2379,-15.9,36.6,0,350,350,1622
1980,54,d) 3,2148,2396,20259,21365,95,3.7,429,16.7,3974,1112,2862,5.2,18.6,6186,1923,4263,9,29,-2212,-10.4,37.2,0,307,307,1213
1980,54,l) Left Censored,17667,21958,422710,447465,692,3.1,1998,8.8,45238,9975,35263,2.2,10.1,94750,17722,77028,4,21.2,-49512,-11.1,20.2,0,1311,1320,7449
1980,55,a) 0,8122,8173,43312,21746,8107,198.4,0,0,43133,43133,0,198.3,198.3,0,0,0,0,0,43133,198.3,0,0,,,
1980,55,b) 1,7000,7101,45831,47391,32,0.4,1698,21.2,9391,477,8914,1,19.8,12510,6299,6211,13.3,26.4,-3119,-6.6,39.6,0,1342,1344,5246
1980,55,c) 2,6725,6898,48544,50672,256,3.4,1431,19,8861,1622,7239,3.2,17.5,13117,6148,6969,12.1,25.9,-4256,-8.4,35,0,1120,1120,4853
1980,55,d) 3,6434,7407,62716,65361,283,3.6,1204,15.3,9189,1705,7484,2.6,14.1,14479,6447,8032,9.9,22.2,-5290,-8.1,28.2,0,821,828,4228
1980,55,l) Left Censored,52106,63648,1417698,1433361,1693,2.6,5211,8,142083,26821,115262,1.9,9.9,173410,47195,126215,3.3,12.1,-31327,-2.2,19.8,0,3467,3492,21129
1980,56,a) 0,1717,1735,9503,4782,1718,198,0,0,9442,9442,0,197.4,197.4,0,0,0,0,0,9442,197.4,0,0,,,
1980,56,b) 1,1384,1414,9801,10170,15,0.9,443,26.8,2897,125,2772,1.2,28.5,3634,1814,1820,17.8,35.7,-737,-7.2,57,0,355,355,1606
1980,56,c) 2,1179,1184,8572,9017,37,2.8,261,20,1790,105,1685,1.2,19.9,2679,1216,1463,13.5,29.7,-889,-9.8,39.8,0,210,210,1067
1980,56,d) 3,986,1089,10462,10703,46,3.9,192,16.4,2454,928,1526,8.7,22.9,2936,984,1952,9.2,27.4,-482,-4.5,45.8,0,140,140,737
1980,56,l) Left Censored,5677,6872,109388,108667,267,3.8,713,10,17712,3087,14625,2.8,16.3,16269,5633,10636,5.2,15,1443,1.3,30,0,467,470,3238
1981,01,a) 0,5979,6013,39202,19690,5957,198.1,0,0,39025,39025,0,198.2,198.2,0,0,0,0,0,39025,198.2,0,0,,,
1981,01,b) 1,4793,4862,31331,33424,38,0.7,1729,29.8,8285,303,7982,0.9,24.8,12470,7551,4919,22.6,37.3,-4185,-12.5,49.6,0,1375,1375,6168
1981,01,c) 2,4325,4456,38335,40561,192,3.9,1135,22.9,7191,1164,6027,2.9,17.7,11643,6307,5336,15.5,28.7,-4452,-11,35.4,0,872,875,5108
1981,01,d) 3,4036,4304,32891,37624,154,3.3,939,19.9,5364,736,4628,2,14.3,14830,6268,8562,16.7,39.4,-9466,-25.1,28.6,0,710,710,4530
1981,01,e) 4,3865,4477,40577,43478,191,3.9,934,19.1,6618,1167,5451,2.7,15.2,12419,6462,5957,14.9,28.6,-5801,-13.4,30.4,0,555,558,2950
1981,01,l) Left Censored,29553,39379,856068,874397,1417,3.4,4641,11.3,106464,28598,77866,3.3,12.2,143122,51454,91668,5.9,16.4,-36658,-4.2,24.4,0,2544,2563,18286
1981,02,a) 0,1128,1138,7121,3573,1127,198.1,0,0,7097,7097,0,198.6,198.6,0,0,0,0,0,7097,198.6,0,0,,,
1981,02,b) 1,802,810,5802,5782,4,0.4,313,31.7,2094,22,2072,0.4,36.2,2054,1305,749,22.6,35.5,40,0.7,71,0,231,231,1050
1981,02,c) 2,790,813,6324,6334,38,4.2,178,19.9,1971,221,1750,3.5,31.1,1990,1058,932,16.7,31.4,-19,-0.3,62.2,0,125,125,772
1981,02,d) 3,630,641,4892,5141,29,4.1,162,22.8,1257,136,1121,2.6,24.5,1754,813,941,15.8,34.1,-497,-9.6,49,0,102,102,476
1981,02,e) 4,636,752,7574,7675,58,7.2,150,18.7,2207,999,1208,13,28.8,2408,970,1438,12.6,31.4,-201,-2.6,57.6,0,80,80,419
1981,02,l) Left Censored,3118,4131,79673,78225,224,5.2,533,12.4,15427,3276,12151,4.2,19.7,12530,4753,7777,6.1,16,2897,3.7,32,0,210,212,1727
1981,04,a) 0,7008,7049,41306,20732,6989,198.3,0,0,41149,41149,0,198.5,198.5,0,0,0,0,0,41149,198.5,0,0,,,
1981,04,b) 1,5508,5586,39029,41515,47,0.7,1970,29.6,10893,635,10258,1.5,26.2,15864,10169,5695,24.5,38.2,-4971,-12,52.4,0,1519,1519,7625
1981,04,c) 2,4522,4629,40167,42192,183,3.5,1332,25.4,10619,1228,9391,2.9,25.2,14669,7689,6980,18.2,34.8,-4050,-9.6,50.4,0,1001,1003,5645
1981,04,d) 3,3635,3697,30662,33437,118,2.9,923,22.3,5763,1008,4755,3,17.2,11313,6366,4947,19,33.8,-5550,-16.6,34.4,0,693,693,4467
1981,04,e) 4,3189,3767,40321,42873,175,4.2,866,21,7019,1720,5299,4,16.4,12122,5740,6382,13.4,28.3,-5103,-11.9,32.8,0,473,474,2855
1981,04,l) Left Censored,18518,26545,613717,615858,1441,5.3,3127,11.4,89575,23256,66319,3.8,14.5,93856,28018,65838,4.5,15.2,-4281,-0.7,29,0,1556,1569,9668
1981,05,a) 0,4252,4269,26802,13429,4241,198.7,0,0,26746,26746,0,199.2,199.2,0,0,0,0,0,26746,199.2,0,0,,,
1981,05,b) 1,3326,3375,22655,23609,27,0.7,1232,30.5,6098,341,5757,1.4,25.8,8006,4626,3380,19.6,33.9,-1908,-8.1,51.6,0,938,938,3629
1981,05,c) 2,3253,3337,22376,24310,129,3.5,833,22.5,4565,812,3753,3.3,18.8,8432,4434,3998,18.2,34.7,-3867,-15.9,37.6,0,632,633,3182
1981,05,d) 3,2848,2891,18352,20130,95,3,684,21.3,2968,545,2423,2.7,14.7,6524,3014,3510,15,32.4,-3556,-17.7,29.4,0,510,510,2295
1981,05,e) 4,2552,2830,21641,23221,112,3.6,604,19.5,3467,860,2607,3.7,14.9,6626,3273,3353,14.1,28.5,-3159,-13.6,29.8,0,358,359,1772
1981,05,l) Left Censored,18775,23584,465085,478756,833,3.4,2797,11.4,51230,15685,35545,3.3,10.7,78572,22349,56223,4.7,16.4,-27342,-5.7,21.4,0,1576,1588,8523
1981,06,a) 0,59926,60311,403165,202391,59824,198.4,0,0,401549,401549,0,198.4,198.4,0,0,0,0,0,401549,198.4,0,0,,,
1981,06,b) 1,46697,47498,343068,359312,351,0.6,16445,29.1,103035,5216,97819,1.5,28.7,135523,79979,55544,22.3,37.7,-32488,-9,57.4,0,11784,11798,56095
1981,06,c) 2,40455,41555,322677,345992,1795,3.9,10754,23.2,75943,13265,62678,3.8,21.9,122573,66497,56076,19.2,35.4,-46630,-13.5,43.8,0,7433,7444,46360
1981,06,d) 3,33765,34764,290261,314914,1496,3.9,8161,21.3,65594,10404,55190,3.3,20.8,114899,49598,65301,15.7,36.5,-49305,-15.7,41.6,0,5788,5797,33935
1981,06,e) 4,33012,38411,429979,457092,1959,4.7,8699,20.7,85500,19826,65674,4.3,18.7,139726,59569,80157,13,30.6,-54226,-11.9,37.4,0,4376,4415,26529
1981,06,l) Left Censored,194477,266370,6444764,6528871,11514,4.1,33303,12,964193,241564,722629,3.7,14.8,1132407,410875,721532,6.3,17.3,-168214,-2.5,29.6,0,16252,16418,127918
1981,08,a) 0,8994,9057,58894,29961,8919,197,0,0,57867,57867,0,193.1,193.1,0,0,0,0,0,57867,193.1,0,0,,,
1981,08,b) 1,6882,6964,49255,51225,41,0.5,2658,31.7,15183,532,14651,1,29.6,19123,11380,7743,22.2,37.3,-3940,-7.7,59.2,0,2017,2017,9140
1981,08,c) 2,6041,6174,48520,52138,281,4.1,1783,25.7,11995,2323,9672,4.5,23,19230,11400,7830,21.9,36.9,-7235,-13.9,46,0,1258,1262,8502
1981,08,d) 3,4940,5036,42749,44275,190,3.4,1198,21.5,9556,2203,7353,5,21.6,12607,6506,6101,14.7,28.5,-3051,-6.9,43.2,0,900,900,5000
1981,08,e) 4,4415,5069,51982,53751,270,4.9,1182,21.3,11098,2776,8322,5.2,20.6,14635,7762,6873,14.4,27.2,-3537,-6.6,41.2,0,687,691,3892
1981,08,l) Left Censored,26501,34915,783171,786907,1772,4.9,4443,12.2,129364,35078,94286,4.5,16.4,136835,50070,86765,6.4,17.4,-7471,-1,32.8,0,2146,2169,19325
1981,09,a) 0,5766,5793,32676,16366,5755,198.7,0,0,32621,32621,0,199.3,199.3,0,0,0,0,0,32621,199.3,0,0,,,
1981,09,b) 1,4522,4590,28799,29466,26,0.5,1275,24.1,7572,344,7228,1.2,25.7,8906,5576,3330,18.9,30.2,-1334,-4.5,51.4,0,846,846,3763
1981,09,c) 2,4040,4089,28750,30234,139,3.1,911,20.2,5507,846,4661,2.8,18.2,8474,4454,4020,14.7,28,-2967,-9.8,36.4,0,614,614,2959
1981,09,d) 3,3745,3831,27698,28748,109,2.6,733,17.6,4784,880,3904,3.1,16.6,6883,3017,3866,10.5,23.9,-2099,-7.3,33.2,0,517,517,2100
1981,09,e) 4,3981,4457,42012,44372,174,3.6,850,17.7,6662,1548,5114,3.5,15,11382,6008,5374,13.5,25.7,-4720,-10.7,30,0,453,453,2405
1981,09,l) Left Censored,34390,41397,1078704,1088927,1164,2.7,4484,10.4,121205,34015,87190,3.1,11.1,141650,48323,93327,4.4,13,-20445,-1.9,22.2,0,2309,2315,14481
1981,10,a) 0,977,977,5692,2856,971,198.8,0,0,5673,5673,0,198.6,198.6,0,0,0,0,0,5673,198.6,0,0,,,
1981,10,b) 1,784,798,5962,5938,9,1,224,24.3,1582,149,1433,2.5,26.6,1534,801,733,13.5,25.8,48,0.8,51.6,0,147,147,517
1981,10,c) 2,745,765,6299,6207,18,2.1,168,19.9,1707,162,1545,2.6,27.5,1522,891,631,14.4,24.5,185,3,49,0,109,109,463
1981,10,d) 3,620,633,4481,4610,28,4,145,20.9,920,256,664,5.6,20,1177,610,567,13.2,25.5,-257,-5.5,40,0,100,100,382
1981,10,e) 4,719,841,8057,8365,28,3.1,148,16.4,1325,358,967,4.3,15.8,1941,881,1060,10.5,23.2,-616,-7.4,31.6,0,73,73,321
1981,10,l) Left Censored,5869,7243,182292,183494,232,3.1,804,10.7,20154,5989,14165,3.3,11,22557,7575,14982,4.1,12.3,-2403,-1.3,22,0,410,413,2834
1981,11,a) 0,1312,1317,16918,8500,1307,198.5,0,0,16836,16836,0,198.1,198.1,0,0,0,0,0,16836,198.1,0,0,,,
1981,11,b) 1,1031,1042,11292,11432,7,0.6,331,27,2975,70,2905,0.6,26,3255,1758,1497,15.4,28.5,-280,-2.5,52,0,233,233,962
1981,11,c) 2,893,908,8187,8607,27,2.7,217,21.5,1746,213,1533,2.5,20.3,2586,1296,1290,15.1,30,-840,-9.7,40.6,0,146,146,1005
1981,11,d) 3,844,867,10591,11166,28,3,174,18.5,1801,299,1502,2.7,16.1,2950,1553,1397,13.9,26.4,-1149,-10.3,32.2,0,121,121,1060
1981,11,e) 4,921,1054,26524,26949,59,5.2,211,18.6,3292,609,2683,2.3,12.2,4141,1946,2195,7.2,15.4,-849,-3.2,24.4,0,103,103,642
1981,11,l) Left Censored,8129,9865,266436,284218,350,3.4,1267,12.2,32231,7448,24783,2.6,11.3,67796,44405,23391,15.6,23.9,-35565,-12.6,22.6,0,582,587,8882
1981,12,a) 0,28804,28915,171667,86167,28709,198.6,0,0,171000,171000,0,198.5,198.5,0,0,0,0,0,171000,198.5,0,0,,,
1981,12,b) 1,21609,21884,156085,159153,126,0.5,7281,28.2,49335,1856,47479,1.2,31,55471,34675,20796,21.8,34.9,-6136,-3.9,62,0,5696,5700,26976
1981,12,c) 2,17375,17778,141494,148785,718,3.6,4430,22.4,32802,4606,28196,3.1,22,47383,25910,21473,17.4,31.8,-14581,-9.8,44,0,3434,3434,19930
1981,12,d) 3,15069,15485,125977,132371,617,3.6,3338,19.7,25815,4652,21163,3.5,19.5,38603,18039,20564,13.6,29.2,-12788,-9.7,39,0,2541,2541,13269
1981,12,e) 4,13903,15911,163699,172517,717,4.1,3359,19.4,31719,5862,25857,3.4,18.4,49354,22746,26608,13.2,28.6,-17635,-10.2,36.8,0,1964,1982,12266
1981,12,l) Left Censored,81469,112442,2321567,2317446,5275,4.5,12991,11.2,382656,98448,284208,4.2,16.5,374414,131891,242523,5.7,16.2,8242,0.3,32.4,0,6980,7050,48292
1981,13,a) 0,10245,10309,68705,34571,10231,198.5,0,0,68268,68268,0,197.5,197.5,0,0,0,0,0,68268,197.5,0,0,,,
1981,13,b) 1,7907,8042,58071,59102,76,0.8,2672,28.2,18748,1319,17429,2.2,31.7,20809,12632,8177,21.4,35.2,-2061,-3.5,63.4,0,2089,2089,9376
1981,13,c) 2,6888,7074,53132,55751,250,3.2,1773,22.5,12277,1807,10470,3.2,22,17515,9396,8119,16.9,31.4,-5238,-9.4,44,0,1322,1322,6745
1981,13,d) 3,6152,6326,50775,52985,244,3.5,1451,20.8,12104,2270,9834,4.3,22.8,16523,9496,7027,17.9,31.2,-4419,-8.4,45.6,0,1040,1040,5750
1981,13,e) 4,6184,7060,67934,75498,332,4.3,1494,19.5,12632,3076,9556,4.1,16.7,27759,18881,8878,25,36.8,-15127,-20.1,33.4,0,845,853,3994
1981,13,l) Left Censored,44614,62075,1427560,1441160,2650,4.1,7070,11,199592,55280,144312,3.8,13.8,226791,73971,152820,5.1,15.7,-27199,-1.9,27.6,0,3554,3568,22513
1981,15,a) 0,2352,2366,15932,7986,2348,198.5,0,0,15893,15893,0,199,199,0,0,0,0,0,15893,199,0,0,,,
1981,15,b) 1,1773,1830,14390,14478,36,1.7,608,28.3,4618,1104,3514,7.6,31.9,4794,2699,2095,18.6,33.1,-176,-1.2,63.8,0,464,465,2129
1981,15,c) 2,1505,1545,14486,15113,49,2.9,370,21.5,2915,222,2693,1.5,19.3,4168,2171,1997,14.4,27.6,-1253,-8.3,38.6,0,286,288,1759
1981,15,d) 3,1273,1299,10710,11834,41,2.9,294,20.5,1554,269,1285,2.3,13.1,3801,1921,1880,16.2,32.1,-2247,-19,26.2,0,216,216,1338
1981,15,e) 4,1232,1531,15136,16192,60,3.6,320,19.2,2524,616,1908,3.8,15.6,4635,2406,2229,14.9,28.6,-2111,-13,31.2,0,147,152,1123
1981,15,l) Left Censored,8939,11833,237568,239705,464,3.8,1255,10.2,30223,8882,21341,3.7,12.6,34497,11933,22564,5,14.4,-4274,-1.8,25.2,0,587,612,4234
1981,16,a) 0,2094,2105,10896,5464,2094,199,0,0,10864,10864,0,198.8,198.8,0,0,0,0,0,10864,198.8,0,0,,,
1981,16,b) 1,1755,1778,11749,12656,11,0.5,731,33.6,2819,68,2751,0.5,22.3,4633,2708,1925,21.4,36.6,-1814,-14.3,44.6,0,568,568,2196
1981,16,c) 2,1590,1621,11783,12417,53,2.9,457,25,2479,332,2147,2.7,20,3747,2013,1734,16.2,30.2,-1268,-10.2,40,0,366,366,1707
1981,16,d) 3,1369,1383,10290,11021,38,2.4,357,22.9,1607,101,1506,0.9,14.6,3068,1466,1602,13.3,27.8,-1461,-13.2,29.2,0,261,261,1122
1981,16,e) 4,1262,1427,11968,12106,53,3.4,317,20.2,2759,1298,1461,10.7,22.8,3034,1508,1526,12.5,25.1,-275,-2.3,45.6,0,189,191,963
1981,16,l) Left Censored,8377,10895,199789,196450,410,3.6,1353,11.9,40639,23461,17178,11.9,20.7,33961,11013,22948,5.6,17.3,6678,3.4,34.6,0,673,691,3992
1981,17,a) 0,17559,17648,117826,59158,17465,197.9,0,0,117337,117337,0,198.3,198.3,0,0,0,0,0,117337,198.3,0,0,,,
1981,17,b) 1,14427,14643,102667,106624,81,0.5,4143,24.5,26537,1108,25429,1,24.9,34451,20114,14337,18.9,32.3,-7914,-7.4,49.8,0,2889,2890,13030
1981,17,c) 2,12673,12918,94203,102570,449,3.1,2992,21,18930,3250,15680,3.2,18.5,35663,21008,14655,20.5,34.8,-16733,-16.3,37,0,2122,2126,16311
1981,17,d) 3,11657,11968,88978,94201,401,3.1,2513,19.2,15971,3355,12616,3.6,17,26417,13558,12859,14.4,28,-10446,-11,34,0,1841,1848,9893
1981,17,e) 4,12123,14001,143461,149379,560,3.7,2751,18.2,24028,5353,18675,3.6,16.1,35863,17457,18406,11.7,24,-11835,-7.9,32.2,0,1480,1489,7934
1981,17,l) Left Censored,105031,132212,3422892,3516366,4413,3.2,15939,11.5,376051,96052,279999,2.7,10.7,562999,189390,373609,5.4,16,-186948,-5.3,21.4,0,8081,8179,61922
1981,18,a) 0,7744,7797,55199,27709,7716,197.9,0,0,54981,54981,0,198.4,198.4,0,0,0,0,0,54981,198.4,0,0,,,
1981,18,b) 1,6474,6560,41335,44319,43,0.6,2044,26.6,10180,585,9595,1.3,23,16148,9536,6612,21.5,36.4,-5968,-13.4,46,0,1510,1510,6519
1981,18,c) 2,6036,6159,40981,43722,220,3.2,1439,21.1,7951,1696,6255,3.9,18.2,13433,6871,6562,15.7,30.7,-5482,-12.5,36.4,0,1075,1078,4935
1981,18,d) 3,5476,5670,42552,44994,196,3.2,1195,19.3,7269,1856,5413,4.1,16.2,12153,5845,6308,13,27,-4884,-10.8,32.4,0,895,895,4320
1981,18,e) 4,5498,6446,62093,65060,226,3.2,1220,17.5,10042,3691,6351,5.7,15.4,15975,7610,8365,11.7,24.6,-5933,-9.2,30.8,0,664,672,3492
1981,18,l) Left Censored,47343,62636,1496987,1539060,1958,3,7123,10.9,157183,32718,124465,2.1,10.2,241330,77932,163398,5.1,15.7,-84147,-5.5,20.4,0,3545,3569,22650
1981,19,a) 0,5404,5446,31708,15933,5392,198,0,0,31550,31550,0,198,198,0,0,0,0,0,31550,198,0,0,,,
1981,19,b) 1,4489,4536,26141,28208,28,0.5,1372,26,5842,731,5111,2.6,20.7,9976,5532,4444,19.6,35.4,-4134,-14.7,41.4,0,1027,1027,4201
1981,19,c) 2,3916,4048,26587,28520,120,2.7,962,21.4,4691,983,3708,3.4,16.4,8557,4488,4069,15.7,30,-3866,-13.6,32.8,0,709,709,3202
1981,19,d) 3,3887,4007,26351,28147,128,2.9,821,18.8,4090,1052,3038,3.7,14.5,7682,3430,4252,12.2,27.3,-3592,-12.8,29,0,631,631,2639
1981,19,e) 4,3990,4561,35291,38015,144,2.9,861,17.5,4424,946,3478,2.5,11.6,9872,5259,4613,13.8,26,-5448,-14.4,23.2,0,526,530,2624
1981,19,l) Left Censored,32071,40862,710573,733366,1205,2.8,4489,10.5,82342,32886,49456,4.5,11.2,127927,45502,82425,6.2,17.4,-45585,-6.2,22.4,0,2423,2441,13017
1981,20,a) 0,5179,5218,31356,15730,5177,198.4,0,0,31252,31252,0,198.7,198.7,0,0,0,0,0,31252,198.7,0,0,,,
1981,20,b) 1,3764,3809,24937,26085,24,0.5,1280,28.5,7123,350,6773,1.3,27.3,9418,6285,3133,24.1,36.1,-2295,-8.8,54.6,0,930,931,4521
1981,20,c) 2,3475,3523,23821,24918,136,3.5,870,22.2,5241,907,4334,3.6,21,7435,3750,3685,15,29.8,-2194,-8.8,42,0,614,614,2511
1981,20,d) 3,3188,3235,21129,22444,105,3,720,20.2,4170,604,3566,2.7,18.6,6799,3771,3028,16.8,30.3,-2629,-11.7,37.2,0,545,545,2881
1981,20,e) 4,3346,3842,34095,35205,166,4,750,18.1,6440,1652,4788,4.7,18.3,8659,4412,4247,12.5,24.6,-2219,-6.3,36.6,0,459,464,2415
1981,20,l) Left Censored,26173,33061,605455,616785,1111,3.2,3860,11.2,71149,20438,50711,3.3,11.5,93808,29479,64329,4.8,15.2,-22659,-3.7,23,0,2057,2071,11760
1981,21,a) 0,5328,5345,32770,16487,5291,198,0,0,32567,32567,0,197.5,197.5,0,0,0,0,0,32567,197.5,0,0,,,
1981,21,b) 1,4138,4207,28394,30292,28,0.6,1402,28.3,6909,312,6597,1,22.8,10705,6228,4477,20.6,35.3,-3796,-12.5,45.6,0,1029,1029,4616
1981,21,c) 2,3917,3991,32930,34131,146,3.3,1077,24,6746,821,5925,2.4,19.8,9147,5072,4075,14.9,26.8,-2401,-7,39.6,0,796,796,3704
1981,21,d) 3,3580,3650,26911,28534,132,3.3,777,19.5,4028,664,3364,2.3,14.1,7273,3672,3601,12.9,25.5,-3245,-11.4,28.2,0,574,574,2555
1981,21,e) 4,3570,4023,33443,35802,189,4.3,812,18.7,5171,1323,3848,3.7,14.4,9888,4886,5002,13.6,27.6,-4717,-13.2,28.8,0,477,483,2595
1981,21,l) Left Censored,29328,37709,779684,800732,1207,3.1,4155,10.6,89514,23127,66387,2.9,11.2,131610,39259,92351,4.9,16.4,-42096,-5.2,22.4,0,2225,2236,13477
1981,22,a) 0,8422,8441,60829,30537,8384,198.6,0,0,60585,60585,0,198.4,198.4,0,0,0,0,0,60585,198.4,0,0,,,
1981,22,b) 1,6351,6440,57092,56191,38,0.5,2104,27.8,18751,1218,17533,2.2,33.4,16948,10323,6625,18.4,30.2,1803,3.2,60.4,0,1606,1606,8017
1981,22,c) 2,5831,5985,56095,56124,216,3.3,1367,20.7,16048,3183,12865,5.7,28.6,16106,7536,8570,13.4,28.7,-58,-0.1,57.2,0,1028,1033,5345
1981,22,d) 3,4691,4760,45257,48360,156,3,993,19,10420,1539,8881,3.2,21.5,16626,6126,10500,12.7,34.4,-6206,-12.9,43,0,726,726,4323
1981,22,e) 4,4368,4981,53688,55785,196,3.7,920,17.2,10581,1648,8933,3,19,14774,7447,7327,13.3,26.5,-4193,-7.5,38,0,547,550,3121
1981,22,l) Left Censored,33647,44715,1011301,1013950,1607,3.5,4866,10.5,149461,33515,115946,3.3,14.7,154758,50612,104146,5,15.3,-5297,-0.6,29.4,0,2546,2576,18274
1981,23,a) 0,2061,2067,11442,5739,2048,198.2,0,0,11407,11407,0,198.8,198.8,0,0,0,0,0,11407,198.8,0,0,,,
1981,23,b) 1,1635,1656,10103,10817,9,0.5,503,26.1,2454,96,2358,0.9,22.7,3881,2619,1262,24.2,35.9,-1427,-13.2,45.4,0,344,344,1222
1981,23,c) 2,1542,1561,11042,10932,53,3.1,320,18.7,2562,289,2273,2.6,23.4,2342,1257,1085,11.5,21.4,220,2,42.8,0,213,213,837
1981,23,d) 3,1446,1479,9500,9828,53,3.3,308,19,1809,238,1571,2.4,18.4,2464,1105,1359,11.2,25.1,-655,-6.7,36.8,0,227,227,841
1981,23,e) 4,1437,1650,14786,14871,71,4,308,17.4,2595,528,2067,3.6,17.5,2765,1290,1475,8.7,18.6,-170,-1.1,35,0,185,185,695
1981,23,l) Left Censored,11000,13567,255499,259738,361,2.5,1572,11.1,30469,4820,25649,1.9,11.7,38946,14495,24451,5.6,15,-8477,-3.3,23.4,0,880,889,4846
1981,24,a) 0,6573,6610,43351,21748,6549,198.2,0,0,43206,43206,0,198.7,198.7,0,0,0,0,0,43206,198.7,0,0,,,
1981,24,b) 1,5167,5243,38010,38545,29,0.5,1609,26.4,10587,353,10234,0.9,27.5,11656,7015,4641,18.2,30.2,-1069,-2.7,55,0,1080,1080,4571
1981,24,c) 2,4595,4694,36259,37502,170,3.3,1095,21.1,8593,1100,7493,2.9,22.9,11078,5750,5328,15.3,29.5,-2485,-6.6,45.8,0,771,771,3874
1981,24,d) 3,4060,4156,31288,32649,137,3,876,19.3,6257,615,5642,1.9,19.2,8978,4468,4510,13.7,27.5,-2721,-8.3,38.4,0,614,614,2717
1981,24,e) 4,4301,4948,52375,67306,200,3.7,992,18.5,10922,4549,6373,6.8,16.2,40784,6657,34127,9.9,60.6,-29862,-44.4,32.4,0,552,552,2579
1981,24,l) Left Censored,35028,45807,1059085,1076994,1810,3.8,5236,11,134872,36553,98319,3.4,12.5,170689,61347,109342,5.7,15.8,-35817,-3.3,25,0,2551,2574,18461
1981,25,a) 0,9093,9129,64586,32378,9066,198.6,0,0,64417,64417,0,199,199,0,0,0,0,0,64417,199,0,0,,,
1981,25,b) 1,7402,7473,56139,56006,32,0.4,1924,22.5,15065,619,14446,1.1,26.9,14799,7893,6906,14.1,26.4,266,0.5,52.8,0,1299,1299,5363
1981,25,c) 2,6734,6885,52262,55472,232,3.1,1353,18,10874,1556,9318,2.8,19.6,17294,7967,9327,14.4,31.2,-6420,-11.6,39.2,0,930,930,5363
1981,25,d) 3,6089,6296,57142,58597,223,3.3,1094,16.1,10560,1608,8952,2.7,18,13469,6099,7370,10.4,23,-2909,-5,36,0,806,809,3851
1981,25,e) 4,6281,7276,101355,103593,313,4,1186,15.3,16449,3919,12530,3.8,15.9,20925,9235,11690,8.9,20.2,-4476,-4.3,31.8,0,608,616,4247
1981,25,l) Left Censored,60613,74309,1923953,1952757,2267,2.9,7715,10,247470,52112,195358,2.7,12.7,305078,124956,180122,6.4,15.6,-57608,-2.9,25.4,0,3793,3824,38779
1981,26,a) 0,12839,12904,82299,41478,12804,198.5,0,0,81642,81642,0,196.8,196.8,0,0,0,0,0,81642,196.8,0,0,,,
1981,26,b) 1,10302,10443,68955,72771,73,0.6,3332,27.2,17061,1251,15810,1.7,23.4,24692,14794,9898,20.3,33.9,-7631,-10.5,46.8,0,2218,2226,9444
1981,26,c) 2,9641,9869,99898,102859,358,3.3,2383,21.7,17035,2638,14397,2.6,16.6,22956,11363,11593,11,22.3,-5921,-5.7,33.2,0,1612,1613,7162
1981,26,d) 3,8873,9112,67255,72717,322,3.2,2028,20.2,11021,1879,9142,2.6,15.2,21944,10780,11164,14.8,30.2,-10923,-15,30.4,0,1407,1407,6629
1981,26,e) 4,8896,10371,98845,104114,394,3.5,2202,19.4,16089,3032,13057,2.9,15.5,26626,12892,13734,12.4,25.6,-10537,-10.1,31,0,1179,1201,6071
1981,26,l) Left Censored,72709,95209,2325208,2410193,3123,3.1,11419,11.5,243538,74466,169072,3.1,10.1,413507,134509,278998,5.6,17.2,-169969,-7.1,20.2,0,5584,5633,35954
1981,27,a) 0,7206,7248,52729,26606,7199,198.6,0,0,52247,52247,0,196.4,196.4,0,0,0,0,0,52247,196.4,0,0,,,
1981,27,b) 1,5986,6060,40269,42871,33,0.5,1698,24.3,9998,326,9672,0.8,23.3,15201,9759,5442,22.8,35.5,-5203,-12.2,46.6,0,1206,1207,7578
1981,27,c) 2,5623,5759,41558,46243,189,3,1254,19.8,7407,1146,6261,2.5,16,16776,7909,8867,17.1,36.3,-9369,-20.3,32,0,872,874,5886
1981,27,d) 3,5093,5248,43193,45162,177,3.1,984,17.3,7617,1589,6028,3.5,16.9,11555,5200,6355,11.5,25.6,-3938,-8.7,33.8,0,700,700,4058
1981,27,e) 4,5044,5816,62553,64101,230,3.7,1051,16.8,10698,2626,8072,4.1,16.7,13794,6226,7568,9.7,21.5,-3096,-4.8,33.4,0,558,562,2775
1981,27,l) Left Censored,39839,50636,1214226,1238471,1589,3,5305,10.1,149733,40731,109002,3.3,12.1,198223,67858,130365,5.5,16,-48490,-3.9,24.2,0,2609,2631,21567
1981,28,a) 0,3984,3999,22893,11588,3968,198.4,0,0,22610,22610,0,195.1,195.1,0,0,0,0,0,22610,195.1,0,0,,,
1981,28,b) 1,3278,3323,21735,22812,19,0.5,1227,30.8,5663,439,5224,1.9,24.8,7817,4819,2998,21.1,34.3,-2154,-9.5,49.6,0,931,931,3590
1981,28,c) 2,2982,3044,21291,22477,108,3.2,758,22.4,4306,936,3370,4.2,19.2,6677,3444,3233,15.3,29.7,-2371,-10.5,38.4,0,556,556,2469
1981,28,d) 3,2465,2503,18819,20207,100,3.6,619,22.3,2998,825,2173,4.1,14.8,5773,2755,3018,13.6,28.6,-2775,-13.8,29.6,0,478,478,2139
1981,28,e) 4,2681,3105,25223,26771,123,3.7,559,16.8,4339,1020,3319,3.8,16.2,7435,2992,4443,11.2,27.8,-3096,-11.6,32.4,0,319,322,1563
1981,28,l) Left Censored,19693,25427,486326,497547,736,2.8,2887,10.9,54422,10672,43750,2.1,10.9,76863,22982,53881,4.6,15.4,-22441,-4.5,21.8,0,1657,1662,10094
1981,29,a) 0,8895,8941,55081,27761,8845,197.9,0,0,54641,54641,0,196.8,196.8,0,0,0,0,0,54641,196.8,0,0,,,
1981,29,b) 1,6762,6870,43655,46925,42,0.5,2372,29.1,10542,654,9888,1.4,22.5,17082,10534,6548,22.4,36.4,-6540,-13.9,45,0,1682,1687,7016
1981,29,c) 2,6241,6369,46230,48395,214,3,1654,23.2,10409,1210,9199,2.5,21.5,14738,8243,6495,17,30.5,-4329,-9,43,0,1187,1189,5955
1981,29,d) 3,5613,5736,42024,45068,199,3.2,1274,20.2,7033,1089,5944,2.4,15.6,13121,6528,6593,14.5,29.1,-6088,-13.5,31.2,0,953,953,4715
1981,29,e) 4,5702,6479,59762,62672,244,3.5,1322,18.8,9931,2632,7299,4.2,15.8,15751,8068,7683,12.9,25.1,-5820,-9.3,31.6,0,744,748,3722
1981,29,l) Left Censored,46405,60375,1361807,1387689,2050,3.3,6930,11,159570,42278,117292,3,11.5,211335,70920,140415,5.1,15.2,-51765,-3.7,23,0,3560,3576,20480
1981,30,a) 0,2196,2205,11530,5806,2182,197.9,0,0,11449,11449,0,197.2,197.2,0,0,0,0,0,11449,197.2,0,0,,,
1981,30,b) 1,1809,1816,11664,11900,7,0.3,581,27.3,3238,43,3195,0.4,27.2,3710,2256,1454,19,31.2,-472,-4,54.4,0,421,421,1762
1981,30,c) 2,1728,1758,11175,11674,70,3.6,431,22.1,2377,411,1966,3.5,20.4,3375,1701,1674,14.6,28.9,-998,-8.5,40.8,0,310,310,1279
1981,30,d) 3,1381,1401,9076,10127,47,3,330,21.2,1450,190,1260,1.9,14.3,3551,1964,1587,19.4,35.1,-2101,-20.8,28.6,0,236,236,1527
1981,30,e) 4,1360,1508,10878,11301,60,3.6,336,20.3,2195,493,1702,4.4,19.4,3041,1566,1475,13.9,26.9,-846,-7.5,38.8,0,193,193,913
1981,30,l) Left Censored,8626,10718,145351,149724,366,3.3,1235,11,17243,3118,14125,2.1,11.5,25988,9629,16359,6.4,17.4,-8745,-5.9,23,0,654,654,4010
1981,31,a) 0,3224,3242,21572,10817,3221,198.7,0,0,21511,21511,0,198.9,198.9,0,0,0,0,0,21511,198.9,0,0,,,
1981,31,b) 1,2582,2605,15995,16724,13,0.4,788,26,4037,199,3838,1.2,24.1,5495,3170,2325,19,32.9,-1458,-8.8,48.2,0,563,563,2161
1981,31,c) 2,2374,2416,14179,15152,68,2.6,529,19.8,2417,379,2038,2.5,16,4362,2283,2079,15.1,28.8,-1945,-12.8,32,0,398,398,1713
1981,31,d) 3,2184,2224,16811,17206,73,3,438,18.1,3196,297,2899,1.7,18.6,3985,1936,2049,11.3,23.2,-789,-4.6,37.2,0,309,309,1360
1981,31,e) 4,2295,2553,19360,20459,95,3.4,491,17.8,2765,402,2363,2,13.5,4962,2565,2397,12.5,24.3,-2197,-10.8,27,0,270,274,1275
1981,31,l) Left Censored,18175,22525,395820,401550,610,2.6,2542,10.8,47849,10313,37536,2.6,11.9,59308,21701,37607,5.4,14.8,-11459,-2.9,23.8,0,1273,1274,7424
1981,32,a) 0,2532,2541,16541,8309,2516,198,0,0,16465,16465,0,198.2,198.2,0,0,0,0,0,16465,198.2,0,0,,,
1981,32,b) 1,1940,1959,18786,19245,14,0.6,779,32.8,5865,213,5652,1.1,30.5,6782,4110,2672,21.4,35.2,-917,-4.7,61,0,604,604,2953
1981,32,c) 2,1745,1774,17225,18485,79,4,470,23.7,3388,696,2692,3.8,18.3,5908,2895,3013,15.7,32,-2520,-13.7,36.6,0,332,332,2059
1981,32,d) 3,1275,1317,12941,14249,51,3.5,354,24,2511,302,2209,2.1,17.6,5127,2676,2451,18.8,36,-2616,-18.4,35.2,0,247,248,2136
1981,32,e) 4,1170,1346,18903,20012,73,5,304,20.7,5319,3390,1929,16.9,26.6,7536,4454,3082,22.3,37.7,-2217,-11.1,53.2,0,165,165,993
1981,32,l) Left Censored,6682,8735,247190,253961,500,5.5,1071,11.8,35835,9605,26230,3.8,14.1,49377,13740,35637,5.4,19.4,-13542,-5.3,28.2,0,513,516,3766
1981,33,a) 0,2014,2024,12571,6315,2003,197.9,0,0,12513,12513,0,198.1,198.1,0,0,0,0,0,12513,198.1,0,0,,,
1981,33,b) 1,1534,1543,9294,9623,6,0.3,476,26.4,2688,140,2548,1.5,27.9,3346,1986,1360,20.6,34.8,-658,-6.9,55.8,0,301,301,1190
1981,33,c) 2,1487,1509,10621,11166,48,2.9,342,20.5,2092,215,1877,1.9,18.7,3182,1550,1632,13.9,28.5,-1090,-9.8,37.4,0,255,255,1052
1981,33,d) 3,1365,1388,10348,10645,51,3.3,318,20.8,2165,315,1850,3,20.3,2759,1428,1331,13.4,25.9,-594,-5.6,40.6,0,222,222,845
1981,33,e) 4,1362,1531,15216,15350,74,4.5,275,16.8,2893,435,2458,2.8,18.8,3161,1816,1345,11.8,20.6,-268,-1.8,37.6,0,166,166,973
1981,33,l) Left Censored,9795,11688,260915,264267,421,3.5,1294,10.6,35915,7896,28019,3,13.6,42618,16459,26159,6.2,16.1,-6703,-2.5,27.2,0,693,696,5146
1981,34,a) 0,13350,13378,80876,40601,13261,198.3,0,0,80551,80551,0,198.4,198.4,0,0,0,0,0,80551,198.4,0,0,,,
1981,34,b) 1,10856,10931,71210,70136,45,0.4,3248,25.6,23309,3070,20239,4.4,33.2,21161,12900,8261,18.4,30.2,2148,3,60.4,0,2197,2197,8064
1981,34,c) 2,9718,9840,68583,69230,353,3.3,2182,20.2,18893,1803,17090,2.6,27.3,20186,12018,8168,17.4,29.2,-1293,-1.9,54.6,0,1477,1477,7251
1981,34,d) 3,8509,8648,59107,60872,303,3.2,1678,17.9,11947,1471,10476,2.4,19.6,15477,6976,8501,11.5,25.4,-3530,-5.8,39.2,0,1199,1199,4914
1981,34,e) 4,9022,9730,86361,88583,351,3.3,1861,17.7,15462,2950,12512,3.3,17.5,19906,10639,9267,12,22.5,-4444,-5,35,0,1043,1046,4765
1981,34,l) Left Censored,78094,94568,2155988,2183657,2924,3,10144,10.3,277418,74674,202744,3.4,12.7,332757,124166,208591,5.7,15.2,-55339,-2.5,25.4,0,5447,5486,33824
1981,35,a) 0,3131,3149,19247,9786,3106,197.3,0,0,18923,18923,0,193.4,193.4,0,0,0,0,0,18923,193.4,0,0,,,
1981,35,b) 1,2515,2544,18596,19388,13,0.4,879,29.1,5066,126,4940,0.6,26.1,6650,4007,2643,20.7,34.3,-1584,-8.2,52.2,0,677,677,3055
1981,35,c) 2,2216,2289,17846,19009,79,3.1,592,23.1,3843,526,3317,2.8,20.2,6168,3130,3038,16.5,32.4,-2325,-12.2,40.4,0,451,453,2484
1981,35,d) 3,1780,1818,13137,14150,70,3.5,400,20,2552,326,2226,2.3,18,4577,2021,2556,14.3,32.3,-2025,-14.3,36,0,299,299,1483
1981,35,e) 4,1700,1917,15672,16624,88,4.2,393,18.9,2865,545,2320,3.3,17.2,4769,2464,2305,14.8,28.7,-1904,-11.5,34.4,0,234,239,1308
1981,35,l) Left Censored,10682,13824,244526,247134,582,4,1832,12.6,38144,9602,28542,3.9,15.4,43359,16063,27296,6.5,17.5,-5215,-2.1,30.8,0,968,971,7263
1981,36,a) 0,31135,31226,197877,99522,30962,198.3,0,0,196710,196710,0,197.7,197.7,0,0,0,0,0,196710,197.7,0,0,,,
1981,36,b) 1,24690,24892,171622,172220,77,0.3,7148,24.8,52305,1492,50813,0.9,30.4,53501,32823,20678,19.1,31.1,-1196,-0.7,60.8,0,5029,5029,22202
1981,36,c) 2,22130,22380,147593,155663,702,2.8,4929,20,29427,3871,25556,2.5,18.9,45566,24195,21371,15.5,29.3,-16139,-10.4,37.8,0,3514,3515,17302
1981,36,d) 3,20413,20778,148252,154840,637,2.8,4055,17.9,28990,5139,23851,3.3,18.7,42165,22676,19489,14.6,27.2,-13175,-8.5,37.4,0,3046,3049,14398
1981,36,e) 4,20356,22592,218869,226559,804,3.3,4121,16.9,37654,6825,30829,3,16.6,53034,24065,28969,10.6,23.4,-15380,-6.8,33.2,0,2441,2458,11723
1981,36,l) Left Censored,188558,224673,4952210,5055444,5774,2.5,25395,10.8,614248,128955,485293,2.6,12.2,820716,300683,520033,5.9,16.2,-206468,-4,24.4,0,14430,14536,90379
1981,37,a) 0,10000,10058,63257,31710,9989,198.6,0,0,63094,63094,0,199,199,0,0,0,0,0,63094,199,0,0,,,
1981,37,b) 1,7683,7804,51334,53700,52,0.6,2727,29.4,14272,719,13553,1.3,26.6,19003,12209,6794,22.7,35.4,-4731,-8.8,53.2,0,2032,2034,8477
1981,37,c) 2,7012,7194,50669,53898,291,3.6,1815,22.7,10196,1677,8519,3.1,18.9,16654,9286,7368,17.2,30.9,-6458,-12,37.8,0,1319,1319,6720
1981,37,d) 3,6476,6656,48833,50497,247,3.4,1412,19.4,9942,2284,7658,4.5,19.7,13269,6352,6917,12.6,26.3,-3327,-6.6,39.4,0,1043,1043,4166
1981,37,e) 4,6296,7191,64235,67851,288,3.7,1444,18.5,10750,1832,8918,2.7,15.8,17981,9817,8164,14.5,26.5,-7231,-10.7,31.6,0,799,803,3970
1981,37,l) Left Censored,50345,68284,1683984,1707895,2416,3.4,7282,10.3,185331,46353,138978,2.7,10.9,233154,79257,153897,4.6,13.7,-47823,-2.8,21.8,0,3871,3893,26164
1981,38,a) 0,1522,1531,8986,4501,1523,199,0,0,8970,8970,0,199.3,199.3,0,0,0,0,0,8970,199.3,0,0,,,
1981,38,b) 1,1202,1213,7712,8119,8,0.6,381,26.9,1933,283,1650,3.5,23.8,2746,1414,1332,17.4,33.8,-813,-10,47.6,0,262,262,1065
1981,38,c) 2,1125,1146,7762,8093,47,3.7,303,23.7,1673,397,1276,4.9,20.7,2334,1273,1061,15.7,28.8,-661,-8.1,41.4,0,225,225,994
1981,38,d) 3,971,985,5910,6495,28,2.6,181,17,1005,126,879,1.9,15.5,2175,933,1242,14.4,33.5,-1170,-18,31,0,128,128,705
1981,38,e) 4,1015,1088,7678,8167,51,4.4,196,16.8,1066,228,838,2.8,13.1,2043,858,1185,10.5,25,-977,-11.9,26.2,0,130,130,592
1981,38,l) Left Censored,7705,9492,131591,134695,313,3.2,973,9.9,14169,3142,11027,2.3,10.5,20377,6314,14063,4.7,15.1,-6208,-4.6,21,0,507,508,2755
1981,39,a) 0,14784,14883,104462,52442,14754,198.3,0,0,104041,104041,0,198.4,198.4,0,0,0,0,0,104041,198.4,0,0,,,
1981,39,b) 1,11798,12035,81050,85858,100,0.7,3899,27.6,20909,1497,19412,1.7,24.4,30525,17292,13233,20.1,35.6,-9616,-11.2,48.8,0,2714,2714,11512
1981,39,c) 2,11009,11241,87133,91366,366,2.9,2730,21.8,17782,2538,15244,2.8,19.5,26248,14418,11830,15.8,28.7,-8466,-9.2,39,0,1887,1889,9463
1981,39,d) 3,9915,10235,77074,80765,421,3.8,2141,19.2,14310,3395,10915,4.2,17.7,21692,10655,11037,13.2,26.9,-7382,-9.2,35.4,0,1519,1521,7302
1981,39,e) 4,10345,12277,116790,123258,476,3.6,2440,18.3,17587,4196,13391,3.4,14.3,30522,15006,15516,12.2,24.8,-12935,-10.5,28.6,0,1219,1230,6334
1981,39,l) Left Censored,93674,128644,3068469,3179328,4252,3.2,13964,10.4,287956,72677,215279,2.3,9.1,509673,165619,344054,5.2,16,-221717,-6.9,18.2,0,6566,6623,42697
1981,40,a) 0,7799,7821,49660,24930,7746,198.1,0,0,49461,49461,0,198.4,198.4,0,0,0,0,0,49461,198.4,0,0,,,
1981,40,b) 1,5836,5907,44439,44760,32,0.5,1987,28.5,14345,549,13796,1.2,32,14986,9542,5444,21.3,33.5,-641,-1.5,64,0,1605,1605,7701
1981,40,c) 2,4939,5079,45280,44360,196,3.5,1332,23.5,13604,2901,10703,6.5,30.7,11763,6640,5123,15,26.5,1841,4.2,53,0,1042,1042,5187
1981,40,d) 3,4095,4168,34335,35180,128,2.8,899,19.6,7208,744,6464,2.1,20.5,8898,4620,4278,13.1,25.3,-1690,-4.8,41,0,701,701,3673
1981,40,e) 4,3791,4313,41945,42644,188,4,853,18.3,8759,1482,7277,3.5,20.5,10157,4716,5441,11.1,23.8,-1398,-3.3,41,0,533,537,2522
1981,40,l) Left Censored,26802,34813,700448,702687,1278,3.5,4134,11.4,99720,24395,75325,3.5,14.2,104197,39971,64226,5.7,14.8,-4477,-0.6,28.4,0,2217,2228,13481
1981,41,a) 0,7023,7060,40499,20376,7002,198.4,0,0,40246,40246,0,197.5,197.5,0,0,0,0,0,40246,197.5,0,0,,,
1981,41,b) 1,5722,5802,36559,39203,51,0.7,2154,31,9291,656,8635,1.7,23.7,14579,8670,5909,22.1,37.2,-5288,-13.5,47.4,0,1667,1667,6589
1981,41,c) 2,4728,4794,31875,35288,225,4.1,1398,25.8,5902,1077,4825,3.1,16.7,12727,6908,5819,19.6,36.1,-6825,-19.4,33.4,0,1018,1019,5064
1981,41,d) 3,4117,4202,29254,32229,198,4.2,1154,24.4,5912,1268,4644,3.9,18.3,11861,6437,5424,20,36.8,-5949,-18.5,36.6,0,813,814,4558
1981,41,e) 4,3945,4478,44069,47490,218,4.4,1107,22.4,6450,1770,4680,3.7,13.6,13292,6244,7048,13.1,28,-6842,-14.4,27.2,0,617,624,2928
1981,41,l) Left Censored,24867,32169,613970,637801,1304,3.9,4094,12.2,69086,21541,47545,3.4,10.8,116747,38850,77897,6.1,18.3,-47661,-7.5,21.6,0,2031,2044,15430
1981,42,a) 0,15125,15214,109265,54785,15090,198.4,0,0,108960,108960,0,198.9,198.9,0,0,0,0,0,108960,198.9,0,0,,,
1981,42,b) 1,12773,12947,88302,91784,83,0.6,3746,25,22279,2085,20194,2.3,24.3,29243,17231,12012,18.8,31.9,-6964,-7.6,48.6,0,2638,2638,11797
1981,42,c) 2,11895,12225,87253,92904,373,2.8,2721,20.2,15847,2701,13146,2.9,17.1,27149,14837,12312,16,29.2,-11302,-12.1,34.2,0,1805,1807,10180
1981,42,d) 3,10817,11084,81100,86195,361,3,2223,18.4,13621,2230,11391,2.6,15.8,23810,12516,11294,14.5,27.6,-10189,-11.8,31.6,0,1542,1544,8340
1981,42,e) 4,11426,13212,134549,139179,529,3.7,2679,18.6,22359,5105,17254,3.7,16.1,31618,16364,15254,11.8,22.7,-9259,-6.6,32.2,0,1381,1396,7779
1981,42,l) Left Censored,108947,141417,3461199,3521092,4460,3,15286,10.4,393181,109952,283229,3.1,11.2,512967,169464,343503,4.8,14.6,-119786,-3.4,22.4,0,7979,8029,51098
1981,44,a) 0,1632,1637,10837,5453,1623,198.3,0,0,10769,10769,0,197.5,197.5,0,0,0,0,0,10769,197.5,0,0,,,
1981,44,b) 1,1288,1301,8113,8343,9,0.6,423,27.6,2171,73,2098,0.9,26,2630,1530,1100,18.3,31.5,-459,-5.5,52,0,277,277,868
1981,44,c) 2,1238,1255,8971,9290,44,3.2,249,18.2,2009,275,1734,3,21.6,2647,1422,1225,15.3,28.5,-638,-6.9,43.2,0,169,169,874
1981,44,d) 3,1119,1131,9246,9665,42,3.4,210,17.2,1606,188,1418,1.9,16.6,2443,948,1495,9.8,25.3,-837,-8.7,33.2,0,149,149,684
1981,44,e) 4,1200,1291,12250,12244,57,4.1,236,17,2374,584,1790,4.8,19.4,2361,983,1378,8,19.3,13,0.1,38.6,0,156,156,525
1981,44,l) Left Censored,11374,13178,285197,292172,367,2.7,1374,10,30879,7096,23783,2.4,10.6,44829,16238,28591,5.6,15.3,-13950,-4.7,21.2,0,729,733,5346
1981,45,a) 0,5103,5137,31330,15709,5100,198.6,0,0,31242,31242,0,198.9,198.9,0,0,0,0,0,31242,198.9,0,0,,,
1981,45,b) 1,3890,3978,27880,29022,24,0.5,1516,31.7,7413,940,6473,3.2,25.5,9696,6076,3620,20.9,33.4,-2283,-7.9,51,0,1089,1089,4161
1981,45,c) 2,3391,3477,24069,25917,106,2.7,945,24.1,5539,443,5096,1.7,21.4,9235,5626,3609,21.7,35.6,-3696,-14.2,42.8,0,649,653,3912
1981,45,d) 3,3272,3347,24383,26197,118,3.2,733,19.9,4499,844,3655,3.2,17.2,8127,3966,4161,15.1,31,-3628,-13.8,34.4,0,511,511,2648
1981,45,e) 4,3108,3454,27045,28853,144,3.8,784,20.7,5089,1628,3461,5.6,17.6,8705,5117,3588,17.7,30.2,-3616,-12.6,35.2,0,432,434,2571
1981,45,l) Left Censored,24689,32853,814452,826567,1257,3.7,3659,10.7,88738,22211,66527,2.7,10.7,112967,37897,75070,4.6,13.7,-24229,-3,21.4,0,1974,1985,12872
1981,46,a) 0,1399,1411,7413,3721,1399,198.3,0,0,7385,,,,198.5,0,0,0,0,0,7385,198.5,0,1,,,
1981,46,b) 1,1197,1210,6757,7284,2,0.1,408,28.5,1392,,,,19.1,2446,1495,951,20.5,33.6,-1054,-14.5,38.2,1,270,270,1084
1981,46,c) 2,1084,1106,7106,7629,36,2.9,289,23.3,1186,172,1014,2.3,15.5,2231,1278,953,16.8,29.2,-1045,-13.7,31,0,198,198,801
1981,46,d) 3,1038,1055,6242,6753,33,2.8,245,20.9,1079,154,925,2.3,16,2100,1123,977,16.6,31.1,-1021,-15.1,32,0,179,179,916
1981,46,e) 4,1007,1112,7387,7878,32,2.7,190,15.9,1088,295,793,3.7,13.8,2069,877,1192,11.1,26.3,-981,-12.5,27.6,0,112,112,471
1981,46,l) Left Censored,8248,9900,133922,138167,263,2.6,1017,9.9,12784,3147,9637,2.3,9.3,21274,6763,14511,4.9,15.4,-8490,-6.1,18.6,0,573,577,3294
1981,47,a) 0,7565,7618,48682,24417,7571,198.8,0,0,48530,48530,0,198.8,198.8,0,0,0,0,0,48530,198.8,0,0,,,
1981,47,b) 1,6017,6097,41380,44507,38,0.5,2229,30.6,11189,459,10730,1,25.1,17442,10477,6965,23.5,39.2,-6253,-14.1,50.2,0,1792,1802,8377
1981,47,c) 2,5458,5612,43422,45750,248,4,1479,23.6,9516,1499,8017,3.3,20.8,14172,7231,6941,15.8,31,-4656,-10.2,41.6,0,1139,1139,5328
1981,47,d) 3,4840,4970,37331,39380,219,4,1100,20.2,7041,1284,5757,3.3,17.9,11139,5718,5421,14.5,28.3,-4098,-10.4,35.8,0,855,855,4302
1981,47,e) 4,4937,5696,57115,60241,228,3.7,1207,19.4,9865,2035,7830,3.4,16.4,16116,7580,8536,12.6,26.8,-6251,-10.4,32.8,0,718,722,3600
1981,47,l) Left Censored,37363,49687,1172362,1189577,1800,3.5,5591,10.8,141675,34363,107312,2.9,11.9,176104,58476,117628,4.9,14.8,-34429,-2.9,23.8,0,2915,2930,20224
1981,48,a) 0,50679,51038,361332,217062,41880,164.1,0,0,288541,288541,0,132.9,132.9,0,0,0,0,0,288541,132.9,0,0,,,
1981,48,b) 1,14178,14612,113318,114710,150,0.9,4672,27.3,35725,2283,33442,2,31.1,38509,24206,14303,21.1,33.6,-2784,-2.5,62.2,0,3553,3554,18014
1981,48,c) 2,23237,24063,219242,219626,1203,6,3287,16.3,38745,14093,24652,6.4,17.6,39513,21824,17689,9.9,18,-768,-0.4,35.2,0,2326,2330,14718
1981,48,d) 3,18613,19256,176547,178886,722,3.8,3303,17.5,34393,6531,27862,3.7,19.2,39071,20453,18618,11.4,21.8,-4678,-2.6,38.4,0,2313,2322,14191
1981,48,e) 4,16983,19935,213728,221463,903,4.2,4175,19.3,41641,7655,33986,3.5,18.8,57111,30750,26361,13.9,25.8,-15470,-7,37.6,0,2135,2152,14606
1981,48,l) Left Censored,111382,162102,3942124,3923123,8027,4.8,19490,11.6,656903,181707,475196,4.6,16.7,618900,214081,404819,5.5,15.8,38003,0.9,31.6,0,9487,9557,69399
1981,49,a) 0,3114,3126,19035,9579,3091,197.8,0,0,18913,18913,0,197.4,197.4,0,0,0,0,0,18913,197.4,0,0,,,
1981,49,b) 1,2336,2373,17704,18886,14,0.5,1000,34.4,5381,128,5253,0.7,28.5,7745,4607,3138,24.4,41,-2364,-12.5,57,0,761,761,3411
1981,49,c) 2,2210,2281,17571,18778,82,3.2,566,22.3,4014,451,3563,2.4,21.4,6428,3382,3046,18,34.2,-2414,-12.8,42.8,0,438,438,2572
1981,49,d) 3,1828,1868,15538,16981,86,4.1,466,22.5,3103,561,2542,3.3,18.3,5989,2928,3061,17.2,35.3,-2886,-17,36.6,0,322,322,1785
1981,49,e) 4,1710,1904,17563,18348,83,4,455,21.7,4217,1972,2245,10.7,23,5787,2919,2868,15.9,31.5,-1570,-8.5,46,0,248,248,1454
1981,49,l) Left Censored,11458,15007,330385,334678,853,5.5,1782,11.5,45627,14409,31218,4.3,13.6,54213,19581,34632,5.9,16.2,-8586,-2.6,27.2,0,873,885,7531
1981,50,a) 0,1271,1277,6298,3152,1273,199.4,0,0,6293,6293,0,199.7,199.7,0,0,0,0,0,6293,199.7,0,0,,,
1981,50,b) 1,1013,1016,5601,5871,3,0.3,331,27.7,1229,113,1116,1.9,20.9,1768,967,801,16.5,30.1,-539,-9.2,41.8,0,217,217,651
1981,50,c) 2,885,896,5417,5937,24,2.4,256,25.1,974,83,891,1.4,16.4,2013,1230,783,20.7,33.9,-1039,-17.5,32.8,0,185,185,996
1981,50,d) 3,920,938,6178,6267,32,3.1,182,17.8,1062,112,950,1.8,16.9,1240,546,694,8.7,19.8,-178,-2.9,33.8,0,136,136,387
1981,50,e) 4,869,972,8298,8547,31,3,167,16,1285,211,1074,2.5,15,1783,785,998,9.2,20.9,-498,-5.9,30,0,89,90,364
1981,50,l) Left Censored,6089,7152,130054,131546,164,2.2,749,10,14236,1927,12309,1.5,10.8,17220,5790,11430,4.4,13.1,-2984,-2.3,21.6,0,430,433,2677
1981,51,a) 0,8901,8958,55242,27704,8883,198.3,0,0,55076,55076,0,198.8,198.8,0,0,0,0,0,55076,198.8,0,0,,,
1981,51,b) 1,7007,7091,47303,47979,48,0.6,2414,28.8,13824,788,13036,1.6,28.8,15176,9763,5413,20.3,31.6,-1352,-2.8,57.6,0,1741,1741,7109
1981,51,c) 2,6109,6247,50108,51819,233,3.3,1579,22.7,11235,1395,9840,2.7,21.7,14657,8293,6364,16,28.3,-3422,-6.6,43.4,0,1126,1127,5567
1981,51,d) 3,5533,5727,45188,47153,210,3.4,1216,19.4,9017,1945,7072,4.1,19.1,12946,5981,6965,12.7,27.5,-3929,-8.4,38.2,0,871,871,4354
1981,51,e) 4,5418,6275,64506,67060,288,4.2,1276,18.8,10986,3213,7773,4.8,16.4,16093,8525,7568,12.7,24,-5107,-7.6,32.8,0,703,707,3507
1981,51,l) Left Censored,43162,59001,1337811,1343852,2404,3.9,6580,10.8,186132,58407,127725,4.3,13.9,198213,77984,120229,5.8,14.7,-12081,-0.8,27.8,0,3322,3365,25956
1981,53,a) 0,9618,9688,55578,28047,9600,198.2,0,0,55063,55063,0,196.3,196.3,0,0,0,0,0,55063,196.3,0,0,,,
1981,53,b) 1,7709,7818,50752,52389,64,0.7,2827,30.2,15044,1018,14026,1.9,28.7,18318,11052,7266,21.1,35,-3274,-6.3,57.4,0,2043,2044,8087
1981,53,c) 2,6734,6839,48384,52741,304,4,1725,22.6,11147,1613,9534,3.1,21.1,19860,8606,11254,16.3,37.7,-8713,-16.6,42.2,0,1252,1254,5888
1981,53,d) 3,5966,6113,45193,47589,288,4.3,1490,22,9701,1294,8407,2.7,20.4,14492,7515,6977,15.8,30.5,-4791,-10.1,40.8,0,1045,1045,5022
1981,53,e) 4,5756,6605,63650,69823,321,4.4,1477,20.4,12382,3619,8763,5.2,17.7,24729,9414,15315,13.5,35.4,-12347,-17.7,35.4,0,772,783,4400
1981,53,l) Left Censored,36477,47882,954214,971476,2017,4,5691,11.4,127876,35187,92689,3.6,13.2,162400,52310,110090,5.4,16.7,-34524,-3.5,26.4,0,2775,2795,17664
1981,54,a) 0,2687,2696,17136,8762,2671,198.1,0,0,16749,16749,0,191.2,191.2,0,0,0,0,0,16749,191.2,0,0,,,
1981,54,b) 1,2079,2107,13090,13661,14,0.6,751,29.9,3765,126,3639,0.9,27.6,4907,3158,1749,23.1,35.9,-1142,-8.3,55.2,0,578,578,2236
1981,54,c) 2,1888,1924,13096,14145,67,3.1,531,24.5,2732,401,2331,2.8,19.3,4830,2609,2221,18.4,34.1,-2098,-14.8,38.6,0,390,390,1615
1981,54,d) 3,1698,1740,12282,12868,78,4.1,371,19.6,2250,364,1886,2.8,17.5,3422,1831,1591,14.2,26.6,-1172,-9.1,35,0,261,261,1238
1981,54,e) 4,1780,1996,17719,18675,66,3,428,19.6,2565,367,2198,2,13.7,4476,2145,2331,11.5,24,-1911,-10.3,27.4,0,280,280,1342
1981,54,l) Left Censored,15873,20143,394354,403927,711,3.4,2298,11,41868,11466,30402,2.8,10.4,61015,19145,41870,4.7,15.1,-19147,-4.7,20.8,0,1275,1278,6646
1981,55,a) 0,7505,7552,48201,24185,7487,198.3,0,0,48032,48032,0,198.6,198.6,0,0,0,0,0,48032,198.6,0,0,,,
1981,55,b) 1,6111,6174,39227,41265,28,0.4,1856,25.9,8590,418,8172,1,20.8,12666,7597,5069,18.4,30.7,-4076,-9.9,41.6,0,1286,1288,5091
1981,55,c) 2,5839,5980,40621,42307,203,3.1,1241,19,7539,1431,6108,3.4,17.8,10911,5581,5330,13.2,25.8,-3372,-8,35.6,0,857,857,3671
1981,55,d) 3,5726,5911,44715,46297,198,3.1,1070,16.7,8495,1951,6544,4.2,18.3,11658,5095,6563,11,25.2,-3163,-6.9,36.6,0,774,774,3477
1981,55,e) 4,5578,6410,55344,58852,203,2.9,1132,16.4,7152,1610,5542,2.7,12.2,14167,5796,8371,9.8,24.1,-7015,-11.9,24.4,0,589,594,2878
1981,55,l) Left Censored,47502,58677,1310288,1350759,1605,2.6,6036,9.9,122865,30501,92364,2.3,9.1,203809,58887,144922,4.4,15.1,-80944,-6,18.2,0,3006,3023,18419
1981,56,a) 0,1719,1730,9769,4917,1715,198.3,0,0,9705,,,,197.4,0,0,0,0,0,9705,197.4,0,1,,,
1981,56,b) 1,1228,1248,9344,9379,7,0.5,457,30.7,3028,,,,32.3,3097,1731,1366,18.5,33,-69,-0.7,64.6,1,349,349,1380
1981,56,c) 2,1143,1167,9123,9422,48,3.7,280,21.8,2317,196,2121,2.1,24.6,2915,1530,1385,16.2,30.9,-598,-6.3,49.2,0,202,202,1092
1981,56,d) 3,984,992,8244,8323,26,2.4,212,19.5,1960,182,1778,2.2,23.5,2118,988,1130,11.9,25.4,-158,-1.9,47,0,159,159,777
1981,56,e) 4,848,943,9595,9819,47,4.6,174,17.2,1753,332,1421,3.4,17.9,2201,853,1348,8.7,22.4,-448,-4.5,35.8,0,93,93,372
1981,56,l) Left Censored,5103,6336,106145,107179,290,4.4,762,11.6,18049,4029,14020,3.8,16.8,20116,6331,13785,5.9,18.8,-2067,-2,33.6,0,426,429,2868
1982,01,a) 0,5770,5908,35344,17892,5861,198.4,0,0,34905,34905,0,195.1,195.1,0,0,0,0,0,34905,195.1,0,0,,,
1982,01,b) 1,4413,4551,38967,39352,72,1.4,1415,26.6,11913,464,11449,1.2,30.3,12682,6757,5925,17.2,32.2,-769,-1.9,60.6,0,1053,1053,5269
1982,01,c) 2,3861,3999,27389,29262,242,5.5,1014,22.9,6472,1570,4902,5.4,22.1,10217,5184,5033,17.7,34.9,-3745,-12.8,44.2,0,650,650,3525
1982,01,d) 3,3645,3834,34242,35937,243,5.9,786,19,6117,2013,4104,5.6,17,9506,4330,5176,12,26.5,-3389,-9.5,34,0,498,498,2896
1982,01,e) 4,3442,3790,29857,31214,215,5.3,648,16,5266,1256,4010,4,16.9,7980,3279,4701,10.5,25.6,-2714,-8.7,33.8,0,424,424,2078
1982,01,f) 5,3388,4108,38093,39400,244,5.7,579,13.4,6333,1760,4573,4.5,16.1,8946,3396,5550,8.6,22.7,-2613,-6.6,32.2,0,336,336,1888
1982,01,l) Left Censored,27007,37359,828438,841613,1899,4.9,3465,9,107043,32214,74829,3.8,12.7,133394,38161,95233,4.5,15.8,-26351,-3.1,25.4,0,1805,1808,11410
1982,02,a) 0,1459,1508,9099,4571,1494,198.1,0,0,9057,9057,0,198.1,198.1,0,0,0,0,0,9057,198.1,0,0,,,
1982,02,b) 1,829,858,6563,6707,23,2.3,267,26.8,2576,162,2414,2.4,38.4,2864,1752,1112,26.1,42.7,-288,-4.3,76.8,0,166,166,1319
1982,02,c) 2,700,713,5488,5604,47,6.2,133,17.5,1579,286,1293,5.1,28.2,1811,816,995,14.6,32.3,-232,-4.1,56.4,0,71,71,475
1982,02,d) 3,679,729,5963,6099,78,10.1,157,20.4,1645,618,1027,10.1,27,1916,841,1075,13.8,31.4,-271,-4.4,54,0,91,91,478
1982,02,e) 4,557,592,5007,5046,59,9.5,111,17.9,1392,308,1084,6.1,27.6,1469,664,805,13.2,29.1,-77,-1.5,55.2,0,66,66,480
1982,02,f) 5,570,696,7486,7510,49,6.8,98,13.6,2161,716,1445,9.5,28.8,2209,768,1441,10.2,29.4,-48,-0.6,57.6,0,49,49,218
1982,02,l) Left Censored,2975,4104,86861,83198,305,7.4,344,8.3,22470,6037,16433,7.3,27,15143,4969,10174,6,18.2,7327,8.8,36.4,0,134,137,2332
1982,04,a) 0,7504,7714,48930,24553,7674,199,0,0,48754,48754,0,198.6,198.6,0,0,0,0,0,48754,198.6,0,0,,,
1982,04,b) 1,5234,5404,38025,39977,139,2.2,1639,26.2,10884,1281,9603,3.2,27.2,14787,7391,7396,18.5,37,-3903,-9.8,54.4,0,1128,1128,5268
1982,04,c) 2,4569,4732,34291,36231,371,7.2,1134,22,9258,3023,6235,8.3,25.6,13138,6413,6725,17.7,36.3,-3880,-10.7,51.2,0,680,680,3776
1982,04,d) 3,3775,4046,32536,35659,369,8.5,914,21.1,8432,3274,5158,9.2,23.6,14678,8465,6213,23.7,41.2,-6246,-17.6,47.2,0,452,452,2635
1982,04,e) 4,3062,3178,26534,28307,214,6.2,661,19.3,5209,1463,3746,5.2,18.4,8755,4070,4685,14.4,30.9,-3546,-12.5,36.8,0,364,364,2440
1982,04,f) 5,2869,3556,40383,40194,306,8.3,503,13.7,8874,3335,5539,8.3,22.1,8495,3259,5236,8.1,21.1,379,1,42.2,0,258,258,1348
1982,04,l) Left Censored,17281,26061,597012,605089,1962,7.5,2331,8.9,92402,36305,56097,6,15.3,108556,26643,81913,4.4,17.9,-16154,-2.6,30.6,0,1096,1103,8057
1982,05,a) 0,4271,4348,24189,12139,4318,198.6,0,0,24101,24101,0,198.5,198.5,0,0,0,0,0,24101,198.5,0,0,,,
1982,05,b) 1,3131,3204,22561,24755,56,1.5,1026,27.4,4691,479,4212,1.9,18.9,9078,4624,4454,18.7,36.7,-4387,-17.8,37.8,0,720,720,3390
1982,05,c) 2,2773,2882,20763,21658,193,6.2,645,20.6,5419,1185,4234,5.5,25,7208,2868,4340,13.2,33.3,-1789,-8.3,50,0,416,416,1819
1982,05,d) 3,2764,2912,20391,21503,180,5.8,538,17.2,4285,1563,2722,7.3,19.9,6508,2241,4267,10.4,30.3,-2223,-10.4,39.8,0,342,342,1269
1982,05,e) 4,2463,2526,16146,17181,126,4.7,435,16.1,2801,670,2131,3.9,16.3,4870,2399,2471,14,28.3,-2069,-12,32.6,0,262,262,1792
1982,05,f) 5,2246,2626,21783,22132,237,8.6,413,15.1,4342,1848,2494,8.3,19.6,5039,2053,2986,9.3,22.8,-697,-3.2,39.2,0,248,249,1143
1982,05,l) Left Censored,17280,22399,447932,455429,1183,5.1,2107,9.2,53667,13601,40066,3,11.8,68660,18839,49821,4.1,15.1,-14993,-3.3,23.6,0,1069,1072,7021
1982,06,a) 0,58074,60018,439083,221102,59607,198.6,0,0,435963,435963,0,197.2,197.2,0,0,0,0,0,435963,197.2,0,0,,,
1982,06,b) 1,45803,47436,456609,434920,1114,2.1,12880,23.8,174532,49564,124968,11.4,40.1,131154,68086,63068,15.7,30.2,43378,9.9,60.4,0,8357,8357,43670
1982,06,c) 2,39196,40644,306159,323811,3127,7.1,9078,20.6,79093,24305,54788,7.5,24.4,114396,52812,61584,16.3,35.3,-35303,-10.9,48.8,0,5488,5489,33862
1982,06,d) 3,34959,36827,290582,304575,2926,7.5,6933,17.7,70965,24267,46698,8,23.3,98950,44145,54805,14.5,32.5,-27985,-9.2,46.6,0,4217,4217,27657
1982,06,e) 4,29226,31088,287113,289518,2277,6.9,5501,16.7,82419,30920,51499,10.7,28.5,87228,32020,55208,11.1,30.1,-4809,-1.6,57,0,3236,3237,19748
1982,06,f) 5,29393,35775,435580,434218,2787,7.5,5054,13.6,105478,48987,56491,11.3,24.3,102753,34312,68441,7.9,23.7,2725,0.6,47.4,0,2633,2644,16608
1982,06,l) Left Censored,179534,256204,6296779,6357033,15677,6,23722,9.1,933036,288015,645021,4.5,14.7,1053546,296948,756598,4.7,16.6,-120510,-1.9,29.4,0,10990,11023,90137
1982,08,a) 0,9401,9629,103825,52078,9587,199.1,0,0,103494,103494,0,198.7,198.7,0,0,0,0,0,103494,198.7,0,0,,,
1982,08,b) 1,6914,7169,63844,61891,174,2.1,1964,24.1,20840,2130,18710,3.4,33.7,16934,8939,7995,14.4,27.4,3906,6.3,54.8,0,1316,1316,6008
1982,08,c) 2,5679,5868,44032,46463,476,7.4,1487,23.2,11653,2910,8743,6.3,25.1,16514,8856,7658,19.1,35.5,-4861,-10.4,50.2,0,829,829,4780
1982,08,d) 3,5142,5452,44773,46437,545,9.4,1208,20.7,12161,4460,7701,9.6,26.2,15488,7551,7937,16.3,33.4,-3327,-7.2,52.4,0,667,667,4175
1982,08,e) 4,4304,4432,38051,39609,254,5.4,766,16.2,7960,1802,6158,4.5,20.1,11076,4057,7019,10.2,28,-3116,-7.9,40.2,0,429,430,2358
1982,08,f) 5,3920,4744,51759,51732,416,8.5,700,14.2,11422,3584,7838,6.9,22.1,11368,5097,6271,9.9,22,54,0.1,44,0,383,383,2828
1982,08,l) Left Censored,24670,33823,780008,781929,2490,7.2,3304,9.6,122784,41911,80873,5.4,15.7,126625,42217,84408,5.4,16.2,-3841,-0.5,31.4,0,1513,1516,12026
1982,09,a) 0,5813,5962,35777,17934,5929,198.9,0,0,35686,35686,0,199,199,0,0,0,0,0,35686,199,0,0,,,
1982,09,b) 1,4697,4830,32485,33059,54,1,943,17.7,7889,778,7111,2.4,23.9,9037,4601,4436,13.9,27.3,-1148,-3.4,47.8,0,626,626,3026
1982,09,c) 2,3959,4090,26881,27610,263,6.1,683,15.8,6196,1732,4464,6.3,22.4,7653,3542,4111,12.8,27.7,-1457,-5.3,44.8,0,467,467,2404
1982,09,d) 3,3603,3688,26352,27857,202,5.2,551,14.2,5701,2005,3696,7.2,20.5,8710,4069,4641,14.6,31.3,-3009,-10.8,41,0,359,359,3340
1982,09,e) 4,3334,3510,27788,27750,230,6.2,517,14,5846,1958,3888,7.1,21.1,5770,2352,3418,8.5,20.8,76,0.3,41.6,0,345,345,1653
1982,09,f) 5,3643,4214,43531,42996,262,6,478,11,8929,2033,6896,4.7,20.8,7859,2730,5129,6.3,18.3,1070,2.5,36.6,0,271,271,1353
1982,09,l) Left Censored,32484,39972,1066209,1071296,1971,4.8,3081,7.6,123361,40956,82405,3.8,11.5,133535,33803,99732,3.2,12.5,-10174,-1,23,0,1584,1588,10674
1982,10,a) 0,1025,1038,6240,3148,1029,198.3,0,0,6185,6185,0,196.5,196.5,0,0,0,0,0,6185,196.5,0,0,,,
1982,10,b) 1,796,810,5768,5951,16,1.8,165,18.3,1408,302,1106,5.1,23.7,1773,889,884,14.9,29.8,-365,-6.1,47.4,0,117,117,741
1982,10,c) 2,699,717,5115,5173,44,5.8,113,15,1237,204,1033,3.9,23.9,1352,577,775,11.2,26.1,-115,-2.2,47.8,0,66,66,251
1982,10,d) 3,661,693,5574,5800,51,7,118,16.2,1125,392,733,6.8,19.4,1576,534,1042,9.2,27.2,-451,-7.8,38.8,0,81,81,369
1982,10,e) 4,563,592,4220,4548,52,8.5,85,13.9,778,355,423,7.8,17.1,1434,360,1074,7.9,31.5,-656,-14.4,34.2,0,48,48,180
1982,10,f) 5,647,786,7982,8028,53,6.5,92,11.3,1428,455,973,5.7,17.8,1520,601,919,7.5,18.9,-92,-1.1,35.6,0,56,56,242
1982,10,l) Left Censored,5524,6916,181131,181588,336,4.7,610,8.6,19104,5650,13454,3.1,10.5,20018,5838,14180,3.2,11,-914,-0.5,21,0,286,290,1395
1982,11,a) 0,1510,1522,9896,4965,1511,198.6,0,0,9863,9863,0,198.7,198.7,0,0,0,0,0,9863,198.7,0,0,,,
1982,11,b) 1,1066,1081,13968,16222,36,3,246,20.6,2336,400,1936,2.5,14.4,6843,2202,4641,13.6,42.2,-4507,-27.8,28.8,0,156,156,1666
1982,11,c) 2,893,914,7778,8446,65,6.6,172,17.6,1659,524,1135,6.2,19.6,2995,1161,1834,13.7,35.5,-1336,-15.9,39.2,0,104,104,673
1982,11,d) 3,783,802,7065,7561,56,6.5,150,17.5,1171,357,814,4.7,15.5,2162,1013,1149,13.4,28.6,-991,-13.1,31,0,99,99,603
1982,11,e) 4,743,784,9938,9730,58,7,135,16.3,2704,1277,1427,13.1,27.8,2288,815,1473,8.4,23.5,416,4.3,47,0,83,83,553
1982,11,f) 5,853,994,27893,27266,86,8.4,141,13.7,4374,758,3616,2.8,16,3120,962,2158,3.5,11.4,1254,4.6,22.8,0,64,64,479
1982,11,l) Left Censored,7683,9493,259189,263565,582,6,897,9.3,38608,18842,19766,7.1,14.6,47360,12739,34621,4.8,18,-8752,-3.4,29.2,0,389,393,4018
1982,12,a) 0,29715,30397,187278,94237,30213,198.8,0,0,186082,186082,0,197.5,197.5,0,0,0,0,0,186082,197.5,0,0,,,
1982,12,b) 1,21657,22223,159903,168092,397,1.5,6547,25.5,42891,3825,39066,2.3,25.5,59269,31541,27728,18.8,35.3,-16378,-9.8,51,0,4560,4560,22002
1982,12,c) 2,17864,18380,131156,141194,1140,5.7,4278,21.3,31395,7364,24031,5.2,22.2,51471,23934,27537,17,36.5,-20076,-14.3,44.4,0,2726,2726,16691
1982,12,d) 3,14932,15687,125602,133443,1099,6.6,3012,18,27464,8789,18675,6.6,20.6,43146,19167,23979,14.4,32.3,-15682,-11.7,41.2,0,1939,1939,12178
1982,12,e) 4,13051,13891,111936,119049,925,6.3,2414,16.4,22813,7241,15572,6.1,19.2,37039,16858,20181,14.2,31.1,-14226,-11.9,38.4,0,1461,1461,11399
1982,12,f) 5,12476,14882,154865,159401,1166,7.6,2069,13.4,31624,11547,20077,7.2,19.8,40695,14281,26414,9,25.5,-9071,-5.7,39.6,0,1132,1133,7486
1982,12,l) Left Censored,75833,109499,2269769,2293732,6967,6.3,9517,8.6,339507,105447,234060,4.6,14.8,387435,102175,285260,4.5,16.9,-47928,-2.1,29.6,0,4719,4744,38195
1982,13,a) 0,10564,10864,67807,34076,10821,199.2,0,0,67463,67463,0,198,198,0,0,0,0,0,67463,198,0,0,,,
1982,13,b) 1,7699,7977,61385,64586,192,2.1,2339,25.5,15686,2686,13000,4.2,24.3,22087,11079,11008,17.2,34.2,-6401,-9.9,48.6,0,1640,1640,8026
1982,13,c) 2,6533,6822,52058,54542,421,5.7,1500,20.2,12567,3763,8804,6.9,23,17535,7859,9676,14.4,32.1,-4968,-9.1,46,0,945,945,5384
1982,13,d) 3,5886,6194,48675,50694,395,6,1185,17.9,10581,3125,7456,6.2,20.9,14618,6509,8109,12.8,28.8,-4037,-7.9,41.8,0,745,745,4269
1982,13,e) 4,5329,5645,45081,47608,418,7,995,16.6,9783,4312,5471,9.1,20.5,14836,5635,9201,11.8,31.2,-5053,-10.7,41,0,611,611,3383
1982,13,f) 5,5517,6528,65700,66746,466,6.9,920,13.5,12536,3538,8998,5.3,18.8,14628,6105,8523,9.1,21.9,-2092,-3.1,37.6,0,501,501,3164
1982,13,l) Left Censored,41100,59547,1425698,1426491,3486,5.7,5551,9.1,206493,80453,126040,5.6,14.5,208078,61037,147041,4.3,14.6,-1585,-0.1,29,0,2411,2416,18192
1982,15,a) 0,2163,2231,13847,6969,2215,198.6,0,0,13757,13757,0,197.4,197.4,0,0,0,0,0,13757,197.4,0,0,,,
1982,15,b) 1,1793,1855,16143,16419,51,2.4,507,23.9,4452,1131,3321,6.9,27.1,5003,2398,2605,14.6,30.5,-551,-3.4,54.2,0,335,335,1611
1982,15,c) 2,1522,1601,18334,16313,112,6.5,316,18.5,8363,6417,1946,39.3,51.3,4321,1766,2555,10.8,26.5,4042,24.8,53,0,203,203,1322
1982,15,d) 3,1291,1365,12345,13137,93,6.4,247,17,2141,797,1344,6.1,16.3,3724,1357,2367,10.3,28.3,-1583,-12,32.6,0,156,156,828
1982,15,e) 4,1108,1170,10424,10421,89,7.2,198,16,2411,827,1584,7.9,23.1,2404,1086,1318,10.4,23.1,7,0,46.2,0,118,118,494
1982,15,f) 5,1088,1453,14759,14919,112,7.5,168,11.2,2503,777,1726,5.2,16.8,2823,1118,1705,7.5,18.9,-320,-2.1,33.6,0,80,80,574
1982,15,l) Left Censored,8309,11419,228354,233125,624,5.4,942,8.1,27129,10246,16883,4.4,11.6,36671,11123,25548,4.8,15.7,-9542,-4.1,23.2,0,463,463,3577
1982,16,a) 0,2120,2184,25351,12696,2170,198.7,0,0,25310,25310,0,199.4,199.4,0,0,0,0,0,25310,199.4,0,0,,,
1982,16,b) 1,1570,1598,9880,10476,26,1.4,489,26.4,2761,472,2289,4.5,26.4,3953,1867,2086,17.8,37.7,-1192,-11.3,52.8,0,318,318,1156
1982,16,c) 2,1445,1481,10256,10948,103,6.3,358,22,2195,916,1279,8.4,20,3579,1744,1835,15.9,32.7,-1384,-12.7,40,0,226,226,1177
1982,16,d) 3,1336,1404,10126,11068,92,6.1,294,19.4,2068,801,1267,7.2,18.7,3951,1351,2600,12.2,35.7,-1883,-17,37.4,0,179,179,851
1982,16,e) 4,1166,1187,8673,9472,62,4.8,223,17.4,1204,329,875,3.5,12.7,2801,1206,1595,12.7,29.6,-1597,-16.9,25.4,0,130,130,848
1982,16,f) 5,1086,1262,10564,11217,94,7,226,16.9,1701,443,1258,3.9,15.2,3007,1319,1688,11.8,26.8,-1306,-11.6,30.4,0,119,120,723
1982,16,l) Left Censored,7739,10423,168208,183572,629,5.9,1005,9.4,17930,5366,12564,2.9,9.8,48657,8335,40322,4.5,26.5,-30727,-16.7,19.6,0,437,437,2696
1982,17,a) 0,18164,18596,141797,71455,18471,198.7,0,0,140685,140685,0,196.9,196.9,0,0,0,0,0,140685,196.9,0,0,,,
1982,17,b) 1,13908,14334,115056,118297,319,2,3334,20.8,28730,3994,24736,3.4,24.3,35214,16988,18226,14.4,29.8,-6484,-5.5,48.6,0,2276,2276,11304
1982,17,c) 2,12405,12795,89887,95492,751,5.5,2381,17.4,19994,5585,14409,5.8,20.9,31203,14287,16916,15,32.7,-11209,-11.8,41.8,0,1617,1618,9741
1982,17,d) 3,11048,11475,86121,89789,685,5.6,1905,15.6,17995,4608,13387,5.1,20,25330,10816,14514,12,28.2,-7335,-8.2,40,0,1250,1251,6331
1982,17,e) 4,10311,10844,81598,84761,664,5.8,1645,14.4,14914,5191,9723,6.1,17.6,21239,8352,12887,9.9,25.1,-6325,-7.5,35.2,0,1042,1042,5628
1982,17,f) 5,10833,12977,140025,143288,837,6.2,1714,12.7,22638,6856,15782,4.8,15.8,29164,12216,16948,8.5,20.4,-6526,-4.6,31.6,0,906,907,4832
1982,17,l) Left Censored,97666,126467,3237181,3327113,6584,5.1,11381,8.8,359555,121788,237767,3.7,10.8,539420,143872,395548,4.3,16.2,-179865,-5.4,21.6,0,5725,5742,41718
1982,18,a) 0,7956,8168,47245,23833,8111,198.6,0,0,46825,46825,0,196.5,196.5,0,0,0,0,0,46825,196.5,0,0,,,
1982,18,b) 1,6017,6228,52671,55124,129,1.8,1617,22.9,11094,1741,9353,3.2,20.1,15999,7805,8194,14.2,29,-4905,-8.9,40.2,0,1179,1181,5884
1982,18,c) 2,5548,5714,36815,38866,280,4.6,1008,16.4,7722,2591,5131,6.7,19.9,11824,4873,6951,12.5,30.4,-4102,-10.5,39.8,0,745,746,3575
1982,18,d) 3,5249,5474,36765,38391,313,5.4,901,15.5,7223,2069,5154,5.4,18.8,10475,4160,6315,10.8,27.3,-3252,-8.5,37.6,0,603,606,2977
1982,18,e) 4,4756,5025,41620,41686,314,5.9,874,16.4,10838,6421,4417,15.4,26,10969,4742,6227,11.4,26.3,-131,-0.3,52,0,555,558,2984
1982,18,f) 5,4951,6000,61281,62284,347,5.6,757,12.1,9964,2844,7120,4.6,16,11969,4016,7953,6.4,19.2,-2005,-3.2,32,0,447,448,2220
1982,18,l) Left Censored,44321,60456,1428356,1461855,3200,5.2,4973,8.1,145550,42440,103110,2.9,10,212548,50788,161760,3.5,14.5,-66998,-4.5,20,0,2494,2504,16136
1982,19,a) 0,5008,5105,29025,14591,5074,198.8,0,0,28869,28869,0,197.9,197.9,0,0,0,0,0,28869,197.9,0,0,,,
1982,19,b) 1,4067,4210,30022,32335,91,1.9,1197,24.7,6355,1099,5256,3.4,19.7,10983,5294,5689,16.4,34,-4628,-14.3,39.4,0,839,839,4016
1982,19,c) 2,3726,3811,21647,23585,178,4.3,756,18.2,3736,1076,2660,4.6,15.8,7611,3598,4013,15.3,32.3,-3875,-16.5,31.6,0,533,533,2480
1982,19,d) 3,3323,3515,54320,40798,180,4.8,621,16.4,34700,11631,23069,28.5,85.1,7655,3481,4174,8.5,18.8,27045,66.3,37.6,0,422,422,2055
1982,19,e) 4,3304,3506,23155,24744,197,5.2,605,16.1,3756,1139,2617,4.6,15.2,6933,2591,4342,10.5,28,-3177,-12.8,30.4,0,369,369,1537
1982,19,f) 5,3537,4211,35849,35699,291,6.6,562,12.8,8133,1985,6148,5.6,22.8,7833,2725,5108,7.6,21.9,300,0.9,43.8,0,311,311,1331
1982,19,l) Left Censored,29374,38567,674209,689932,1804,4.5,3524,8.9,71848,19913,51935,2.9,10.4,103293,27617,75676,4,15,-31445,-4.6,20.8,0,1813,1814,9317
1982,20,a) 0,5136,5240,30306,15202,5210,198.9,0,0,30208,30208,0,198.7,198.7,0,0,0,0,0,30208,198.7,0,0,,,
1982,20,b) 1,3944,4094,28547,30160,104,2.2,1125,24.1,7234,1145,6089,3.8,24,10459,6115,4344,20.3,34.7,-3225,-10.7,48,0,839,839,4913
1982,20,c) 2,3189,3287,22124,23418,219,6.2,660,18.6,5015,1703,3312,7.3,21.4,7603,3425,4178,14.6,32.5,-2588,-11.1,42.8,0,469,469,2548
1982,20,d) 3,2986,3096,20946,22039,208,6.3,567,17.2,4606,1975,2631,9,20.9,6792,3164,3628,14.4,30.8,-2186,-9.9,41.8,0,379,379,2261
1982,20,e) 4,2755,2873,18711,19903,164,5.4,485,15.8,3440,995,2445,5,17.3,5823,2408,3415,12.1,29.3,-2383,-12,34.6,0,310,310,1582
1982,20,f) 5,2972,3570,32792,33417,264,7.1,484,13,6372,2525,3847,7.6,19.1,7622,3814,3808,11.4,22.8,-1250,-3.7,38.2,0,272,272,1397
1982,20,l) Left Censored,24130,31354,593106,599119,1620,5,2950,9.2,71195,18344,52851,3.1,11.9,83220,24792,58428,4.1,13.9,-12025,-2,23.8,0,1457,1479,9522
1982,21,a) 0,5851,5959,39183,19717,5922,198.8,0,0,38932,38932,0,197.5,197.5,0,0,0,0,0,38932,197.5,0,0,,,
1982,21,b) 1,4119,4237,30842,32025,94,2,1131,23.5,7762,1020,6742,3.2,24.2,10127,5080,5047,15.9,31.6,-2365,-7.4,48.4,0,835,835,3475
1982,21,c) 2,3473,3571,24741,26320,242,6.2,802,20.7,5186,1575,3611,6,19.7,8344,4178,4166,15.9,31.7,-3158,-12,39.4,0,543,543,2769
1982,21,d) 3,3362,3493,29116,30687,235,6.3,662,17.7,5019,1430,3589,4.7,16.4,8161,3503,4658,11.4,26.6,-3142,-10.2,32.8,0,415,415,2410
1982,21,e) 4,3106,3222,24685,25696,218,6.4,580,16.9,5407,2199,3208,8.6,21,7429,3242,4187,12.6,28.9,-2022,-7.9,42,0,363,363,2086
1982,21,f) 5,3150,3670,32024,32818,253,6.6,541,14.1,5931,2151,3780,6.6,18.1,7519,3554,3965,10.8,22.9,-1588,-4.8,36.2,0,309,312,1986
1982,21,l) Left Censored,27037,36006,765420,772308,1846,5,3208,8.7,99604,26396,73208,3.4,12.9,113381,27690,85691,3.6,14.7,-13777,-1.8,25.8,0,1701,1701,8931
1982,22,a) 0,9241,9497,58297,29469,9446,198.9,0,0,57657,57657,0,195.7,195.7,0,0,0,0,0,57657,195.7,0,0,,,
1982,22,b) 1,6642,6817,62988,63068,142,1.9,1639,21.4,19796,2760,17036,4.4,31.4,19955,8314,11641,13.2,31.6,-159,-0.2,62.8,0,1178,1178,6019
1982,22,c) 2,5482,5653,53995,54454,357,5.9,1060,17.6,14415,2870,11545,5.3,26.5,15332,6989,8343,12.8,28.2,-917,-1.7,53,0,656,661,4486
1982,22,d) 3,5150,5476,52797,54363,389,6.8,901,15.6,12489,3922,8567,7.2,23,15620,6245,9375,11.5,28.7,-3131,-5.7,46,0,569,569,3973
1982,22,e) 4,4129,4221,46399,45252,233,5.2,687,15.3,13842,2176,11666,4.8,30.6,11547,4577,6970,10.1,25.5,2295,5.1,51,0,422,422,2916
1982,22,f) 5,3943,4720,54079,54155,380,7.8,607,12.5,12209,4365,7844,8.1,22.5,12361,4359,8002,8,22.8,-152,-0.3,45,0,329,329,2403
1982,22,l) Left Censored,31172,42937,987964,998218,2326,5.3,3773,8.6,146296,41848,104448,4.2,14.7,166804,52387,114417,5.2,16.7,-20508,-2,29.4,0,1772,1784,19103
1982,23,a) 0,1982,2025,12021,6030,2010,198.5,0,0,11983,11983,0,198.7,198.7,0,0,0,0,0,11983,198.7,0,0,,,
1982,23,b) 1,1583,1634,12207,11819,37,2,432,23.2,3922,729,3193,6.2,33.2,3146,1703,1443,14.4,26.6,776,6.6,53.2,0,290,290,1322
1982,23,c) 2,1399,1447,9580,9679,93,6,252,16.3,2095,531,1564,5.5,21.6,2292,988,1304,10.2,23.7,-197,-2.1,43.2,0,166,166,681
1982,23,d) 3,1317,1343,9381,10063,71,4.9,256,17.7,1598,322,1276,3.2,15.9,2962,1219,1743,12.1,29.4,-1364,-13.5,31.8,0,162,162,803
1982,23,e) 4,1280,1361,9074,9310,85,5.9,198,13.9,1754,501,1253,5.4,18.8,2225,822,1403,8.8,23.9,-471,-5.1,37.6,0,118,118,585
1982,23,f) 5,1271,1505,14775,14746,86,5.5,204,13,2440,436,2004,3,16.5,2381,879,1502,6,16.1,59,0.4,32.2,0,119,119,420
1982,23,l) Left Censored,10240,12940,248074,251740,638,4.8,1137,8.6,30113,9586,20527,3.8,12,37445,13775,23670,5.5,14.9,-7332,-2.9,24,0,589,596,6118
1982,24,a) 0,6776,6956,46695,23445,6909,198.6,0,0,46500,46500,0,198.3,198.3,0,0,0,0,0,46500,198.3,0,0,,,
1982,24,b) 1,5195,5350,43061,43246,115,1.9,1261,21,10977,1206,9771,2.8,25.4,11347,5533,5814,12.8,26.2,-370,-0.8,50.8,0,856,856,3985
1982,24,c) 2,4447,4568,36125,36925,304,6.2,863,17.6,8663,2648,6015,7.2,23.5,10262,4218,6044,11.4,27.8,-1599,-4.3,47,0,573,573,2822
1982,24,d) 3,4075,4249,34826,35504,300,6.7,690,15.4,7662,2063,5599,5.8,21.6,9017,3959,5058,11.2,25.4,-1355,-3.8,43.2,0,426,426,2594
1982,24,e) 4,3622,3849,31828,31929,308,7.7,597,14.8,7146,3176,3970,9.9,22.4,7347,2633,4714,8.2,23,-201,-0.6,44.8,0,367,367,1637
1982,24,f) 5,3918,4674,51620,52423,323,6.7,572,11.9,9801,2974,6827,5.7,18.7,11406,4527,6879,8.6,21.8,-1605,-3.1,37.4,0,298,298,2414
1982,24,l) Left Censored,32789,44350,1034441,1045859,2593,5.8,3723,8.3,136470,46343,90127,4.4,13,159306,44030,115276,4.2,15.2,-22836,-2.2,26,0,1744,1746,13524
1982,25,a) 0,9658,9926,82319,47516,9874,199,0,0,69607,69607,0,146.5,146.5,0,0,0,0,0,69607,146.5,0,0,,,
1982,25,b) 1,7408,7592,67883,69149,151,1.8,1572,18.7,15531,1831,13700,2.6,22.5,18062,8631,9431,12.5,26.1,-2531,-3.6,45,0,1031,1031,5929
1982,25,c) 2,6581,6726,50027,51617,366,5.2,1009,14.2,11233,2813,8420,5.4,21.8,14412,6481,7931,12.6,27.9,-3179,-6.1,43.6,0,649,649,4076
1982,25,d) 3,6024,6291,52064,52111,365,5.5,894,13.6,12580,3441,9139,6.6,24.1,12673,5609,7064,10.8,24.3,-93,-0.2,48.2,0,556,556,3670
1982,25,e) 4,5440,5824,55901,56276,362,6,792,13,11160,3239,7921,5.8,19.8,11909,4525,7384,8,21.2,-749,-1.4,39.6,0,478,478,3146
1982,25,f) 5,5693,6902,102726,102599,475,6.7,789,11.1,16809,4898,11911,4.8,16.4,16554,6018,10536,5.9,16.1,255,0.3,32.2,0,419,421,3194
1982,25,l) Left Censored,57298,72047,1915045,1919325,3629,5,5474,7.5,228472,65434,163038,3.4,11.9,237032,62351,174681,3.2,12.3,-8560,-0.4,23.8,0,2819,2823,21297
1982,26,a) 0,12700,13077,78071,39370,12998,198.8,0,0,77402,77402,0,196.6,196.6,0,0,0,0,0,77402,196.6,0,0,,,
1982,26,b) 1,10062,10389,78116,80893,232,2,2505,21.5,17380,2332,15048,2.9,21.5,22934,10698,12236,13.2,28.4,-5554,-6.9,43,0,1681,1681,7331
1982,26,c) 2,8638,8941,60922,64373,597,6.2,1904,19.7,13860,4744,9116,7.4,21.5,20761,10903,9858,16.9,32.3,-6901,-10.8,43,0,1159,1159,6627
1982,26,d) 3,8400,8798,93280,96603,575,6.2,1521,16.3,12505,4472,8033,4.6,12.9,19151,8732,10419,9,19.8,-6646,-6.9,25.8,0,947,947,5376
1982,26,e) 4,7680,8096,58969,63227,542,6.3,1382,16.1,10972,4495,6477,7.1,17.4,19488,8124,11364,12.8,30.8,-8516,-13.4,34.8,0,821,822,5303
1982,26,f) 5,7939,9633,94516,96750,643,6.4,1266,12.7,15267,5075,10192,5.2,15.8,19734,7674,12060,7.9,20.4,-4467,-4.6,31.6,0,691,693,4398
1982,26,l) Left Censored,67241,91228,2171218,2246492,4697,5,8111,8.7,231241,65956,165285,2.9,10.3,381788,100767,281021,4.5,17,-150547,-6.7,20.6,0,3917,3927,26967
1982,27,a) 0,7000,7232,46452,23300,7186,198.7,0,0,46305,46305,0,198.7,198.7,0,0,0,0,0,46305,198.7,0,0,,,
1982,27,b) 1,5679,5846,50478,51813,124,1.9,1373,20.9,11063,1528,9535,2.9,21.4,13733,6224,7509,12,26.5,-2670,-5.1,42.8,0,927,927,4374
1982,27,c) 2,5097,5256,35165,37365,276,4.9,953,16.8,7256,1922,5334,5.1,19.4,11655,4649,7006,12.4,31.2,-4399,-11.8,38.8,0,600,600,3215
1982,27,d) 3,4850,5099,37263,39447,309,5.7,877,16.1,7387,2226,5161,5.6,18.7,11755,5190,6565,13.2,29.8,-4368,-11.1,37.4,0,562,562,3338
1982,27,e) 4,4406,4675,38511,40434,267,5.4,739,14.9,6374,1894,4480,4.7,15.8,10220,3467,6753,8.6,25.3,-3846,-9.5,31.6,0,467,467,2206
1982,27,f) 5,4567,5469,59107,60446,383,6.8,655,11.6,10942,3270,7672,5.4,18.1,13619,4414,9205,7.3,22.5,-2677,-4.4,36.2,0,336,337,2429
1982,27,l) Left Censored,37087,48614,1170041,1191914,2346,4.7,3922,7.9,139327,38946,100381,3.3,11.7,183073,45665,137408,3.8,15.4,-43746,-3.7,23.4,0,1911,1920,12410
1982,28,a) 0,4009,4081,20722,10512,4058,198.9,0,0,20420,20420,0,194.3,194.3,0,0,0,0,0,20420,194.3,0,0,,,
1982,28,b) 1,2988,3063,22557,23229,54,1.5,914,25.8,5273,658,4615,2.8,22.7,6616,3325,3291,14.3,28.5,-1343,-5.8,45.4,0,678,678,2539
1982,28,c) 2,2717,2788,19217,20386,168,5.5,616,20.2,4006,1158,2848,5.7,19.7,6343,3505,2838,17.2,31.1,-2337,-11.4,39.4,0,397,397,2238
1982,28,d) 3,2521,2643,19822,20456,201,7.1,519,18.3,4746,1593,3153,7.8,23.2,6013,2574,3439,12.6,29.4,-1267,-6.2,46.4,0,335,335,1561
1982,28,e) 4,2092,2180,16625,17338,150,6.4,398,17,2887,1296,1591,7.5,16.7,4313,1922,2391,11.1,24.9,-1426,-8.2,33.4,0,250,250,983
1982,28,f) 5,2345,2803,24041,24615,181,6.1,399,13.5,4096,1359,2737,5.5,16.6,5244,1969,3275,8,21.3,-1148,-4.7,33.2,0,216,216,769
1982,28,l) Left Censored,17996,24077,460515,472601,1118,4.5,2160,8.7,46913,15223,31690,3.2,9.9,71084,19780,51304,4.2,15,-24171,-5.1,19.8,0,1082,1084,6245
1982,29,a) 0,8557,8782,51885,26145,8718,198.5,0,0,51481,,,,196.9,0,0,0,0,0,51481,196.9,0,1,,,
1982,29,b) 1,6798,7062,51926,55237,186,2.3,1918,23.8,11948,2015,9933,3.6,21.6,18569,9984,8585,18.1,33.6,-6621,-12,43.2,0,1362,1362,7134
1982,29,c) 2,5632,5841,38558,40311,385,6.1,1221,19.3,9089,3490,5599,8.7,22.5,12595,5973,6622,14.8,31.2,-3506,-8.7,45,0,857,858,4384
1982,29,d) 3,5413,5657,41708,43650,407,6.8,979,16.3,8579,2376,6203,5.4,19.7,12463,4900,7563,11.2,28.6,-3884,-8.9,39.4,0,658,658,3443
1982,29,e) 4,4775,4991,72908,57068,333,6.2,956,17.8,43633,,,,76.5,11953,5128,6825,9,20.9,31680,55.6,41.8,1,612,612,3737
1982,29,f) 5,5023,5940,59537,60002,410,6.6,865,13.9,11799,4990,6809,8.3,19.7,12729,5317,7412,8.9,21.2,-930,-1.5,39.4,0,456,456,2229
1982,29,l) Left Censored,42645,57246,1339899,1346997,2859,4.9,5352,9.1,175936,52102,123834,3.9,13.1,190133,55102,135031,4.1,14.1,-14197,-1,26.2,0,2579,2600,16590
1982,30,a) 0,2181,2220,11258,5672,2207,198.8,0,0,11173,11173,0,197,197,0,0,0,0,0,11173,197,0,0,,,
1982,30,b) 1,1655,1691,10849,11081,27,1.4,502,25.7,3278,170,3108,1.5,29.6,3742,1858,1884,16.8,33.8,-464,-4.2,59.2,0,336,336,1333
1982,30,c) 2,1513,1538,10580,11082,90,5.4,321,19.1,2401,712,1689,6.4,21.7,3405,1540,1865,13.9,30.7,-1004,-9,43.4,0,209,209,1144
1982,30,d) 3,1452,1530,9988,10541,91,5.5,305,18.4,2122,761,1361,7.2,20.1,3227,1275,1952,12.1,30.6,-1105,-10.5,40.2,0,188,188,847
1982,30,e) 4,1184,1210,7869,8460,60,4.6,222,17,1482,458,1024,5.4,17.5,2663,1186,1477,14,31.5,-1181,-14,35,0,126,126,832
1982,30,f) 5,1188,1363,10771,11010,88,6.1,199,13.8,2037,667,1370,6.1,18.5,2515,996,1519,9,22.8,-478,-4.3,37,0,103,103,563
1982,30,l) Left Censored,7885,10076,138167,141163,498,4.8,947,9.1,18628,6225,12403,4.4,13.2,24620,6759,17861,4.8,17.4,-5992,-4.2,26.4,0,470,473,3247
1982,31,a) 0,3120,3206,17997,9039,3182,198.5,0,0,17917,17917,0,198.2,198.2,0,0,0,0,0,17917,198.2,0,0,,,
1982,31,b) 1,2479,2548,15183,18557,52,1.8,659,22.7,2843,399,2444,2.2,15.3,9591,3261,6330,17.6,51.7,-6748,-36.4,30.6,0,448,448,2188
1982,31,c) 2,2213,2248,13363,14524,129,5.3,407,16.8,2571,779,1792,5.4,17.7,4892,2093,2799,14.4,33.7,-2321,-16,35.4,0,296,296,1513
1982,31,d) 3,2065,2143,13671,14331,91,4,328,14.3,2414,569,1845,4,16.8,3733,1341,2392,9.4,26,-1319,-9.2,33.6,0,224,224,872
1982,31,e) 4,1869,1934,15105,15886,87,4.2,316,15.2,2283,718,1565,4.5,14.4,3845,1431,2414,9,24.2,-1562,-9.8,28.8,0,193,193,939
1982,31,f) 5,2022,2331,18140,18780,159,6.5,326,13.3,3118,1159,1959,6.2,16.6,4398,1827,2571,9.7,23.4,-1280,-6.8,33.2,0,193,196,994
1982,31,l) Left Censored,16819,21386,384694,388969,1049,4.8,1842,8.4,44689,12884,31805,3.3,11.5,53238,14999,38239,3.9,13.7,-8549,-2.2,23,0,996,996,5685
1982,32,a) 0,2520,2570,21873,11319,2556,198.9,0,0,21108,21108,0,186.5,186.5,0,0,0,0,0,21108,186.5,0,0,,,
1982,32,b) 1,1883,1935,15703,16199,51,2.3,624,27.7,5046,976,4070,6,31.2,6037,2908,3129,18,37.3,-991,-6.1,62.4,0,441,441,2158
1982,32,c) 2,1575,1619,15755,17142,117,6.6,418,23.4,3703,948,2755,5.5,21.6,6476,2775,3701,16.2,37.8,-2773,-16.2,43.2,0,240,241,1424
1982,32,d) 3,1529,1595,15952,16543,136,8.1,298,17.7,4307,2496,1811,15.1,26,5488,1952,3536,11.8,33.2,-1181,-7.2,52,0,170,170,1112
1982,32,e) 4,1120,1169,11579,12060,82,6.6,191,15.4,2399,535,1864,4.4,19.9,3361,1283,2078,10.6,27.9,-962,-8,39.8,0,117,117,928
1982,32,f) 5,1040,1242,15989,17531,92,7.1,188,14.5,3630,763,2867,4.4,20.7,6714,2081,4633,11.9,38.3,-3084,-17.6,41.4,0,89,89,1477
1982,32,l) Left Censored,6263,8530,241380,243816,653,7.6,788,9.1,37130,11732,25398,4.8,15.2,42001,12556,29445,5.1,17.2,-4871,-2,30.4,0,350,350,3541
1982,33,a) 0,2077,2103,11412,5733,2092,199,0,0,11358,11358,0,198.1,198.1,0,0,0,0,0,11358,198.1,0,0,,,
1982,33,b) 1,1597,1632,12622,12444,29,1.6,377,20.6,3899,222,3677,1.8,31.3,3542,1840,1702,14.8,28.5,357,2.8,57,0,252,252,1329
1982,33,c) 2,1314,1334,8785,8998,89,6.2,264,18.3,2206,544,1662,6,24.5,2631,1376,1255,15.3,29.2,-425,-4.7,49,0,187,187,1028
1982,33,d) 3,1314,1348,10449,10433,63,4.4,196,13.7,2235,440,1795,4.2,21.4,2203,890,1313,8.5,21.1,32,0.3,42.2,0,130,130,579
1982,33,e) 4,1215,1276,9299,9789,86,6.4,182,13.6,2003,532,1471,5.4,20.5,2983,1393,1590,14.2,30.5,-980,-10,41,0,104,104,939
1982,33,f) 5,1220,1437,15181,15114,109,7.4,172,11.6,2527,587,1940,3.9,16.7,2392,1115,1277,7.4,15.8,135,0.9,31.6,0,99,99,869
1982,33,l) Left Censored,9171,11180,262544,264184,574,5,987,8.6,30496,9394,21102,3.6,11.5,33775,10169,23606,3.8,12.8,-3279,-1.3,23,0,510,511,3815
1982,34,a) 0,14019,14287,81769,41195,14181,198.5,0,0,81148,81148,0,197,197,0,0,0,0,0,81148,197,0,0,,,
1982,34,b) 1,10659,10870,85813,84782,143,1.2,2484,20.4,25092,3153,21939,3.7,29.6,23030,10678,12352,12.6,27.2,2062,2.4,54.4,0,1617,1617,7167
1982,34,c) 2,9586,9753,68055,68576,574,5.6,1576,15.3,17351,3507,13844,5.1,25.3,18393,7209,11184,10.5,26.8,-1042,-1.5,50.6,0,1049,1051,5245
1982,34,d) 3,8677,8887,64074,65656,536,5.7,1363,14.6,13646,3521,10125,5.4,20.8,16809,6146,10663,9.4,25.6,-3163,-4.8,41.6,0,839,839,4187
1982,34,e) 4,7630,7921,57323,57670,501,6,1128,13.6,13195,4865,8330,8.4,22.9,13889,4910,8979,8.5,24.1,-694,-1.2,45.8,0,682,682,3159
1982,34,f) 5,8186,9026,87372,87409,597,6.4,1208,12.9,18572,5303,13269,6.1,21.2,18646,7879,10767,9,21.3,-74,-0.1,42.4,0,673,673,4033
1982,34,l) Left Censored,72892,90259,2127323,2140611,4116,4.5,7787,8.4,289079,76597,212482,3.6,13.5,315656,103673,211983,4.8,14.7,-26577,-1.2,27,0,3957,3964,26365
1982,35,a) 0,3134,3190,20219,10221,3158,198,0,0,19997,19997,0,195.6,195.6,0,0,0,0,0,19997,195.6,0,0,,,
1982,35,b) 1,2406,2495,17825,18470,61,2.2,674,23.8,5146,594,4552,3.2,27.9,6435,3322,3113,18,34.8,-1289,-6.9,55.8,0,488,488,2526
1982,35,c) 2,2101,2158,16701,17471,141,6,470,20.1,4390,1404,2986,8,25.1,5929,2940,2989,16.8,33.9,-1539,-8.8,50.2,0,299,299,2127
1982,35,d) 3,1914,2030,15936,16573,135,6.3,365,16.9,3654,872,2782,5.3,22,4927,1990,2937,12,29.7,-1273,-7.7,44,0,226,226,1138
1982,35,e) 4,1543,1591,12585,12707,79,4.6,262,15.4,3090,722,2368,5.7,24.3,3334,1568,1766,12.3,26.2,-244,-1.9,48.6,0,163,163,1125
1982,35,f) 5,1534,1786,15299,15551,133,7.2,251,13.5,3093,752,2341,4.8,19.9,3596,1538,2058,9.9,23.1,-503,-3.2,39.8,0,143,143,858
1982,35,l) Left Censored,9923,13342,242000,244247,840,6.2,1209,8.9,33543,9500,24043,3.9,13.7,38037,11747,26290,4.8,15.6,-4494,-1.9,27.4,0,565,565,3444
1982,36,a) 0,32571,33128,206205,104129,32900,198.6,0,0,204153,204153,0,196.1,196.1,0,0,0,0,0,204153,196.1,0,0,,,
1982,36,b) 1,24982,25475,199555,200125,358,1.3,5621,19.8,52135,4923,47212,2.5,26.1,53275,25294,27981,12.6,26.6,-1140,-0.5,52.2,0,3746,3746,17880
1982,36,c) 2,21534,21926,167519,168651,1161,5,3809,16.3,41726,7630,34096,4.5,24.7,43990,21119,22871,12.5,26.1,-2264,-1.4,49.4,0,2565,2565,14472
1982,36,d) 3,19574,20080,137583,142220,1080,5.1,3079,14.5,29332,6231,23101,4.4,20.6,38606,17617,20989,12.4,27.1,-9274,-6.5,41.2,0,2031,2031,12187
1982,36,e) 4,18022,18703,154877,151610,988,5,2773,14,43555,13787,29768,9.1,28.7,37020,14736,22284,9.7,24.4,6535,4.3,48.8,0,1776,1776,10567
1982,36,f) 5,18370,20969,227032,224971,1370,6.3,2788,12.8,45951,17293,28658,7.7,20.4,41828,16637,25191,7.4,18.6,4123,1.8,37.2,0,1542,1548,8182
1982,36,l) Left Censored,175149,213190,4881802,4912851,9024,4.1,18810,8.6,603026,173042,429984,3.5,12.3,665123,200920,464203,4.1,13.5,-62097,-1.2,24.6,0,10427,10450,67022
1982,37,a) 0,10380,10616,60549,30359,10552,198.8,0,0,60380,60380,0,198.9,198.9,0,0,0,0,0,60380,198.9,0,0,,,
1982,37,b) 1,7609,7827,79144,72313,141,1.6,2173,24.2,33162,16736,16426,23.1,45.9,19500,9878,9622,13.7,27,13662,18.9,54,0,1616,1616,7132
1982,37,c) 2,6479,6677,45539,48121,319,4.4,1309,18.1,9271,1965,7306,4.1,19.3,14435,6801,7634,14.1,30,-5164,-10.7,38.6,0,969,969,5132
1982,37,d) 3,6100,6378,46030,48412,406,6,1107,16.3,9290,2859,6431,5.9,19.2,14054,5601,8453,11.6,29,-4764,-9.8,38.4,0,731,731,3470
1982,37,e) 4,5713,5977,44354,45885,352,5.6,908,14.4,8395,2791,5604,6.1,18.3,11456,4197,7259,9.1,25,-3061,-6.7,36.6,0,593,593,2898
1982,37,f) 5,5579,6696,61320,62645,465,6.7,924,13.3,10628,3076,7552,4.9,17,13277,5977,7300,9.5,21.2,-2649,-4.2,34,0,533,533,2172
1982,37,l) Left Censored,46789,65638,1640486,1659933,3280,4.9,5394,8.1,177262,53703,123559,3.2,10.7,216156,58568,157588,3.5,13,-38894,-2.3,21.4,0,2849,2864,18334
1982,38,a) 0,1509,1528,8072,4044,1520,199,0,0,8057,8057,0,199.2,199.2,0,0,0,0,0,8057,199.2,0,0,,,
1982,38,b) 1,1168,1198,8809,9069,25,1.8,323,23.6,1958,212,1746,2.3,21.6,2477,1310,1167,14.4,27.3,-519,-5.7,43.2,0,209,209,873
1982,38,c) 2,1040,1064,6893,7347,56,4.9,184,16.1,1265,230,1035,3.1,17.2,2172,814,1358,11.1,29.6,-907,-12.4,34.4,0,121,121,565
1982,38,d) 3,959,999,7233,7448,56,5.2,180,16.8,1661,365,1296,4.9,22.3,2091,869,1222,11.7,28.1,-430,-5.8,44.6,0,106,106,611
1982,38,e) 4,842,863,5375,5550,47,5.1,132,14.3,1099,174,925,3.1,19.8,1449,691,758,12.5,26.1,-350,-6.3,39.6,0,79,79,469
1982,38,f) 5,882,981,7163,7411,57,5.5,132,12.8,1389,475,914,6.4,18.7,1885,904,981,12.2,25.4,-496,-6.7,37.4,0,64,64,517
1982,38,l) Left Censored,7107,9035,130160,130446,430,4.6,767,8.3,15210,3871,11339,3,11.7,15781,4237,11544,3.2,12.1,-571,-0.4,23.4,0,404,405,2154
1982,39,a) 0,14702,15132,100744,50652,15037,198.7,0,0,100185,100185,0,197.8,197.8,0,0,0,0,0,100185,197.8,0,0,,,
1982,39,b) 1,11560,11946,100401,103673,298,2.2,2925,21.7,22817,4043,18774,3.9,22,29361,13862,15499,13.4,28.3,-6544,-6.3,44,0,1972,1972,9636
1982,39,c) 2,10102,10524,72835,76302,695,6.2,1995,17.7,16214,4660,11554,6.1,21.2,23147,10618,12529,13.9,30.3,-6933,-9.1,42.4,0,1365,1365,7129
1982,39,d) 3,9549,9988,74646,78201,658,6.2,1715,16.2,15005,4885,10120,6.2,19.2,22115,10679,11436,13.7,28.3,-7110,-9.1,38.4,0,1090,1090,7554
1982,39,e) 4,8576,9146,71191,73635,622,6.4,1484,15.3,15608,5476,10132,7.4,21.2,20496,8079,12417,11,27.8,-4888,-6.6,42.4,0,883,883,4859
1982,39,f) 5,9343,11655,115630,116472,880,7.3,1395,11.6,23485,7951,15534,6.8,20.2,25168,8160,17008,7,21.6,-1683,-1.4,40.4,0,723,723,3485
1982,39,l) Left Censored,86881,123206,2939996,3004544,6287,5,10664,8.5,323139,99792,223347,3.3,10.8,452235,112800,339435,3.8,15.1,-129096,-4.3,21.6,0,4879,4896,33294
1982,40,a) 0,8994,9183,58369,29329,9137,199,0,0,58080,58080,0,198,198,0,0,0,0,0,58080,198,0,0,,,
1982,40,b) 1,6062,6222,57061,55386,142,2,1615,23,19352,2176,17176,3.9,34.9,16001,8320,7681,15,28.9,3351,6,57.8,0,1172,1172,6069
1982,40,c) 2,4924,5080,41809,43353,288,5.2,1060,19.3,12210,3126,9084,7.2,28.2,15298,7016,8282,16.2,35.3,-3088,-7.1,56.4,0,677,677,4285
1982,40,d) 3,4300,4552,38704,40124,312,6.5,796,16.5,9934,3088,6846,7.7,24.8,12773,6872,5901,17.1,31.8,-2839,-7,49.6,0,500,500,3901
1982,40,e) 4,3577,3664,32102,32679,150,3.8,578,14.8,6490,905,5585,2.8,19.9,7643,3092,4551,9.5,23.4,-1153,-3.5,39.8,0,367,367,2204
1982,40,f) 5,3334,3964,42683,42621,244,5.9,557,13.4,9784,2671,7113,6.3,23,9660,4421,5239,10.4,22.7,124,0.3,45.4,0,336,338,2435
1982,40,l) Left Censored,24784,33416,708562,704267,1842,5.4,3004,8.8,108069,26987,81082,3.8,15.3,99478,28126,71352,4,14.1,8591,1.2,28.2,0,1567,1567,10020
1982,41,a) 0,6389,6559,36242,18188,6517,198.7,0,0,36108,36108,0,198.5,198.5,0,0,0,0,0,36108,198.5,0,0,,,
1982,41,b) 1,5126,5269,34132,37443,115,1.9,1721,27.8,8022,898,7124,2.4,21.4,14644,7436,7208,19.9,39.1,-6622,-17.7,42.8,0,1182,1182,5139
1982,41,c) 2,4411,4549,52659,44211,269,5.2,1370,26.5,29857,10592,19265,24,67.5,12961,6697,6264,15.1,29.3,16896,38.2,58.6,0,821,821,4269
1982,41,d) 3,3862,3999,26608,29358,283,6.4,994,22.6,5282,1874,3408,6.4,18,10782,4548,6234,15.5,36.7,-5500,-18.7,36,0,604,604,2664
1982,41,e) 4,3427,3591,23884,26191,282,7.2,806,20.7,4374,1375,2999,5.2,16.7,8988,3629,5359,13.9,34.3,-4614,-17.6,33.4,0,478,478,2230
1982,41,f) 5,3388,3992,41108,42910,334,7.9,749,17.7,7589,2866,4723,6.7,17.7,11193,4714,6479,11,26.1,-3604,-8.4,35.4,0,390,392,2864
1982,41,l) Left Censored,22638,30420,561287,586187,1818,5.8,3294,10.5,61350,21241,40109,3.6,10.5,111150,29074,82076,5,19,-49800,-8.5,21,0,1479,1495,9963
1982,42,a) 0,15852,16268,109778,55462,16164,198.7,0,0,108632,108632,0,195.9,195.9,0,0,0,0,0,108632,195.9,0,0,,,
1982,42,b) 1,12231,12608,106527,108033,268,1.9,2618,18.8,24449,3738,20711,3.5,22.6,27461,13471,13990,12.5,25.4,-3012,-2.8,45.2,0,1802,1802,9386
1982,42,c) 2,11199,11508,81708,83949,658,5.4,1846,15.1,17716,4139,13577,4.9,21.1,22197,10167,12030,12.1,26.4,-4481,-5.3,42.2,0,1265,1265,6861
1982,42,d) 3,10609,11143,83598,85142,739,6.3,1653,14.2,19152,5521,13631,6.5,22.5,22239,10324,11915,12.1,26.1,-3087,-3.6,45,0,1028,1028,6868
1982,42,e) 4,9654,10264,79680,80785,759,7.1,1461,13.6,16187,6318,9869,7.8,20,18397,7617,10780,9.4,22.8,-2210,-2.8,40,0,875,875,5192
1982,42,f) 5,10424,12468,133006,133833,935,7.3,1491,11.6,23694,7595,16099,5.7,17.7,25347,9529,15818,7.1,18.9,-1653,-1.2,35.4,0,769,777,4141
1982,42,l) Left Censored,100948,135285,3341702,3398240,6647,4.8,11340,8.2,404512,118295,286217,3.5,11.9,517588,134463,383125,4,15.2,-113076,-3.3,23.8,0,5735,5758,39163
1982,44,a) 0,1608,1633,8640,4331,1624,198.9,0,0,8618,8618,0,199,199,0,0,0,0,0,8618,199,0,0,,,
1982,44,b) 1,1270,1285,9517,10180,13,0.9,332,22.7,1904,134,1770,1.3,18.7,3230,1528,1702,15,31.7,-1326,-13,37.4,0,234,234,1134
1982,44,c) 2,1150,1175,7618,7836,79,6.4,185,15,1807,695,1112,8.9,23.1,2243,901,1342,11.5,28.6,-436,-5.5,46.2,0,114,114,535
1982,44,d) 3,1106,1137,8064,8307,57,4.8,161,13.5,1681,455,1226,5.5,20.2,2167,702,1465,8.5,26.1,-486,-5.9,40.4,0,106,106,461
1982,44,e) 4,979,1012,8019,8645,60,5.6,171,15.9,1384,327,1057,3.8,16,2636,1412,1224,16.3,30.5,-1252,-14.5,32,0,110,110,1056
1982,44,f) 5,1100,1209,11708,11977,69,5.5,137,10.9,1932,410,1522,3.4,16.1,2469,747,1722,6.2,20.6,-537,-4.5,32.2,0,79,79,505
1982,44,l) Left Censored,10679,12579,275318,279962,554,4.3,1077,8.4,29641,9658,19983,3.4,10.6,38928,9974,28954,3.6,13.9,-9287,-3.3,21.2,0,562,563,3656
1982,45,a) 0,5364,5468,33010,16622,5435,198.8,0,0,32777,32777,0,197.2,197.2,0,0,0,0,0,32777,197.2,0,0,,,
1982,45,b) 1,3898,4032,31078,31578,92,2,1110,24.1,9210,1948,7262,6.2,29.2,10210,5259,4951,16.7,32.3,-1000,-3.1,58.4,0,842,842,4249
1982,45,c) 2,3325,3463,24288,25917,269,7.2,721,19.4,5156,1643,3513,6.3,19.9,8414,4259,4155,16.4,32.5,-3258,-12.6,39.8,0,521,521,3307
1982,45,d) 3,2981,3132,21705,22062,249,7.5,536,16.2,5405,1808,3597,8.2,24.5,6119,2552,3567,11.6,27.7,-714,-3.2,49,0,382,382,1903
1982,45,e) 4,2857,3040,23640,24601,236,7.4,523,16.3,4546,1611,2935,6.5,18.5,6467,2400,4067,9.8,26.3,-1921,-7.8,37,0,319,319,1681
1982,45,f) 5,2774,3262,26176,26467,288,8.6,445,13.2,5142,2011,3131,7.6,19.4,5724,2423,3301,9.2,21.6,-582,-2.2,38.8,0,259,259,1257
1982,45,l) Left Censored,22752,31424,765491,774751,1639,5.1,2764,8.6,89961,32181,57780,4.2,11.6,108480,27142,81338,3.5,14,-18519,-2.4,23.2,0,1449,1453,11211
1982,46,a) 0,1314,1341,7446,3752,1329,198.2,0,0,7389,7389,0,196.9,196.9,0,0,0,0,0,7389,196.9,0,0,,,
1982,46,b) 1,1054,1076,6865,7144,10,0.8,301,24.1,1657,34,1623,0.5,23.2,2214,1292,922,18.1,31,-557,-7.8,46.4,0,202,202,893
1982,46,c) 2,1014,1036,5842,6260,65,5.8,196,17.5,1121,319,802,5.1,17.9,1957,833,1124,13.3,31.3,-836,-13.4,35.8,0,132,133,616
1982,46,d) 3,922,954,6366,6546,51,5,178,17.3,1277,595,682,9.1,19.5,1637,620,1017,9.5,25,-360,-5.5,39,0,120,120,444
1982,46,e) 4,887,916,5493,5893,52,5.3,159,16.1,1018,317,701,5.4,17.3,1818,786,1032,13.3,30.9,-800,-13.6,34.6,0,91,91,476
1982,46,f) 5,881,1012,6757,7085,79,7.4,142,13.3,1145,445,700,6.3,16.2,1801,582,1219,8.2,25.4,-656,-9.2,32.4,0,78,78,292
1982,46,l) Left Censored,7601,9326,128687,130629,369,3.8,766,8,14171,4292,9879,3.3,10.8,18054,5079,12975,3.9,13.8,-3883,-3,21.6,0,426,426,2356
1982,47,a) 0,7968,8192,50474,25334,8142,198.8,0,0,50280,50280,0,198.5,198.5,0,0,0,0,0,50280,198.5,0,0,,,
1982,47,b) 1,5604,5785,45787,48350,122,1.8,1781,26.5,10629,1234,9395,2.6,22,15754,7928,7826,16.4,32.6,-5125,-10.6,44,0,1313,1313,6180
1982,47,c) 2,4915,5044,36310,38392,291,5.2,1201,21.6,7891,2424,5467,6.3,20.6,12055,5810,6245,15.1,31.4,-4164,-10.8,41.2,0,787,787,3939
1982,47,d) 3,4569,4810,38969,41116,284,5.5,984,18.9,7986,2036,5950,5,19.4,12280,5613,6667,13.7,29.9,-4294,-10.5,38.8,0,647,647,3783
1982,47,e) 4,4120,4362,33642,35615,264,5.6,814,17.4,6523,2133,4390,6,18.3,10468,4490,5978,12.6,29.4,-3945,-11.1,36.6,0,516,516,3048
1982,47,f) 5,4351,5252,54789,55671,397,7.2,774,14.1,10211,2813,7398,5.1,18.3,11975,4564,7411,8.2,21.5,-1764,-3.2,36.6,0,447,448,2306
1982,47,l) Left Censored,34643,47690,1130732,1150656,2791,5.7,4338,8.9,133506,47817,85689,4.2,11.6,173354,43137,130217,3.7,15.1,-39848,-3.5,23.2,0,2106,2112,14801
1982,48,a) 0,39903,41182,270483,135767,40980,199,0,0,269432,269432,0,198.5,198.5,0,0,0,0,0,269432,198.5,0,0,,,
1982,48,b) 1,40664,42054,371948,368502,903,1.9,9165,19.6,116764,12380,104384,3.4,31.7,109873,53156,56717,14.4,29.8,6891,1.9,59.6,0,6885,6885,40737
1982,48,c) 2,11960,12696,107159,109002,875,6.4,2577,18.9,30688,8707,21981,8,28.2,34374,17615,16759,16.2,31.5,-3686,-3.3,56.4,0,1631,1631,11762
1982,48,d) 3,20359,22029,215916,218502,1532,6.6,3433,14.9,52967,13875,39092,6.4,24.2,58140,22002,36138,10.1,26.6,-5173,-2.4,48.4,0,2294,2294,14924
1982,48,e) 4,16245,17086,163345,167997,933,5.1,2699,14.9,36781,7569,29212,4.5,21.9,46084,20408,25676,12.1,27.4,-9303,-5.5,43.8,0,1610,1610,12950
1982,48,f) 5,15403,19033,221332,217436,1688,8.7,2407,12.3,54058,19155,34903,8.8,24.9,46266,17972,28294,8.3,21.3,7792,3.6,42.6,0,1347,1348,9190
1982,48,l) Left Censored,102967,158349,4028508,3979662,11628,7.3,14324,8.9,699513,252846,446667,6.4,17.6,601821,184585,417236,4.6,15.1,97692,2.5,30.2,0,6503,6519,51583
1982,49,a) 0,3184,3273,19895,10003,3246,198.4,0,0,19785,19785,0,197.8,197.8,0,0,0,0,0,19785,197.8,0,0,,,
1982,49,b) 1,2344,2441,19506,19598,62,2.2,706,25.2,6475,1046,5429,5.3,33,6659,3668,2991,18.7,34,-184,-1,66,0,489,489,2768
1982,49,c) 2,1924,2022,14366,15835,169,7.7,489,22.2,3702,1416,2286,8.9,23.4,6640,3135,3505,19.8,41.9,-2938,-18.5,46.8,0,311,311,2142
1982,49,d) 3,1862,1996,16100,16744,144,6.7,399,18.6,4392,1204,3188,7.2,26.2,5680,3011,2669,18,33.9,-1288,-7.7,52.4,0,237,237,1704
1982,49,e) 4,1563,1625,13715,14559,90,5.1,309,17.7,2787,635,2152,4.4,19.1,4475,1895,2580,13,30.7,-1688,-11.6,38.2,0,194,194,1314
1982,49,f) 5,1515,1775,17181,17421,162,8.8,260,14.1,3677,1570,2107,9,21.1,4156,1455,2701,8.4,23.9,-479,-2.8,42.2,0,145,145,802
1982,49,l) Left Censored,10599,14445,324424,327137,973,6.6,1356,9.2,42217,13380,28837,4.1,12.9,47643,13539,34104,4.1,14.6,-5426,-1.7,25.8,0,608,608,4406
1982,50,a) 0,1358,1377,6653,3332,1373,199.4,0,0,6643,6643,0,199.4,199.4,0,0,0,0,0,6643,199.4,0,0,,,
1982,50,b) 1,1025,1037,6296,6278,14,1.2,218,18.9,1683,218,1465,3.5,26.8,1646,827,819,13.2,26.2,37,0.6,52.4,0,145,145,539
1982,50,c) 2,866,880,4933,5244,47,5,166,17.5,915,170,745,3.2,17.4,1536,711,825,13.6,29.3,-621,-11.9,34.8,0,118,118,494
1982,50,d) 3,797,815,5572,5450,63,7.4,129,15.1,1464,668,796,12.3,26.9,1219,504,715,9.2,22.4,245,4.5,44.8,0,78,78,278
1982,50,e) 4,812,834,5521,5781,38,4.3,121,13.7,867,163,704,2.8,15,1386,540,846,9.3,24,-519,-9,30,0,65,65,319
1982,50,f) 5,782,899,8540,8557,58,6.2,117,12.5,1587,286,1301,3.3,18.5,1620,558,1062,6.5,18.9,-33,-0.4,37,0,68,68,300
1982,50,l) Left Censored,5657,6801,125001,127377,305,4.4,590,8.5,12787,2640,10147,2.1,10,17539,5930,11609,4.7,13.8,-4752,-3.8,20,0,316,329,2357
1982,51,a) 0,9087,9279,56802,28511,9219,198.7,0,0,56582,56582,0,198.5,198.5,0,0,0,0,0,56582,198.5,0,0,,,
1982,51,b) 1,6868,7117,57615,58596,202,2.5,1883,23.3,16444,3356,13088,5.7,28.1,18406,9328,9078,15.9,31.4,-1962,-3.3,56.2,0,1288,1288,7284
1982,51,c) 2,5944,6114,43567,45596,412,6.2,1250,19,9240,2316,6924,5.1,20.3,13298,5970,7328,13.1,29.2,-4058,-8.9,40.6,0,848,848,4412
1982,51,d) 3,5395,5654,45606,47767,433,7.3,955,16,9124,2703,6421,5.7,19.1,13446,4366,9080,9.1,28.1,-4322,-9,38.2,0,628,628,2878
1982,51,e) 4,4803,5138,42640,44154,339,6.2,829,15.2,9087,3141,5946,7.1,20.6,12115,4329,7786,9.8,27.4,-3028,-6.8,41.2,0,502,502,2683
1982,51,f) 5,4813,5875,65577,65507,448,7.3,805,13.2,12361,4719,7642,7.2,18.9,12221,4636,7585,7.1,18.7,140,0.2,37.4,0,454,455,2325
1982,51,l) Left Censored,40011,56817,1314054,1324183,3213,5.5,4836,8.3,184967,48030,136937,3.6,14,205226,51430,153796,3.9,15.5,-20259,-1.5,28,0,2335,2338,15920
1982,53,a) 0,9795,10049,56818,28743,9969,198.4,0,0,56151,56151,0,195.4,195.4,0,0,0,0,0,56151,195.4,0,0,,,
1982,53,b) 1,7171,7403,54626,56170,173,2,2180,25.4,15729,1743,13986,3.1,28,18817,8914,9903,15.9,33.5,-3088,-5.5,56,0,1489,1489,6332
1982,53,c) 2,6450,6660,43594,46501,493,6.8,1471,20.4,10663,3308,7355,7.1,22.9,16477,7811,8666,16.8,35.4,-5814,-12.5,45.8,0,862,862,4688
1982,53,d) 3,5689,5908,40662,44188,430,6.8,1202,18.9,9109,3164,5945,7.2,20.6,16160,6729,9431,15.2,36.6,-7051,-16,41.2,0,696,696,4185
1982,53,e) 4,5057,5326,43311,44204,417,7.3,1063,18.6,11180,3970,7210,9,25.3,12966,5047,7919,11.4,29.3,-1786,-4,50.6,0,624,624,3279
1982,53,f) 5,5128,6139,59667,61681,508,8,890,13.9,11955,4267,7688,6.9,19.4,15983,5488,10495,8.9,25.9,-4028,-6.5,38.8,0,467,467,3275
1982,53,l) Left Censored,33908,46194,904808,928576,2853,6.1,4149,8.8,109267,38110,71157,4.1,11.8,156802,38264,118538,4.1,16.9,-47535,-5.1,23.6,0,2000,2022,13477
1982,54,a) 0,2760,2815,17215,8669,2789,198.2,0,0,17092,17092,0,197.2,197.2,0,0,0,0,0,17092,197.2,0,0,,,
1982,54,b) 1,2032,2078,16069,16629,44,1.8,602,25.2,4170,790,3380,4.8,25.1,5289,2515,2774,15.1,31.8,-1119,-6.7,50.2,0,435,435,1957
1982,54,c) 2,1671,1716,11291,12139,84,4.4,414,21.7,2150,455,1695,3.7,17.7,3846,1642,2204,13.5,31.7,-1696,-14,35.4,0,281,281,1200
1982,54,d) 3,1588,1657,11255,12170,122,6.8,347,19.4,2318,766,1552,6.3,19,4147,1710,2437,14.1,34.1,-1829,-15.1,38,0,231,231,986
1982,54,e) 4,1397,1485,11456,11961,94,5.8,300,18.4,2499,732,1767,6.1,20.9,3509,1650,1859,13.8,29.3,-1010,-8.4,41.8,0,187,187,910
1982,54,f) 5,1544,1776,16756,17239,119,6.3,287,15.2,2873,1056,1817,6.1,16.7,3838,1604,2234,9.3,22.3,-965,-5.6,33.4,0,148,148,623
1982,54,l) Left Censored,14350,18870,379214,386112,967,5,1867,9.6,44479,12768,31711,3.3,11.5,58275,18921,39354,4.9,15.1,-13796,-3.6,23,0,900,901,6509
1982,55,a) 0,7426,7592,45240,22748,7542,198.7,0,0,44984,44984,0,197.7,197.7,0,0,0,0,0,44984,197.7,0,0,,,
1982,55,b) 1,5979,6154,45280,47096,117,1.7,1381,20.1,9720,2016,7704,4.3,20.6,13352,6327,7025,13.4,28.4,-3632,-7.8,41.2,0,959,959,4198
1982,55,c) 2,5297,5458,36943,37899,350,6,925,15.9,8350,2936,5414,7.7,22,10261,4073,6188,10.7,27.1,-1911,-5.1,44,0,652,652,3150
1982,55,d) 3,5117,5321,37244,38493,304,5.4,832,14.8,6899,2235,4664,5.8,17.9,9396,3455,5941,9,24.4,-2497,-6.5,35.8,0,519,519,2071
1982,55,e) 4,4978,5226,41708,42564,293,5.3,843,15.1,8115,2572,5543,6,19.1,9826,3725,6101,8.8,23.1,-1711,-4,38.2,0,503,503,2235
1982,55,f) 5,5030,6001,54936,55290,423,6.8,738,11.9,10203,3819,6384,6.9,18.5,10910,4490,6420,8.1,19.7,-707,-1.2,37,0,391,391,1836
1982,55,l) Left Censored,44356,56414,1273629,1290736,2935,5.1,4524,7.9,137211,44044,93167,3.4,10.6,171425,43012,128413,3.3,13.3,-34214,-2.7,21.2,0,2341,2350,14710
1982,56,a) 0,1738,1770,17682,8847,1762,199.1,0,0,17671,,,,199.7,0,0,0,0,0,17671,199.7,0,1,,,
1982,56,b) 1,1319,1351,9013,9481,27,1.7,390,25.3,2423,236,2187,2.5,25.6,3358,1766,1592,18.6,35.4,-935,-9.8,51.2,0,266,266,1179
1982,56,c) 2,1014,1050,8673,8999,68,5.9,251,21.8,2571,651,1920,7.2,28.6,3222,1509,1713,16.8,35.8,-651,-7.2,57.2,0,149,149,937
1982,56,d) 3,1002,1052,8357,8621,90,8.1,187,16.9,1939,568,1371,6.6,22.5,2467,973,1494,11.3,28.6,-528,-6.1,45,0,114,114,606
1982,56,e) 4,837,851,7203,7681,42,4.6,167,18.1,1168,,,,15.2,2124,799,1325,10.4,27.7,-956,-12.5,30.4,1,93,93,463
1982,56,f) 5,752,871,8675,9169,68,7.5,127,14,1874,715,1159,7.8,20.4,2861,816,2045,8.9,31.2,-987,-10.8,40.8,0,76,76,352
1982,56,l) Left Censored,4731,6137,101177,103437,436,7,561,9,15024,3989,11035,3.9,14.5,19543,5052,14491,4.9,18.9,-4519,-4.4,29,0,283,283,1867
1983,01,a) 0,5907,5953,30543,15429,5832,195.9,0,0,30229,30229,0,195.9,195.9,0,0,0,0,0,30229,195.9,0,0,,,
1983,01,b) 1,4288,4432,32387,33900,23,0.4,1427,27.6,9091,412,8679,1.2,26.8,12116,6997,5119,20.6,35.7,-3025,-8.9,53.6,0,1129,1129,5783
1983,01,c) 2,3698,3831,31186,34988,121,2.9,851,20.3,5548,802,4746,2.3,15.9,13151,6655,6496,19,37.6,-7603,-21.7,31.8,0,683,683,3272
1983,01,d) 3,3395,3544,24200,25786,109,2.9,606,16.1,4469,396,4073,1.5,17.3,7641,4004,3637,15.5,29.6,-3172,-12.3,34.6,0,472,472,3495
1983,01,e) 4,3261,3456,33373,33694,122,3.4,536,14.8,6288,1108,5180,3.3,18.7,6930,3330,3600,9.9,20.6,-642,-1.9,37.4,0,396,396,2228
1983,01,f) 5,3131,3487,27679,28901,111,3,480,13.2,4453,596,3857,2.1,15.4,6897,2631,4266,9.1,23.9,-2444,-8.5,30.8,0,343,343,1853
1983,01,g) 6 to 10,3165,3838,37656,38372,127,3.2,437,11,5912,716,5196,1.9,15.4,7344,2517,4827,6.6,19.1,-1432,-3.7,30.8,0,256,258,1464
1983,01,l) Left Censored,25705,35993,781567,797506,1360,3.7,3057,8.3,102281,34154,68127,4.3,12.8,134159,37617,96542,4.7,16.8,-31878,-4,25.6,0,1591,1612,10601
1983,02,a) 0,1789,1808,9242,4696,1766,195.4,0,0,9092,9092,0,193.6,193.6,0,0,0,0,0,9092,193.6,0,0,,,
1983,02,b) 1,1090,1136,8549,8787,8,0.6,367,27.8,2783,54,2729,0.6,31.7,3259,1690,1569,19.2,37.1,-476,-5.4,63.4,0,261,261,1272
1983,02,c) 2,685,722,6597,6573,46,5.8,180,22.9,2070,309,1761,4.7,31.5,2022,1188,834,18.1,30.8,48,0.7,61.6,0,132,132,795
1983,02,d) 3,635,648,5147,5342,29,4.3,108,15.9,1263,142,1121,2.7,23.6,1653,841,812,15.7,30.9,-390,-7.3,47.2,0,75,75,514
1983,02,e) 4,635,703,5798,5766,52,7.3,93,13,1560,292,1268,5.1,27.1,1496,525,971,9.1,25.9,64,1.2,51.8,0,60,60,375
1983,02,f) 5,523,563,5227,5156,25,4.3,72,12.5,1430,115,1315,2.2,27.7,1287,425,862,8.2,25,143,2.7,50,0,51,51,260
1983,02,g) 6 to 10,547,691,7669,7777,41,5.9,70,10,1707,371,1336,4.8,21.9,1922,745,1177,9.6,24.7,-215,-2.8,43.8,0,31,31,168
1983,02,l) Left Censored,2896,4105,82282,84662,290,7.1,331,8.1,15686,5605,10081,6.6,18.5,20445,5246,15199,6.2,24.1,-4759,-5.6,37,0,147,147,1457
1983,04,a) 0,7098,7217,49470,24889,7097,196.7,0,0,49162,49162,0,197.5,197.5,0,0,0,0,0,49162,197.5,0,0,,,
1983,04,b) 1,5659,5881,41505,44849,58,0.9,1777,26.1,11510,834,10676,1.9,25.7,18197,9790,8407,21.8,40.6,-6687,-14.9,51.4,0,1338,1340,7570
1983,04,c) 2,4370,4554,35418,36642,214,4.3,1065,21.4,8681,1715,6966,4.7,23.7,11129,5834,5295,15.9,30.4,-2448,-6.7,47.4,0,841,841,4877
1983,04,d) 3,3996,4178,32079,33276,181,4.1,797,17.9,7218,1241,5977,3.7,21.7,9611,4000,5611,12,28.9,-2393,-7.2,43.4,0,630,631,3420
1983,04,e) 4,3469,3736,31605,32172,238,6.1,573,14.8,7354,1736,5618,5.4,22.9,8488,3422,5066,10.6,26.4,-1134,-3.5,45.8,0,446,448,2689
1983,04,f) 5,2856,3004,24928,25758,162,5.2,373,12.1,4442,888,3554,3.4,17.2,6101,2340,3761,9.1,23.7,-1659,-6.5,34.4,0,286,287,1917
1983,04,g) 6 to 10,2697,3365,39099,40087,171,4.9,404,11.7,6691,1425,5266,3.6,16.7,8666,2330,6336,5.8,21.6,-1975,-4.9,33.4,0,225,227,1149
1983,04,l) Left Censored,16384,25258,579619,584877,1326,5.2,2208,8.6,90477,23604,66873,4,15.5,100992,26358,74634,4.5,17.3,-10515,-1.8,31,0,978,990,8157
1983,05,a) 0,4233,4283,21919,11040,4201,196.2,0,0,21759,21759,0,197.1,197.1,0,0,0,0,0,21759,197.1,0,0,,,
1983,05,b) 1,3156,3223,21200,22518,9,0.2,1072,28.3,4593,49,4544,0.2,20.4,7229,3942,3287,17.5,32.1,-2636,-11.7,40.8,0,874,875,3242
1983,05,c) 2,2646,2723,20512,21406,97,3.3,575,19.4,3738,589,3149,2.8,17.5,5526,2885,2641,13.5,25.8,-1788,-8.3,35,0,459,459,2447
1983,05,d) 3,2472,2590,19722,20231,109,4,422,15.4,3623,682,2941,3.4,17.9,4640,2104,2536,10.4,22.9,-1017,-5,35.8,0,337,337,1779
1983,05,e) 4,2522,2672,19022,19721,87,3.1,371,13.3,3177,465,2712,2.4,16.1,4575,1683,2892,8.5,23.2,-1398,-7.1,32.2,0,275,275,1142
1983,05,f) 5,2264,2330,15570,15960,63,2.6,294,12.1,2488,312,2176,2,15.6,3267,1490,1777,9.3,20.5,-779,-4.9,31.2,0,219,219,1170
1983,05,g) 6 to 10,2125,2521,21840,22088,105,4.1,268,10.4,3408,547,2861,2.5,15.4,3903,1150,2753,5.2,17.7,-495,-2.3,30.8,0,181,181,697
1983,05,l) Left Censored,16500,21522,432423,437683,776,3.5,1829,8.3,51780,13500,38280,3.1,11.8,62299,16086,46213,3.7,14.2,-10519,-2.4,23.6,0,1021,1028,6021
1983,06,a) 0,54209,54857,360397,181901,53786,196.1,0,0,356993,356993,0,196.3,196.3,0,0,0,0,0,356993,196.3,0,0,,,
1983,06,b) 1,43777,45750,333904,383920,307,0.6,13665,25.8,95037,4827,90210,1.3,24.8,195069,63334,131735,16.5,50.8,-100032,-26,49.6,0,9869,9888,47532
1983,06,c) 2,38870,40590,353990,405503,1626,3.7,8260,18.8,75287,11253,64034,2.8,18.6,178312,63463,114849,15.7,44,-103025,-25.4,37.2,0,6056,6056,37746
1983,06,d) 3,34315,35793,282102,293954,1332,3.5,6455,16.9,58418,6667,51751,2.3,19.9,82121,35951,46170,12.2,27.9,-23703,-8,39.8,0,4638,4643,27808
1983,06,e) 4,31054,32894,273088,282361,1153,3.3,5440,15.6,55611,6216,49395,2.2,19.7,74156,32547,41609,11.5,26.3,-18545,-6.6,39.4,0,3811,3816,22104
1983,06,f) 5,26651,28539,243869,265070,1054,3.5,3961,13.3,46419,8007,38412,3,17.5,88821,26662,62159,10.1,33.5,-42402,-16,35,0,2638,2646,15429
1983,06,g) 6 to 10,27106,33385,386618,410776,1397,4,4125,11.9,65280,14950,50330,3.6,15.9,113595,32403,81192,7.9,27.7,-48315,-11.8,31.8,0,2313,2344,18289
1983,06,l) Left Censored,170533,246208,5944811,6098931,10136,4,21594,8.6,808890,192369,616521,3.2,13.3,1117131,311257,805874,5.1,18.3,-308241,-5,26.6,0,10617,10779,81631
1983,08,a) 0,8824,8996,56384,28407,8864,197.1,0,0,55955,55955,0,197,197,0,0,0,0,0,55955,197,0,0,,,
1983,08,b) 1,6919,7166,52314,78087,38,0.5,2422,28.8,14515,1154,13361,1.5,18.6,66061,11636,54425,14.9,84.6,-51546,-66,37.2,0,1893,1894,8888
1983,08,c) 2,5677,5920,54724,59434,211,3.2,1434,21.9,10046,1270,8776,2.1,16.9,19466,9348,10118,15.7,32.8,-9420,-15.9,33.8,0,1083,1084,6885
1983,08,d) 3,5088,5272,40479,42949,303,5.4,937,16.8,8315,1813,6502,4.2,19.4,13254,6017,7237,14,30.9,-4939,-11.5,38.8,0,703,706,4902
1983,08,e) 4,4664,4943,40660,42525,274,5.3,825,15.9,8223,1467,6756,3.4,19.3,11952,4723,7229,11.1,28.1,-3729,-8.8,38.6,0,595,597,3635
1983,08,f) 5,3950,4097,34164,36086,179,4.2,564,13.2,5750,1355,4395,3.8,15.9,9594,3373,6221,9.3,26.6,-3844,-10.7,31.8,0,406,406,2304
1983,08,g) 6 to 10,3653,4453,48599,50504,210,4.6,556,12.1,8029,1696,6333,3.4,15.9,11840,3998,7842,7.9,23.4,-3811,-7.5,31.8,0,324,341,2048
1983,08,l) Left Censored,23504,32782,735728,750759,1760,5.3,2962,8.9,100214,28776,71438,3.8,13.3,130275,33474,96801,4.5,17.4,-30061,-4.1,26.6,0,1410,1415,9126
1983,09,a) 0,5696,5727,30217,15302,5612,196,0,0,29831,29831,0,194.9,194.9,0,0,0,0,0,29831,194.9,0,0,,,
1983,09,b) 1,4778,4922,48220,41985,18,0.3,1005,18.5,21049,263,20786,0.6,50.1,8578,3806,4772,9.1,20.4,12471,29.7,40.8,0,751,751,2653
1983,09,c) 2,4152,4312,31746,32123,152,3.3,660,14.5,6640,1296,5344,4,20.7,7393,2986,4407,9.3,23,-753,-2.3,41.4,0,497,497,2204
1983,09,d) 3,3568,3700,25567,26214,119,3.1,531,13.7,4490,674,3816,2.6,17.1,5784,2709,3075,10.3,22.1,-1294,-5,34.2,0,415,416,2173
1983,09,e) 4,3331,3422,26709,26515,113,3.2,409,11.5,5087,569,4518,2.1,19.2,4699,1811,2888,6.8,17.7,388,1.5,35.4,0,310,310,1539
1983,09,f) 5,3132,3405,30395,31117,91,2.6,351,10,6319,2526,3793,8.1,20.3,7762,2076,5686,6.7,24.9,-1443,-4.6,40.6,0,244,244,1183
1983,09,g) 6 to 10,3416,3979,43835,44190,156,3.8,436,10.6,8260,1574,6686,3.6,18.7,8969,3370,5599,7.6,20.3,-709,-1.6,37.4,0,270,270,1315
1983,09,l) Left Censored,31200,38655,1026145,1043922,1274,3.2,2812,7.2,110296,24834,85462,2.4,10.6,145851,35492,110359,3.4,14,-35555,-3.4,21.2,0,1563,1569,10387
1983,10,a) 0,1075,1080,5011,2561,1047,193.9,0,0,4900,,,,191.3,0,0,0,0,0,4900,191.3,0,1,,,
1983,10,b) 1,790,799,5735,5960,6,0.7,233,25.4,1547,,,,26,1997,1389,608,23.3,33.5,-450,-7.5,52,1,152,152,1138
1983,10,c) 2,709,728,5265,5523,29,3.8,114,14.8,804,108,696,2,14.6,1319,737,582,13.3,23.9,-515,-9.3,29.2,0,88,88,539
1983,10,d) 3,636,657,4808,4978,21,3.1,92,13.4,993,330,663,6.6,19.9,1333,449,884,9,26.8,-340,-6.9,39.8,0,69,69,379
1983,10,e) 4,607,637,5517,5558,23,3.5,80,12.1,1005,115,890,2.1,18.1,1087,379,708,6.8,19.6,-82,-1.5,36.2,0,61,61,301
1983,10,f) 5,524,551,3956,4088,16,2.8,67,11.7,647,57,590,1.4,15.8,911,368,543,9,22.3,-264,-6.5,31.6,0,41,41,196
1983,10,g) 6 to 10,617,757,8724,8364,35,4.5,80,10.4,1782,243,1539,2.9,21.3,1062,291,771,3.5,12.7,720,8.6,25.4,0,54,55,180
1983,10,l) Left Censored,5329,6721,178146,179651,253,3.7,507,7.4,21146,7387,13759,4.1,11.8,24156,6660,17496,3.7,13.4,-3010,-1.6,23.6,0,246,250,1647
1983,11,a) 0,1473,1484,11628,5859,1458,196.5,0,0,11539,11539,0,196.9,196.9,0,0,0,0,0,11539,196.9,0,0,,,
1983,11,b) 1,1208,1225,9550,9702,7,0.5,292,21.2,2521,44,2477,0.5,26,2825,1534,1291,15.8,29.1,-304,-3.1,52,0,217,217,1125
1983,11,c) 2,965,981,11851,12013,45,4.4,151,14.6,1653,264,1389,2.2,13.8,1977,642,1335,5.3,16.5,-324,-2.7,27.6,0,123,123,595
1983,11,d) 3,811,829,7184,7511,24,2.8,135,15.5,1302,169,1133,2.3,17.3,1955,912,1043,12.1,26,-653,-8.7,34.6,0,96,96,609
1983,11,e) 4,733,754,6549,6877,31,4,94,12,851,106,745,1.5,12.4,1507,483,1024,7,21.9,-656,-9.5,24.8,0,76,76,427
1983,11,f) 5,699,742,9344,9633,28,3.7,75,9.8,1377,121,1256,1.3,14.3,1955,455,1500,4.7,20.3,-578,-6,28.6,0,56,56,359
1983,11,g) 6 to 10,831,985,27665,27755,64,6.5,91,9.2,3421,501,2920,1.8,12.3,3600,648,2952,2.3,13,-179,-0.7,24.6,0,45,45,227
1983,11,l) Left Censored,7424,9191,278248,268664,380,4.1,744,8,55432,6686,48746,2.5,20.6,36263,10768,25495,4,13.5,19169,7.1,27,0,351,353,3314
1983,12,a) 0,29208,29511,157523,79600,29015,196.6,0,0,155846,155846,0,195.8,195.8,0,0,0,0,0,155846,195.8,0,0,,,
1983,12,b) 1,21819,22496,167773,177954,123,0.5,7678,29,45250,3438,41812,1.9,25.4,65614,36897,28717,20.7,36.9,-20364,-11.5,50.8,0,5628,5639,26986
1983,12,c) 2,17880,18503,141882,150169,729,3.6,4409,21.7,30460,4840,25620,3.2,20.3,47034,25831,21203,17.2,31.3,-16574,-11,40.6,0,3200,3200,19082
1983,12,d) 3,14851,15308,112485,121691,511,3,3658,21.8,21192,2574,18618,2.1,17.4,39604,21048,18556,17.3,32.5,-18412,-15.1,34.8,0,2325,2327,13428
1983,12,e) 4,12510,13200,113058,119493,442,3.1,3042,21.1,21774,3348,18426,2.8,18.2,34644,19043,15601,15.9,29,-12870,-10.8,36.4,0,1758,1759,10668
1983,12,f) 5,11722,12559,102648,107322,440,3.3,1937,14.7,18870,2651,16219,2.5,17.6,28217,12322,15895,11.5,26.3,-9347,-8.7,35.2,0,1274,1274,7727
1983,12,g) 6 to 10,11446,13965,149166,153814,693,4.8,1808,12.5,25061,6122,18939,4,16.3,34356,13546,20810,8.8,22.3,-9295,-6,32.6,0,1058,1073,6194
1983,12,l) Left Censored,71078,105442,2200914,2229701,4877,4.5,9498,8.8,310779,96960,213819,4.3,13.9,368354,104970,263384,4.7,16.5,-57575,-2.6,27.8,0,4595,4647,33535
1983,13,a) 0,10762,10834,56676,28579,10654,196.7,0,0,56195,56195,0,196.6,196.6,0,0,0,0,0,56195,196.6,0,0,,,
1983,13,b) 1,7990,8317,63438,65384,74,0.8,2510,26.2,17654,2245,15409,3.4,27,21545,13494,8051,20.6,33,-3891,-6,54,0,1981,1982,10772
1983,13,c) 2,6616,6918,60820,61101,263,3.5,1330,17.9,13959,1913,12046,3.1,22.8,14520,7268,7252,11.9,23.8,-561,-1,45.6,0,1051,1053,5970
1983,13,d) 3,5767,6080,48561,50526,217,3.4,1016,15.8,8995,1345,7650,2.7,17.8,12925,5432,7493,10.8,25.6,-3930,-7.8,35.6,0,786,786,4347
1983,13,e) 4,5325,5628,47021,47884,191,3.2,802,13.6,9206,1123,8083,2.3,19.2,10932,4975,5957,10.4,22.8,-1726,-3.6,38.4,0,601,601,3915
1983,13,f) 5,4964,5304,45828,45817,199,3.6,650,11.9,8860,1239,7621,2.7,19.3,8838,3663,5175,8,19.3,22,0,38.6,0,493,493,2868
1983,13,g) 6 to 10,5154,6143,64128,65144,277,4.4,708,11.2,11492,3588,7904,5.5,17.6,13524,5405,8119,8.3,20.8,-2032,-3.2,35.2,0,449,451,2791
1983,13,l) Left Censored,39650,58285,1383374,1397070,3009,5.1,4570,7.8,195879,62120,133759,4.4,14,223271,59933,163338,4.3,16,-27392,-2,28,0,2256,2268,15230
1983,15,a) 0,2167,2175,12104,6197,2131,196,0,0,11814,11814,0,190.6,190.6,0,0,0,0,0,11814,190.6,0,0,,,
1983,15,b) 1,1704,1759,11777,12635,5,0.3,458,23,2950,18,2932,0.1,23.3,4665,3092,1573,24.5,36.9,-1715,-13.6,46.6,0,338,346,2613
1983,15,c) 2,1550,1606,15891,15909,73,4.2,308,17.9,3477,902,2575,5.7,21.9,3513,1594,1919,10,22.1,-36,-0.2,43.8,0,246,246,1364
1983,15,d) 3,1324,1419,11288,14835,63,4.2,259,17.1,2332,513,1819,3.5,15.7,9425,2091,7334,14.1,63.5,-7093,-47.8,31.4,0,195,195,1518
1983,15,e) 4,1178,1252,11705,12108,35,2.7,160,12.2,1524,212,1312,1.8,12.6,2329,807,1522,6.7,19.2,-805,-6.6,25.2,0,121,121,519
1983,15,f) 5,1040,1088,9695,10087,28,2.5,141,12.5,1233,197,1036,2,12.2,2016,768,1248,7.6,20,-783,-7.8,24.4,0,96,105,545
1983,15,g) 6 to 10,1019,1363,17622,16619,47,3.3,149,10.6,4791,555,4236,3.3,28.8,2785,973,1812,5.9,16.8,2006,12,33.6,0,80,80,471
1983,15,l) Left Censored,7988,11169,220510,224531,403,3.6,784,6.9,25093,7141,17952,3.2,11.2,33135,8623,24512,3.8,14.8,-8042,-3.6,22.4,0,417,421,2943
1983,16,a) 0,2032,2078,12197,6139,2026,195,0,0,12116,12116,0,197.4,197.4,0,0,0,0,0,12116,197.4,0,0,,,
1983,16,b) 1,1575,1638,10986,18157,6,0.3,527,27.6,2776,181,2595,1,15.3,17118,2348,14770,12.9,94.3,-14342,-79,30.6,0,416,420,1994
1983,16,c) 2,1310,1336,8667,9409,49,3.3,317,21.6,1430,179,1251,1.9,15.2,2913,1469,1444,15.6,31,-1483,-15.8,30.4,0,243,243,1039
1983,16,d) 3,1226,1260,8167,8687,39,2.8,266,19.4,1536,151,1385,1.7,17.7,2576,1405,1171,16.2,29.7,-1040,-12,35.4,0,204,204,1041
1983,16,e) 4,1199,1263,9496,9751,40,3,182,13.7,1754,366,1388,3.8,18,2263,903,1360,9.3,23.2,-509,-5.2,36,0,141,142,703
1983,16,f) 5,1069,1090,8198,8443,40,3.5,149,13.1,1213,222,991,2.6,14.4,1702,670,1032,7.9,20.2,-489,-5.8,28.8,0,101,101,468
1983,16,g) 6 to 10,1005,1171,9798,10277,49,4,156,12.8,1364,314,1050,3.1,13.3,2321,692,1629,6.7,22.6,-957,-9.3,26.6,0,81,81,347
1983,16,l) Left Censored,7426,10053,162394,164284,357,3.5,820,8,18627,3101,15526,1.9,11.3,22407,7605,14802,4.6,13.6,-3780,-2.3,22.6,0,418,420,2667
1983,17,a) 0,16627,16822,104734,52736,16526,196.5,0,0,103997,103997,0,197.2,197.2,0,0,0,0,0,103997,197.2,0,0,,,
1983,17,b) 1,14058,14638,120351,131716,130,0.8,3958,23.8,28726,3779,24947,2.9,21.8,51455,18380,33075,14,39.1,-22729,-17.3,43.6,0,2648,2661,12345
1983,17,c) 2,11772,12191,102569,108296,369,2.8,2491,18.8,19313,1949,17364,1.8,17.8,30767,15113,15654,14,28.4,-11454,-10.6,35.6,0,1710,1710,9414
1983,17,d) 3,10533,10919,82991,86604,324,2.7,2292,19.4,16582,1536,15046,1.8,19.1,23807,13066,10741,15.1,27.5,-7225,-8.4,38.2,0,1378,1386,8375
1983,17,e) 4,9709,10144,77136,81910,297,2.7,1761,16.3,12736,2432,10304,3,15.5,22284,9635,12649,11.8,27.2,-9548,-11.7,31,0,1081,1084,5569
1983,17,f) 5,9350,9856,78408,79903,289,2.8,1396,13.5,14638,3300,11338,4.1,18.3,17627,7954,9673,10,22.1,-2989,-3.8,36.6,0,907,908,4895
1983,17,g) 6 to 10,10025,12122,136471,139472,472,3.8,1441,11.5,20882,4540,16342,3.3,15,26884,9559,17325,6.9,19.3,-6002,-4.3,30,0,782,792,4239
1983,17,l) Left Censored,89849,118411,3014528,3120148,4302,3.5,12288,10,311519,81958,229561,2.6,10,522760,155636,367124,5,16.8,-211241,-6.8,20,0,5512,5576,41220
1983,18,a) 0,7265,7345,40519,20265,7336,199.8,0,0,40508,40508,0,199.9,199.9,0,0,0,0,0,40508,199.9,0,0,,,
1983,18,b) 1,5664,5912,42453,45239,23,0.3,2165,30.6,9834,634,9200,1.4,21.7,15405,10050,5355,22.2,34.1,-5571,-12.4,43.4,0,1414,1418,6266
1983,18,c) 2,4661,4879,45284,48703,125,2.3,1348,24.3,6965,1126,5839,2.3,14.3,13802,7354,6448,15.1,28.3,-6837,-14,28.6,0,877,877,4708
1983,18,d) 3,4405,4582,32363,34455,80,1.6,1125,21.8,5773,549,5224,1.6,16.8,9957,5615,4342,16.3,28.9,-4184,-12.1,33.6,0,671,671,3069
1983,18,e) 4,4385,4616,32916,34571,117,2.3,889,17.6,5378,421,4957,1.2,15.6,8688,4434,4254,12.8,25.1,-3310,-9.5,31.2,0,525,525,2778
1983,18,f) 5,4099,4365,34754,37995,128,2.7,710,15.1,5634,974,4660,2.6,14.8,12115,3876,8239,10.2,31.9,-6481,-17.1,29.6,0,461,461,2428
1983,18,g) 6 to 10,4375,5390,57160,58886,186,3.3,744,13.1,8603,1372,7231,2.3,14.6,12054,4569,7485,7.8,20.5,-3451,-5.9,29.2,0,385,398,2065
1983,18,l) Left Censored,39862,55585,1328979,1376091,1689,2.9,6123,10.6,136650,29277,107373,2.1,9.9,230875,72907,157968,5.3,16.8,-94225,-6.9,19.8,0,2729,2763,20125
1983,19,a) 0,4804,4873,27124,13714,4741,194.6,0,0,26820,26820,0,195.6,195.6,0,0,0,0,0,26820,195.6,0,0,,,
1983,19,b) 1,3918,4123,25432,27511,22,0.5,1070,22.9,4675,205,4470,0.7,17,8832,5316,3516,19.3,32.1,-4157,-15.1,34,0,850,852,4099
1983,19,c) 2,3531,3689,26393,28278,124,3.1,686,17.4,3986,665,3321,2.4,14.1,7757,3675,4082,13,27.4,-3771,-13.3,28.2,0,544,544,2755
1983,19,d) 3,3363,3454,21672,22647,88,2.4,531,14.6,3101,241,2860,1.1,13.7,5051,2362,2689,10.4,22.3,-1950,-8.6,27.4,0,427,427,1727
1983,19,e) 4,3011,3207,21618,37995,105,3.1,475,14.2,3311,465,2846,1.2,8.7,36065,2529,33536,6.7,94.9,-32754,-86.2,17.4,0,361,361,1790
1983,19,f) 5,3068,3261,21526,22346,93,2.8,409,12.1,3501,587,2914,2.6,15.7,5140,2303,2837,10.3,23,-1639,-7.3,31.4,0,291,291,1568
1983,19,g) 6 to 10,3300,3976,34958,35110,112,2.7,414,10.1,6673,700,5973,2,19,6977,3287,3690,9.4,19.9,-304,-0.9,38,0,281,283,1213
1983,19,l) Left Censored,28384,37304,621758,644554,1124,3,2809,7.4,68978,21923,47055,3.4,10.7,114570,32302,82268,5,17.8,-45592,-7.1,21.4,0,1545,1551,8300
1983,20,a) 0,5072,5133,25652,12911,5046,196.6,0,0,25482,25482,0,197.4,197.4,0,0,0,0,0,25482,197.4,0,0,,,
1983,20,b) 1,4007,4112,27635,29380,19,0.4,1108,23.7,5753,317,5436,1.1,19.6,9242,4749,4493,16.2,31.5,-3489,-11.9,39.2,0,877,878,3689
1983,20,c) 2,3361,3536,24012,26241,126,3.3,698,18.3,3810,442,3368,1.7,14.5,8268,3734,4534,14.2,31.5,-4458,-17,29,0,525,525,3084
1983,20,d) 3,2785,2887,19590,21024,88,2.9,546,17.7,3058,578,2480,2.7,14.5,5925,3015,2910,14.3,28.2,-2867,-13.7,29,0,423,423,2439
1983,20,e) 4,2705,2822,19205,19947,98,3.3,405,13.7,3585,418,3167,2.1,18,5068,2053,3015,10.3,25.4,-1483,-7.4,36,0,320,320,1630
1983,20,f) 5,2523,2663,17711,18236,86,3.1,324,11.7,3092,505,2587,2.8,17,4141,1542,2599,8.5,22.7,-1049,-5.7,34,0,254,254,1267
1983,20,g) 6 to 10,2795,3345,31750,32321,120,3.5,397,11.5,5441,961,4480,3,16.8,6582,2206,4376,6.8,20.4,-1141,-3.6,33.6,0,249,255,1298
1983,20,l) Left Censored,23147,30255,541480,563477,1105,3.6,2431,7.9,61710,18955,42755,3.4,11,105703,31942,73761,5.7,18.8,-43993,-7.8,22,0,1322,1336,7122
1983,21,a) 0,5721,5766,35214,17738,5672,196.7,0,0,34952,34952,0,197,197,0,0,0,0,0,34952,197,0,0,,,
1983,21,b) 1,4391,4518,34373,36839,32,0.6,1405,26.8,7227,466,6761,1.3,19.6,12158,7545,4613,20.5,33,-4931,-13.4,39.2,0,1134,1136,6428
1983,21,c) 2,3466,3585,28125,29444,114,2.9,745,19.1,5515,765,4750,2.6,18.7,8153,4372,3781,14.8,27.7,-2638,-9,37.4,0,596,596,3576
1983,21,d) 3,3046,3156,22316,23649,87,2.6,534,15.9,3538,411,3127,1.7,15,6203,2901,3302,12.3,26.2,-2665,-11.2,30,0,422,422,2350
1983,21,e) 4,3000,3137,26729,28075,103,3.1,496,15,3322,465,2857,1.7,11.8,6014,2288,3726,8.1,21.4,-2692,-9.6,23.6,0,376,376,1646
1983,21,f) 5,2807,2925,21871,23297,83,2.7,416,13.5,3308,540,2768,2.3,14.2,6160,2656,3504,11.4,26.4,-2852,-12.2,28.4,0,331,331,2028
1983,21,g) 6 to 10,2988,3495,30563,31575,137,3.8,367,10.2,4550,897,3653,2.8,14.4,6574,2209,4365,7,20.8,-2024,-6.4,28.8,0,233,234,1544
1983,21,l) Left Censored,25776,34591,706566,734682,1110,3.1,2851,8.1,74324,16830,57494,2.3,10.1,130556,30572,99984,4.2,17.8,-56232,-7.7,20.2,0,1525,1532,9181
1983,22,a) 0,8088,8183,45967,23265,8036,196.4,0,0,45404,45404,0,195.2,195.2,0,0,0,0,0,45404,195.2,0,0,,,
1983,22,b) 1,7014,7278,47681,53016,21,0.3,2149,25.6,11511,407,11104,0.8,21.7,22180,11269,10911,21.3,41.8,-10669,-20.1,43.4,0,1729,1730,8862
1983,22,c) 2,5597,5774,50986,56969,150,2.4,1193,19,8722,1074,7648,1.9,15.3,20688,9272,11416,16.3,36.3,-11966,-21,30.6,0,981,981,7863
1983,22,d) 3,4809,4994,44051,49099,157,3,842,15.8,6710,931,5779,1.9,13.7,16805,6208,10597,12.6,34.2,-10095,-20.5,27.4,0,684,684,4901
1983,22,e) 4,4637,4914,44409,48609,147,2.8,722,14,7811,1378,6433,2.8,16.1,16211,7287,8924,15,33.3,-8400,-17.2,32.2,0,549,553,4299
1983,22,f) 5,3782,3872,38284,42407,108,2.7,529,13.1,4390,493,3897,1.2,10.4,12636,3790,8846,8.9,29.8,-8246,-19.4,20.8,0,407,408,3143
1983,22,g) 6 to 10,3734,4492,48732,51291,183,4,498,10.8,8798,2034,6764,4,17.2,13915,5543,8372,10.8,27.1,-5117,-9.9,34.4,0,303,311,3772
1983,22,l) Left Censored,29838,41376,893865,935464,1673,4,3438,8.1,118081,34296,83785,3.7,12.6,201278,47737,153541,5.1,21.5,-83197,-8.9,25.2,0,1778,1785,13404
1983,23,a) 0,2120,2125,9735,4922,2079,195.7,0,0,9627,9627,0,195.6,195.6,0,0,0,0,0,9627,195.6,0,0,,,
1983,23,b) 1,1589,1635,10732,11349,11,0.6,386,21.1,2341,305,2036,2.7,20.6,3575,2037,1538,17.9,31.5,-1234,-10.9,41.2,0,267,267,1496
1983,23,c) 2,1362,1415,10137,11210,47,3.1,265,17.4,1526,171,1355,1.5,13.6,3672,2464,1208,22,32.8,-2146,-19.2,27.2,0,195,195,769
1983,23,d) 3,1272,1313,8929,9088,43,3.1,168,12.2,1610,140,1470,1.5,17.7,1927,770,1157,8.5,21.2,-317,-3.5,35.4,0,132,132,553
1983,23,e) 4,1198,1223,9347,9388,39,3,165,12.9,1644,189,1455,2,17.5,1725,607,1118,6.5,18.4,-81,-0.9,35,0,114,114,455
1983,23,f) 5,1203,1275,8511,8755,44,3.4,147,11.2,1416,138,1278,1.6,16.2,1904,662,1242,7.6,21.7,-488,-5.5,32.4,0,103,103,529
1983,23,g) 6 to 10,1172,1394,14426,14584,55,3.8,171,11.8,2377,563,1814,3.9,16.3,2693,1096,1597,7.5,18.5,-316,-2.2,32.6,0,81,81,406
1983,23,l) Left Censored,9762,12435,247048,247731,367,2.9,992,7.8,27870,6586,21284,2.7,11.3,29236,9314,19922,3.8,11.8,-1366,-0.5,22.6,0,584,587,3319
1983,24,a) 0,7103,7190,38687,19537,7052,196.2,0,0,38300,38300,0,196,196,0,0,0,0,0,38300,196,0,0,,,
1983,24,b) 1,5428,5642,47305,47234,53,0.8,1307,20.7,12376,742,11634,1.6,26.2,12234,6873,5361,14.6,25.9,142,0.3,51.8,0,1007,1009,5100
1983,24,c) 2,4612,4782,40814,42003,180,3.6,763,15.1,7901,912,6989,2.2,18.8,10279,4354,5925,10.4,24.5,-2378,-5.7,37.6,0,600,600,3220
1983,24,d) 3,4077,4193,35995,36097,156,3.6,570,13,7096,1292,5804,3.6,19.7,7300,2785,4515,7.7,20.2,-204,-0.5,39.4,0,435,444,2185
1983,24,e) 4,3736,3905,34875,34878,139,3.4,512,12.6,7204,870,6334,2.5,20.7,7210,3401,3809,9.8,20.7,-6,0,41.4,0,387,387,2827
1983,24,f) 5,3439,3665,31639,31807,145,3.9,388,10.3,6614,1283,5331,4,20.8,6950,1994,4956,6.3,21.9,-336,-1.1,41.6,0,279,282,1500
1983,24,g) 6 to 10,3706,4425,50184,50364,162,3.6,433,9.6,8920,2160,6760,4.3,17.7,9279,2832,6447,5.6,18.4,-359,-0.7,35.4,0,274,275,1461
1983,24,l) Left Censored,31555,43116,1014232,1025517,1657,3.8,3264,7.5,123717,27674,96043,2.7,12.1,146287,43454,102833,4.2,14.3,-22570,-2.2,24.2,0,1671,1683,11954
1983,25,a) 0,9617,9703,58504,29486,9532,196.5,0,0,58036,58036,0,196.8,196.8,0,0,0,0,0,58036,196.8,0,0,,,
1983,25,b) 1,7856,8134,86564,86398,51,0.6,1760,19.5,20198,974,19224,1.1,23.4,19865,9729,10136,11.3,23,333,0.4,46,0,1294,1295,7226
1983,25,c) 2,6535,6712,63779,64730,208,2.9,1074,15,12979,1455,11524,2.2,20.1,14881,7346,7535,11.3,23,-1902,-2.9,40.2,0,804,806,5238
1983,25,d) 3,5979,6124,48958,49387,195,3,857,13.4,9549,1056,8493,2.1,19.3,10406,4649,5757,9.4,21.1,-857,-1.8,38.6,0,645,646,3795
1983,25,e) 4,5554,5842,50092,50716,222,3.7,738,12.2,10068,2044,8024,4,19.9,11315,5195,6120,10.2,22.3,-1247,-2.4,39.8,0,525,526,3921
1983,25,f) 5,5023,5408,55102,55625,148,2.6,629,11.2,10506,2706,7800,4.9,18.9,11551,5631,5920,10.1,20.8,-1045,-1.9,37.8,0,448,453,3069
1983,25,g) 6 to 10,5386,6572,102511,103591,278,4.1,666,9.9,15408,4830,10578,4.7,14.9,17567,6911,10656,6.7,17,-2159,-2.1,29.8,0,386,389,2583
1983,25,l) Left Censored,54990,69822,1871788,1892310,2140,3,4809,6.8,210067,52203,157864,2.8,11.1,251110,59382,191728,3.1,13.3,-41043,-2.2,22.2,0,2791,2808,20671
1983,26,a) 0,12730,12839,67901,34267,12590,196.1,0,0,67269,67269,0,196.3,196.3,0,0,0,0,0,67269,196.3,0,0,,,
1983,26,b) 1,9960,10310,75454,76208,49,0.4,2672,22.9,20200,830,19370,1.1,26.5,21708,12233,9475,16.1,28.5,-1508,-2,53,0,1885,1897,8287
1983,26,c) 2,8782,9126,72827,75505,291,3,1549,15.9,12794,1660,11134,2.2,16.9,18150,8114,10036,10.7,24,-5356,-7.1,33.8,0,1160,1160,5516
1983,26,d) 3,7926,8234,58727,60124,463,5.4,1250,14.6,12087,2685,9402,4.5,20.1,14880,6260,8620,10.4,24.7,-2793,-4.6,40.2,0,911,914,4534
1983,26,e) 4,7633,8034,89922,91632,278,3.3,1136,13.5,10876,1914,8962,2.1,11.9,14295,6147,8148,6.7,15.6,-3419,-3.7,23.8,0,802,802,4464
1983,26,f) 5,7068,7498,56657,58017,282,3.6,1012,13,10647,1882,8765,3.2,18.4,13366,5741,7625,9.9,23,-2719,-4.6,36.8,0,717,717,4092
1983,26,g) 6 to 10,7413,9147,91572,93492,366,3.9,1033,11,13570,3095,10475,3.3,14.5,17410,6662,10748,7.1,18.6,-3840,-4.1,29,0,609,624,3470
1983,26,l) Left Censored,64137,87901,2099564,2140962,2962,3.3,7005,7.8,220937,52894,168043,2.5,10.3,303733,77672,226061,3.6,14.2,-82796,-3.9,20.6,0,3644,3672,25438
1983,27,a) 0,7090,7197,44810,22626,7027,195.3,0,0,44368,44368,0,196.1,196.1,0,0,0,0,0,44368,196.1,0,0,,,
1983,27,b) 1,5595,5863,42636,44184,22,0.3,1326,20.2,8896,358,8538,0.8,20.1,11991,6069,5922,13.7,27.1,-3095,-7,40.2,0,968,969,4549
1983,27,c) 2,4938,5119,42773,45217,145,2.6,881,16.1,7142,1040,6102,2.3,15.8,12029,6401,5628,14.2,26.6,-4887,-10.8,31.6,0,668,668,4615
1983,27,d) 3,4543,4705,33037,33941,138,2.8,714,14.4,6691,861,5830,2.5,19.7,8499,4059,4440,12,25,-1808,-5.3,39.4,0,512,512,3008
1983,27,e) 4,4413,4657,35753,36486,117,2.4,618,12.7,6379,683,5696,1.9,17.5,7844,3400,4444,9.3,21.5,-1465,-4,35,0,459,459,2718
1983,27,f) 5,4070,4368,35978,37163,142,3.1,534,11.8,5178,1007,4171,2.7,13.9,7547,2656,4891,7.1,20.3,-2369,-6.4,27.8,0,393,395,2019
1983,27,g) 6 to 10,4341,5236,58882,59329,177,3.3,483,9,9595,1706,7889,2.9,16.2,10488,3448,7040,5.8,17.7,-893,-1.5,32.4,0,266,270,1541
1983,27,l) Left Censored,35607,47006,1108752,1136948,1547,3.2,3503,7.3,125556,31672,93884,2.8,11,181949,45926,136023,4,16,-56393,-5,22,0,1841,1853,12893
1983,28,a) 0,3935,3963,19598,9902,3858,194.7,0,0,19392,19392,0,195.8,195.8,0,0,0,0,0,19392,195.8,0,0,,,
1983,28,b) 1,3014,3089,17355,18987,13,0.4,957,26.7,3686,167,3519,0.9,19.4,6949,3674,3275,19.4,36.6,-3263,-17.2,38.8,0,781,781,2883
1983,28,c) 2,2515,2593,19571,20824,81,2.9,544,19.3,3443,694,2749,3.3,16.5,5948,3002,2946,14.4,28.6,-2505,-12.1,33,0,451,451,2278
1983,28,d) 3,2396,2469,17611,18495,74,2.8,445,17,3112,355,2757,1.9,16.8,4880,1831,3049,9.9,26.4,-1768,-9.6,33.6,0,349,349,1456
1983,28,e) 4,2305,2427,18552,19253,76,3,345,13.6,3487,402,3085,2.1,18.1,4888,1667,3221,8.7,25.4,-1401,-7.3,36.2,0,274,274,1462
1983,28,f) 5,1967,2064,15310,16008,67,3.2,236,11.1,2099,308,1791,1.9,13.1,3494,1238,2256,7.7,21.8,-1395,-8.7,26.2,0,171,171,870
1983,28,g) 6 to 10,2203,2642,22625,23441,83,3,324,11.9,3393,660,2733,2.8,14.5,5025,1847,3178,7.9,21.4,-1632,-6.9,29,0,209,222,1249
1983,28,l) Left Censored,17244,23235,442140,446951,880,3.7,1880,7.9,55045,17047,37998,3.8,12.3,64667,17164,47503,3.8,14.5,-9622,-2.2,24.6,0,1034,1038,6364
1983,29,a) 0,8837,8919,46822,23594,8725,195.6,0,0,46457,46457,0,196.9,196.9,0,0,0,0,0,46457,196.9,0,0,,,
1983,29,b) 1,6581,6814,46633,48961,36,0.5,1879,24.1,10737,323,10414,0.7,21.9,15392,9024,6368,18.4,31.4,-4655,-9.5,43.8,0,1479,1482,6842
1983,29,c) 2,5825,6103,48434,50012,191,2.9,1149,17.5,9463,1589,7874,3.2,18.9,12619,6279,6340,12.6,25.2,-3156,-6.3,37.8,0,900,901,4591
1983,29,d) 3,5038,5240,40507,39524,166,3,833,15.1,10789,1050,9739,2.7,27.3,8822,4156,4666,10.5,22.3,1967,5,44.6,0,649,651,3430
1983,29,e) 4,4943,5181,38135,39940,160,3,725,13.4,6845,1050,5795,2.6,17.1,10454,4865,5589,12.2,26.2,-3609,-9.1,34.2,0,533,533,3386
1983,29,f) 5,4446,4653,34919,53759,185,3.8,578,12,5609,974,4635,1.8,10.4,43289,2732,40557,5.1,80.5,-37680,-70.1,20.8,0,438,438,1870
1983,29,g) 6 to 10,4745,5643,55525,57328,232,4,614,10.6,9126,2318,6808,4,15.9,12731,3968,8763,6.9,22.2,-3605,-6.3,31.8,0,381,382,2387
1983,29,l) Left Censored,40985,55271,1279172,1302448,2099,3.7,4627,8.2,159249,47378,111871,3.6,12.2,205801,63002,142799,4.8,15.8,-46552,-3.6,24.4,0,2311,2346,15340
1983,30,a) 0,2165,2214,12892,6505,2154,194.6,0,0,12775,12775,0,196.4,196.4,0,0,0,0,0,12775,196.4,0,0,,,
1983,30,b) 1,1649,1687,9302,10217,3,0.2,506,25.9,1826,17,1809,0.2,17.9,3656,2106,1550,20.6,35.8,-1830,-17.9,35.8,0,380,383,1591
1983,30,c) 2,1401,1433,9093,9926,52,3.3,296,19,1833,208,1625,2.1,18.5,3498,2121,1377,21.4,35.2,-1665,-16.7,37,0,236,236,1925
1983,30,d) 3,1312,1343,8963,9778,48,3.3,244,17,1500,379,1121,3.9,15.3,3129,1210,1919,12.4,32,-1629,-16.7,30.6,0,177,177,1020
1983,30,e) 4,1342,1410,9161,9390,54,3.7,187,12.8,1825,294,1531,3.1,19.4,2283,1027,1256,10.9,24.3,-458,-4.9,38.8,0,127,127,747
1983,30,f) 5,1102,1131,7254,7528,49,4.2,146,12.5,1126,180,946,2.4,15,1674,646,1028,8.6,22.2,-548,-7.2,30,0,96,96,417
1983,30,g) 6 to 10,1141,1311,9815,10181,53,4,140,10.5,1406,249,1157,2.4,13.8,2137,724,1413,7.1,21,-731,-7.2,27.6,0,82,83,374
1983,30,l) Left Censored,7630,9778,129717,133056,327,3.3,797,8,15769,3276,12493,2.5,11.9,22447,5387,17060,4,16.9,-6678,-5,23.8,0,419,430,2661
1983,31,a) 0,3090,3151,23601,11877,3067,194.7,0,0,23448,23448,0,197.4,197.4,0,0,0,0,0,23448,197.4,0,0,,,
1983,31,b) 1,2480,2566,16758,17381,14,0.5,620,21.5,4036,851,3185,4.9,23.2,5281,3171,2110,18.2,30.4,-1245,-7.2,46.4,0,445,445,2354
1983,31,c) 2,2157,2234,13948,14638,79,3.3,415,17.4,2574,451,2123,3.1,17.6,3953,2105,1848,14.4,27,-1379,-9.4,35.2,0,320,320,1687
1983,31,d) 3,1981,2021,12647,13092,52,2.4,302,14.2,2119,160,1959,1.2,16.2,3008,1304,1704,10,23,-889,-6.8,32.4,0,235,235,1057
1983,31,e) 4,1883,1969,13116,13390,52,2.5,257,12.5,2018,312,1706,2.3,15.1,2566,1158,1408,8.6,19.2,-548,-4.1,30.2,0,187,187,918
1983,31,f) 5,1777,1847,13172,14189,56,3,204,10.8,1464,186,1278,1.3,10.3,3498,1622,1876,11.4,24.7,-2034,-14.4,20.6,0,145,145,1483
1983,31,g) 6 to 10,1924,2227,17133,17707,74,3.2,242,10.6,2704,521,2183,2.9,15.3,3852,1656,2196,9.4,21.8,-1148,-6.5,30.6,0,147,152,871
1983,31,l) Left Censored,16226,20664,357549,368327,538,2.6,1540,7.3,37315,6784,30531,1.8,10.1,58871,15221,43650,4.1,16,-21556,-5.9,20.2,0,823,828,4916
1983,32,a) 0,2211,2239,13754,6956,2193,195.9,0,0,13596,13596,0,195.5,195.5,0,0,0,0,0,13596,195.5,0,0,,,
1983,32,b) 1,1790,1839,18302,19878,15,0.7,714,32.4,3819,200,3619,1,19.2,6971,3547,3424,17.8,35.1,-3152,-15.9,38.4,0,538,542,2908
1983,32,c) 2,1550,1605,13578,14605,55,3.1,379,21.4,2781,253,2528,1.7,19,4834,2645,2189,18.1,33.1,-2053,-14.1,38,0,302,302,1821
1983,32,d) 3,1339,1382,14455,15089,58,3.9,294,19.6,2831,477,2354,3.2,18.8,4098,1548,2550,10.3,27.2,-1267,-8.4,37.6,0,223,223,1319
1983,32,e) 4,1364,1430,13362,14607,44,2.9,219,14.5,1707,245,1462,1.7,11.7,4197,2124,2073,14.5,28.7,-2490,-17,23.4,0,158,158,1362
1983,32,f) 5,1003,1066,9994,10794,42,3.8,160,14.3,1451,266,1185,2.5,13.4,3050,847,2203,7.8,28.3,-1599,-14.9,26.8,0,128,128,713
1983,32,g) 6 to 10,954,1147,14647,15352,50,4.2,159,13.3,2650,817,1833,5.3,17.3,4060,1196,2864,7.8,26.4,-1410,-9.1,34.6,0,98,98,531
1983,32,l) Left Censored,5954,8182,228369,235087,377,4.5,755,9,28423,10109,18314,4.3,12.1,41858,9943,31915,4.2,17.8,-13435,-5.7,24.2,0,338,339,2750
1983,33,a) 0,2192,2204,12034,6066,2151,195.2,0,0,11937,11937,0,196.8,196.8,0,0,0,0,0,11937,196.8,0,0,,,
1983,33,b) 1,1672,1700,11882,11479,11,0.6,381,20,4051,374,3677,3.3,35.3,3245,2155,1090,18.8,28.3,806,7,56.6,0,281,281,1416
1983,33,c) 2,1384,1417,12171,12401,45,3,263,17.3,2378,300,2078,2.4,19.2,2838,1594,1244,12.9,22.9,-460,-3.7,38.4,0,209,209,1380
1983,33,d) 3,1198,1226,8870,8914,46,3.6,174,13.6,2065,368,1697,4.1,23.2,2153,867,1286,9.7,24.2,-88,-1,46.4,0,131,131,644
1983,33,e) 4,1208,1243,10121,10218,34,2.6,151,11.7,1655,135,1520,1.3,16.2,1848,843,1005,8.3,18.1,-193,-1.9,32.4,0,123,123,695
1983,33,f) 5,1101,1166,8672,8953,35,2.9,147,12.1,1333,161,1172,1.8,14.9,1894,703,1191,7.9,21.2,-561,-6.3,29.8,0,117,117,563
1983,33,g) 6 to 10,1146,1355,14936,15062,57,4.1,153,11,2482,746,1736,5,16.5,2733,1061,1672,7,18.1,-251,-1.6,33,0,83,83,539
1983,33,l) Left Censored,8812,10853,256871,259279,382,3.5,780,7.1,30865,6517,24348,2.5,11.9,35681,8949,26732,3.5,13.8,-4816,-1.9,23.8,0,453,455,3431
1983,34,a) 0,13929,14008,69439,35039,13724,195.9,0,0,68801,68801,0,196.4,196.4,0,0,0,0,0,68801,196.4,0,0,,,
1983,34,b) 1,11184,11443,83778,82364,58,0.5,2749,21.4,22724,1260,21464,1.5,27.6,19896,11241,8655,13.6,24.2,2828,3.4,48.4,0,1961,1962,8452
1983,34,c) 2,9381,9617,82527,84686,340,3.3,1596,15.6,18748,1909,16839,2.3,22.1,23065,9875,13190,11.7,27.2,-4317,-5.1,44.2,0,1201,1201,6730
1983,34,d) 3,8678,8866,66939,67571,302,3.3,1254,13.5,13170,1716,11454,2.5,19.5,14433,6258,8175,9.3,21.4,-1263,-1.9,39,0,953,953,4411
1983,34,e) 4,8055,8259,62537,62861,260,3,1004,11.7,12171,1894,10277,3,19.4,12819,5009,7810,8,20.4,-648,-1,38.8,0,714,718,3859
1983,34,f) 5,7058,7320,56226,56946,227,3,949,12.5,10100,1751,8349,3.1,17.7,11539,5078,6461,8.9,20.3,-1439,-2.6,35.4,0,667,673,3548
1983,34,g) 6 to 10,7690,8541,83042,85150,304,3.5,920,10.5,13215,2259,10956,2.7,15.5,17430,5290,12140,6.2,20.5,-4215,-5,31,0,604,605,2895
1983,34,l) Left Censored,69797,87086,2104522,2118683,2936,3.3,6693,7.5,287598,78127,209471,3.7,13.6,315919,104021,211898,4.9,14.9,-28321,-1.3,27.2,0,3799,3813,25485
1983,35,a) 0,3214,3274,21095,10613,3212,196.2,0,0,20964,20964,0,197.5,197.5,0,0,0,0,0,20964,197.5,0,0,,,
1983,35,b) 1,2263,2320,17809,18910,20,0.7,830,30.1,4908,683,4225,3.6,26,7109,4155,2954,22,37.6,-2201,-11.6,52,0,607,608,3180
1983,35,c) 2,2078,2148,15445,16590,61,2.6,400,17.3,3036,328,2708,2,18.3,5326,2559,2767,15.4,32.1,-2290,-13.8,36.6,0,301,301,1838
1983,35,d) 3,1855,1916,14787,15646,69,3.4,332,16.3,3072,417,2655,2.7,19.6,4789,1945,2844,12.4,30.6,-1717,-11,39.2,0,250,250,1465
1983,35,e) 4,1750,1861,15130,15468,81,4.2,247,12.8,3011,694,2317,4.5,19.5,3687,1334,2353,8.6,23.8,-676,-4.3,39,0,180,180,1035
1983,35,f) 5,1422,1474,11477,12065,51,3.3,205,13.4,2028,289,1739,2.4,16.8,3203,1210,1993,10,26.5,-1175,-9.7,33.6,0,152,152,1031
1983,35,g) 6 to 10,1438,1700,14297,14829,71,4.1,197,11.3,2559,501,2058,3.4,17.3,3623,1633,1990,11,24.4,-1064,-7.1,34.6,0,125,126,1056
1983,35,l) Left Censored,9515,12895,223335,229934,511,3.9,1118,8.5,29137,7569,21568,3.3,12.7,42335,11936,30399,5.2,18.4,-13198,-5.7,25.4,0,556,557,3758
1983,36,a) 0,33273,33478,171913,86753,32837,196.2,0,0,170321,170321,0,196.3,196.3,0,0,0,0,0,170321,196.3,0,0,,,
1983,36,b) 1,25824,26371,185158,190696,66,0.2,6470,21.8,45016,1042,43974,0.5,23.6,56092,31207,24885,16.4,29.4,-11076,-5.8,47.2,0,4920,4923,23970
1983,36,c) 2,21904,22401,192845,194753,688,2.9,3803,15.9,43588,4050,39538,2.1,22.4,47403,23331,24072,12,24.3,-3815,-1.9,44.8,0,2938,2938,15824
1983,36,d) 3,19376,19751,161456,164457,635,3.1,3014,14.5,30388,3198,27190,1.9,18.5,36389,14930,21459,9.1,22.1,-6001,-3.6,37,0,2336,2343,12295
1983,36,e) 4,17887,18443,135162,136664,558,2.9,2503,13,28802,2890,25912,2.1,21.1,31806,14324,17482,10.5,23.3,-3004,-2.2,42.2,0,1961,1961,11674
1983,36,f) 5,16666,17363,138922,147350,443,2.5,2113,11.7,21602,2560,19042,1.7,14.7,38457,10431,28026,7.1,26.1,-16855,-11.4,29.4,0,1613,1619,8246
1983,36,g) 6 to 10,17146,19800,218063,222859,660,3.2,2117,10.4,33470,5677,27793,2.5,15,43061,12785,30276,5.7,19.3,-9591,-4.3,30,0,1461,1462,7244
1983,36,l) Left Censored,166778,204632,4759864,4824709,5592,2.7,16311,7.8,588604,128432,460172,2.7,12.2,718293,199119,519174,4.1,14.9,-129689,-2.7,24.4,0,10266,10327,65377
1983,37,a) 0,9517,9630,52653,26335,9622,199.8,0,0,52637,52637,0,199.9,199.9,0,0,0,0,0,52637,199.9,0,0,,,
1983,37,b) 1,7255,7492,51841,55479,38,0.4,2944,32.5,12516,705,11811,1.3,22.6,19791,13022,6769,23.5,35.7,-7275,-13.1,45.2,0,1994,1994,8738
1983,37,c) 2,5917,6125,54573,66968,134,1.9,1681,24.1,9632,1527,8105,2.3,14.4,34421,10405,24016,15.5,51.4,-24789,-37,28.8,0,1081,1081,5749
1983,37,d) 3,5171,5377,39858,42482,151,2.5,1333,22.1,7409,1114,6295,2.6,17.4,12656,7349,5307,17.3,29.8,-5247,-12.4,34.8,0,756,756,3942
1983,37,e) 4,5036,5309,42963,44510,127,2.2,1094,18.7,7975,1009,6966,2.3,17.9,11069,6063,5006,13.6,24.9,-3094,-7,35.8,0,634,634,3742
1983,37,f) 5,4892,5150,42903,43389,129,2.3,860,15.5,7621,931,6690,2.1,17.6,8592,4067,4525,9.4,19.8,-971,-2.2,35.2,0,478,478,2386
1983,37,g) 6 to 10,4842,5947,59481,60226,227,3.6,890,14.1,9842,2422,7420,4,16.3,11332,4702,6630,7.8,18.8,-1490,-2.5,32.6,0,459,462,2455
1983,37,l) Left Censored,42322,61221,1598469,1611931,1985,3.1,5934,9.4,184792,56546,128246,3.5,11.5,211715,64602,147113,4,13.1,-26923,-1.6,23,0,2646,2686,17569
1983,38,a) 0,1423,1440,8248,4160,1401,194.6,0,0,8176,,,,196.5,0,0,0,0,0,8176,196.5,0,1,,,
1983,38,b) 1,1154,1173,6600,7239,1,0.1,330,24.4,1341,,,,18.5,2619,1347,1272,18.6,36.2,-1278,-17.7,37,1,248,248,992
1983,38,c) 2,1003,1037,7522,8178,38,3.4,210,18.8,1070,200,870,2.4,13.1,2381,996,1385,12.2,29.1,-1311,-16,26.2,0,163,163,862
1983,38,d) 3,932,953,6080,6475,31,3.1,149,14.8,977,194,783,3,15.1,1767,764,1003,11.8,27.3,-790,-12.2,30.2,0,111,111,553
1983,38,e) 4,885,924,6246,6523,39,4.1,131,13.7,983,169,814,2.6,15.1,1536,675,861,10.3,23.5,-553,-8.4,30.2,0,105,105,611
1983,38,f) 5,770,791,4621,5005,25,3,116,14,638,105,533,2.1,12.7,1406,612,794,12.2,28.1,-768,-15.4,25.4,0,91,91,535
1983,38,g) 6 to 10,835,932,6715,6975,24,2.5,99,10.4,968,145,823,2.1,13.9,1487,474,1013,6.8,21.3,-519,-7.4,27.8,0,59,59,252
1983,38,l) Left Censored,6881,8762,123406,126462,260,2.9,664,7.5,12961,2484,10477,2,10.2,19073,6277,12796,5,15.1,-6112,-4.9,20.4,0,349,352,2546
1983,39,a) 0,14065,14269,75450,38128,13942,195.4,0,0,74645,74645,0,195.8,195.8,0,0,0,0,0,74645,195.8,0,0,,,
1983,39,b) 1,11565,12026,81924,92760,54,0.4,3034,22.3,17300,452,16848,0.5,18.7,38971,13914,25057,15,42,-21671,-23.3,37.4,0,2232,2237,10393
1983,39,c) 2,10011,10425,91523,95265,367,3.3,1896,17,14796,2304,12492,2.4,15.5,22279,10901,11378,11.4,23.4,-7483,-7.9,31,0,1458,1458,7716
1983,39,d) 3,9014,9483,68261,70888,303,3,1469,14.7,12825,1659,11166,2.3,18.1,18079,7736,10343,10.9,25.5,-5254,-7.4,36.2,0,1039,1047,5909
1983,39,e) 4,8716,9149,74315,74615,286,3,1255,13.1,15361,5230,10131,7,20.6,15961,7563,8398,10.1,21.4,-600,-0.8,41.2,0,930,932,6045
1983,39,f) 5,7957,8538,67821,69666,300,3.4,1103,12.5,11827,1507,10320,2.2,17,15517,6156,9361,8.8,22.3,-3690,-5.3,34,0,781,781,4924
1983,39,g) 6 to 10,8771,10995,108773,112241,337,3,1138,10,17688,2655,15033,2.4,15.8,24623,8496,16127,7.6,21.9,-6935,-6.1,31.6,0,631,637,3103
1983,39,l) Left Censored,83220,118728,2809488,2873973,3994,3.3,9436,7.8,300231,78710,221521,2.7,10.4,429200,98352,330848,3.4,14.9,-128969,-4.5,20.8,0,4635,4696,29865
1983,40,a) 0,7407,7486,39412,19891,7375,197,0,0,39043,39043,0,196.3,196.3,0,0,0,0,0,39043,196.3,0,0,,,
1983,40,b) 1,6366,6564,45723,52935,30,0.4,2535,32.2,9719,398,9321,0.8,18.4,24143,12887,11256,24.3,45.6,-14424,-27.2,36.8,0,2140,2140,11187
1983,40,c) 2,4977,5145,40039,47474,141,2.5,1212,21.3,6339,782,5557,1.6,13.4,21208,9145,12063,19.3,44.7,-14869,-31.3,26.8,0,997,997,7618
1983,40,d) 3,4248,4398,35642,38617,122,2.6,836,17.7,6873,749,6124,1.9,17.8,12823,5145,7678,13.3,33.2,-5950,-15.4,35.6,0,674,674,4063
1983,40,e) 4,3811,4018,31491,34962,123,2.9,690,16.1,5076,819,4257,2.3,14.5,12017,5335,6682,15.3,34.4,-6941,-19.9,29,0,499,508,3475
1983,40,f) 5,3248,3336,26704,29282,94,2.7,457,13.1,3719,388,3331,1.3,12.7,8875,2858,6017,9.8,30.3,-5156,-17.6,25.4,0,355,355,2393
1983,40,g) 6 to 10,3116,3760,37100,40239,146,3.8,415,10.7,5329,1291,4038,3.2,13.2,11607,3983,7624,9.9,28.8,-6278,-15.6,26.4,0,268,274,2220
1983,40,l) Left Censored,23623,32157,654366,675383,1223,3.7,2639,8,91673,29775,61898,4.4,13.6,133706,27926,105780,4.1,19.8,-42033,-6.2,27.2,0,1449,1456,10064
1983,41,a) 0,5991,6116,35672,17975,5984,195.7,0,0,35394,35394,0,196.9,196.9,0,0,0,0,0,35394,196.9,0,0,,,
1983,41,b) 1,4719,4865,31680,33636,22,0.4,1635,28.6,7580,292,7288,0.9,22.5,11492,6621,4871,19.7,34.2,-3912,-11.7,45,0,1189,1203,5037
1983,41,c) 2,4257,4403,30890,32366,122,2.5,1014,21,6367,951,5416,2.9,19.7,9319,4724,4595,14.6,28.8,-2952,-9.1,39.4,0,779,779,3803
1983,41,d) 3,3909,4058,25723,39448,190,4.4,735,17.1,4709,785,3924,2,11.9,32158,4097,28061,10.4,81.5,-27449,-69.6,23.8,0,533,533,3476
1983,41,e) 4,3394,3526,24463,25517,149,4,656,17.4,4393,537,3856,2.1,17.2,6501,3055,3446,12,25.5,-2108,-8.3,34.4,0,497,497,2458
1983,41,f) 5,3088,3250,21868,22881,140,4.1,540,15.8,3773,527,3246,2.3,16.5,5798,2177,3621,9.5,25.3,-2025,-8.8,33,0,375,375,1641
1983,41,g) 6 to 10,3114,3693,37785,39209,195,5.1,540,14.1,7049,1868,5181,4.8,18,9897,3301,6596,8.4,25.2,-2848,-7.2,36,0,318,319,1914
1983,41,l) Left Censored,21601,29260,533862,545727,1231,4.1,2583,8.7,63692,13489,50203,2.5,11.7,87422,23517,63905,4.3,16,-23730,-4.3,23.4,0,1277,1291,8132
1983,42,a) 0,15945,16108,92734,46786,15769,195.8,0,0,91896,91896,0,196.4,196.4,0,0,0,0,0,91896,196.4,0,0,,,
1983,42,b) 1,12770,13215,106840,108679,85,0.6,2939,19.9,25266,1785,23481,1.6,23.2,28943,15258,13685,14,26.6,-3677,-3.4,46.4,0,2179,2183,10283
1983,42,c) 2,10809,11190,99283,102936,298,2.5,1736,14.6,16418,1858,14560,1.8,15.9,23723,10321,13402,10,23,-7305,-7.1,31.8,0,1294,1295,7660
1983,42,d) 3,10125,10441,76729,79096,269,2.5,1419,13,13075,1194,11881,1.5,16.5,17808,7311,10497,9.2,22.5,-4733,-6,33,0,1102,1102,5815
1983,42,e) 4,9705,10226,77980,80526,326,3.1,1352,12.7,13593,1823,11770,2.3,16.9,18685,6388,12297,7.9,23.2,-5092,-6.3,33.8,0,957,957,4654
1983,42,f) 5,8989,9608,78626,79383,282,2.8,1092,11,13644,2633,11011,3.3,17.2,15157,5931,9226,7.5,19.1,-1513,-1.9,34.4,0,765,765,3711
1983,42,g) 6 to 10,9839,11839,128050,131311,433,3.6,1228,10.1,19036,4894,14142,3.7,14.5,25557,8973,16584,6.8,19.5,-6521,-5,29,0,677,684,4126
1983,42,l) Left Censored,97010,130771,3119085,3229082,4223,3.2,10260,7.7,341806,92828,248978,2.9,10.6,561801,136563,425238,4.2,17.4,-219995,-6.8,21.2,0,5370,5420,37575
1983,44,a) 0,1660,1672,7986,4030,1636,195.7,0,0,7913,,,,196.4,0,0,0,0,0,7913,196.4,0,1,,,
1983,44,b) 1,1289,1314,8994,8804,1,0.1,304,20.6,2638,,,,30,2258,1045,1213,11.9,25.6,380,4.4,51.2,1,232,232,795
1983,44,c) 2,1118,1134,8881,9222,33,2.7,179,14.8,1779,143,1636,1.6,19.3,2461,1440,1021,15.6,26.7,-682,-7.4,38.6,0,135,135,963
1983,44,d) 3,1023,1051,7330,7461,37,3.3,156,14.1,1317,149,1168,2,17.7,1578,771,807,10.3,21.1,-261,-3.4,35.4,0,122,122,571
1983,44,e) 4,1020,1049,7878,7969,33,3,128,11.7,1219,214,1005,2.7,15.3,1400,563,837,7.1,17.6,-181,-2.3,30.6,0,97,97,469
1983,44,f) 5,892,927,7745,7872,37,3.8,132,13.6,1362,113,1249,1.4,17.3,1616,649,967,8.2,20.5,-254,-3.2,34.6,0,96,96,478
1983,44,g) 6 to 10,1053,1151,12250,12084,33,2.8,114,9.6,2434,186,2248,1.5,20.1,2102,705,1397,5.8,17.4,332,2.7,34.8,0,63,65,265
1983,44,l) Left Censored,10240,12072,270880,273084,311,2.5,904,7.3,27831,5288,22543,1.9,10.2,32238,8693,23545,3.2,11.8,-4407,-1.6,20.4,0,549,549,3244
1983,45,a) 0,4731,4800,25565,12786,4795,199.8,0,0,25558,25558,0,199.9,199.9,0,0,0,0,0,25558,199.9,0,0,,,
1983,45,b) 1,3825,3937,29481,31512,27,0.6,1447,30.7,7590,705,6885,2.2,24.1,11652,6716,4936,21.3,37,-4062,-12.9,48.2,0,1000,1001,4218
1983,45,c) 2,3079,3211,26545,28071,87,2.4,823,22.8,4983,471,4512,1.7,17.8,8034,4525,3509,16.1,28.6,-3051,-10.8,35.6,0,549,549,2915
1983,45,d) 3,2672,2817,21370,22659,75,2.4,669,21.3,3733,308,3425,1.4,16.5,6310,3288,3022,14.5,27.8,-2577,-11.3,33,0,392,392,1910
1983,45,e) 4,2452,2606,19614,20528,84,2.9,535,18.7,4001,933,3068,4.5,19.5,5828,3051,2777,14.9,28.4,-1827,-8.9,39,0,308,308,1711
1983,45,f) 5,2430,2620,21396,22407,82,2.9,463,16.4,3467,598,2869,2.7,15.5,5489,2324,3165,10.4,24.5,-2022,-9,31,0,289,289,1404
1983,45,g) 6 to 10,2394,2888,23557,24764,111,3.6,440,14.3,4115,760,3355,3.1,16.6,6529,3320,3209,13.4,26.4,-2414,-9.8,33.2,0,260,268,1984
1983,45,l) Left Censored,20644,29325,728912,743580,1033,3.4,2880,9.5,80994,23960,57034,3.2,10.9,110329,29238,81091,3.9,14.8,-29335,-3.9,21.8,0,1446,1451,10028
1983,46,a) 0,1370,1385,6990,3519,1350,194.9,0,0,6942,,,,197.3,0,0,0,0,0,6942,197.3,0,1,,,
1983,46,b) 1,1018,1051,6755,7298,5,0.4,286,23.9,1082,,,,14.8,2167,1208,959,16.6,29.7,-1085,-14.9,29.6,1,209,209,921
1983,46,c) 2,899,921,6655,6739,25,2.5,186,18.7,1263,133,1130,2,18.7,1431,744,687,11,21.2,-168,-2.5,37.4,0,144,144,596
1983,46,d) 3,909,931,5292,5579,26,2.7,153,15.7,790,107,683,1.9,14.2,1364,718,646,12.9,24.4,-574,-10.2,28.4,0,111,111,531
1983,46,e) 4,828,859,5871,6141,25,2.8,144,15.9,885,123,762,2,14.4,1425,797,628,13,23.2,-540,-8.8,28.8,0,103,103,633
1983,46,f) 5,833,870,5367,5339,39,4.4,106,11.9,1085,251,834,4.7,20.3,1029,487,542,9.1,19.3,56,1,38.6,0,79,79,388
1983,46,g) 6 to 10,833,963,6558,6655,32,3.2,107,10.8,1142,250,892,3.8,17.2,1335,544,791,8.2,20.1,-193,-2.9,34.4,0,62,62,358
1983,46,l) Left Censored,7334,8985,122315,125087,229,2.5,707,7.7,12292,2911,9381,2.3,9.8,17836,4576,13260,3.7,14.3,-5544,-4.5,19.6,0,370,374,1883
1983,47,a) 0,7996,8053,45135,22730,7902,196.2,0,0,44810,44810,0,197.1,197.1,0,0,0,0,0,44810,197.1,0,0,,,
1983,47,b) 1,5882,6110,49018,51639,44,0.6,2033,28.4,11492,703,10789,1.4,22.3,16733,10455,6278,20.2,32.4,-5241,-10.1,44.6,0,1670,1673,8754
1983,47,c) 2,4695,4880,40243,42393,146,2.7,1061,19.9,7423,702,6721,1.7,17.5,11723,5438,6285,12.8,27.7,-4300,-10.2,35,0,859,859,4450
1983,47,d) 3,4364,4520,33681,35215,161,3.4,770,16.1,5630,831,4799,2.4,16,8697,3933,4764,11.2,24.7,-3067,-8.7,32,0,617,621,3416
1983,47,e) 4,4061,4273,40381,39552,127,2.8,692,15.3,10157,735,9422,1.9,25.7,8498,3785,4713,9.6,21.5,1659,4.2,43,0,497,497,2840
1983,47,f) 5,3820,4077,33622,33699,131,3.1,500,11.9,6751,919,5832,2.7,20,6904,2381,4523,7.1,20.5,-153,-0.5,40,0,374,376,1840
1983,47,g) 6 to 10,4066,4931,51839,53320,200,3.9,595,11.7,8813,1834,6979,3.4,16.5,11774,4434,7340,8.3,22.1,-2961,-5.6,33,0,358,366,2698
1983,47,l) Left Censored,33098,46107,1108106,1111986,1954,4.2,3837,8.2,150294,47951,102343,4.3,13.5,158053,38729,119324,3.5,14.2,-7759,-0.7,27,0,1959,1973,12891
1983,48,a) 0,36417,36802,218497,110210,36173,196.6,0,0,216575,216575,0,196.5,196.5,0,0,0,0,0,216575,196.5,0,0,,,
1983,48,b) 1,29511,30745,225371,247644,158,0.4,10089,28.1,59689,1985,57704,0.8,24.1,104235,56020,48215,22.6,42.1,-44546,-18,48.2,0,8054,8061,44923
1983,48,c) 2,34333,35767,304206,336354,1098,2.8,7236,18.6,60741,9060,51681,2.7,18.1,125038,50430,74608,15,37.2,-64297,-19.1,36.2,0,5882,5884,40989
1983,48,d) 3,10584,11329,99195,104360,405,3.4,1871,15.6,20679,3334,17345,3.2,19.8,31009,12764,18245,12.2,29.7,-10330,-9.9,39.6,0,1434,1441,9695
1983,48,e) 4,18352,19954,192175,202639,676,3.2,2905,13.9,37195,5512,31683,2.7,18.4,58123,20608,37515,10.2,28.7,-20928,-10.3,36.8,0,2181,2183,15624
1983,48,f) 5,14935,15814,144269,154579,603,3.7,2132,13,24569,4294,20275,2.8,15.9,45189,14544,30645,9.4,29.2,-20620,-13.3,31.8,0,1643,1650,11053
1983,48,g) 6 to 10,14292,17934,201374,212018,828,4.5,2217,12,38561,9562,28999,4.5,18.2,59849,18313,41536,8.6,28.2,-21288,-10,36.4,0,1332,1353,9633
1983,48,l) Left Censored,98291,154121,3755728,3867774,8442,5.4,13695,8.8,565990,193242,372748,5,14.6,790083,187855,602228,4.9,20.4,-224093,-5.8,29.2,0,6457,6653,52289
1983,49,a) 0,2833,2894,21912,11080,2806,193.9,0,0,21665,21665,0,195.5,195.5,0,0,0,0,0,21665,195.5,0,0,,,
1983,49,b) 1,2356,2451,18051,18929,24,0.8,814,28.5,5447,590,4857,3.1,28.8,7203,4482,2721,23.7,38.1,-1756,-9.3,57.6,0,609,609,3079
1983,49,c) 2,1936,2038,17271,18607,62,2.8,478,21.3,3651,500,3151,2.7,19.6,6322,3344,2978,18,34,-2671,-14.4,39.2,0,366,366,2529
1983,49,d) 3,1665,1758,12362,13423,56,3,342,18.1,2483,308,2175,2.3,18.5,4604,2394,2210,17.8,34.3,-2121,-15.8,37,0,242,242,1603
1983,49,e) 4,1654,1779,14006,15006,58,3.1,286,15.2,2519,227,2292,1.5,16.8,4518,1745,2773,11.6,30.1,-1999,-13.3,33.6,0,193,194,1286
1983,49,f) 5,1445,1504,13124,13442,60,3.8,208,13.3,2848,300,2548,2.2,21.2,3484,1511,1973,11.2,25.9,-636,-4.7,42.4,0,153,154,988
1983,49,g) 6 to 10,1417,1655,16496,16794,62,3.6,208,12.1,2637,356,2281,2.1,15.7,3232,1101,2131,6.6,19.2,-595,-3.5,31.4,0,113,113,631
1983,49,l) Left Censored,10157,14024,304840,312766,612,4.3,1167,8.2,36158,10304,25854,3.3,11.6,52009,11017,40992,3.5,16.6,-15851,-5,23.2,0,560,566,3945
1983,50,a) 0,1322,1327,5802,2922,1297,195.5,0,0,5761,,,,197.2,0,0,0,0,0,5761,197.2,0,1,,,
1983,50,b) 1,1083,1104,6265,6452,4,0.3,260,21,1602,,,,24.8,1975,902,1073,14,30.6,-373,-5.8,49.6,1,200,200,622
1983,50,c) 2,896,909,5711,6001,27,2.8,155,15.9,948,202,746,3.4,15.8,1527,749,778,12.5,25.4,-579,-9.6,31.6,0,113,113,409
1983,50,d) 3,759,773,4869,4903,19,2.3,135,16.4,919,78,841,1.6,18.7,986,490,496,10,20.1,-67,-1.4,37.4,0,101,101,387
1983,50,e) 4,706,721,4813,5191,18,2.3,113,14.7,708,123,585,2.4,13.6,1463,516,947,9.9,28.2,-755,-14.6,27.2,0,82,82,370
1983,50,f) 5,736,757,5341,5436,19,2.4,104,13.1,730,97,633,1.8,13.4,919,363,556,6.7,16.9,-189,-3.5,26.8,0,72,72,252
1983,50,g) 6 to 10,745,872,8400,8492,33,3.7,72,8.1,1447,200,1247,2.4,17,1631,428,1203,5,19.2,-184,-2.2,34,0,47,48,328
1983,50,l) Left Censored,5444,6565,120819,123015,173,2.6,487,7.3,10633,2410,8223,2,8.6,15024,2823,12201,2.3,12.2,-4391,-3.6,17.2,0,288,289,1482
1983,51,a) 0,9088,9161,46282,23303,9003,196.6,0,0,45959,45959,0,197.2,197.2,0,0,0,0,0,45959,197.2,0,0,,,
1983,51,b) 1,7120,7340,55432,56517,55,0.7,1903,22.9,14155,1209,12946,2.1,25,16325,9612,6713,17,28.9,-2170,-3.9,50,0,1503,1511,7247
1983,51,c) 2,5991,6283,54816,56340,249,3.7,1109,16.6,11032,1953,9079,3.5,19.6,14080,5929,8151,10.5,25,-3048,-5.4,39.2,0,902,902,4889
1983,51,d) 3,5386,5549,41483,42231,191,3.3,792,13.6,8030,887,7143,2.1,19,9525,4011,5514,9.5,22.6,-1495,-3.6,38,0,620,620,3163
1983,51,e) 4,4956,5218,45295,45413,182,3.4,656,12.1,8169,1197,6972,2.6,18,8404,3228,5176,7.1,18.5,-235,-0.5,36,0,490,491,2521
1983,51,f) 5,4469,4828,42997,42705,164,3.3,587,11.8,9037,1589,7448,3.7,21.2,8453,3048,5405,7.1,19.8,584,1.4,39.6,0,429,429,2147
1983,51,g) 6 to 10,4548,5636,65446,65109,233,4.1,545,9.5,11364,2338,9026,3.6,17.5,10689,3654,7035,5.6,16.4,675,1.1,32.8,0,354,360,2211
1983,51,l) Left Censored,38490,55247,1267647,1290503,2158,3.8,4303,7.7,151905,36213,115692,2.8,11.8,197616,46916,150700,3.6,15.3,-45711,-3.5,23.6,0,2152,2187,14563
1983,53,a) 0,9871,9996,55153,27908,9776,195.6,0,0,54490,54490,0,195.2,195.2,0,0,0,0,0,54490,195.2,0,0,,,
1983,53,b) 1,7452,7682,54722,56318,36,0.4,2288,25.8,14855,754,14101,1.3,26.4,18047,10346,7701,18.4,32,-3192,-5.6,52.8,0,1650,1674,8145
1983,53,c) 2,6164,6394,46954,49981,269,3.9,1298,18.9,9446,1149,8297,2.3,18.9,15500,6807,8693,13.6,31,-6054,-12.1,37.8,0,960,960,4777
1983,53,d) 3,5769,5985,40179,42216,250,4,1013,16,8071,1170,6901,2.8,19.1,12145,5519,6626,13.1,28.8,-4074,-9.7,38.2,0,760,760,4035
1983,53,e) 4,5132,5352,35639,38303,223,4,888,15.8,6461,1071,5390,2.8,16.9,11788,4899,6889,12.8,30.8,-5327,-13.9,33.8,0,648,659,3821
1983,53,f) 5,4739,5007,38348,40980,194,3.8,643,12.4,6117,828,5289,2,14.9,11381,3238,8143,7.9,27.8,-5264,-12.9,29.8,0,436,437,2132
1983,53,g) 6 to 10,4805,5761,55983,57512,254,4.3,707,11.9,9533,2079,7454,3.6,16.6,12591,3979,8612,6.9,21.9,-3058,-5.3,33.2,0,381,382,1852
1983,53,l) Left Censored,32361,44618,892929,897030,1738,3.8,3715,8.2,131240,50470,80770,5.6,14.6,139441,32274,107167,3.6,15.5,-8201,-0.9,29.2,0,1896,1916,12236
1983,54,a) 0,2395,2427,12680,6439,2349,193.6,0,0,12482,12482,0,193.8,193.8,0,0,0,0,0,12482,193.8,0,0,,,
1983,54,b) 1,2041,2093,15903,17318,13,0.5,687,28,3038,147,2891,0.8,17.5,5867,3327,2540,19.2,33.9,-2829,-16.4,35,0,551,551,2542
1983,54,c) 2,1720,1764,13891,14931,57,3,368,19.2,2174,272,1902,1.8,14.6,4253,1903,2350,12.7,28.5,-2079,-13.9,29.2,0,295,295,1566
1983,54,d) 3,1465,1524,10109,10840,51,3.1,286,17.6,1275,170,1105,1.6,11.8,2736,1189,1547,11,25.2,-1461,-13.4,23.6,0,221,221,909
1983,54,e) 4,1446,1517,9893,10616,49,3.1,228,14.4,1509,358,1151,3.4,14.2,2955,1270,1685,12,27.8,-1446,-13.6,28.4,0,164,164,1027
1983,54,f) 5,1296,1400,10243,10768,71,4.9,193,13.4,1685,297,1388,2.8,15.6,2735,1080,1655,10,25.4,-1050,-9.8,31.2,0,139,139,804
1983,54,g) 6 to 10,1451,1689,15076,16071,59,3.4,204,11.8,1931,373,1558,2.3,12,3921,1064,2857,6.6,24.4,-1990,-12.4,24,0,127,127,600
1983,54,l) Left Censored,13932,18353,334419,356438,723,3.9,1552,8.3,31185,11167,20018,3.1,8.7,75223,15796,59427,4.4,21.1,-44038,-12.4,17.4,0,819,823,5176
1983,55,a) 0,7219,7317,39286,19866,7153,195.5,0,0,38840,38840,0,195.5,195.5,0,0,0,0,0,38840,195.5,0,0,,,
1983,55,b) 1,5947,6141,40737,43167,40,0.6,1436,20.9,8144,892,7252,2.1,18.9,13004,7049,5955,16.3,30.1,-4860,-11.2,37.8,0,1062,1063,5184
1983,55,c) 2,5214,5391,41089,43053,134,2.3,896,15.5,6683,895,5788,2.1,15.5,10611,5108,5503,11.9,24.6,-3928,-9.1,31,0,657,658,3582
1983,55,d) 3,4793,4945,34306,35730,162,3.1,714,13.8,5570,825,4745,2.3,15.6,8418,4201,4217,11.8,23.6,-2848,-8,31.2,0,525,525,3378
1983,55,e) 4,4679,4892,35734,36428,153,3,626,12.3,6114,1267,4847,3.5,16.8,7501,3064,4437,8.4,20.6,-1387,-3.8,33.6,0,441,441,2319
1983,55,f) 5,4668,4940,38335,40153,151,3,540,10.6,5804,899,4905,2.2,14.5,9439,2850,6589,7.1,23.5,-3635,-9,29,0,390,391,2152
1983,55,g) 6 to 10,4768,5722,50971,52970,206,3.5,579,9.9,6774,1684,5090,3.2,12.8,10771,3138,7633,5.9,20.3,-3997,-7.5,25.6,0,338,342,1609
1983,55,l) Left Censored,42952,54919,1211197,1243249,1618,2.9,3782,6.8,120075,26549,93526,2.1,9.7,184178,38740,145438,3.1,14.8,-64103,-5.1,19.4,0,2030,2045,13226
1983,56,a) 0,1474,1507,9023,4605,1464,194.3,0,0,8836,8836,0,191.9,191.9,0,0,0,0,0,8836,191.9,0,0,,,
1983,56,b) 1,1222,1252,7578,12572,10,0.7,507,33.6,1652,152,1500,1.2,13.1,11640,2303,9337,18.3,92.6,-9988,-79.5,26.2,0,393,393,1883
1983,56,c) 2,1074,1109,6619,7794,38,3.1,266,21.7,881,100,781,1.3,11.3,3231,1309,1922,16.8,41.5,-2350,-30.2,22.6,0,201,201,1102
1983,56,d) 3,848,889,5802,7212,33,3.4,188,19.5,775,114,661,1.6,10.7,3595,1368,2227,19,49.8,-2820,-39.1,21.4,0,141,142,1196
1983,56,e) 4,862,916,6607,7524,32,3.3,180,18.3,879,120,759,1.6,11.7,2712,1034,1678,13.7,36,-1833,-24.3,23.4,0,142,142,837
1983,56,f) 5,748,762,5819,6524,24,3,128,15.9,692,101,591,1.5,10.6,2102,733,1369,11.2,32.2,-1410,-21.6,21.2,0,99,99,510
1983,56,g) 6 to 10,697,809,8082,8716,22,2.6,103,12.3,1066,124,942,1.4,12.2,2333,700,1633,8,26.8,-1267,-14.6,24.4,0,59,59,360
1983,56,l) Left Censored,4540,5874,84648,91474,238,4,547,9.1,10526,3295,7231,3.6,11.5,24177,4717,19460,5.2,26.4,-13651,-14.9,23,0,275,275,1867
1984,01,a) 0,7749,7796,40627,20363,7761,199.1,0,0,40528,40528,0,199,199,0,0,0,0,0,40528,199,0,0,,,
1984,01,b) 1,4448,4516,31406,31457,26,0.5,1421,27.1,9161,496,8665,1.6,29.1,9263,5741,3522,18.3,29.4,-102,-0.3,58.2,0,1110,1111,4739
1984,01,c) 2,3574,3718,30627,31592,152,3.7,841,20.6,7247,852,6395,2.7,22.9,9176,6137,3039,19.4,29,-1929,-6.1,45.8,0,669,670,5323
1984,01,d) 3,3257,3389,31136,31052,130,3.6,572,15.8,6345,612,5733,2,20.4,6177,2863,3314,9.2,19.9,168,0.5,39.8,0,447,447,2334
1984,01,e) 4,3062,3199,24872,24487,138,4.1,477,14.1,5312,479,4833,2,21.7,4542,2106,2436,8.6,18.5,770,3.2,37,0,355,356,1516
1984,01,f) 5,2935,3135,33623,33544,143,4.3,471,14.3,5852,943,4909,2.8,17.4,5693,2375,3318,7.1,17,159,0.4,34,0,334,335,1798
1984,01,g) 6 to 10,5875,6920,68453,67480,311,4.4,760,10.7,13120,2016,11104,3,19.4,11173,4484,6689,6.6,16.6,1947,2.8,33.2,0,483,483,2561
1984,01,l) Left Censored,24237,34559,818266,800620,1385,3.9,2866,8.1,127021,29125,97896,3.6,15.9,91729,32322,59407,4,11.5,35292,4.4,23,0,1490,1508,10173
1984,02,a) 0,1951,1964,9707,4870,1948,198.4,0,0,9675,9675,0,198.7,198.7,0,0,0,0,0,9675,198.7,0,0,,,
1984,02,b) 1,1325,1358,8970,9119,16,1,451,28.5,3028,104,2924,1.1,33.2,3325,1967,1358,21.6,36.5,-297,-3.3,66.4,0,319,319,1554
1984,02,c) 2,888,929,7400,7841,33,3.2,230,22.3,1883,123,1760,1.6,24,2764,1407,1357,17.9,35.3,-881,-11.3,48,0,165,165,1024
1984,02,d) 3,615,652,6241,6429,39,5.7,103,15,1634,411,1223,6.4,25.4,2010,679,1331,10.6,31.3,-376,-5.9,50.8,0,78,78,382
1984,02,e) 4,583,598,5355,5218,30,4.8,76,12.2,1536,265,1271,5.1,29.4,1261,441,820,8.5,24.2,275,5.2,48.4,0,54,54,342
1984,02,f) 5,574,639,5292,5500,34,5.1,99,14.8,1123,172,951,3.1,20.4,1538,822,716,14.9,28,-415,-7.6,40.8,0,54,54,525
1984,02,g) 6 to 10,997,1183,12318,12608,65,5.3,139,11.4,2182,408,1774,3.2,17.3,2762,959,1803,7.6,21.9,-580,-4.6,34.6,0,71,71,522
1984,02,l) Left Censored,2789,4042,85811,84452,296,7.3,361,8.9,16360,5475,10885,6.5,19.4,13643,3978,9665,4.7,16.2,2717,3.2,32.4,0,160,161,1412
1984,04,a) 0,8600,8684,48495,24314,8634,198.8,0,0,48363,48363,0,198.9,198.9,0,0,0,0,0,48363,198.9,0,0,,,
1984,04,b) 1,5479,5652,51501,50316,77,1.2,1565,24.3,18837,2821,16016,5.6,37.4,16467,6858,9609,13.6,32.7,2370,4.7,65.4,0,1158,1158,5271
1984,04,c) 2,4742,4970,44460,43215,220,4.1,1104,20.3,13202,1615,11587,3.7,30.5,10711,5703,5008,13.2,24.8,2491,5.7,49.6,0,836,841,4458
1984,04,d) 3,3802,3984,34994,34649,149,3.5,719,16.8,8555,708,7847,2,24.7,7864,4038,3826,11.7,22.7,691,2,45.4,0,519,521,2924
1984,04,e) 4,3567,3753,33540,32781,163,4.1,593,15,8600,778,7822,2.4,26.2,7081,3313,3768,10.1,21.6,1519,4.6,43.2,0,434,436,2543
1984,04,f) 5,3123,3388,35101,33209,151,4.2,489,13.7,10003,2650,7353,8,30.1,6219,2833,3386,8.5,18.7,3784,11.4,37.4,0,355,355,2089
1984,04,g) 6 to 10,5117,5906,70261,67452,268,4.4,742,12.1,16697,1713,14984,2.5,24.8,11079,4367,6712,6.5,16.4,5618,8.4,32.8,0,442,446,2601
1984,04,l) Left Censored,15542,24615,616834,600155,1317,5.3,2024,8.1,106544,30069,76475,5,17.8,73186,23336,49850,3.9,12.2,33358,5.6,24.4,0,887,896,7344
1984,05,a) 0,5363,5389,25479,12765,5361,199,0,0,25428,25428,0,199.2,199.2,0,0,0,0,0,25428,199.2,0,0,,,
1984,05,b) 1,3183,3236,21321,21195,21,0.6,1024,27.2,6397,291,6106,1.4,30.2,6144,4068,2076,19.2,29,253,1.2,58,0,791,791,3153
1984,05,c) 2,2621,2682,20519,20809,90,3,609,20.6,4302,374,3928,1.8,20.7,4881,2657,2224,12.8,23.5,-579,-2.8,41.4,0,478,479,2178
1984,05,d) 3,2295,2370,20252,20394,80,3.1,424,16.7,3858,313,3545,1.5,18.9,4142,1854,2288,9.1,20.3,-284,-1.4,37.8,0,319,319,1518
1984,05,e) 4,2215,2336,19723,19778,88,3.6,345,14,4037,619,3418,3.1,20.4,4146,1714,2432,8.7,21,-109,-0.6,40.8,0,246,246,1419
1984,05,f) 5,2309,2455,19689,19286,92,3.6,311,12.1,4005,435,3570,2.3,20.8,3198,1440,1758,7.5,16.6,807,4.2,33.2,0,231,233,1169
1984,05,g) 6 to 10,4089,4584,40389,39096,186,3.9,483,10.2,8009,1606,6403,4.1,20.5,5423,2422,3001,6.2,13.9,2586,6.6,27.8,0,326,327,1507
1984,05,l) Left Censored,15554,20673,446796,438753,847,4,1740,8.3,63582,13427,50155,3.1,14.5,47496,16552,30944,3.8,10.8,16086,3.7,21.6,0,969,984,5989
1984,06,a) 0,60570,61126,362699,182186,60803,198.9,0,0,361026,361026,0,198.2,198.2,0,0,0,0,0,361026,198.2,0,0,,,
1984,06,b) 1,41733,42624,373819,367434,277,0.6,12044,24.7,113220,6327,106893,1.7,30.8,100449,57347,43102,15.6,27.3,12771,3.5,54.6,0,8630,8631,44659
1984,06,c) 2,37499,39370,335601,335343,1769,4.2,7826,18.4,93417,11023,82394,3.3,27.9,92900,52069,40831,15.5,27.7,517,0.2,55.4,0,5542,5564,40629
1984,06,d) 3,34668,36377,382753,367092,1710,4.4,5868,15.2,100276,15469,84807,4.2,27.3,68953,33931,35022,9.2,18.8,31323,8.5,37.6,0,4115,4121,24455
1984,06,e) 4,31137,32585,298849,290272,1571,4.6,4823,14.1,73217,8205,65012,2.8,25.2,56063,26915,29148,9.3,19.3,17154,5.9,38.6,0,3314,3332,19475
1984,06,f) 5,28436,30225,272081,268109,1508,4.8,4233,13.4,64202,8286,55916,3.1,23.9,56258,27243,29015,10.2,21,7944,2.9,42,0,2869,2876,18172
1984,06,g) 6 to 10,50241,58429,671009,650619,3092,5.1,6664,11.1,145984,24652,121332,3.8,22.4,105203,41313,63890,6.3,16.2,40781,6.2,32.4,0,3943,3972,23021
1984,06,l) Left Censored,160385,237064,6140419,6040954,10794,4.5,20096,8.3,991429,249620,741809,4.1,16.4,792499,240060,552439,4,13.1,198930,3.3,26.2,0,9895,9976,62454
1984,08,a) 0,10251,10324,57329,28767,10274,199,0,0,57125,57125,0,198.6,198.6,0,0,0,0,0,57125,198.6,0,0,,,
1984,08,b) 1,6637,6859,57994,57180,81,1,2182,27.5,20690,4561,16129,8,36.2,19062,9355,9707,16.4,33.3,1628,2.9,66.6,0,1662,1662,7446
1984,08,c) 2,5767,6010,48025,50137,248,3.8,1360,20.7,12242,1798,10444,3.6,24.4,16466,7945,8521,15.8,32.8,-4224,-8.4,48.8,0,1043,1045,6072
1984,08,d) 3,4984,5228,54024,54561,229,4.1,933,16.7,10677,1253,9424,2.3,19.6,11750,5232,6518,9.6,21.5,-1073,-1.9,39.2,0,709,709,3719
1984,08,e) 4,4516,4701,40821,40710,188,3.8,791,15.8,9271,1151,8120,2.8,22.8,9049,4305,4744,10.6,22.2,222,0.6,44.4,0,612,613,3311
1984,08,f) 5,4179,4457,39432,40055,202,4.3,702,14.9,7940,1020,6920,2.5,19.8,9186,4066,5120,10.2,22.9,-1246,-3.1,39.6,0,487,489,2961
1984,08,g) 6 to 10,6966,7895,84432,83023,365,4.5,994,12.1,18817,2542,16275,3.1,22.7,15998,5770,10228,6.9,19.3,2819,3.4,38.6,0,658,661,3682
1984,08,l) Left Censored,22221,31781,747269,741842,1673,5.2,2770,8.6,109473,32858,76615,4.4,14.8,98621,30487,68134,4.1,13.3,10852,1.5,26.6,0,1304,1318,8671
1984,09,a) 0,6531,6568,35753,17927,6537,199.1,0,0,35652,35652,0,198.9,198.9,0,0,0,0,0,35652,198.9,0,0,,,
1984,09,b) 1,4658,4698,31605,31054,18,0.3,1009,19.4,9752,157,9595,0.5,31.4,8649,5334,3315,17.2,27.9,1103,3.5,55.8,0,758,758,4445
1984,09,c) 2,4154,4294,47611,47437,121,2.6,720,15.6,8434,624,7810,1.3,17.8,8086,3583,4503,7.6,17,348,0.8,34,0,547,548,2937
1984,09,d) 3,3754,3920,33641,32707,127,3.1,528,12.8,7471,861,6610,2.6,22.8,5602,2338,3264,7.1,17.1,1869,5.7,34.2,0,399,399,1671
1984,09,e) 4,3251,3380,26034,25766,94,2.7,430,12.1,5013,405,4608,1.6,19.5,4477,1905,2572,7.4,17.4,536,2.1,34.8,0,316,316,1347
1984,09,f) 5,3088,3177,26875,26666,93,2.8,351,10.6,5281,446,4835,1.7,19.8,4862,1737,3125,6.5,18.2,419,1.6,36.4,0,252,252,1226
1984,09,g) 6 to 10,6138,6967,75811,75414,257,3.6,705,9.8,13966,1993,11973,2.6,18.5,13172,4101,9071,5.4,17.5,794,1,35,0,465,467,2245
1984,09,l) Left Censored,29729,37355,1046457,1035790,1330,3.5,2605,6.9,138365,34268,104097,3.3,13.4,117031,35028,82003,3.4,11.3,21334,2.1,22.6,0,1450,1458,11056
1984,10,a) 0,1257,1264,6665,3342,1255,198.6,0,0,6646,6646,0,198.9,198.9,0,0,0,0,0,6646,198.9,0,0,,,
1984,10,b) 1,848,859,5566,5381,7,0.7,219,22.6,1654,46,1608,0.9,30.7,1284,765,519,14.2,23.9,370,6.8,47.8,0,159,159,576
1984,10,c) 2,693,702,5670,5603,39,5.2,131,17.5,1387,331,1056,5.9,24.8,1253,631,622,11.3,22.4,134,2.4,44.8,0,94,94,466
1984,10,d) 3,620,643,5573,5419,18,2.6,100,14.6,1130,276,854,5.1,20.9,822,314,508,5.8,15.2,308,5.7,30.4,0,72,72,227
1984,10,e) 4,563,581,4642,4727,15,2.4,92,14.9,963,41,922,0.9,20.4,1132,592,540,12.5,23.9,-169,-3.5,40.8,0,62,62,413
1984,10,f) 5,547,579,5831,5659,18,3,75,12.3,1315,132,1183,2.3,23.2,971,388,583,6.9,17.2,344,6,34.4,0,59,59,321
1984,10,g) 6 to 10,1050,1211,13106,12928,41,3.3,140,11.1,2524,242,2282,1.9,19.5,2168,770,1398,6,16.8,356,2.7,33.6,0,83,84,289
1984,10,l) Left Censored,5024,6431,183673,180644,245,3.7,543,8.3,25007,6127,18880,3.4,13.8,18949,6221,12728,3.4,10.5,6058,3.3,21,0,251,253,1468
1984,11,a) 0,1325,1335,8534,4272,1334,199.9,0,0,8524,8524,0,199.5,199.5,0,0,0,0,0,8524,199.5,0,0,,,
1984,11,b) 1,1108,1116,9707,10586,8,0.6,342,26.3,2724,,,,25.7,4481,1668,2813,15.8,42.3,-1757,-16.6,51.4,1,204,204,1129
1984,11,c) 2,947,962,8794,9129,37,3.4,284,26,2519,218,2301,2.4,27.6,3189,2010,1179,22,34.9,-670,-7.3,55.2,0,175,175,801
1984,11,d) 3,801,819,11899,11748,27,3,172,19.1,1896,164,1732,1.4,16.1,1594,865,729,7.4,13.6,302,2.5,27.2,0,103,103,536
1984,11,e) 4,665,680,6711,6935,21,2.8,160,21.2,1441,127,1314,1.8,20.8,1888,1177,711,17,27.2,-447,-6.4,41.6,0,97,97,900
1984,11,f) 5,632,655,7134,6713,23,3.3,119,16.9,2079,,,,31,1237,699,538,10.4,18.4,842,12.6,36.8,1,74,74,418
1984,11,g) 6 to 10,1387,1565,39822,38427,53,3.2,211,12.8,6770,1118,5652,2.9,17.6,3980,1341,2639,3.5,10.4,2790,7.2,20.8,0,126,126,653
1984,11,l) Left Censored,6936,8791,255313,266597,366,4.1,786,8.7,30570,8260,22310,3.1,11.5,53137,10230,42907,3.8,19.9,-22567,-8.4,23,0,395,395,2419
1984,12,a) 0,33251,33445,188325,94369,33297,199.1,0,0,187912,187912,0,199.1,199.1,0,0,0,0,0,187912,199.1,0,0,,,
1984,12,b) 1,22286,22690,164240,160401,153,0.6,6725,25.8,55873,2409,53464,1.5,34.8,48194,28480,19714,17.8,30,7679,4.8,60,0,5199,5200,22819
1984,12,c) 2,18594,19245,165680,165932,1064,5.1,4203,20.1,42546,6574,35972,4,25.6,43050,22551,20499,13.6,25.9,-504,-0.3,51.2,0,3245,3269,17897
1984,12,d) 3,15918,16560,151558,147380,904,5.2,2854,16.3,38477,6943,31534,4.7,26.1,30120,15407,14713,10.5,20.4,8357,5.7,40.8,0,2187,2189,11951
1984,12,e) 4,13764,14222,119036,115822,1154,7.8,2289,15.5,31793,7950,23843,6.9,27.4,25365,13182,12183,11.4,21.9,6428,5.5,43.8,0,1738,1740,10324
1984,12,f) 5,11969,12645,120671,116771,1124,8.7,1705,13.2,30974,8316,22658,7.1,26.5,23174,10118,13056,8.7,19.8,7800,6.7,39.6,0,1240,1244,7359
1984,12,g) 6 to 10,21632,25045,255939,251922,1380,5.4,2899,11.2,54481,11117,43364,4.4,21.6,46446,17728,28718,7,18.4,8035,3.2,36.8,0,1882,1887,10687
1984,12,l) Left Censored,67588,103282,2331039,2270162,5738,5.5,7995,7.7,398172,126030,272142,5.6,17.5,276419,89440,186979,3.9,12.2,121753,5.3,24.4,0,4076,4144,27429
1984,13,a) 0,13054,13162,73336,36741,13109,199.2,0,0,73191,73191,0,199.2,199.2,0,0,0,0,0,73191,199.2,0,0,,,
1984,13,b) 1,8294,8388,60260,58170,50,0.5,2414,25.1,20519,786,19733,1.4,35.3,16338,10679,5659,18.4,28.1,4181,7.2,56.2,0,1810,1810,8203
1984,13,c) 2,6759,7087,64493,63982,249,3.2,1448,18.8,15870,1980,13890,3.1,24.8,14847,8753,6094,13.7,23.2,1023,1.6,46.4,0,1097,1098,6251
1984,13,d) 3,5839,6108,59027,58821,231,3.6,1008,15.5,13848,2046,11802,3.5,23.5,13436,6833,6603,11.6,22.8,412,0.7,45.6,0,730,734,5148
1984,13,e) 4,5206,5544,51590,50099,259,4.5,808,13.9,11492,1198,10294,2.4,22.9,8510,4286,4224,8.6,17,2982,5.9,34,0,579,580,3157
1984,13,f) 5,4861,5178,49514,48273,248,4.6,732,13.5,12018,2241,9777,4.6,24.9,9535,4362,5173,9,19.8,2483,5.1,39.6,0,493,502,2714
1984,13,g) 6 to 10,9416,10798,118197,115055,467,4.2,1199,10.8,25121,3454,21667,3,21.8,18837,7616,11221,6.6,16.4,6284,5.4,32.8,0,732,732,4612
1984,13,l) Left Censored,37515,56572,1456327,1420289,2535,4.4,4360,7.6,217240,56599,160641,4,15.3,145163,48836,96327,3.4,10.2,72077,5.1,20.4,0,2088,2102,15134
1984,15,a) 0,1802,1818,9409,4719,1807,198.8,0,0,9380,9380,0,198.8,198.8,0,0,0,0,0,9380,198.8,0,0,,,
1984,15,b) 1,1654,1675,11500,11720,17,0.9,491,25.5,2840,130,2710,1.1,24.2,3279,1898,1381,16.2,28,-439,-3.8,48.4,0,351,351,1443
1984,15,c) 2,1444,1481,10840,11266,51,3.2,314,19.4,2416,365,2051,3.2,21.4,3267,2017,1250,17.9,29,-851,-7.6,42.8,0,235,241,1525
1984,15,d) 3,1366,1441,16070,16242,51,3.3,229,15,2389,278,2111,1.7,14.7,2733,1136,1597,7,16.8,-344,-2.1,29.4,0,161,161,925
1984,15,e) 4,1174,1263,11354,11247,51,3.8,208,15.5,2283,326,1957,2.9,20.3,2068,1022,1046,9.1,18.4,215,1.9,36.8,0,144,144,705
1984,15,f) 5,1075,1160,11473,11618,50,4.1,150,12.4,2005,468,1537,4,17.3,2295,789,1506,6.8,19.8,-290,-2.5,34.6,0,98,99,566
1984,15,g) 6 to 10,1879,2263,23896,25792,93,3.9,294,12.4,3318,498,2820,1.9,12.9,7109,2090,5019,8.1,27.6,-3791,-14.7,25.8,0,169,170,1068
1984,15,l) Left Censored,7562,10706,215892,217833,396,3.6,839,7.7,24335,6459,17876,3,11.2,28217,8546,19671,3.9,13,-3882,-1.8,22.4,0,392,416,2605
1984,16,a) 0,2172,2185,10919,5477,2171,198.7,0,0,10884,10884,0,198.7,198.7,0,0,0,0,0,10884,198.7,0,0,,,
1984,16,b) 1,1555,1606,13778,13036,13,0.7,468,25.4,5245,308,4937,2.4,40.2,3760,2003,1757,15.4,28.8,1485,11.4,57.6,0,356,356,1646
1984,16,c) 2,1332,1392,9889,10391,54,3.6,287,19,1965,299,1666,2.9,18.9,2968,1530,1438,14.7,28.6,-1003,-9.7,37.8,0,213,213,1249
1984,16,d) 3,1150,1187,8959,8852,54,4.3,203,16.1,2009,254,1755,2.9,22.7,1794,821,973,9.3,20.3,215,2.4,40.6,0,160,160,682
1984,16,e) 4,1092,1130,8550,8368,56,4.7,187,15.6,1961,272,1689,3.3,23.4,1596,735,861,8.8,19.1,365,4.3,38.2,0,138,138,555
1984,16,f) 5,1091,1148,12848,11152,51,4.2,165,13.7,5564,125,5439,1.1,49.9,2172,1237,935,11.1,19.5,3392,30.4,39,0,109,109,558
1984,16,g) 6 to 10,1968,2167,19055,18571,114,5.2,216,9.8,3463,495,2968,2.7,18.6,2495,1031,1464,5.6,13.4,968,5.2,26.8,0,148,148,752
1984,16,l) Left Censored,6990,9652,163798,163097,351,3.6,768,7.8,20940,5160,15780,3.2,12.8,19537,6241,13296,3.8,12,1403,0.8,24,0,438,441,2680
1984,17,a) 0,19408,19585,112244,56245,19479,198.9,0,0,111998,111998,0,199.1,199.1,0,0,0,0,0,111998,199.1,0,0,,,
1984,17,b) 1,13289,13497,112693,110683,73,0.5,3230,21.3,35286,1971,33315,1.8,31.9,31265,15243,16022,13.8,28.2,4021,3.7,56.4,0,2244,2247,10674
1984,17,c) 2,12463,12895,122381,120463,638,4.7,2204,16.1,27398,4726,22672,3.9,22.7,23562,10841,12721,9,19.6,3836,3.1,39.2,0,1571,1576,7624
1984,17,d) 3,10673,11082,107528,105049,539,4.6,1639,14.1,23422,3640,19782,3.5,22.3,18464,8087,10377,7.7,17.6,4958,4.7,35.2,0,1172,1172,5443
1984,17,e) 4,9903,10277,86497,84361,742,7,1391,13.1,19184,4484,14700,5.3,22.7,14911,7247,7664,8.6,17.7,4273,5,35.4,0,1002,1004,5266
1984,17,f) 5,9104,9533,78310,77541,577,5.9,1190,12.1,15800,3559,12241,4.6,20.4,14262,6388,7874,8.2,18.4,1538,2,36.8,0,862,863,4934
1984,17,g) 6 to 10,18222,20812,215783,215356,988,4.6,2234,10.4,38377,7888,30489,3.7,17.8,37522,13380,24142,6.2,17.4,855,0.4,34.8,0,1323,1334,7235
1984,17,l) Left Censored,87698,116972,3138076,3081840,4713,4,7583,6.4,438395,99432,338963,3.2,14.2,325924,103635,222289,3.4,10.6,112471,3.6,21.2,0,2117,2147,11781
1984,18,a) 0,9782,9884,56870,29112,9648,195.2,0,0,55517,55517,0,190.7,190.7,0,0,0,0,0,55517,190.7,0,0,,,
1984,18,b) 1,6528,6635,47141,44552,36,0.5,758,10.8,13323,990,12333,2.2,29.9,8144,2888,5256,6.5,18.3,5179,11.6,36.6,0,34,34,134
1984,18,c) 2,5149,5395,45288,43851,166,2.9,667,11.8,11005,1661,9344,3.8,25.1,8131,3403,4728,7.8,18.5,2874,6.6,37,0,33,34,358
1984,18,d) 3,4400,4630,47427,46694,112,2.4,460,9.7,8494,752,7742,1.6,18.2,7027,3093,3934,6.6,15,1467,3.2,30,0,17,17,213
1984,18,e) 4,4330,4526,34859,33996,82,1.8,308,6.8,6503,683,5820,2,19.1,4776,1386,3390,4.1,14,1727,5.1,28,0,11,11,127
1984,18,f) 5,4297,4555,36002,34826,133,2.9,363,7.9,7345,1005,6340,2.9,21.1,4993,1812,3181,5.2,14.3,2352,6.8,28.6,0,9,9,38
1984,18,g) 6 to 10,8188,9474,95831,93870,299,3.1,856,8.9,16908,2417,14491,2.6,18,12985,4276,8709,4.6,13.8,3923,4.2,27.6,0,16,24,184
1984,18,l) Left Censored,39345,55294,1383794,1357635,1720,3.1,2985,5.4,197933,47989,149944,3.5,14.6,145616,50742,94874,3.7,10.7,52317,3.9,21.4,0,35,55,869
1984,19,a) 0,5820,5845,28132,14110,5818,199.1,0,0,28044,28044,0,198.8,198.8,0,0,0,0,0,28044,198.8,0,0,,,
1984,19,b) 1,3703,3863,25953,26529,104,2.4,1080,24.7,8182,3136,5046,11.8,30.8,9334,4241,5093,16,35.2,-1152,-4.4,61.6,0,832,832,3460
1984,19,c) 2,3279,3378,23058,23888,97,2.6,713,19.3,4169,598,3571,2.5,17.5,5829,3166,2663,13.3,24.4,-1660,-6.9,35,0,543,545,2399
1984,19,d) 3,3112,3269,26470,26683,102,2.9,520,14.9,4103,776,3327,2.9,15.4,4528,2320,2208,8.7,17,-425,-1.6,30.8,0,390,390,1539
1984,19,e) 4,3010,3092,20208,20904,82,2.5,448,13.7,3907,317,3590,1.5,18.7,5298,1935,3363,9.3,25.3,-1391,-6.6,37.4,0,327,327,1400
1984,19,f) 5,2749,2928,19918,20133,120,3.9,389,12.7,3345,598,2747,3,16.6,3775,1823,1952,9.1,18.8,-430,-2.2,33.2,0,273,273,1324
1984,19,g) 6 to 10,5836,6742,53752,55110,292,4.2,800,11.4,7849,1601,6248,2.9,14.2,10564,4170,6394,7.6,19.2,-2715,-5,28.4,0,536,538,2503
1984,19,l) Left Censored,26722,35782,628539,625495,1072,2.9,2696,7.4,76890,16181,60709,2.6,12.3,70801,19887,50914,3.2,11.3,6089,1,22.6,0,1527,1535,7429
1984,20,a) 0,6110,6145,32529,16289,6125,199.3,0,0,32480,32480,0,199.4,199.4,0,0,0,0,0,32480,199.4,0,0,,,
1984,20,b) 1,3805,3878,25137,25359,24,0.5,1241,27.5,7526,432,7094,1.7,29.7,7970,5194,2776,20.5,31.4,-444,-1.7,59.4,0,891,891,3853
1984,20,c) 2,3241,3352,25813,26845,107,2.9,846,22.7,5130,792,4338,3,19.1,7193,3933,3260,14.7,26.8,-2063,-7.7,38.2,0,557,558,2489
1984,20,d) 3,2879,3035,26121,25020,122,3.7,619,18.8,7377,712,6665,2.8,29.5,5174,2758,2416,11,20.7,2203,8.8,41.4,0,393,393,1755
1984,20,e) 4,2467,2568,18724,19119,115,4.2,447,16.4,3504,695,2809,3.6,18.3,4293,2273,2020,11.9,22.5,-789,-4.2,36.6,0,278,280,1508
1984,20,f) 5,2373,2478,18484,18868,76,2.9,433,16.3,3526,448,3078,2.4,18.7,4293,2400,1893,12.7,22.8,-767,-4.1,37.4,0,243,243,1080
1984,20,g) 6 to 10,4707,5419,46457,47932,210,3.7,830,14.5,8387,1495,6892,3.1,17.5,11336,5038,6298,10.5,23.7,-2949,-6.2,35,0,519,519,2916
1984,20,l) Left Censored,21409,28677,583446,562781,1061,3.6,2694,9.1,105700,16784,88916,3,18.8,64370,24053,40317,4.3,11.4,41330,7.4,22.8,0,1274,1281,9007
1984,21,a) 0,6713,6755,33918,16991,6726,199.1,0,0,33854,33854,0,199.2,199.2,0,0,0,0,0,33854,199.2,0,0,,,
1984,21,b) 1,4365,4426,33860,34629,23,0.5,1314,25.8,7961,654,7307,1.9,23,9498,5752,3746,16.6,27.4,-1537,-4.4,46,0,1040,1040,4688
1984,21,c) 2,3668,3796,30749,32491,132,3.2,823,19.8,6784,1122,5662,3.5,20.9,10267,6516,3751,20.1,31.6,-3483,-10.7,41.8,0,654,655,5706
1984,21,d) 3,3028,3153,26624,27180,109,3.2,541,16,5148,577,4571,2.1,18.9,6260,3281,2979,12.1,23,-1112,-4.1,37.8,0,436,436,2776
1984,21,e) 4,2672,2790,21251,21822,100,3.4,477,16,3966,417,3549,1.9,18.2,5107,2652,2455,12.2,23.4,-1141,-5.2,36.4,0,344,344,1860
1984,21,f) 5,2679,2811,26342,26662,95,3.2,419,14.1,4058,491,3567,1.8,15.2,4698,2160,2538,8.1,17.6,-640,-2.4,30.4,0,304,304,1320
1984,21,g) 6 to 10,5315,5942,54990,54961,260,4.2,752,12.2,9183,1579,7604,2.9,16.7,9125,3759,5366,6.8,16.6,58,0.1,33.2,0,494,496,2128
1984,21,l) Left Censored,24226,33142,721572,713317,1258,3.7,2691,8,94098,23320,70778,3.3,13.2,77587,24216,53371,3.4,10.9,16511,2.3,21.8,0,1454,1460,8716
1984,22,a) 0,8706,8750,49948,25122,8696,198.8,0,0,49653,49653,0,197.6,197.6,0,0,0,0,0,49653,197.6,0,0,,,
1984,22,b) 1,6132,6256,47883,46926,53,0.7,1910,26.5,16177,952,15225,2,34.5,14263,7811,6452,16.6,30.4,1914,4.1,60.8,0,1467,1467,6017
1984,22,c) 2,5777,6032,44608,46055,223,3.4,1420,21.4,10957,1203,9754,2.6,23.8,13850,8015,5835,17.4,30.1,-2893,-6.3,47.6,0,1071,1076,6337
1984,22,d) 3,4785,4963,47861,49162,157,2.9,955,17.8,9702,1355,8347,2.8,19.7,12304,5433,6871,11.1,25,-2602,-5.3,39.4,0,740,741,4160
1984,22,e) 4,4220,4398,41265,42683,136,2.9,743,15.8,7583,681,6902,1.6,17.8,10419,4429,5990,10.4,24.4,-2836,-6.6,35.6,0,561,562,3303
1984,22,f) 5,4127,4415,41386,43041,162,3.5,672,14.4,7149,1334,5815,3.1,16.6,10459,3772,6687,8.8,24.3,-3310,-7.7,33.2,0,495,495,2733
1984,22,g) 6 to 10,6844,7651,83912,85228,278,3.5,975,12.2,13624,2733,10891,3.2,16,16256,6645,9611,7.8,19.1,-2632,-3.1,32,0,652,653,3923
1984,22,l) Left Censored,28159,40092,878595,887977,1843,4.5,3242,8,115765,32240,83525,3.6,13,134529,37928,96601,4.3,15.2,-18764,-2.2,26,0,1618,1636,10388
1984,23,a) 0,2558,2572,11596,5811,2558,198.9,0,0,11570,11570,0,199.1,199.1,0,0,0,0,0,11570,199.1,0,0,,,
1984,23,b) 1,1716,1728,10184,10002,6,0.3,384,19.9,2792,80,2712,0.8,27.9,2428,1205,1223,12,24.3,364,3.6,48.6,0,274,274,900
1984,23,c) 2,1380,1427,10760,10737,36,2.4,237,15.5,2097,121,1976,1.1,19.5,2050,1042,1008,9.7,19.1,47,0.4,38.2,0,188,188,892
1984,23,d) 3,1224,1270,10253,10203,44,3.3,194,14.4,1917,218,1699,2.1,18.8,1816,889,927,8.7,17.8,101,1,35.6,0,146,146,604
1984,23,e) 4,1182,1218,9220,9075,45,3.6,149,11.8,1918,162,1756,1.8,21.1,1627,1011,616,11.1,17.9,291,3.2,35.8,0,106,107,754
1984,23,f) 5,1117,1145,9376,9388,48,4.1,121,10.2,1470,142,1328,1.5,15.7,1493,632,861,6.7,15.9,-23,-0.2,31.4,0,82,82,500
1984,23,g) 6 to 10,2234,2523,23750,23422,115,4.4,266,10.3,3891,571,3320,2.4,16.6,3234,1122,2112,4.8,13.8,657,2.8,27.6,0,174,174,578
1984,23,l) Left Censored,9213,11972,252485,249225,469,3.9,876,7.2,31040,6685,24355,2.7,12.5,24521,7187,17334,2.9,9.8,6519,2.7,19.6,0,474,481,2422
1984,24,a) 0,7076,7128,48017,24026,7113,199.6,0,0,47982,47982,0,199.7,199.7,0,0,0,0,0,47982,199.7,0,0,,,
1984,24,b) 1,5318,5415,40003,39089,31,0.5,1706,27.1,13321,556,12765,1.4,34.1,11493,7924,3569,20.3,29.4,1828,4.7,58.8,0,1056,1058,4863
1984,24,c) 2,4396,4610,44345,45363,128,2.5,1098,21.4,9643,957,8686,2.1,21.3,11678,7256,4422,16,25.7,-2035,-4.4,42.6,0,651,654,4981
1984,24,d) 3,3843,4007,40133,40501,103,2.3,845,19.2,8686,1240,7446,3.1,21.4,9422,5345,4077,13.2,23.3,-736,-1.9,42.8,0,497,497,3448
1984,24,e) 4,3441,3558,34798,35304,113,2.9,725,18.7,6501,438,6063,1.2,18.4,7512,3914,3598,11.1,21.3,-1011,-2.9,36.8,0,433,433,2281
1984,24,f) 5,3394,3559,36035,35463,120,3.2,467,12.5,7191,566,6625,1.6,20.3,6046,2420,3626,6.8,17,1145,3.3,34,0,326,326,1687
1984,24,g) 6 to 10,6576,7536,83626,82847,318,4.1,881,11.3,15164,2260,12904,2.7,18.3,13605,4830,8775,5.8,16.4,1559,1.9,32.8,0,514,519,2697
1984,24,l) Left Censored,29659,41575,1054530,1032895,1723,4.1,3326,7.9,154487,44592,109895,4.3,15,111217,39202,72015,3.8,10.8,43270,4.2,21.6,0,1719,1728,10990
1984,25,a) 0,11224,11299,71316,35725,11247,199.1,0,0,71182,71182,0,199.2,199.2,0,0,0,0,0,71182,199.2,0,0,,,
1984,25,b) 1,7933,8058,65293,62818,67,0.8,1657,18.7,19269,1937,17332,3.1,30.7,14319,8082,6237,12.9,22.8,4950,7.9,45.6,0,1177,1177,5658
1984,25,c) 2,6930,7205,84049,84129,246,3.2,1135,14.8,15668,1455,14213,1.7,18.6,15827,5742,10085,6.8,18.8,-159,-0.2,37.2,0,837,841,4189
1984,25,d) 3,5992,6178,67946,65681,222,3.4,759,11.8,15111,1501,13610,2.3,23,10580,4185,6395,6.4,16.1,4531,6.9,32.2,0,567,570,2944
1984,25,e) 4,5462,5601,50734,50123,181,3.1,750,12.7,10907,1010,9897,2,21.8,9685,4333,5352,8.6,19.3,1222,2.5,38.6,0,523,523,2588
1984,25,f) 5,5176,5448,51007,50553,198,3.5,585,10.4,9786,1135,8651,2.2,19.4,8877,3286,5591,6.5,17.6,909,1.8,35.2,0,396,398,2268
1984,25,g) 6 to 10,9792,11364,163419,161269,437,3.7,1096,9.4,25495,4139,21356,2.6,15.8,21194,7533,13661,4.7,13.1,4301,2.7,26.2,0,681,681,3997
1984,25,l) Left Censored,52226,67442,1958085,1920098,2163,3.2,4671,6.8,274326,55159,219167,2.9,14.3,198352,58834,139518,3.1,10.3,75974,4,20.6,0,2703,2709,20010
1984,26,a) 0,15439,15558,83941,42098,15470,198.9,0,0,83686,83686,0,198.8,198.8,0,0,0,0,0,83686,198.8,0,0,,,
1984,26,b) 1,10339,10481,73560,70639,60,0.5,2318,19.9,21260,1210,20050,1.7,30.1,15417,8277,7140,11.7,21.8,5843,8.3,43.6,0,1642,1642,6349
1984,26,c) 2,8623,8976,73213,74296,387,4,1673,17.4,17397,2361,15036,3.2,23.4,19563,9754,9809,13.1,26.3,-2166,-2.9,46.8,0,1238,1244,7814
1984,26,d) 3,7869,8189,75953,73843,301,3.5,1216,14.1,16274,2069,14205,2.8,22,12053,6171,5882,8.4,16.3,4221,5.7,32.6,0,878,886,4428
1984,26,e) 4,7269,7600,61022,60164,314,4,1005,12.7,12769,1543,11226,2.6,21.2,11052,4911,6141,8.2,18.4,1717,2.8,36.8,0,738,739,3236
1984,26,f) 5,7036,7435,65743,63353,316,4.1,931,12,14540,1809,12731,2.9,23,9759,4837,4922,7.6,15.4,4781,7.6,30.8,0,679,683,3823
1984,26,g) 6 to 10,13512,15659,155272,151862,691,4.3,1747,10.8,30056,5340,24716,3.5,19.8,23236,9660,13576,6.4,15.3,6820,4.5,30.6,0,1068,1071,5683
1984,26,l) Left Censored,60870,84746,2200436,2145265,3039,3.5,6459,7.5,317286,60756,256530,2.8,14.8,206943,83085,123858,3.9,9.6,110343,5.2,19.2,0,3415,3449,19947
1984,27,a) 0,8718,8828,49224,24653,8781,198.9,0,0,49142,49142,0,199.3,199.3,0,0,0,0,0,49142,199.3,0,0,,,
1984,27,b) 1,5689,5934,47287,46135,151,2.3,1364,20.8,15319,3826,11493,8.3,33.2,13014,7638,5376,16.6,28.2,2305,5,56.4,0,1006,1006,6244
1984,27,c) 2,4812,5041,42746,42457,164,3,924,17,9388,959,8429,2.3,22.1,8810,4385,4425,10.3,20.8,578,1.3,41.6,0,707,713,3422
1984,27,d) 3,4412,4595,45172,44425,143,2.9,672,13.8,8867,1112,7755,2.5,20,7373,3727,3646,8.4,16.6,1494,3.4,33.2,0,494,494,2507
1984,27,e) 4,4166,4312,34602,33607,163,3.6,576,12.8,7634,668,6966,2,22.7,5643,2692,2951,8,16.8,1991,5.9,33.6,0,418,425,2202
1984,27,f) 5,4022,4259,36578,35995,139,3.1,546,12.2,7377,543,6834,1.5,20.5,6210,2827,3383,7.9,17.3,1167,3.2,34.6,0,400,404,1980
1984,27,g) 6 to 10,7802,8976,97080,96024,342,3.7,980,10.6,18170,2708,15462,2.8,18.9,16057,5254,10803,5.5,16.7,2113,2.2,33.4,0,609,632,3169
1984,27,l) Left Censored,33845,45292,1158731,1134171,1592,3.5,3409,7.4,171553,40239,131314,3.5,15.1,122434,43587,78847,3.8,10.8,49119,4.3,21.6,0,1747,1756,12701
1984,28,a) 0,4880,4899,24701,12398,4866,198.7,0,0,24606,24606,0,198.5,198.5,0,0,0,0,0,24606,198.5,0,0,,,
1984,28,b) 1,2958,3002,18611,19050,19,0.5,948,27.2,5080,225,4855,1.2,26.7,5958,3273,2685,17.2,31.3,-878,-4.6,53.4,0,741,741,2715
1984,28,c) 2,2481,2542,17603,17769,81,2.9,610,21.7,4147,614,3533,3.5,23.3,4478,2634,1844,14.8,25.2,-331,-1.9,46.6,0,485,485,2085
1984,28,d) 3,2220,2301,20623,20654,79,3.2,378,15.4,4538,765,3773,3.7,22,4599,2845,1754,13.8,22.3,-61,-0.3,44,0,280,280,1240
1984,28,e) 4,2150,2227,18201,17907,89,3.8,349,14.8,3597,323,3274,1.8,20.1,3008,1412,1596,7.9,16.8,589,3.3,33.6,0,257,257,1019
1984,28,f) 5,2091,2221,18711,18670,101,4.3,315,13.5,3524,411,3113,2.2,18.9,3442,1309,2133,7,18.4,82,0.5,36.8,0,224,224,1003
1984,28,g) 6 to 10,3873,4415,38424,38314,196,4.3,501,11,6420,888,5532,2.3,16.8,6200,2716,3484,7.1,16.2,220,0.6,32.4,0,321,321,1824
1984,28,l) Left Censored,16247,22302,456463,447936,799,3.5,1761,7.7,63294,13470,49824,3,14.1,46239,15944,30295,3.6,10.3,17055,3.8,20.6,0,951,962,5070
1984,29,a) 0,10014,10086,53073,26617,10042,199.1,0,0,52912,52912,0,198.8,198.8,0,0,0,0,0,52912,198.8,0,0,,,
1984,29,b) 1,6543,6665,48791,48498,64,0.8,2234,28.7,16226,3821,12405,7.9,33.5,15640,10430,5210,21.5,32.2,586,1.3,64.4,0,1573,1573,6905
1984,29,c) 2,5354,5610,45417,45943,205,3.3,1382,22.2,10650,1528,9122,3.3,23.2,11701,7281,4420,15.8,25.5,-1051,-2.3,46.4,0,948,954,5249
1984,29,d) 3,5017,5318,47681,48138,181,3.2,978,17.1,8823,1059,7764,2.2,18.3,9737,5241,4496,10.9,20.2,-914,-1.9,36.6,0,691,691,3629
1984,29,e) 4,4539,4718,36327,36414,165,3.3,716,14.4,7164,1263,5901,3.5,19.7,7337,3263,4074,9,20.1,-173,-0.4,39.4,0,522,524,2326
1984,29,f) 5,4496,4736,37541,37677,183,3.7,636,12.8,7435,691,6744,1.8,19.7,7707,3390,4317,9,20.5,-272,-0.8,39.4,0,468,468,2624
1984,29,g) 6 to 10,8420,9536,91957,91168,390,3.9,1172,11.8,17370,3036,14334,3.3,19.1,15791,6792,8999,7.4,17.3,1579,1.8,34.6,0,763,766,3909
1984,29,l) Left Censored,38655,53119,1336309,1318216,1998,3.7,4389,8.1,190928,46332,144596,3.5,14.5,154742,46405,108337,3.5,11.7,36186,2.8,23.4,0,2289,2307,17837
1984,30,a) 0,2521,2530,10658,5349,2510,198.4,0,0,10618,10618,0,198.5,198.5,0,0,0,0,0,10618,198.5,0,0,,,
1984,30,b) 1,1639,1713,11292,12116,28,1.4,519,26.4,3171,,,,26.2,4818,1959,2859,16.2,39.8,-1647,-13.6,52.4,1,390,390,1554
1984,30,c) 2,1381,1413,8671,8969,50,3.2,313,20.2,1754,268,1486,3,19.6,2349,1258,1091,14,26.2,-595,-6.6,39.2,0,229,229,943
1984,30,d) 3,1250,1279,8396,8777,51,3.8,203,14.9,1460,184,1276,2.1,16.6,2221,1035,1186,11.8,25.3,-761,-8.7,33.2,0,150,150,750
1984,30,e) 4,1216,1244,8678,8842,69,5.3,181,14,1583,249,1334,2.8,17.9,1910,759,1151,8.6,21.6,-327,-3.7,35.8,0,130,130,540
1984,30,f) 5,1221,1294,9055,9091,49,3.6,160,11.8,1646,,,,18.1,1718,626,1092,6.9,18.9,-72,-0.8,36.2,1,116,116,475
1984,30,g) 6 to 10,2097,2294,17029,17066,133,5.6,281,11.9,3076,616,2460,3.6,18,3149,1319,1830,7.7,18.5,-73,-0.5,36,0,162,163,706
1984,30,l) Left Censored,7229,9381,127730,128673,323,3.4,723,7.6,14838,2422,12416,1.9,11.5,16724,4798,11926,3.7,13,-1886,-1.5,23,0,375,377,2021
1984,31,a) 0,3184,3192,15865,7952,3173,198.8,0,0,15826,15826,0,199,199,0,0,0,0,0,15826,199,0,0,,,
1984,31,b) 1,2356,2455,19202,21414,45,1.6,720,25.7,6411,,,,29.9,10834,2741,8093,12.8,50.6,-4423,-20.7,59.8,1,466,466,2009
1984,31,c) 2,2063,2142,15177,15888,66,2.8,468,19.9,2506,379,2127,2.4,15.8,3928,2031,1897,12.8,24.7,-1422,-8.9,31.6,0,324,326,1414
1984,31,d) 3,1840,1923,13103,13460,76,3.7,380,18.3,2444,301,2143,2.2,18.2,3158,1753,1405,13,23.5,-714,-5.3,36.4,0,242,242,1271
1984,31,e) 4,1708,1735,11381,12218,53,2.8,343,18.3,2024,153,1871,1.3,16.6,3698,2644,1054,21.6,30.3,-1674,-13.7,33.2,0,195,195,1455
1984,31,f) 5,1623,1681,11095,11516,56,3.1,327,18,1641,,,,14.2,2482,1503,979,13.1,21.6,-841,-7.4,28.4,1,189,189,760
1984,31,g) 6 to 10,3381,3765,28935,29527,158,4,493,12.6,4650,653,3997,2.2,15.7,5834,2604,3230,8.8,19.8,-1184,-4.1,31.4,0,296,297,1450
1984,31,l) Left Censored,15140,19659,363891,364579,607,3,1634,8.1,41692,8903,32789,2.4,11.4,43068,13888,29180,3.8,11.8,-1376,-0.4,22.8,0,826,835,4483
1984,32,a) 0,2731,2746,16627,8333,2730,198.8,0,0,16589,16589,0,199.1,199.1,0,0,0,0,0,16589,199.1,0,0,,,
1984,32,b) 1,1652,1683,13867,13734,8,0.4,537,27.4,4770,88,4682,0.6,34.7,4503,2747,1756,20,32.8,267,1.9,65.6,0,407,407,2211
1984,32,c) 2,1495,1539,18517,18131,81,4.8,365,21.6,5054,377,4677,2.1,27.9,4281,2288,1993,12.6,23.6,773,4.3,47.2,0,274,274,1270
1984,32,d) 3,1328,1383,13620,13518,52,3.5,271,18.1,3037,163,2874,1.2,22.5,2832,1309,1523,9.7,20.9,205,1.6,41.8,0,190,190,1036
1984,32,e) 4,1220,1260,14173,13708,61,4.6,190,14.4,3571,351,3220,2.6,26.1,2640,1171,1469,8.5,19.3,931,6.8,38.6,0,134,134,874
1984,32,f) 5,1214,1280,13873,13588,54,4,205,15.1,2741,285,2456,2.1,20.2,2171,1119,1052,8.2,16,570,4.2,32,0,143,143,912
1984,32,g) 6 to 10,1845,2103,25566,24715,105,4.9,230,10.7,5623,695,4928,2.8,22.8,3921,1406,2515,5.7,15.9,1702,6.9,31.8,0,136,136,769
1984,32,l) Left Censored,5692,8013,245555,238261,444,5.5,614,7.6,41926,10361,31565,4.3,17.6,27337,10013,17324,4.2,11.5,14589,6.1,23,0,297,297,2053
1984,33,a) 0,2760,2775,14853,7448,2760,198.9,0,0,14811,14811,0,198.9,198.9,0,0,0,0,0,14811,198.9,0,0,,,
1984,33,b) 1,1766,1778,13316,12753,13,0.7,423,21.2,4838,379,4459,3,37.9,3711,2062,1649,16.2,29.1,1127,8.8,58.2,0,303,303,1471
1984,33,c) 2,1473,1502,12274,12234,54,3.4,241,15.1,2892,349,2543,2.9,23.6,2812,1574,1238,12.9,23,80,0.6,46,0,184,184,972
1984,33,d) 3,1223,1256,13001,12555,45,3.4,203,15.2,2943,311,2632,2.5,23.4,2050,1117,933,8.9,16.3,893,7.1,32.6,0,159,159,951
1984,33,e) 4,1097,1123,9507,9032,36,3.1,143,12.2,2445,218,2227,2.4,27.1,1495,675,820,7.5,16.6,950,10.5,33.2,0,99,99,422
1984,33,f) 5,1127,1160,11801,10942,44,3.7,127,10.6,3185,214,2971,2,29.1,1466,754,712,6.9,13.4,1719,15.7,26.8,0,94,94,584
1984,33,g) 6 to 10,2115,2421,24654,24159,131,5.3,235,9.5,4940,896,4044,3.7,20.4,3949,1392,2557,5.8,16.3,991,4.1,32.6,0,151,151,738
1984,33,l) Left Censored,8378,10494,271656,261029,393,3.7,778,7.3,44446,12835,31611,4.9,17,23192,8792,14400,3.4,8.9,21254,8.1,17.8,0,436,441,2755
1984,34,a) 0,15373,15456,82047,41122,15366,198.8,0,0,81851,81851,0,199,199,0,0,0,0,0,81851,199,0,0,,,
1984,34,b) 1,11278,11365,78396,75148,40,0.3,2573,20.3,24340,494,23846,0.7,32.4,17843,8972,8871,11.9,23.7,6497,8.7,47.4,0,1778,1778,6516
1984,34,c) 2,9762,10019,84989,84325,361,3.4,1726,16.1,19428,2030,17398,2.4,23,18099,8494,9605,10.1,21.5,1329,1.5,43,0,1265,1265,6165
1984,34,d) 3,8461,8682,77634,79065,295,3.2,1216,13.3,16576,2022,14554,2.6,21,19438,10403,9035,13.2,24.6,-2862,-3.6,42,0,853,853,8394
1984,34,e) 4,7917,8100,70225,68356,274,3.2,1074,12.6,15102,2657,12445,3.9,22.1,11364,4857,6507,7.1,16.6,3738,5.5,33.2,0,740,741,3400
1984,34,f) 5,7361,7563,59591,60897,246,3.1,959,12.1,12124,1093,11031,1.8,19.9,14735,8871,5864,14.6,24.2,-2611,-4.3,39.8,0,664,666,3787
1984,34,g) 6 to 10,13769,14947,147477,144265,578,3.7,1562,10.1,29451,4048,25403,2.8,20.4,23026,8793,14233,6.1,16,6425,4.4,32,0,1021,1021,4775
1984,34,l) Left Censored,65919,83659,2157463,2127795,2858,3.3,6420,7.5,311658,85565,226093,4,14.6,252323,75249,177074,3.5,11.9,59335,2.7,23.8,0,3684,3703,21074
1984,35,a) 0,3441,3457,17422,8726,3442,199.1,0,0,17392,17392,0,199.3,199.3,0,0,0,0,0,17392,199.3,0,0,,,
1984,35,b) 1,2412,2486,20003,20499,18,0.6,776,26.9,5650,440,5210,2.1,27.6,6642,3284,3358,16,32.4,-992,-4.8,55.2,0,596,596,2670
1984,35,c) 2,1821,1873,15605,16673,82,3.9,505,24.1,3464,465,2999,2.8,20.8,5600,2750,2850,16.5,33.6,-2136,-12.8,41.6,0,391,395,2131
1984,35,d) 3,1787,1854,14636,15026,54,2.7,336,16.8,3014,236,2778,1.6,20.1,3794,1830,1964,12.2,25.2,-780,-5.1,40.2,0,254,254,1350
1984,35,e) 4,1695,1763,14677,14732,92,5,248,13.5,3190,598,2592,4.1,21.7,3300,1367,1933,9.3,22.4,-110,-0.7,43.4,0,182,183,1088
1984,35,f) 5,1545,1641,14666,14910,55,3.1,279,15.9,3050,321,2729,2.2,20.5,3538,1493,2045,10,23.7,-488,-3.2,41,0,180,180,977
1984,35,g) 6 to 10,2661,2986,25544,25711,150,4.9,346,11.2,4795,826,3969,3.2,18.6,5128,1691,3437,6.6,19.9,-333,-1.3,37.2,0,220,220,1041
1984,35,l) Left Censored,8977,12374,230955,227953,569,4.5,1078,8.5,36203,12716,23487,5.6,15.9,30199,8646,21553,3.8,13.2,6004,2.7,26.4,0,539,539,3073
1984,36,a) 0,36014,36211,184335,92403,36064,199.2,0,0,183865,183865,0,199,199,0,0,0,0,0,183865,199,0,0,,,
1984,36,b) 1,26668,26948,185903,178218,102,0.3,6436,21.3,59573,1923,57650,1.1,33.4,44203,25447,18756,14.3,24.8,15370,8.6,49.6,0,4648,4649,20625
1984,36,c) 2,22211,22760,180165,182195,724,2.9,4215,17.2,38950,4808,34142,2.6,21.4,43009,22456,20553,12.3,23.6,-4059,-2.2,42.8,0,3196,3199,18066
1984,36,d) 3,19409,19918,181838,187312,596,2.8,3093,14.6,31539,3402,28137,1.8,16.8,42487,15012,27475,8,22.7,-10948,-5.9,33.6,0,2374,2377,12109
1984,36,e) 4,17373,17753,161831,161518,531,2.8,2578,13.7,28656,2251,26405,1.4,17.7,28030,13826,14204,8.6,17.4,626,0.3,34.8,0,1952,1952,11059
1984,36,f) 5,16162,16671,132212,134643,450,2.6,2264,12.9,24889,2929,21960,2.2,18.5,29751,10325,19426,7.7,22.1,-4862,-3.6,37,0,1613,1613,7407
1984,36,g) 6 to 10,30990,34481,357566,357529,1179,3.3,3969,11.1,59176,9053,50123,2.5,16.6,59101,23774,35327,6.6,16.5,75,0.1,33,0,2740,2749,14691
1984,36,l) Left Censored,156253,194176,4824995,4804892,5273,2.6,15812,7.9,631597,161520,470077,3.4,13.1,591393,176149,415244,3.7,12.3,40204,0.8,24.6,0,9736,9764,77909
1984,37,a) 0,14528,14642,71293,36100,14327,195.7,0,0,70387,70387,0,195,195,0,0,0,0,0,70387,195,0,0,,,
1984,37,b) 1,8365,8510,56907,57029,36,0.4,1178,13,15689,556,15133,1,27.5,15934,4371,11563,7.7,27.9,-245,-0.4,55,0,60,60,324
1984,37,c) 2,6556,6800,56147,54018,248,3.5,930,13,13936,1800,12136,3.3,25.8,9678,4671,5007,8.6,17.9,4258,7.9,35.8,0,54,55,350
1984,37,d) 3,5736,5965,59338,57662,171,2.8,486,8,11199,919,10280,1.6,19.4,7847,2852,4995,4.9,13.6,3352,5.8,27.2,0,25,25,174
1984,37,e) 4,5137,5335,44563,42462,137,2.6,361,6.7,9932,1519,8413,3.6,23.4,5730,2187,3543,5.2,13.5,4202,9.9,27,0,15,16,88
1984,37,f) 5,5047,5332,47693,45570,152,2.9,332,6.2,10121,1342,8779,2.9,22.2,5874,1786,4088,3.9,12.9,4247,9.3,25.8,0,21,21,149
1984,37,g) 6 to 10,9798,11164,108207,105656,336,3,676,6.1,18905,2287,16618,2.2,17.9,13802,3490,10312,3.3,13.1,5103,4.8,26.2,0,16,18,197
1984,37,l) Left Censored,42265,61708,1690366,1638978,2162,3.5,2652,4.3,237241,47997,189244,2.9,14.5,134464,36237,98227,2.2,8.2,102777,6.3,16.4,0,39,44,467
1984,38,a) 0,1593,1601,7750,3885,1589,198.5,0,0,7731,7731,0,199,199,0,0,0,0,0,7731,199,0,0,,,
1984,38,b) 1,1103,1163,8076,8332,45,3.5,315,24.2,2484,985,1499,11.8,29.8,2996,1324,1672,15.9,36,-512,-6.2,59.6,0,210,210,883
1984,38,c) 2,972,990,6058,6277,38,3.5,209,19.4,1167,294,873,4.7,18.6,1605,749,856,11.9,25.6,-438,-7,37.2,0,152,152,541
1984,38,d) 3,846,878,7141,7313,27,2.8,182,19,1259,156,1103,2.1,17.2,1603,894,709,12.2,21.9,-344,-4.7,34.4,0,120,120,621
1984,38,e) 4,812,835,5604,5853,19,2.1,144,16.1,868,45,823,0.8,14.8,1365,681,684,11.6,23.3,-497,-8.5,29.6,0,88,88,417
1984,38,f) 5,802,840,5929,6090,30,3.4,117,13.3,942,157,785,2.6,15.5,1263,510,753,8.4,20.7,-321,-5.2,31,0,71,71,273
1984,38,g) 6 to 10,1477,1598,11104,11263,56,3.4,195,11.7,1572,303,1269,2.7,14,1890,777,1113,6.9,16.8,-318,-2.8,28,0,111,112,455
1984,38,l) Left Censored,6492,8392,122441,122893,266,3.1,658,7.7,13571,2561,11010,2.1,11,14475,4931,9544,4,11.8,-904,-0.8,22,0,302,304,1866
1984,39,a) 0,17104,17225,97717,49097,17115,198.7,0,0,97241,97241,0,198.1,198.1,0,0,0,0,0,97241,198.1,0,0,,,
1984,39,b) 1,11247,11476,83947,81803,67,0.5,2766,21.5,24639,1844,22795,2.3,30.1,20351,11462,8889,14,24.9,4288,5.2,49.8,0,2025,2032,8660
1984,39,c) 2,9963,10393,77221,78115,395,3.5,1940,17.3,17073,2517,14556,3.2,21.9,18860,9655,9205,12.4,24.1,-1787,-2.2,43.8,0,1462,1468,6928
1984,39,d) 3,8969,9407,96497,94280,339,3.4,1367,13.8,18318,2300,16018,2.4,19.4,13883,6288,7595,6.7,14.7,4435,4.7,29.4,0,977,977,4334
1984,39,e) 4,8189,8669,67758,67168,348,3.8,1162,12.8,13246,1653,11593,2.5,19.7,12066,4905,7161,7.3,18,1180,1.7,36,0,809,809,3423
1984,39,f) 5,7953,8409,76054,75191,322,3.7,1101,12.5,13788,1405,12383,1.9,18.3,12062,5442,6620,7.2,16,1726,2.3,32,0,787,787,3710
1984,39,g) 6 to 10,15666,18514,177266,176708,845,4.4,1932,10.2,31063,5641,25422,3.2,17.6,29947,10961,18986,6.2,16.9,1116,0.7,33.8,0,1138,1150,6210
1984,39,l) Left Censored,78968,114371,2891434,2851423,3970,3.4,8532,7.3,379594,80894,298700,2.8,13.3,299572,86666,212906,3,10.5,80022,2.8,21,0,4212,4279,23829
1984,40,a) 0,8283,8335,41725,20921,8285,198.8,0,0,41609,41609,0,198.9,198.9,0,0,0,0,0,41609,198.9,0,0,,,
1984,40,b) 1,5497,5585,35347,37350,36,0.6,1886,28.8,9112,522,8590,1.4,24.4,13118,7793,5325,20.9,35.1,-4006,-10.7,48.8,0,1464,1464,6338
1984,40,c) 2,5117,5303,40620,43162,193,3.3,1419,23.9,8058,1361,6697,3.2,18.7,13141,7379,5762,17.1,30.4,-5083,-11.7,37.4,0,1129,1129,5882
1984,40,d) 3,4146,4315,35544,37563,154,3.3,958,20.3,6349,921,5428,2.5,16.9,10387,5052,5335,13.4,27.7,-4038,-10.8,33.8,0,768,770,4196
1984,40,e) 4,3707,3848,30549,32974,102,2.5,655,15.9,5361,753,4608,2.3,16.3,10211,4419,5792,13.4,31,-4850,-14.7,32.6,0,503,503,3301
1984,40,f) 5,3391,3584,28336,29733,124,3.3,554,14.6,4586,768,3818,2.6,15.4,7380,3095,4285,10.4,24.8,-2794,-9.4,30.8,0,411,411,2336
1984,40,g) 6 to 10,5763,6514,60378,62198,228,3.3,823,12.1,9556,1906,7650,3.1,15.4,13195,5122,8073,8.2,21.2,-3639,-5.8,30.8,0,579,581,3395
1984,40,l) Left Censored,22197,30985,643450,650326,1343,4.3,2483,7.9,88365,25558,62807,3.9,13.6,102116,28690,73426,4.4,15.7,-13751,-2.1,27.2,0,1356,1361,7742
1984,41,a) 0,7249,7277,35953,18033,7225,198.6,0,0,35841,35841,0,198.8,198.8,0,0,0,0,0,35841,198.8,0,0,,,
1984,41,b) 1,4553,4706,33887,35032,33,0.6,1397,25.8,9473,526,8947,1.5,27,11762,5103,6659,14.6,33.6,-2289,-6.6,54,0,1082,1082,4254
1984,41,c) 2,4064,4204,32380,31972,202,4.5,838,18.5,8574,1607,6967,5,26.8,7758,4261,3497,13.3,24.3,816,2.5,48.6,0,643,643,3085
1984,41,d) 3,3754,3910,31162,31026,173,4.2,675,16.2,6328,1033,5295,3.3,20.4,6056,3002,3054,9.7,19.5,272,0.9,39,0,512,512,2439
1984,41,e) 4,3543,3680,26086,25806,173,4.5,554,14.3,5662,566,5096,2.2,21.9,5102,2461,2641,9.5,19.8,560,2.1,39.6,0,397,397,1852
1984,41,f) 5,3103,3245,25644,25132,179,5.3,471,13.9,5866,916,4950,3.6,23.3,4842,2084,2758,8.3,19.3,1024,4,38.6,0,327,330,1485
1984,41,g) 6 to 10,5736,6468,60401,59918,333,5,822,12.3,11302,1520,9782,2.5,18.9,10336,3570,6766,6,17.3,966,1.6,34.6,0,523,523,2496
1984,41,l) Left Censored,20490,28271,544101,538701,1281,4.5,2303,8,76574,15011,61563,2.8,14.2,65774,20378,45396,3.8,12.2,10800,2,24.4,0,1239,1247,6833
1984,42,a) 0,18776,18924,107663,53977,18833,199,0,0,107372,107372,0,198.9,198.9,0,0,0,0,0,107372,198.9,0,0,,,
1984,42,b) 1,12756,12962,97776,95966,78,0.5,3060,21.1,27268,1274,25994,1.3,28.4,23648,12583,11065,13.1,24.6,3620,3.8,49.2,0,2148,2150,9205
1984,42,c) 2,11012,11438,107679,106249,338,2.7,2035,16.5,25885,7597,18288,7.2,24.4,23024,12954,10070,12.2,21.7,2861,2.7,43.4,0,1392,1398,8796
1984,42,d) 3,9618,10015,97198,98372,326,3.1,1495,14.1,18606,2352,16254,2.4,18.9,20954,12105,8849,12.3,21.3,-2348,-2.4,37.8,0,1066,1067,10230
1984,42,e) 4,9173,9491,76999,76615,284,2.8,1288,12.9,13872,1563,12309,2,18.1,13103,6231,6872,8.1,17.1,769,1,34.2,0,902,903,4671
1984,42,f) 5,8863,9384,79111,78842,336,3.4,1201,12.2,14643,2238,12405,2.8,18.6,14104,6040,8064,7.7,17.9,539,0.7,35.8,0,802,802,4003
1984,42,g) 6 to 10,17478,20200,212121,209983,849,4.1,2193,10.5,35240,6105,29135,2.9,16.8,30964,11910,19054,5.7,14.7,4276,2.1,29.4,0,1325,1331,5914
1984,42,l) Left Censored,91218,125125,3178822,3147477,4219,3.3,9943,7.8,420029,93877,326152,3,13.3,357338,113754,243584,3.6,11.4,62691,1.9,22.8,0,5282,5335,33452
1984,44,a) 0,2036,2041,10061,5050,2027,198.6,0,0,10023,10023,0,198.5,198.5,0,0,0,0,0,10023,198.5,0,0,,,
1984,44,b) 1,1349,1361,9335,8789,4,0.3,311,20.5,2878,,,,32.7,1785,903,882,10.3,20.3,1093,12.4,40.6,1,235,236,580
1984,44,c) 2,1122,1151,9532,9265,35,2.8,188,15.3,2226,191,2035,2.1,24,1691,918,773,9.9,18.3,535,5.7,36.6,0,138,138,692
1984,44,d) 3,1003,1020,9012,8940,34,3.2,147,13.6,1770,170,1600,1.9,19.8,1625,653,972,7.3,18.2,145,1.6,36.4,0,124,124,561
1984,44,e) 4,936,965,7469,7330,39,3.9,132,13.1,1520,218,1302,3,20.7,1242,472,770,6.4,16.9,278,3.8,33.8,0,96,96,389
1984,44,f) 5,930,962,8721,8333,33,3.3,116,11.6,2062,,,,24.7,1285,599,686,7.2,15.4,777,9.3,30.8,1,89,89,528
1984,44,g) 6 to 10,1789,1916,19983,19975,61,3.1,219,11,3529,615,2914,3.1,17.7,3512,1059,2453,5.3,17.6,17,0.1,35.2,0,141,142,583
1984,44,l) Left Censored,9645,11468,278413,275031,281,2.4,867,7.4,35523,7698,27825,2.8,12.9,28759,9026,19733,3.3,10.5,6764,2.4,21,0,500,502,3057
1984,45,a) 0,6908,6960,37697,19064,6815,195.8,0,0,37267,37267,0,195.5,195.5,0,0,0,0,0,37267,195.5,0,0,,,
1984,45,b) 1,4250,4333,33674,31493,24,0.5,507,11.1,10264,1652,8612,5.2,32.6,5901,2207,3694,7,18.7,4363,13.9,37.4,1,29,29,
1984,45,c) 2,3440,3572,30666,30092,118,3.1,498,13.3,7292,856,6436,2.8,24.2,6143,3139,3004,10.4,20.4,1149,3.8,40.8,0,20,21,236
1984,45,d) 3,2889,3029,28087,27463,88,2.8,336,10.8,5931,763,5168,2.8,21.6,4682,1844,2838,6.7,17,1249,4.6,34,0,10,10,113
1984,45,e) 4,2663,2781,23983,22669,112,4,206,7.4,5577,821,4756,3.6,24.6,2949,1179,1770,5.2,13,2628,11.6,26,1,2,2,
1984,45,f) 5,2454,2607,21736,20775,73,2.8,164,6.3,4213,414,3799,2,20.3,2291,609,1682,2.9,11,1922,9.3,22,0,9,10,47
1984,45,g) 6 to 10,4797,5468,46884,46519,223,4.1,452,8.3,8774,1406,7368,3,18.9,8043,3085,4958,6.6,17.3,731,1.6,34.6,0,15,15,126
1984,45,l) Left Censored,20366,29356,756122,741545,1174,4,1674,5.7,100057,25036,75021,3.4,13.5,70903,21251,49652,2.9,9.6,29154,3.9,19.2,0,42,43,500
1984,46,a) 0,1634,1637,7562,3799,1623,198.3,0,0,7527,7527,0,198.1,198.1,0,0,0,0,0,7527,198.1,0,0,,,
1984,46,b) 1,1012,1066,6872,6956,39,3.2,343,28,1960,349,1611,5,28.2,2127,1084,1043,15.6,30.6,-167,-2.4,56.4,0,240,240,850
1984,46,c) 2,873,899,5357,5754,36,3.7,178,18.3,730,87,643,1.5,12.7,1524,792,732,13.8,26.5,-794,-13.8,25.4,0,116,116,517
1984,46,d) 3,806,824,6011,5784,28,3.2,124,14.2,1417,132,1285,2.3,24.5,962,538,424,9.3,16.6,455,7.9,33.2,0,78,78,351
1984,46,e) 4,783,798,4897,5061,39,4.5,166,19.2,1001,266,735,5.3,19.8,1329,897,432,17.7,26.3,-328,-6.5,39.6,0,94,94,390
1984,46,f) 5,723,750,5508,5597,29,3.6,141,17.5,970,99,871,1.8,17.3,1148,637,511,11.4,20.5,-178,-3.2,34.6,0,78,78,299
1984,46,g) 6 to 10,1524,1685,11220,11611,62,3.5,228,12.9,1608,252,1356,2.2,13.8,2390,1119,1271,9.6,20.6,-782,-6.8,27.6,0,128,129,543
1984,46,l) Left Censored,6911,8600,127715,125921,293,3.3,688,7.8,16663,2908,13755,2.3,13.2,13075,4571,8504,3.6,10.4,3588,2.8,20.8,0,333,334,1901
1984,47,a) 0,10135,10182,56702,28415,10135,199.1,0,0,56574,56574,0,199.1,199.1,0,0,0,0,0,56574,199.1,0,0,,,
1984,47,b) 1,6020,6111,45509,46178,39,0.6,1918,27.1,12977,621,12356,1.3,28.1,14314,8922,5392,19.3,31,-1337,-2.9,56.2,0,1505,1505,7093
1984,47,c) 2,4848,5056,45274,45922,178,3.2,1186,21.3,10186,1771,8415,3.9,22.2,11481,6040,5441,13.2,25,-1295,-2.8,44.4,0,904,916,4448
1984,47,d) 3,4046,4229,40637,40454,159,3.5,814,17.9,8568,1064,7504,2.6,21.2,8202,4613,3589,11.4,20.3,366,0.9,40.6,0,639,641,3552
1984,47,e) 4,3856,4020,33789,33665,135,3.2,644,15.1,6706,617,6089,1.8,19.9,6457,3148,3309,9.4,19.2,249,0.7,38.4,0,479,483,2375
1984,47,f) 5,3690,3901,37126,38567,143,3.5,518,12.7,7520,1185,6335,3.1,19.5,10402,2981,7421,7.7,27,-2882,-7.5,39,0,394,395,2368
1984,47,g) 6 to 10,7329,8449,91993,89175,396,4.5,989,11.3,18578,2761,15817,3.1,20.8,12942,5364,7578,6,14.5,5636,6.3,29,0,625,628,3113
1984,47,l) Left Censored,31134,44320,1138873,1125645,1895,4.2,3688,8.2,160158,38188,121970,3.4,14.2,133701,41928,91773,3.7,11.9,26457,2.3,23.8,0,1890,1902,12182
1984,48,a) 0,39399,39872,242799,121805,39665,199,0,0,241989,241989,0,198.7,198.7,0,0,0,0,0,241989,198.7,0,0,,,
1984,48,b) 1,27496,28012,224479,223109,200,0.6,8634,26.6,72762,3600,69162,1.6,32.6,70023,42224,27799,18.9,31.4,2739,1.2,62.8,0,6623,6623,33568
1984,48,c) 2,23915,25131,215291,219811,949,3.4,6376,22.8,55942,6379,49563,2.9,25.5,64981,36731,28250,16.7,29.6,-9039,-4.1,51,0,4852,4862,28041
1984,48,d) 3,29415,30849,296726,303037,931,2.8,5779,17.3,63966,6857,57109,2.3,21.1,76588,37717,38871,12.4,25.3,-12622,-4.2,42.2,0,4552,4563,30485
1984,48,e) 4,9315,10034,96035,97318,320,3,1651,15.4,20592,3482,17110,3.6,21.2,23157,10592,12565,10.9,23.8,-2565,-2.6,42.4,0,1174,1186,8123
1984,48,f) 5,16384,17914,185833,187695,605,3.2,2639,13.9,37348,4081,33267,2.2,19.9,41071,19090,21981,10.2,21.9,-3723,-2,39.8,0,1901,1907,12682
1984,48,g) 6 to 10,26664,31235,341288,343791,1452,4.5,4054,12.5,70394,15433,54961,4.5,20.5,75400,26732,48668,7.8,21.9,-5006,-1.4,41,0,2573,2593,14933
1984,48,l) Left Censored,91505,148784,3784604,3769638,8068,5.3,13512,8.9,604671,218473,386198,5.8,16,574739,166822,407917,4.4,15.2,29932,0.8,30.4,0,6229,6294,44349
1984,49,a) 0,3285,3329,21112,10666,3302,198.4,0,0,20893,20893,0,195.9,195.9,0,0,0,0,0,20893,195.9,0,0,,,
1984,49,b) 1,2140,2207,19552,20765,23,0.9,682,26.7,5320,679,4641,3.3,25.6,7746,3533,4213,17,37.3,-2426,-11.7,51.2,0,497,497,2383
1984,49,c) 2,1961,2054,17077,17545,91,4,471,20.9,4439,1027,3412,5.9,25.3,5374,2460,2914,14,30.6,-935,-5.3,50.6,0,360,360,1991
1984,49,d) 3,1672,1772,17157,17337,57,3,326,17.1,3775,412,3363,2.4,21.8,4135,2111,2024,12.2,23.9,-360,-2.1,43.6,0,240,240,1485
1984,49,e) 4,1491,1578,12873,12607,73,4.4,261,15.6,3064,538,2526,4.3,24.3,2532,1387,1145,11,20.1,532,4.2,40.2,0,187,187,1059
1984,49,f) 5,1531,1652,14092,14072,94,5.5,232,13.5,2955,437,2518,3.1,21,2914,1177,1737,8.4,20.7,41,0.3,41.4,0,153,153,803
1984,49,g) 6 to 10,2694,2996,29642,29579,153,5,319,10.4,5509,928,4581,3.1,18.6,5382,2202,3180,7.4,18.2,127,0.4,36.4,0,178,178,1337
1984,49,l) Left Censored,9630,13569,317644,311081,626,4.5,1073,7.8,45891,8839,37052,2.8,14.8,32764,10623,22141,3.4,10.5,13127,4.3,21,0,530,531,3137
1984,50,a) 0,1637,1647,7888,3963,1632,198.2,0,0,7850,7850,0,198.1,198.1,0,0,0,0,0,7850,198.1,0,0,,,
1984,50,b) 1,1085,1094,5627,5705,9,0.7,234,19.3,1497,69,1428,1.2,26.2,1653,855,798,15,29,-156,-2.8,52.4,0,159,159,717
1984,50,c) 2,934,957,6412,6303,27,2.6,160,15.6,1547,113,1434,1.8,24.5,1329,646,683,10.2,21.1,218,3.4,42.2,0,120,120,506
1984,50,d) 3,803,816,5853,5776,24,2.8,111,12.9,1187,73,1114,1.3,20.6,1033,529,504,9.2,17.9,154,2.7,35.8,0,90,90,395
1984,50,e) 4,693,707,4812,4688,25,3.4,100,13.5,1010,64,946,1.4,21.5,761,377,384,8,16.2,249,5.3,32.4,0,72,72,253
1984,50,f) 5,646,661,4986,4906,23,3.3,86,12.4,995,92,903,1.9,20.3,834,387,447,7.9,17,161,3.3,34,0,62,62,298
1984,50,g) 6 to 10,1356,1504,14072,13890,58,3.7,183,11.7,2261,292,1969,2.1,16.3,1896,916,980,6.6,13.7,365,2.6,27.4,0,120,120,441
1984,50,l) Left Censored,5151,6302,123814,122213,212,3.3,451,7,14269,3025,11244,2.5,11.7,11067,3700,7367,3,9.1,3202,2.6,18.2,0,276,278,1680
1984,51,a) 0,10052,10108,52588,26295,10106,200,0,0,52586,52586,0,200,200,0,0,0,0,0,52586,200,0,0,,,
1984,51,b) 1,6497,6587,46012,46407,38,0.5,2469,31.4,14121,796,13325,1.7,30.4,14911,10721,4190,23.1,32.1,-790,-1.7,60.8,0,1500,1500,6288
1984,51,c) 2,5647,5857,53093,54126,173,2.6,1574,23.8,12556,2101,10455,3.9,23.2,14622,8907,5715,16.5,27,-2066,-3.8,46.4,0,976,976,5670
1984,51,d) 3,4967,5222,54186,54537,147,2.6,1159,20.1,10896,887,10009,1.6,20,11597,7095,4502,13,21.3,-701,-1.3,40,0,714,715,3292
1984,51,e) 4,4542,4700,40883,41080,161,3.1,998,19.4,8247,741,7506,1.8,20.1,8640,5649,2991,13.8,21,-393,-0.9,40.2,0,535,535,2992
1984,51,f) 5,4201,4458,44409,44796,160,3.3,855,17.7,8223,1037,7186,2.3,18.4,8996,4494,4502,10,20.1,-773,-1.7,36.8,0,432,433,1984
1984,51,g) 6 to 10,7937,9394,109238,108446,429,4.3,1405,14.2,21233,3807,17426,3.5,19.6,19648,8262,11386,7.6,18.1,1585,1.5,36.2,0,688,706,4201
1984,51,l) Left Censored,34866,52076,1301166,1277567,2335,4.4,5144,9.6,185687,47357,138330,3.7,14.5,138489,52956,85533,4.1,10.8,47198,3.7,21.6,0,2209,2212,17358
1984,53,a) 0,11649,11710,58596,29396,11634,198.7,0,0,58401,58401,0,198.7,198.7,0,0,0,0,0,58401,198.7,0,0,,,
1984,53,b) 1,7638,7794,51705,53960,47,0.5,2162,24.3,15262,980,14282,1.8,28.3,19772,9644,10128,17.9,36.6,-4510,-8.3,56.6,0,1586,1586,7177
1984,53,c) 2,6358,6592,52201,52820,296,4.1,1341,18.8,12279,1705,10574,3.2,23.2,13517,7305,6212,13.8,25.6,-1238,-2.4,46.4,0,1009,1009,5560
1984,53,d) 3,5494,5724,48011,47995,258,4.3,939,15.5,10111,902,9209,1.9,21.1,10079,4473,5606,9.3,21,32,0.1,42,0,686,688,3583
1984,53,e) 4,5212,5431,41656,40930,233,4.1,820,14.3,9582,1870,7712,4.6,23.4,8129,3984,4145,9.7,19.9,1453,3.5,39.8,0,579,579,3016
1984,53,f) 5,4709,4917,35760,35651,256,5,701,13.7,7626,906,6720,2.5,21.4,7407,3474,3933,9.7,20.8,219,0.6,41.6,0,507,507,2506
1984,53,g) 6 to 10,8956,10211,94750,94771,580,5.5,1180,11.3,17921,2656,15265,2.8,18.9,17962,6513,11449,6.9,19,-41,-0.1,37.8,0,761,762,3919
1984,53,l) Left Censored,30680,43124,904750,897029,1854,4.2,3371,7.7,132375,32503,99872,3.6,14.8,116933,32622,84311,3.6,13,15442,1.8,26,0,1786,1791,10034
1984,54,a) 0,2700,2711,12645,6323,2710,199.9,0,0,12644,12644,0,200,200,0,0,0,0,0,12644,200,0,0,,,
1984,54,b) 1,1662,1688,11161,11985,5,0.2,708,34.4,3183,13,3170,0.1,26.6,4831,3294,1537,27.5,40.3,-1648,-13.7,53.2,0,454,454,2228
1984,54,c) 2,1596,1631,15008,15401,43,2.3,475,25.6,2950,267,2683,1.7,19.2,3736,2388,1348,15.5,24.3,-786,-5.1,38.4,0,289,289,1245
1984,54,d) 3,1391,1432,12155,13022,39,2.4,350,21.9,2249,212,2037,1.6,17.3,3982,1581,2401,12.1,30.6,-1733,-13.3,34.6,0,210,210,829
1984,54,e) 4,1204,1271,9429,9750,59,4.2,296,21.2,1462,238,1224,2.4,15,2104,1191,913,12.2,21.6,-642,-6.6,30,0,160,160,698
1984,54,f) 5,1225,1291,9575,9664,57,4.1,266,19,1815,293,1522,3,18.8,1993,1042,951,10.8,20.6,-178,-1.8,37.6,0,160,160,635
1984,54,g) 6 to 10,2386,2771,24790,25365,135,4.6,442,15,4116,880,3236,3.5,16.2,5266,2423,2843,9.6,20.8,-1150,-4.6,32.4,0,219,219,1310
1984,54,l) Left Censored,12526,16919,329724,330409,654,3.7,1973,11.2,41247,11189,30058,3.4,12.5,42616,17944,24672,5.4,12.9,-1369,-0.4,25,0,774,779,4622
1984,55,a) 0,8996,9043,48073,24133,8996,199,0,0,47880,47880,0,198.4,198.4,0,0,0,0,0,47880,198.4,0,0,,,
1984,55,b) 1,5721,5842,41235,40267,44,0.7,1463,22.2,11937,929,11008,2.3,29.6,10001,5760,4241,14.3,24.8,1936,4.8,49.6,0,1045,1045,3958
1984,55,c) 2,5164,5360,41184,40908,202,3.5,932,16.2,9058,1644,7414,4,22.1,8505,4513,3992,11,20.8,553,1.3,41.6,0,691,692,3429
1984,55,d) 3,4664,4834,41499,41798,173,3.4,732,14.3,7398,1026,6372,2.5,17.7,7995,4196,3799,10,19.1,-597,-1.4,35.4,0,504,506,2118
1984,55,e) 4,4369,4517,34801,34570,181,3.8,641,13.5,6525,952,5573,2.8,18.9,6062,2743,3319,7.9,17.5,463,1.4,35,0,443,443,1898
1984,55,f) 5,4274,4492,33841,34586,166,3.5,567,12.1,5513,985,4528,2.8,15.9,7002,3066,3936,8.9,20.2,-1489,-4.3,31.8,0,392,393,2391
1984,55,g) 6 to 10,8763,9926,93165,91119,358,3.5,1077,10.5,17167,2299,14868,2.5,18.8,13074,5547,7527,6.1,14.3,4093,4.5,28.6,0,626,635,3192
1984,55,l) Left Censored,40699,52940,1251544,1230995,1777,3.3,3814,7.1,166441,33355,133086,2.7,13.5,125342,38567,86775,3.1,10.2,41099,3.3,20.4,0,2103,2110,11503
1984,56,a) 0,1437,1438,6509,3259,1433,199.3,0,0,6500,6500,0,199.4,199.4,0,0,0,0,0,6500,199.4,0,0,,,
1984,56,b) 1,1105,1145,7425,8248,10,0.8,363,27.3,2105,,,,25.5,3751,1544,2207,18.7,45.5,-1646,-20,51,1,265,265,
1984,56,c) 2,980,1022,6862,7136,55,4.8,276,24.3,1547,210,1337,2.9,21.7,2094,1062,1032,14.9,29.3,-547,-7.6,43.4,0,209,210,893
1984,56,d) 3,925,954,5796,6198,34,3.3,188,18.2,965,85,880,1.4,15.6,1769,741,1028,12,28.5,-804,-12.9,31.2,0,129,130,490
1984,56,e) 4,738,779,5114,5459,26,3.1,138,16.5,789,102,687,1.9,14.5,1478,587,891,10.8,27.1,-689,-12.6,29,1,98,98,
1984,56,f) 5,751,796,5886,6202,28,3.3,143,16.7,978,,,,15.8,1609,674,935,10.9,25.9,-631,-10.1,31.6,1,90,91,444
1984,56,g) 6 to 10,1323,1456,13057,13471,73,4.8,190,12.6,2127,697,1430,5.2,15.8,2955,1000,1955,7.4,21.9,-828,-6.1,31.6,0,117,117,560
1984,56,l) Left Censored,4257,5602,83864,84585,257,4.5,539,9.4,13112,5251,7861,6.2,15.5,14554,4907,9647,5.8,17.2,-1442,-1.7,31,0,237,237,1502
1985,01,a) 0,7140,7230,41850,21007,7195,199,0,0,41687,41687,0,198.4,198.4,0,0,0,0,0,41687,198.4,0,0,,,
1985,01,b) 1,6135,6220,49184,48930,50,0.7,1537,21.9,12356,923,11433,1.9,25.3,11847,6457,5390,13.2,24.2,509,1.1,48.4,0,1140,1140,4955
1985,01,c) 2,3662,3748,28863,29127,177,4.3,907,22,7631,873,6758,3,26.2,8159,4312,3847,14.8,28,-528,-1.8,52.4,0,709,712,3526
1985,01,d) 3,3107,3273,32181,31540,138,3.9,595,17,8378,1258,7120,4,26.6,7095,3726,3369,11.8,22.5,1283,4.1,45,0,456,459,2735
1985,01,e) 4,2929,3062,34640,33882,101,3.1,449,13.9,8030,516,7514,1.5,23.7,6513,3210,3303,9.5,19.2,1517,4.5,38.4,0,329,330,2271
1985,01,f) 5,2786,2927,23905,24457,120,3.9,407,13.3,4484,527,3957,2.2,18.3,5588,2264,3324,9.3,22.8,-1104,-4.5,36.6,0,300,301,1679
1985,01,g) 6 to 10,8145,9463,101408,101678,468,4.8,1054,10.8,16846,3537,13309,3.5,16.6,17386,6602,10784,6.5,17.1,-540,-0.5,33.2,0,737,741,4605
1985,01,l) Left Censored,23018,33372,820402,822984,1398,4.1,2909,8.5,100191,21671,78520,2.6,12.2,105356,35880,69476,4.4,12.8,-5165,-0.6,24.4,0,1491,1510,12798
1985,02,a) 0,1835,1851,9849,4952,1838,198.6,0,0,9794,,,,197.8,0,0,0,0,0,9794,197.8,0,1,,,
1985,02,b) 1,1417,1427,8745,9242,4,0.2,525,30.9,2994,,,,32.4,3988,2309,1679,25,43.2,-994,-10.8,64.8,1,398,398,1644
1985,02,c) 2,1033,1069,7473,8245,58,4.8,327,27,1754,270,1484,3.3,21.3,3297,1625,1672,19.7,40,-1543,-18.7,42.6,0,240,240,1095
1985,02,d) 3,754,796,7205,7229,37,4.3,163,18.9,2098,189,1909,2.6,29,2145,1006,1139,13.9,29.7,-47,-0.7,58,0,116,118,776
1985,02,e) 4,551,592,6104,6190,28,4.5,89,14.3,1340,110,1230,1.8,21.6,1511,471,1040,7.6,24.4,-171,-2.8,43.2,0,58,58,281
1985,02,f) 5,534,548,4987,5220,28,4.9,80,13.9,894,141,753,2.7,17.1,1359,487,872,9.3,26,-465,-8.9,34.2,0,57,58,375
1985,02,g) 6 to 10,1422,1690,17976,17755,97,5.5,232,13.2,4107,529,3578,3,23.1,3665,1530,2135,8.6,20.6,442,2.5,41.2,0,149,150,923
1985,02,l) Left Censored,2641,3952,91237,90649,260,6.5,385,9.6,17775,5406,12369,6,19.6,16598,6731,9867,7.4,18.3,1177,1.3,36.6,0,157,158,1003
1985,04,a) 0,9007,9077,61983,31098,9017,198.7,0,0,61771,61771,0,198.6,198.6,0,0,0,0,0,61771,198.6,0,0,,,
1985,04,b) 1,6588,6707,54961,52334,52,0.7,1914,24.9,20811,1677,19134,3.2,39.8,15557,9457,6100,18.1,29.7,5254,10.1,59.4,0,1436,1437,7604
1985,04,c) 2,4600,4816,51852,51941,248,4.7,1036,19.8,13919,3002,10917,5.8,26.8,14097,7212,6885,13.9,27.1,-178,-0.3,53.6,0,829,829,6074
1985,04,d) 3,4138,4371,44214,44342,198,4.2,800,17.1,11283,968,10315,2.2,25.4,11539,5732,5807,12.9,26,-256,-0.6,50.8,0,598,600,4209
1985,04,e) 4,3377,3577,37331,36180,169,4.5,566,15,9814,1303,8511,3.6,27.1,7512,3581,3931,9.9,20.8,2302,6.3,41.6,0,404,406,2716
1985,04,f) 5,3245,3431,34949,34273,149,4.1,481,13.4,8848,770,8078,2.2,25.8,7495,3101,4394,9,21.9,1353,3.9,43.8,0,348,350,2302
1985,04,g) 6 to 10,7524,8566,113393,109381,442,4.9,1174,13.1,28450,4420,24030,4,26,20425,9520,10905,8.7,18.7,8025,7.3,37.4,0,721,738,5607
1985,04,l) Left Censored,14800,24037,651339,638425,1356,5.6,2000,8.2,109116,26056,83060,4.1,17.1,83289,30762,52527,4.8,13,25827,4.1,26,0,875,883,8573
1985,05,a) 0,4791,4837,24536,12288,4818,199.2,0,0,24497,24497,0,199.4,199.4,0,0,0,0,0,24497,199.4,0,0,,,
1985,05,b) 1,4138,4172,25327,25664,22,0.5,1174,24.5,7336,339,6997,1.3,28.6,8010,4883,3127,19,31.2,-674,-2.6,57.2,0,920,920,3916
1985,05,c) 2,2613,2677,19023,19980,106,3.6,627,21.2,4144,868,3276,4.3,20.7,6058,3144,2914,15.7,30.3,-1914,-9.6,41.4,0,510,510,2619
1985,05,d) 3,2284,2345,18723,19687,85,3.4,432,17.2,3611,323,3288,1.6,18.3,5538,3171,2367,16.1,28.1,-1927,-9.8,36.6,0,338,338,2137
1985,05,e) 4,2049,2111,19357,19767,97,4.3,354,15.8,3251,344,2907,1.7,16.4,4071,1906,2165,9.6,20.6,-820,-4.2,32.8,0,250,250,1410
1985,05,f) 5,2007,2133,19505,19841,82,3.7,296,13.2,3260,454,2806,2.3,16.4,3932,1560,2372,7.9,19.8,-672,-3.4,32.8,0,224,224,1130
1985,05,g) 6 to 10,5892,6575,59428,59762,265,3.9,741,10.9,10271,2050,8221,3.4,17.2,10938,4369,6569,7.3,18.3,-667,-1.1,34.4,0,535,539,2943
1985,05,l) Left Censored,15058,20125,471602,473520,670,3.2,1670,8.1,56026,12158,43868,2.6,11.8,59864,23046,36818,4.9,12.6,-3838,-0.8,23.6,0,913,944,7123
1985,06,a) 0,63198,63829,383333,192763,63339,198.5,0,0,381140,381140,0,197.7,197.7,0,0,0,0,0,381140,197.7,0,0,,,
1985,06,b) 1,48622,49432,401088,390783,314,0.6,11449,20.7,130756,5860,124896,1.5,33.5,110145,55471,54674,14.2,28.2,20611,5.3,56.4,0,7808,7809,39633
1985,06,c) 2,35650,37104,398673,402359,1909,4.8,7299,18.3,105085,20108,84977,5,26.1,112456,48359,64097,12,27.9,-7371,-1.8,52.2,0,5509,5516,36138
1985,06,d) 3,33116,34977,334746,335269,1588,4.3,6011,16.2,82374,13350,69024,4,24.6,83420,39223,44197,11.7,24.9,-1046,-0.3,49.2,0,4277,4308,28818
1985,06,e) 4,31393,33169,381130,382804,1444,4.2,4788,13.8,76359,11740,64619,3.1,19.9,79707,33183,46524,8.7,20.8,-3348,-0.9,39.8,0,3295,3306,20940
1985,06,f) 5,28484,29900,285919,291783,1341,4.3,4103,13.1,57749,7630,50119,2.6,19.8,69476,31762,37714,10.9,23.8,-11727,-4,39.6,0,2856,2871,22732
1985,06,g) 6 to 10,72463,82340,913054,925833,3841,4.5,10391,12.2,166152,27659,138493,3,17.9,191709,80935,110774,8.7,20.7,-25557,-2.8,35.8,0,6342,6386,47889
1985,06,l) Left Censored,150404,226017,6161445,6160539,9927,4.3,20983,9.1,922938,242005,680933,3.9,15,921127,330399,590728,5.4,15,1811,0,30,0,9721,9871,86497
1985,08,a) 0,10139,10227,59175,29768,10183,199.1,0,0,58814,58814,0,197.6,197.6,0,0,0,0,0,58814,197.6,0,0,,,
1985,08,b) 1,7757,7874,56753,57902,55,0.6,2426,26.6,16853,1125,15728,1.9,29.1,19151,10947,8204,18.9,33.1,-2298,-4,58.2,0,1875,1876,8965
1985,08,c) 2,5360,5628,61801,63377,256,4.1,1455,23.3,14599,3921,10678,6.2,23,17750,8982,8768,14.2,28,-3151,-5,46,0,1165,1167,7015
1985,08,d) 3,4881,5082,41721,44677,218,3.9,1133,20.4,8413,1714,6699,3.8,18.8,14324,8198,6126,18.3,32.1,-5911,-13.3,37.6,0,853,861,6239
1985,08,e) 4,4360,4606,49636,51784,167,3.4,802,16.3,7697,1198,6499,2.3,14.9,11992,4554,7438,8.8,23.2,-4295,-8.3,29.8,0,591,593,3088
1985,08,f) 5,4022,4197,37250,38839,168,3.8,652,14.7,6343,540,5803,1.4,16.3,9520,3867,5653,10,24.5,-3177,-8.2,32.6,0,477,478,2694
1985,08,g) 6 to 10,10022,11262,112434,117124,537,4.6,1623,13.8,19867,3793,16074,3.2,17,29246,13177,16069,11.3,25,-9379,-8,34,0,1077,1083,7990
1985,08,l) Left Censored,20850,30545,742277,742566,1634,5.2,2986,9.6,102548,27202,75346,3.7,13.8,103127,35952,67175,4.8,13.9,-579,-0.1,27.6,0,1427,1431,12124
1985,09,a) 0,6977,7016,36613,18406,6972,198.7,0,0,36414,36414,0,197.8,197.8,0,0,0,0,0,36414,197.8,0,0,,,
1985,09,b) 1,5472,5533,42634,40380,26,0.4,1020,16.8,12895,574,12321,1.4,31.9,8387,4157,4230,10.3,20.8,4508,11.1,41.6,0,712,712,3160
1985,09,c) 2,3992,4038,27960,29246,138,3.2,750,17.2,6239,1126,5113,3.9,21.3,8810,5085,3725,17.4,30.1,-2571,-8.8,42.6,0,582,582,4253
1985,09,d) 3,3706,3854,46506,47053,122,3,555,13.6,7137,445,6692,0.9,15.2,8230,3772,4458,8,17.5,-1093,-2.3,30.4,0,433,434,3009
1985,09,e) 4,3389,3558,34144,34372,116,3.1,482,12.9,6459,1160,5299,3.4,18.8,6914,3053,3861,8.9,20.1,-455,-1.3,37.6,0,364,365,2247
1985,09,f) 5,2943,3074,26327,26187,96,3,405,12.6,4597,353,4244,1.3,17.6,4316,1807,2509,6.9,16.5,281,1.1,33,0,294,295,1239
1985,09,g) 6 to 10,8513,9304,102391,99899,319,3.3,1025,10.6,20324,2045,18279,2,20.3,15339,6821,8518,6.8,15.4,4985,4.9,30.8,0,717,719,3955
1985,09,l) Left Censored,28243,36130,1069744,1065996,1226,3.3,2724,7.4,126161,23633,102528,2.2,11.8,118665,40134,78531,3.8,11.1,7496,0.7,22.2,0,1530,1539,11540
1985,10,a) 0,1297,1304,6851,3464,1296,198.8,0,0,6775,6775,0,195.6,195.6,0,0,0,0,0,6775,195.6,0,0,,,
1985,10,b) 1,1036,1045,7412,7193,11,1,219,18.9,2003,191,1812,2.7,27.8,1565,884,681,12.3,21.8,438,6,43.6,0,146,146,606
1985,10,c) 2,720,734,5493,5510,34,4.3,151,19,1335,182,1153,3.3,24.2,1368,759,609,13.8,24.8,-33,-0.6,48.4,0,99,100,435
1985,10,d) 3,610,619,5548,5628,24,3.6,109,16.5,1123,110,1013,2,20,1282,726,556,12.9,22.8,-159,-2.8,40,0,79,79,554
1985,10,e) 4,577,603,5347,5435,26,4.2,70,11.2,857,91,766,1.7,15.8,1032,576,456,10.6,19,-175,-3.2,31.6,0,45,45,291
1985,10,f) 5,512,531,5339,4993,18,3.2,70,12.6,1584,195,1389,3.9,31.7,892,402,490,8.1,17.9,692,13.8,35.8,0,56,56,343
1985,10,g) 6 to 10,1467,1664,20666,19754,63,3.7,182,10.6,4386,606,3780,3.1,22.2,2561,858,1703,4.3,13,1825,9.2,26,0,117,117,549
1985,10,l) Left Censored,4793,6224,188568,187327,264,4.2,474,7.5,24640,5078,19562,2.7,13.2,22158,6968,15190,3.7,11.8,2482,1.4,23.6,0,225,226,1840
1985,11,a) 0,1349,1353,11728,5885,1346,199,0,0,11686,11686,0,198.6,198.6,0,0,0,0,0,11686,198.6,0,0,,,
1985,11,b) 1,1213,1225,11798,10864,7,0.5,130,10.1,3560,161,3399,1.5,32.8,1692,573,1119,5.3,15.6,1868,17.2,31.2,1,8,8,
1985,11,c) 2,1022,1036,8574,9171,60,5.6,143,13.3,2143,818,1325,8.9,23.4,3336,916,2420,10,36.4,-1193,-13,46.8,0,14,14,44
1985,11,d) 3,885,902,7967,8401,45,4.8,117,12.5,1661,442,1219,5.3,19.8,2529,580,1949,6.9,30.1,-868,-10.3,39.6,0,14,19,122
1985,11,e) 4,774,797,10465,10826,33,4.1,64,7.9,1487,321,1166,3,13.7,2209,929,1280,8.6,20.4,-722,-6.7,27.4,1,10,10,
1985,11,f) 5,646,664,7123,6930,23,3.4,46,6.8,1421,140,1281,2,20.5,1034,348,686,5,14.9,387,5.6,29.8,0,17,17,68
1985,11,g) 6 to 10,1857,2072,46571,46911,101,4.7,244,11.4,5401,788,4613,1.7,11.5,6080,2336,3744,5,13,-679,-1.5,23,0,133,137,958
1985,11,l) Left Censored,6545,8442,259850,257158,355,4.1,726,8.4,38844,9361,29483,3.6,15.1,33460,15657,17803,6.1,13,5384,2.1,26,0,227,229,4507
1985,12,a) 0,34766,35113,196292,98410,34942,199,0,0,195764,195764,0,198.9,198.9,0,0,0,0,0,195764,198.9,0,0,,,
1985,12,b) 1,25517,25809,203813,201914,120,0.4,7395,24.9,66215,3231,62984,1.6,32.8,62417,34763,27654,17.2,30.9,3798,1.9,61.8,0,5582,5582,26970
1985,12,c) 2,18339,18756,160229,161908,851,4.1,4563,22,46211,5322,40889,3.3,28.5,49569,25993,23576,16.1,30.6,-3358,-2.1,57,0,3622,3630,20724
1985,12,d) 3,16159,16778,154367,159723,673,3.7,3117,17.3,31836,3740,28096,2.3,19.9,42547,18600,23947,11.6,26.6,-10711,-6.7,39.8,0,2380,2390,13895
1985,12,e) 4,14045,14724,147109,149152,593,3.8,2413,15.4,30243,4774,25469,3.2,20.3,34329,15521,18808,10.4,23,-4086,-2.7,40.6,0,1832,1839,11726
1985,12,f) 5,12425,12911,114318,116955,528,3.9,1883,13.9,22110,3026,19084,2.6,18.9,27383,10729,16654,9.2,23.4,-5273,-4.5,37.8,0,1415,1417,7877
1985,12,g) 6 to 10,30730,34864,366443,371628,1525,4.2,4418,12.2,66514,10993,55521,3,17.9,76883,33500,43383,9,20.7,-10369,-2.8,35.8,0,2945,2963,21177
1985,12,l) Left Censored,63196,100413,2353964,2343618,5730,5.6,8638,8.5,357247,111145,246102,4.7,15.2,336555,115086,221469,4.9,14.4,20692,0.8,28.8,0,4263,4303,37798
1985,13,a) 0,13714,13823,82171,41263,13756,199,0,0,81816,81816,0,198.3,198.3,0,0,0,0,0,81816,198.3,0,0,,,
1985,13,b) 1,10457,10610,86970,83323,82,0.7,2495,21,28090,4015,24075,4.8,33.7,20796,11831,8965,14.2,25,7294,8.7,50,0,1827,1827,8908
1985,13,c) 2,7069,7208,58731,59060,341,4.4,1463,18.8,14678,1689,12989,2.9,24.9,15335,8061,7274,13.6,26,-657,-1.1,49.8,0,1124,1124,6063
1985,13,d) 3,5997,6349,64735,64861,262,3.9,1021,15.2,13736,1680,12056,2.6,21.2,13988,6488,7500,10,21.6,-252,-0.4,42.4,0,760,765,5014
1985,13,e) 4,5277,5572,59937,59043,249,4.3,772,13.2,12480,1899,10581,3.2,21.1,10691,4823,5868,8.2,18.1,1789,3,36.2,0,541,541,3193
1985,13,f) 5,4755,5102,57910,54891,248,4.7,716,13.4,16769,1985,14784,3.6,30.5,10730,5262,5468,9.6,19.5,6039,11,39,0,476,485,3336
1985,13,g) 6 to 10,13266,15010,165602,166030,737,4.8,1717,11.1,31260,5611,25649,3.4,18.8,32115,14109,18006,8.5,19.3,-855,-0.5,37.6,0,1075,1092,7355
1985,13,l) Left Censored,35771,55112,1522694,1500215,2649,4.7,4368,7.8,220403,51626,168777,3.4,14.7,175446,58752,116694,3.9,11.7,44957,3,23.4,0,2065,2081,15093
1985,15,a) 0,2148,2168,12738,6381,2159,199.2,0,0,12714,12714,0,199.2,199.2,0,0,0,0,0,12714,199.2,0,0,,,
1985,15,b) 1,1484,1505,10875,10539,10,0.6,307,18.4,3102,254,2848,2.4,29.4,2429,1189,1240,11.3,23,673,6.4,46,0,204,204,843
1985,15,c) 2,1436,1460,11201,11253,79,5,281,17.9,2372,349,2023,3.1,21.1,2476,1160,1316,10.3,22,-104,-0.9,42.2,0,219,219,933
1985,15,d) 3,1259,1302,10373,10623,57,4.1,227,16.3,1965,375,1590,3.5,18.5,2464,981,1483,9.2,23.2,-499,-4.7,37,0,166,166,734
1985,15,e) 4,1248,1308,13910,13721,53,3.9,165,12.1,2524,204,2320,1.5,18.4,2146,805,1341,5.9,15.6,378,2.8,31.2,0,126,126,561
1985,15,f) 5,1058,1154,10799,11077,45,3.7,162,13.4,2088,261,1827,2.4,18.8,2643,1131,1512,10.2,23.9,-555,-5.1,37.6,0,124,125,734
1985,15,g) 6 to 10,2697,3137,32654,33072,138,4.2,412,12.6,5224,1165,4059,3.5,15.8,6059,3087,2972,9.3,18.3,-835,-2.5,31.6,0,236,244,1568
1985,15,l) Left Censored,7123,10340,218274,219086,392,3.7,766,7.3,25569,6843,18726,3.1,11.7,27192,8894,18298,4.1,12.4,-1623,-0.7,23.4,0,393,397,2411
1985,16,a) 0,2115,2133,10806,5436,2122,199,0,0,10741,10741,0,197.6,197.6,0,0,0,0,0,10741,197.6,0,0,,,
1985,16,b) 1,1753,1778,10606,10732,11,0.6,383,19.3,3039,55,2984,0.5,28.3,3291,1570,1721,14.6,30.7,-252,-2.4,56.6,0,273,273,1205
1985,16,c) 2,1247,1310,10393,12055,62,4.2,336,23,2027,491,1536,4.1,16.8,5351,1611,3740,13.4,44.4,-3324,-27.6,33.6,0,253,254,1289
1985,16,d) 3,1103,1170,9110,9454,36,2.8,255,19.9,1846,124,1722,1.3,19.5,2534,1235,1299,13.1,26.8,-688,-7.3,39,0,195,195,1014
1985,16,e) 4,993,1028,8108,8598,37,3.3,195,17.6,1455,94,1361,1.1,16.9,2435,1434,1001,16.7,28.3,-980,-11.4,33.8,0,131,132,817
1985,16,f) 5,986,1031,7931,8246,46,4.3,151,14,1398,354,1044,4.3,17,2027,1079,948,13.1,24.6,-629,-7.6,34,0,113,113,794
1985,16,g) 6 to 10,2800,3051,27122,29299,116,3.7,371,11.7,3955,476,3479,1.6,13.5,8308,2204,6104,7.5,28.4,-4353,-14.9,27,0,258,259,1574
1985,16,l) Left Censored,6726,9382,166048,166932,345,3.6,780,8.1,19254,3796,15458,2.3,11.5,21023,6100,14923,3.7,12.6,-1769,-1.1,23,0,409,415,2344
1985,17,a) 0,19245,19396,119606,59942,19286,198.9,0,0,119329,119329,0,199.1,199.1,0,0,0,0,0,119329,199.1,0,0,,,
1985,17,b) 1,15972,16252,133821,131842,114,0.6,3321,18.5,35163,3664,31499,2.8,26.7,31207,14287,16920,10.8,23.7,3956,3,47.4,0,2415,2415,10678
1985,17,c) 2,11447,11671,104446,106319,475,3.8,2197,17.5,21181,3050,18131,2.9,19.9,24927,12288,12639,11.6,23.4,-3746,-3.5,39.8,0,1664,1667,9222
1985,17,d) 3,11028,11432,117451,119925,393,3.2,1841,15.1,21000,2347,18653,2,17.5,25947,11650,14297,9.7,21.6,-4947,-4.1,35,0,1387,1390,8339
1985,17,e) 4,9620,10030,103979,105904,361,3.4,1409,13.4,17911,2355,15556,2.2,16.9,21761,11365,10396,10.7,20.5,-3850,-3.6,33.8,0,1036,1038,8450
1985,17,f) 5,8974,9350,84305,85099,359,3.7,1292,13.2,14997,2360,12637,2.8,17.6,16585,6843,9742,8,19.5,-1588,-1.9,35.2,0,935,939,4933
1985,17,g) 6 to 10,25157,28142,287153,290390,1033,3.5,3294,11.3,49999,8045,41954,2.8,17.2,56473,25512,30961,8.8,19.4,-6474,-2.2,34.4,0,2139,2160,16116
1985,17,l) Left Censored,83246,112654,3146498,3166730,4111,3.6,9795,8.5,375174,95070,280104,3,11.8,415638,138888,276750,4.4,13.1,-40464,-1.3,23.6,0,5152,5198,40685
1985,18,a) 0,9570,9707,53927,27082,9636,198.5,0,0,53690,53690,0,198.2,198.2,0,0,0,0,0,53690,198.2,0,0,,,
1985,18,b) 1,7932,8092,61177,60806,66,0.7,1778,19.8,15938,1545,14393,2.5,26.2,15195,8294,6901,13.6,25,743,1.2,50,0,1342,1342,6282
1985,18,c) 2,5473,5593,44814,45833,171,2.8,1162,19,9517,1459,8058,3.2,20.8,11555,5426,6129,11.8,25.2,-2038,-4.4,41.6,0,892,892,4148
1985,18,d) 3,4513,4768,42958,43896,151,3,795,15.6,8465,1168,7297,2.7,19.3,10341,5304,5037,12.1,23.6,-1876,-4.3,38.6,0,589,590,3994
1985,18,e) 4,4047,4256,46510,46335,165,3.7,523,11.8,8049,1061,6988,2.3,17.4,7698,3422,4276,7.4,16.6,351,0.8,33.2,0,392,394,2629
1985,18,f) 5,3969,4177,36467,35825,129,3,509,11.7,7226,1402,5824,3.9,20.2,5941,2565,3376,7.2,16.6,1285,3.6,33.2,0,379,379,1933
1985,18,g) 6 to 10,11580,13162,132693,132368,591,4.3,1537,11.3,22876,4672,18204,3.5,17.3,22226,9841,12385,7.4,16.8,650,0.5,33.6,0,957,961,6264
1985,18,l) Left Censored,37443,53246,1399439,1406011,1917,3.5,4463,8.2,156860,43954,112906,3.1,11.2,170004,55677,114327,4,12.1,-13144,-0.9,22.4,0,2250,2275,18592
1985,19,a) 0,4917,4962,25104,12667,4935,198.9,0,0,24874,24874,0,196.4,196.4,0,0,0,0,0,24874,196.4,0,0,,,
1985,19,b) 1,4635,4679,25746,26832,24,0.5,1121,21.3,5710,195,5515,0.7,21.3,7881,4413,3468,16.4,29.4,-2171,-8.1,42.6,0,828,828,3434
1985,19,c) 2,3052,3238,23566,24753,110,3.1,713,20,4111,497,3614,2,16.6,6485,3750,2735,15.1,26.2,-2374,-9.6,33.2,0,555,555,2986
1985,19,d) 3,2820,2913,20767,21764,90,2.9,536,17.1,3538,614,2924,2.8,16.3,5532,2624,2908,12.1,25.4,-1994,-9.1,32.6,0,415,416,1913
1985,19,e) 4,2754,2904,25240,25897,101,3.3,458,14.8,3615,560,3055,2.2,14,4928,2240,2688,8.6,19,-1313,-5,28,0,345,348,1594
1985,19,f) 5,2653,2739,19373,19791,89,3.1,435,14.9,3959,383,3576,1.9,20,4794,2295,2499,11.6,24.2,-835,-4.2,40,0,323,323,1768
1985,19,g) 6 to 10,7744,8861,69660,71821,298,3.2,1112,12,10821,1693,9128,2.4,15.1,15143,8114,7029,11.3,21.1,-4322,-6,30.2,0,748,750,3718
1985,19,l) Left Censored,25192,34052,640833,644509,1002,2.9,3042,8.7,66802,14301,52501,2.2,10.4,74153,25173,48980,3.9,11.5,-7351,-1.1,20.8,0,1716,1728,10042
1985,20,a) 0,5525,5592,30249,15173,5565,199,0,0,30153,30153,0,198.7,198.7,0,0,0,0,0,30153,198.7,0,0,,,
1985,20,b) 1,4865,4912,32938,32764,28,0.5,1180,21.3,9217,603,8614,1.8,28.1,8869,5417,3452,16.5,27.1,348,1,54.2,0,923,923,4574
1985,20,c) 2,3238,3329,21892,23470,200,5.6,719,20,5096,1179,3917,5,21.7,8252,4760,3492,20.3,35.2,-3156,-13.5,43.4,0,558,560,3737
1985,20,d) 3,2911,3028,24225,25000,178,5.6,493,15.5,4474,786,3688,3.1,17.9,6023,3224,2799,12.9,24.1,-1549,-6.2,35.8,0,384,385,2246
1985,20,e) 4,2642,2800,23446,24910,157,5.4,388,13.3,4574,801,3773,3.2,18.4,7502,2124,5378,8.5,30.1,-2928,-11.7,36.8,0,280,280,1493
1985,20,f) 5,2275,2369,17670,18132,146,5.9,336,13.6,3073,675,2398,3.7,16.9,3996,2116,1880,11.7,22,-923,-5.1,33.8,0,251,255,1694
1985,20,g) 6 to 10,6635,7489,63861,64385,434,5.6,862,11.2,10733,2616,8117,4.1,16.7,11781,5283,6498,8.2,18.3,-1048,-1.6,33.4,0,604,606,3527
1985,20,l) Left Censored,20706,27850,574856,587375,1231,4.3,2278,8,68980,18740,50240,3.2,11.7,94017,47160,46857,8,16,-25037,-4.3,23.4,0,1115,1123,8574
1985,21,a) 0,6012,6066,36406,18275,6035,199,0,0,36262,36262,0,198.4,198.4,0,0,0,0,0,36262,198.4,0,0,,,
1985,21,b) 1,5470,5540,36276,36290,36,0.6,1204,19.5,10155,855,9300,2.4,28,10182,6107,4075,16.8,28.1,-27,-0.1,56,0,926,926,3789
1985,21,c) 2,3606,3674,32886,33237,137,3.4,845,20.9,7166,797,6369,2.4,21.6,7867,4717,3150,14.2,23.7,-701,-2.1,43.2,0,679,680,3584
1985,21,d) 3,3219,3322,29391,29653,117,3.3,579,16.3,5992,931,5061,3.1,20.2,6516,3202,3314,10.8,22,-524,-1.8,40.4,0,444,455,2118
1985,21,e) 4,2732,2860,33545,33717,92,3.1,407,13.5,5056,380,4676,1.1,15,5399,2327,3072,6.9,16,-343,-1,30,0,317,318,1878
1985,21,f) 5,2430,2550,20524,20862,116,4.3,354,13.3,3293,662,2631,3.2,15.8,3969,1627,2342,7.8,19,-676,-3.2,31.6,0,286,287,1350
1985,21,g) 6 to 10,7345,8112,85080,83208,331,3.9,999,11.9,16380,3046,13334,3.7,19.7,12636,5196,7440,6.2,15.2,3744,4.5,30.4,0,709,714,3679
1985,21,l) Left Censored,23365,32203,767016,765563,1178,3.6,2657,8.1,86208,18161,68047,2.4,11.3,83301,29904,53397,3.9,10.9,2907,0.4,21.8,0,1433,1443,10086
1985,22,a) 0,8306,8387,50331,25225,8344,199,0,0,50213,50213,0,199.1,199.1,0,0,0,0,0,50213,199.1,0,0,,,
1985,22,b) 1,6894,6979,58808,58442,35,0.4,1717,21.8,15517,731,14786,1.3,26.6,14785,7481,7304,12.8,25.3,732,1.3,50.6,0,1331,1331,5646
1985,22,c) 2,5043,5168,41980,44622,209,3.7,1236,21.7,8949,1343,7606,3,20.1,14233,6974,7259,15.6,31.9,-5284,-11.8,40.2,0,992,994,5226
1985,22,d) 3,4965,5212,41791,43413,212,3.8,1037,18.4,8335,1001,7334,2.3,19.2,11578,5324,6254,12.3,26.7,-3243,-7.5,38.4,0,802,804,4007
1985,22,e) 4,4222,4397,48548,49406,165,3.5,742,15.9,8815,1206,7609,2.4,17.8,10530,4651,5879,9.4,21.3,-1715,-3.5,35.6,0,565,567,3175
1985,22,f) 5,3779,3949,37661,39181,144,3.5,603,14.5,6630,821,5809,2.1,16.9,9670,4392,5278,11.2,24.7,-3040,-7.8,33.8,0,428,436,3217
1985,22,g) 6 to 10,9925,11070,121723,123193,446,3.9,1427,12.3,21928,5761,16167,4.7,17.8,24868,9340,15528,7.6,20.2,-2940,-2.4,35.6,0,987,995,5390
1985,22,l) Left Censored,26414,38306,846417,862422,1632,4.2,3494,8.9,103651,28253,75398,3.3,12,135660,43594,92066,5.1,15.7,-32009,-3.7,24,0,1720,1735,14328
1985,23,a) 0,2768,2784,12556,6306,2762,198.4,0,0,12500,12500,0,198.2,198.2,0,0,0,0,0,12500,198.2,0,0,,,
1985,23,b) 1,2127,2152,13408,12949,14,0.6,405,17.1,3767,443,3324,3.4,29.1,2849,1161,1688,9,22,918,7.1,44,0,273,273,877
1985,23,c) 2,1488,1504,10282,10229,51,3.2,260,16.1,2395,273,2122,2.7,23.4,2288,1004,1284,9.8,22.4,107,1,44.8,0,193,193,787
1985,23,d) 3,1226,1271,10168,10457,44,3.3,196,14.5,1741,228,1513,2.2,16.6,2319,1135,1184,10.9,22.2,-578,-5.6,33.2,0,144,145,992
1985,23,e) 4,1114,1162,10132,10194,40,3.3,142,11.7,1534,98,1436,1,15,1657,696,961,6.8,16.3,-123,-1.3,30,0,103,103,592
1985,23,f) 5,1080,1115,9125,9178,35,3,138,11.8,1660,105,1555,1.1,18.1,1766,725,1041,7.9,19.2,-106,-1.1,36.2,0,92,92,487
1985,23,g) 6 to 10,3116,3441,33165,32890,153,4.3,391,11,5623,705,4918,2.1,17.1,5072,2092,2980,6.4,15.4,551,1.7,30.8,0,265,265,1124
1985,23,l) Left Censored,8880,11609,249031,252833,393,3.3,944,8,28751,8210,20541,3.2,11.4,36356,15923,20433,6.3,14.4,-7605,-3,22.8,0,498,500,4429
1985,24,a) 0,8715,8870,56498,28480,8784,198.1,0,0,56036,56036,0,196.8,196.8,0,0,0,0,0,56036,196.8,0,0,,,
1985,24,b) 1,6508,6599,60507,55343,49,0.7,626,9.1,20184,892,19292,1.6,36.5,9856,2654,7202,4.8,17.8,10328,18.7,35.6,0,48,48,295
1985,24,c) 2,4881,5007,43523,42214,219,4.2,638,12.2,11805,2119,9686,5,28,9187,3729,5458,8.8,21.8,2618,6.2,43.6,0,31,31,170
1985,24,d) 3,4143,4350,46262,45320,169,3.8,477,10.6,10478,1416,9062,3.1,23.1,8593,3333,5260,7.4,19,1885,4.1,38,0,46,63,775
1985,24,e) 4,3676,3847,43065,45018,148,3.8,356,9.1,9374,1222,8152,2.7,20.8,13279,2696,10583,6,29.5,-3905,-8.7,41.6,0,39,40,319
1985,24,f) 5,3346,3478,40270,38383,124,3.5,262,7.4,9565,1478,8087,3.9,24.9,5790,1640,4150,4.3,15.1,3775,9.8,30.2,0,79,79,713
1985,24,g) 6 to 10,9282,10452,121217,120034,410,3.8,1063,9.9,23831,3033,20798,2.5,19.9,21464,9502,11962,7.9,17.9,2367,2,35.8,0,664,668,5664
1985,24,l) Left Censored,27942,40024,1072730,1058624,1673,4.1,3192,7.8,156354,42420,113934,4,14.8,128141,47103,81038,4.4,12.1,28213,2.7,24.2,0,1447,1456,13923
1985,25,a) 0,12386,12485,79012,39607,12420,199,0,0,78810,78810,0,199,199,0,0,0,0,0,78810,199,0,0,,,
1985,25,b) 1,9481,9586,98210,88778,59,0.6,1711,16.4,36920,1375,35545,1.5,41.6,18056,9603,8453,10.8,20.3,18864,21.3,40.6,0,1211,1211,7929
1985,25,c) 2,6949,7080,64303,64515,267,3.5,1173,15.5,14699,1416,13283,2.2,22.8,15122,7388,7734,11.5,23.4,-423,-0.6,45.6,0,887,887,5963
1985,25,d) 3,6199,6477,82590,83130,210,3.1,918,13.4,13279,1806,11473,2.2,16,14359,5975,8384,7.2,17.3,-1080,-1.3,32,0,667,667,3971
1985,25,e) 4,5476,5675,71584,69986,173,2.9,692,11.7,15710,1132,14578,1.6,22.4,12513,5144,7369,7.4,17.9,3197,4.5,35.8,0,498,498,2544
1985,25,f) 5,5001,5164,50650,50344,193,3.6,624,11.6,9788,1165,8623,2.3,19.4,9176,3976,5200,7.9,18.2,612,1.2,36.4,0,477,478,2885
1985,25,g) 6 to 10,13852,15762,216637,215340,597,3.7,1676,10.3,33358,4153,29205,1.9,15.5,30763,14024,16739,6.5,14.3,2595,1.2,28.6,0,1087,1096,8135
1985,25,l) Left Censored,49298,64750,1945225,1950102,2051,3.1,4823,7.3,238468,44650,193818,2.3,12.2,248221,83391,164830,4.3,12.7,-9753,-0.5,24.4,0,2701,2720,29548
1985,26,a) 0,15548,15747,91420,45843,15656,198.8,0,0,91155,91155,0,198.8,198.8,0,0,0,0,0,91155,198.8,0,0,,,
1985,26,b) 1,12743,12944,98644,94675,91,0.6,2585,18.1,29550,3217,26333,3.4,31.2,21611,10372,11239,11,22.8,7939,8.4,45.6,0,1897,1897,7639
1985,26,c) 2,8942,9110,74256,73352,356,3.6,1621,16.6,17118,1970,15148,2.7,23.3,15309,7472,7837,10.2,20.9,1809,2.4,41.8,0,1283,1283,5924
1985,26,d) 3,7700,8056,71647,72417,304,3.6,1224,14.4,14399,1560,12839,2.2,19.9,15939,7299,8640,10.1,22,-1540,-2.1,39.8,0,930,935,5518
1985,26,e) 4,7206,7549,77020,76707,306,3.9,947,12,15053,2126,12927,2.8,19.6,14427,6489,7938,8.5,18.8,626,0.8,37.6,0,709,716,4012
1985,26,f) 5,6680,7023,59872,60165,274,3.7,881,12,11098,1313,9785,2.2,18.4,11683,5194,6489,8.6,19.4,-585,-1,36.8,0,645,650,3875
1985,26,g) 6 to 10,19152,21789,224768,222717,970,4.3,2380,10.6,39347,7206,32141,3.2,17.7,35244,15978,19266,7.2,15.8,4103,1.9,31.6,0,1555,1565,9959
1985,26,l) Left Censored,57270,81178,2219312,2206708,2961,3.6,6603,8,304520,95838,208682,4.3,13.8,279311,119782,159529,5.4,12.7,25209,1.1,25.4,0,3562,3594,27402
1985,27,a) 0,8536,8642,53226,26674,8597,199,0,0,53105,53105,0,199.1,199.1,0,0,0,0,0,53105,199.1,0,0,,,
1985,27,b) 1,7109,7258,57195,56244,50,0.6,1557,19.3,15735,2341,13394,4.2,28,13832,7359,6473,13.1,24.6,1903,3.4,49.2,0,1141,1141,5754
1985,27,c) 2,4825,5102,47436,47984,164,3,989,17.9,10216,1589,8627,3.3,21.3,11312,6157,5155,12.8,23.6,-1096,-2.3,42.6,0,740,740,4607
1985,27,d) 3,4131,4348,40817,41557,135,2.9,816,17.4,8203,585,7618,1.4,19.7,9683,5082,4601,12.2,23.3,-1480,-3.6,39.4,0,618,620,3752
1985,27,e) 4,3952,4125,45235,45067,134,3.1,593,13.6,8641,1036,7605,2.3,19.2,8304,3613,4691,8,18.4,337,0.8,36.8,0,443,446,2549
1985,27,f) 5,3743,3900,34320,34470,134,3.3,548,13.4,6370,1072,5298,3.1,18.5,6669,3035,3634,8.8,19.3,-299,-0.8,37,0,395,396,2394
1985,27,g) 6 to 10,10789,12270,129697,131931,523,4.1,1513,11.9,21616,3300,18316,2.5,16.4,26083,13312,12771,10.1,19.8,-4467,-3.4,32.8,0,1029,1035,8889
1985,27,l) Left Censored,32145,43563,1178605,1175370,1535,3.4,3523,7.9,153235,42711,110524,3.6,13,146765,58375,88390,5,12.5,6470,0.5,25,0,1835,1854,26194
1985,28,a) 0,4417,4453,23539,11805,4420,198.5,0,0,23469,23469,0,198.8,198.8,0,0,0,0,0,23469,198.8,0,0,,,
1985,28,b) 1,3773,3802,23879,24629,7,0.2,1056,24.2,5618,200,5418,0.8,22.8,7118,4003,3115,16.3,28.9,-1500,-6.1,45.6,0,799,799,3086
1985,28,c) 2,2423,2468,17596,18003,97,3.6,594,21.8,4516,348,4168,1.9,25.1,5329,2547,2782,14.1,29.6,-813,-4.5,50.2,0,462,463,1999
1985,28,d) 3,2107,2168,15616,16554,70,3,424,18,2345,252,2093,1.5,14.2,4220,2045,2175,12.4,25.5,-1875,-11.3,28.4,0,346,346,1807
1985,28,e) 4,1987,2073,22081,21721,77,3.5,298,13.6,4293,711,3582,3.3,19.8,3572,1528,2044,7,16.4,721,3.4,32.8,0,218,218,1042
1985,28,f) 5,1908,1980,16759,17428,77,3.7,327,15.5,2713,326,2387,1.9,15.6,4051,1865,2186,10.7,23.2,-1338,-7.6,31.2,0,235,236,1463
1985,28,g) 6 to 10,5459,6175,54638,55798,302,4.7,767,12,8898,1930,6968,3.5,15.9,11217,4274,6943,7.7,20.1,-2319,-4.2,31.8,0,508,510,2438
1985,28,l) Left Censored,15503,21648,484042,486174,810,3.7,1687,7.6,55798,12761,43037,2.6,11.5,60061,20779,39282,4.3,12.4,-4263,-0.9,23,0,896,910,6958
1985,29,a) 0,10229,10330,56888,28541,10266,198.8,0,0,56694,56694,0,198.6,198.6,0,0,0,0,0,56694,198.6,0,0,,,
1985,29,b) 1,8073,8191,58799,58567,51,0.6,1864,20.4,15927,1333,14594,2.3,27.2,15463,7908,7555,13.5,26.4,464,0.8,52.8,0,1370,1370,6071
1985,29,c) 2,5591,5737,47509,48061,318,5.1,1205,19.4,11209,2558,8651,5.3,23.3,12313,7187,5126,15,25.6,-1104,-2.3,46.6,0,959,959,5766
1985,29,d) 3,4821,5103,43270,44252,268,5,768,14.4,8215,1573,6642,3.6,18.6,10178,4738,5440,10.7,23,-1963,-4.4,37.2,0,597,599,3692
1985,29,e) 4,4555,4850,45996,46701,220,4.3,689,13.6,8161,1303,6858,2.8,17.5,9571,4822,4749,10.3,20.5,-1410,-3,35,0,514,515,2731
1985,29,f) 5,4088,4271,36520,36667,161,3.6,620,13.8,7242,1063,6179,2.9,19.8,7535,3416,4119,9.3,20.5,-293,-0.7,39.6,0,457,458,2560
1985,29,g) 6 to 10,11825,13231,129324,129856,591,4.3,1673,12.2,21942,3967,17975,3.1,16.9,23006,10645,12361,8.2,17.7,-1064,-0.8,33.8,0,1145,1152,6864
1985,29,l) Left Censored,36837,51287,1348061,1352930,1972,3.8,4243,8.1,161495,42061,119434,3.1,11.9,171234,70473,100761,5.2,12.7,-9739,-0.8,23.8,0,2241,2266,18030
1985,30,a) 0,2340,2347,10675,5356,2329,198.5,0,0,10639,10639,0,198.6,198.6,0,0,0,0,0,10639,198.6,0,0,,,
1985,30,b) 1,1886,1904,9659,10155,4,0.2,600,27,2412,28,2384,0.3,23.8,3404,1788,1616,17.6,33.5,-992,-9.7,47.6,0,434,434,1356
1985,30,c) 2,1362,1451,9983,10546,63,4,311,19.7,1953,438,1515,4.2,18.5,3078,1575,1503,14.9,29.2,-1125,-10.7,37,0,243,243,1312
1985,30,d) 3,1168,1198,7553,8048,45,3.5,252,19.3,1310,115,1195,1.4,16.3,2300,1275,1025,15.8,28.6,-990,-12.3,32.6,0,186,186,980
1985,30,e) 4,1107,1134,8376,8492,32,2.7,180,14.9,1685,214,1471,2.5,19.8,1916,916,1000,10.8,22.6,-231,-2.8,39.6,0,138,139,735
1985,30,f) 5,1088,1120,7890,8189,43,3.6,163,13.8,1168,138,1030,1.7,14.3,1766,710,1056,8.7,21.6,-598,-7.3,28.6,0,119,119,574
1985,30,g) 6 to 10,3044,3315,23814,24876,143,4.1,422,12.2,3557,559,2998,2.2,14.3,5680,2529,3151,10.2,22.8,-2123,-8.5,28.6,0,278,280,1248
1985,30,l) Left Censored,7083,9149,140098,143051,280,3,814,8.6,12967,2035,10932,1.4,9.1,18874,7222,11652,5,13.2,-5907,-4.1,18.2,0,421,421,2232
1985,31,a) 0,3284,3303,18550,9334,3276,198.4,0,0,18433,18433,0,197.5,197.5,0,0,0,0,0,18433,197.5,0,0,,,
1985,31,b) 1,2659,2684,16211,16274,14,0.5,491,16.7,3989,297,3692,1.8,24.5,4115,2063,2052,12.7,25.3,-126,-0.8,49,0,352,352,1332
1985,31,c) 2,2040,2157,18491,19052,124,5.4,428,18.5,3594,1003,2591,5.3,18.9,4715,2687,2028,14.1,24.7,-1121,-5.8,37.8,0,331,331,1899
1985,31,d) 3,1822,1895,14219,14648,82,4.1,329,16.3,2526,452,2074,3.1,17.2,3383,1911,1472,13,23.1,-857,-5.9,34.4,0,251,252,1322
1985,31,e) 4,1682,1762,12053,12365,92,5,248,13.5,1883,290,1593,2.3,15.2,2507,1082,1425,8.8,20.3,-624,-5.1,30.4,0,196,196,835
1985,31,f) 5,1594,1624,11774,11544,123,7.3,238,14.2,2997,1589,1408,13.8,26,2537,1425,1112,12.3,22,460,4,44,0,178,180,804
1985,31,g) 6 to 10,4704,5160,40076,40281,301,5.7,591,11.1,6134,1338,4796,3.3,15.2,6544,2710,3834,6.7,16.2,-410,-1,30.4,0,417,420,1904
1985,31,l) Left Censored,15038,19503,379777,380529,731,3.7,1579,7.9,44753,13225,31528,3.5,11.8,46257,19757,26500,5.2,12.2,-1504,-0.4,23.6,0,877,882,8633
1985,32,a) 0,2506,2522,17152,8601,2510,199,0,0,17103,,,,198.8,0,0,0,0,0,17103,198.8,0,1,,,
1985,32,b) 1,1995,2022,18434,17752,14,0.6,714,29.9,6755,,,,38.1,5391,3067,2324,17.3,30.4,1364,7.7,60.8,1,565,565,2510
1985,32,c) 2,1336,1393,14348,14781,76,4.9,361,23.4,3908,474,3434,3.2,26.4,4774,2131,2643,14.4,32.3,-866,-5.9,52.8,0,286,286,1835
1985,32,d) 3,1303,1351,15592,16191,69,4.8,267,18.4,2966,300,2666,1.9,18.3,4163,2155,2008,13.3,25.7,-1197,-7.4,36.6,0,190,192,1255
1985,32,e) 4,1197,1254,11934,12779,68,5.2,200,15.2,2215,407,1808,3.2,17.3,3905,2276,1629,17.8,30.6,-1690,-13.3,34.6,0,143,143,1870
1985,32,f) 5,1087,1130,12951,13738,48,4,189,15.7,1968,362,1606,2.6,14.3,3541,1138,2403,8.3,25.8,-1573,-11.5,28.6,0,126,126,618
1985,32,g) 6 to 10,2801,3123,39841,39741,149,4.6,427,13.1,7742,1758,5984,4.4,19.5,7542,3592,3950,9,19,200,0.5,38,0,277,277,1536
1985,32,l) Left Censored,5386,7683,245994,245699,414,5.3,709,9.1,29765,6443,23322,2.6,12.1,29174,13774,15400,5.6,11.9,591,0.2,23.8,0,308,313,3784
1985,33,a) 0,3205,3218,16867,8454,3200,198.9,0,0,16826,16826,0,199,199,0,0,0,0,0,16826,199,0,0,,,
1985,33,b) 1,2322,2355,18286,16911,23,0.9,428,16.7,5775,266,5509,1.6,34.1,3025,1530,1495,9,17.9,2750,16.2,35.8,0,305,305,1123
1985,33,c) 2,1519,1541,11946,12051,56,3.4,273,16.5,2565,317,2248,2.6,21.3,2774,1295,1479,10.7,23,-209,-1.7,42.6,0,218,218,942
1985,33,d) 3,1318,1353,12844,12624,45,3.2,197,13.8,2970,458,2512,3.6,23.5,2530,1499,1031,11.9,20,440,3.5,40,0,152,152,1123
1985,33,e) 4,1095,1120,11659,12294,29,2.4,169,14.2,2332,718,1614,5.8,19,3602,1019,2583,8.3,29.3,-1270,-10.3,38,0,118,118,721
1985,33,f) 5,1015,1040,9900,9711,35,3.2,122,11.3,2067,169,1898,1.7,21.3,1688,712,976,7.3,17.4,379,3.9,34.8,0,92,92,525
1985,33,g) 6 to 10,3002,3369,35917,36146,143,4.1,373,10.7,7227,1122,6105,3.1,20,7685,3726,3959,10.3,21.3,-458,-1.3,40,0,250,251,1474
1985,33,l) Left Censored,8108,10281,293916,292362,393,3.7,846,8.1,38965,7707,31258,2.6,13.3,35856,13239,22617,4.5,12.3,3109,1,24.6,0,465,468,5352
1985,34,a) 0,16682,16787,84291,42406,16649,198.4,0,0,83770,83770,0,197.5,197.5,0,0,0,0,0,83770,197.5,0,0,,,
1985,34,b) 1,12632,12774,105129,96655,71,0.5,2662,18.8,38546,8560,29986,8.9,39.9,21598,11241,10357,11.6,22.3,16948,17.6,44.6,0,1852,1852,7794
1985,34,c) 2,9815,9929,78582,78067,385,3.6,1725,16.2,21111,2209,18902,2.8,27,20081,9888,10193,12.7,25.7,1030,1.3,51.4,0,1287,1287,6533
1985,34,d) 3,8778,9033,81202,83108,327,3.4,1316,13.8,16105,2942,13163,3.5,19.4,19917,8541,11376,10.3,24,-3812,-4.6,38.8,0,980,985,6233
1985,34,e) 4,7731,7960,75443,76458,286,3.4,998,12,13150,1717,11433,2.2,17.2,15180,6077,9103,7.9,19.9,-2030,-2.7,34.4,0,710,710,4296
1985,34,f) 5,7264,7441,66196,66614,270,3.5,932,12,11901,941,10960,1.4,17.9,12737,5412,7325,8.1,19.1,-836,-1.2,35.8,0,698,701,4176
1985,34,g) 6 to 10,19742,21151,207856,207812,863,4,2278,10.4,38904,8626,30278,4.2,18.7,38815,16498,22317,7.9,18.7,89,0,37.4,0,1522,1528,10029
1985,34,l) Left Censored,62485,80634,2208087,2198512,2969,3.6,6363,7.7,302766,62901,239865,2.9,13.8,283617,97032,186585,4.4,12.9,19149,0.9,25.8,0,3674,3703,28701
1985,35,a) 0,3318,3334,18541,9325,3310,198.6,0,0,18433,18433,0,197.7,197.7,0,0,0,0,0,18433,197.7,0,0,,,
1985,35,b) 1,2623,2657,16510,16979,14,0.5,768,25.1,4608,96,4512,0.6,27.1,5545,3036,2509,17.9,32.7,-937,-5.6,54.2,0,580,580,2375
1985,35,c) 2,1986,2068,17896,19033,91,4,482,21.2,3642,469,3173,2.5,19.1,5916,3166,2750,16.6,31.1,-2274,-12,38.2,0,388,388,2646
1985,35,d) 3,1569,1621,13986,14789,72,4.1,321,18.4,3075,439,2636,3,20.8,4680,2632,2048,17.8,31.6,-1605,-10.8,41.6,0,241,241,1666
1985,35,e) 4,1570,1633,14044,14287,58,3.3,275,15.8,2644,261,2383,1.8,18.5,3130,1454,1676,10.2,21.9,-486,-3.4,37,0,193,194,1101
1985,35,f) 5,1501,1565,13854,14183,55,3.3,248,14.9,2585,331,2254,2.3,18.2,3243,1752,1491,12.4,22.9,-658,-4.7,36.4,0,183,185,1168
1985,35,g) 6 to 10,3834,4257,38394,39180,196,4.4,564,12.7,7131,1111,6020,2.8,18.2,8702,3591,5111,9.2,22.2,-1571,-4,36.4,0,346,346,2096
1985,35,l) Left Censored,8559,11924,247627,246115,569,4.7,1060,8.7,36747,8729,28018,3.5,14.9,33723,13784,19939,5.6,13.7,3024,1.2,27.4,0,457,463,3239
1985,36,a) 0,38174,38313,194162,97799,38075,198.8,0,0,192727,192727,0,197.1,197.1,0,0,0,0,0,192727,197.1,0,0,,,
1985,36,b) 1,29546,29896,210270,204267,140,0.4,6246,18.9,61223,3553,57670,1.7,30,49217,25556,23661,12.5,24.1,12006,5.9,48.2,0,4535,4535,18707
1985,36,c) 2,22919,23230,172308,178560,914,3.6,4426,17.6,38957,4492,34465,2.5,21.8,51461,21814,29647,12.2,28.8,-12504,-7,43.6,0,3403,3404,16230
1985,36,d) 3,19706,20275,172721,175895,702,3.3,3157,14.7,33784,3934,29850,2.2,19.2,40132,21404,18728,12.2,22.8,-6348,-3.6,38.4,0,2439,2441,14871
1985,36,e) 4,17501,18031,179261,179585,562,3,2478,13.1,32218,3515,28703,2,17.9,32865,14076,18789,7.8,18.3,-647,-0.4,35.8,0,1901,1904,9725
1985,36,f) 5,15761,16150,158549,159560,531,3.1,2127,12.6,27680,2571,25109,1.6,17.3,29702,13498,16204,8.5,18.6,-2022,-1.3,34.6,0,1575,1576,9308
1985,36,g) 6 to 10,43432,47524,493291,491398,1631,3.3,5312,10.8,80170,9664,70506,2,16.3,76384,33114,43270,6.7,15.5,3786,0.8,31,0,3798,3816,20767
1985,36,l) Left Censored,146438,184697,4829579,4833469,5159,2.7,15476,8.2,575449,122321,453128,2.5,11.9,583230,204266,378964,4.2,12.1,-7781,-0.2,23.8,0,9515,9596,71980
1985,37,a) 0,13696,13841,73921,37118,13749,198.7,0,0,73607,73607,0,198.3,198.3,0,0,0,0,0,73607,198.3,0,0,,,
1985,37,b) 1,11942,12133,81163,78984,94,0.7,2500,18.6,23152,2368,20784,3,29.3,18793,9031,9762,11.4,23.8,4359,5.5,47.6,0,1842,1846,6691
1985,37,c) 2,7031,7189,56683,56708,215,2.7,1458,18.6,14102,1427,12675,2.5,24.9,14153,7512,6641,13.2,25,-51,-0.1,49.8,0,1121,1121,5856
1985,37,d) 3,5746,5987,53657,54711,175,2.7,988,15.5,10408,1148,9260,2.1,19,12516,6399,6117,11.7,22.9,-2108,-3.9,38,0,719,719,3799
1985,37,e) 4,5212,5467,60526,61387,186,3.3,745,13,8427,1309,7118,2.1,13.7,10148,3989,6159,6.5,16.5,-1721,-2.8,27.4,0,540,540,2605
1985,37,f) 5,4739,4934,45586,45561,184,3.6,640,12.4,8606,953,7653,2.1,18.9,8555,3758,4797,8.2,18.8,51,0.1,37.6,0,444,449,2430
1985,37,g) 6 to 10,13786,15482,152024,153400,624,3.9,1710,10.7,26594,5185,21409,3.4,17.3,29345,12711,16634,8.3,19.1,-2751,-1.8,34.6,0,1092,1097,7717
1985,37,l) Left Censored,40003,59653,1723391,1720402,2212,3.6,4441,7.3,202347,46970,155377,2.7,11.8,196371,57442,138929,3.3,11.4,5976,0.4,22.8,0,2232,2244,16871
1985,38,a) 0,1477,1493,7221,3626,1486,199.1,0,0,7191,7191,0,198.3,198.3,0,0,0,0,0,7191,198.3,0,0,,,
1985,38,b) 1,1277,1291,6445,7087,4,0.3,303,20.9,1472,21,1451,0.3,20.8,2756,1487,1269,21,38.9,-1284,-18.1,41.6,0,222,222,1063
1985,38,c) 2,932,1011,8112,8218,45,4.1,215,19.6,1791,187,1604,2.3,21.8,2003,1023,980,12.4,24.4,-212,-2.6,43.6,0,162,162,822
1985,38,d) 3,861,882,5611,5836,40,4.3,151,16.1,1018,109,909,1.9,17.4,1468,718,750,12.3,25.2,-450,-7.8,34.8,0,115,115,531
1985,38,e) 4,768,797,6390,6621,38,4.5,119,14.2,919,146,773,2.2,13.9,1380,518,862,7.8,20.8,-461,-6.9,27.8,0,82,82,411
1985,38,f) 5,758,780,6547,6069,50,6.2,104,12.9,2158,410,1748,6.8,35.6,1201,609,592,10,19.8,957,15.8,39.6,0,77,77,462
1985,38,g) 6 to 10,2094,2254,16284,16612,100,4.3,276,11.8,2316,567,1749,3.4,13.9,2972,1074,1898,6.5,17.9,-656,-4,27.8,0,173,174,686
1985,38,l) Left Censored,6497,8348,133210,133779,297,3.5,611,7.2,12908,2975,9933,2.2,9.6,14046,4332,9714,3.2,10.5,-1138,-0.9,19.2,0,314,315,1592
1985,39,a) 0,16676,16840,99719,50208,16759,199,0,0,99023,99023,0,197.2,197.2,0,0,0,0,0,99023,197.2,0,0,,,
1985,39,b) 1,14076,14308,114383,109877,92,0.6,2891,18.3,34059,2406,31653,2.2,31,25047,12727,12320,11.6,22.8,9012,8.2,45.6,0,2206,2206,10340
1985,39,c) 2,9719,9994,78013,79747,415,3.9,1812,16.9,17268,2905,14363,3.6,21.7,20736,10783,9953,13.5,26,-3468,-4.3,43.4,0,1423,1423,8849
1985,39,d) 3,8782,9198,75609,76367,341,3.5,1544,15.8,15290,1901,13389,2.5,20,16806,9048,7758,11.8,22,-1516,-2,40,0,1175,1186,7073
1985,39,e) 4,8224,8706,95464,96527,328,3.6,1036,11.4,15603,1611,13992,1.7,16.2,17728,7449,10279,7.7,18.4,-2125,-2.2,32.4,0,772,774,5577
1985,39,f) 5,7539,8023,67637,68413,342,4.1,1026,12.3,12023,1464,10559,2.1,17.6,13574,5829,7745,8.5,19.8,-1551,-2.2,35.2,0,750,753,4088
1985,39,g) 6 to 10,21897,25276,259048,256739,1029,3.9,2724,10.4,47477,9815,37662,3.8,18.5,42859,21839,21020,8.5,16.7,4618,1.8,33.4,0,1802,1814,10383
1985,39,l) Left Censored,74298,109072,2890577,2876504,3850,3.4,8990,8.1,356851,57312,299539,2,12.4,328704,124698,204006,4.3,11.4,28147,1,22.8,0,4269,4343,39629
1985,40,a) 0,7485,7551,39637,19929,7506,198.8,0,0,39416,39416,0,197.8,197.8,0,0,0,0,0,39416,197.8,0,0,,,
1985,40,b) 1,6295,6360,39560,40981,32,0.4,1922,26.1,10646,892,9754,2.2,26,13487,7905,5582,19.3,32.9,-2841,-6.9,52,0,1512,1512,6275
1985,40,c) 2,4333,4437,29849,32370,205,4.1,1293,25.8,6861,812,6049,2.5,21.2,11903,6888,5015,21.3,36.8,-5042,-15.6,42.4,0,1025,1026,5347
1985,40,d) 3,4329,4485,36254,38416,160,3.3,986,20.2,6373,742,5631,1.9,16.6,10696,5144,5552,13.4,27.8,-4323,-11.2,33.2,0,757,758,3863
1985,40,e) 4,3583,3753,32508,33949,137,3.4,692,17.2,5258,720,4538,2.1,15.5,8139,3411,4728,10,24,-2881,-8.5,31,0,551,552,2657
1985,40,f) 5,3270,3412,27400,29077,132,3.6,584,16.1,4600,686,3914,2.4,15.8,7953,3598,4355,12.4,27.4,-3353,-11.6,31.6,0,455,457,2590
1985,40,g) 6 to 10,8159,9113,83537,86476,330,3.4,1333,13.9,13162,3002,10160,3.5,15.2,19039,9171,9868,10.6,22,-5877,-6.8,30.4,0,915,924,6201
1985,40,l) Left Censored,21204,30061,665730,674540,1245,4,2643,8.6,73718,19221,54497,2.8,10.9,91338,26966,64372,4,13.5,-17620,-2.6,21.8,0,1398,1401,8428
1985,41,a) 0,7012,7056,37019,18563,7013,198.8,0,0,36913,36913,0,198.9,198.9,0,0,0,0,0,36913,198.9,0,0,,,
1985,41,b) 1,5465,5526,37203,37342,28,0.4,1704,26.6,10215,753,9462,2,27.4,10492,6329,4163,16.9,28.1,-277,-0.7,54.8,0,1266,1266,5059
1985,41,c) 2,3686,3913,35725,34901,196,4.6,957,22.2,10253,3444,6809,9.9,29.4,8604,4657,3947,13.3,24.7,1649,4.7,49.4,0,763,763,3745
1985,41,d) 3,3495,3649,31313,32121,131,3.3,699,17.8,6568,1002,5566,3.1,20.4,8184,4241,3943,13.2,25.5,-1616,-5.1,40.8,0,563,565,3314
1985,41,e) 4,3325,3488,30072,30598,152,4.1,574,15.5,6020,743,5277,2.4,19.7,7072,3751,3321,12.3,23.1,-1052,-3.4,39.4,0,424,425,2567
1985,41,f) 5,3192,3315,23436,24575,153,4.4,505,14.5,3799,604,3195,2.5,15.5,6077,2631,3446,10.7,24.7,-2278,-9.2,31,0,387,388,2191
1985,41,g) 6 to 10,8067,8946,82811,84655,417,4.5,1237,13.2,14103,2344,11759,2.8,16.7,17790,6945,10845,8.2,21,-3687,-4.3,33.4,0,794,801,4229
1985,41,l) Left Censored,19491,27043,556931,560309,1042,3.7,2546,9.2,70749,14875,55874,2.7,12.6,77504,28289,49215,5,13.8,-6755,-1.2,25.2,0,1263,1293,9627
1985,42,a) 0,18889,19158,120353,60612,19043,198.8,0,0,119483,119483,0,197.1,197.1,0,0,0,0,0,119483,197.1,0,0,,,
1985,42,b) 1,15523,15945,134935,131376,172,1,3111,17.7,37276,3896,33380,3,28.4,30157,13633,16524,10.4,23,7119,5.4,46,0,2091,2091,8737
1985,42,c) 2,11080,11326,94664,96160,488,4,2010,16.6,21947,4112,17835,4.3,22.8,24938,12035,12903,12.5,25.9,-2991,-3.1,45.6,0,1509,1509,8805
1985,42,d) 3,9890,10342,101264,104395,416,3.8,1526,14,19125,3194,15931,3.1,18.3,25386,15218,10168,14.6,24.3,-6261,-6,36.6,0,1139,1148,12717
1985,42,e) 4,8807,9226,99779,99448,344,3.6,1152,12,16791,2238,14553,2.3,16.9,16128,6900,9228,6.9,16.2,663,0.7,32.4,0,801,809,4914
1985,42,f) 5,8445,8767,76314,76836,337,3.7,1077,11.8,13470,1511,11959,2,17.5,14514,7289,7225,9.5,18.9,-1044,-1.4,35,0,780,782,5514
1985,42,g) 6 to 10,24436,27695,294867,293478,1159,4,3120,10.9,50674,8979,41695,3.1,17.3,47895,21507,26388,7.3,16.3,2779,1,32.6,0,1988,1997,13250
1985,42,l) Left Censored,85678,119080,3096957,3131420,4098,3.4,10219,8.4,337277,74782,262495,2.4,10.8,406202,153662,252540,4.9,13,-68925,-2.2,21.6,0,5321,5395,60418
1985,44,a) 0,2138,2144,11197,5603,2138,199.4,0,0,11188,11188,0,199.7,199.7,0,0,0,0,0,11188,199.7,0,0,,,
1985,44,b) 1,1655,1665,13291,12524,15,0.8,371,20,4056,282,3774,2.3,32.4,2521,1333,1188,10.6,20.1,1535,12.3,40.2,0,276,276,1009
1985,44,c) 2,1172,1185,8809,9056,42,3.3,206,16.2,1959,432,1527,4.8,21.6,2452,1346,1106,14.9,27.1,-493,-5.5,43.2,0,150,150,1150
1985,44,d) 3,1002,1035,9899,9714,31,2.8,149,13.6,2191,334,1857,3.4,22.6,1820,885,935,9.1,18.7,371,3.9,37.4,0,119,119,767
1985,44,e) 4,914,931,9406,9232,20,2.1,112,11.5,1654,84,1570,0.9,17.9,1305,595,710,6.4,14.1,349,3.8,28.2,0,81,81,496
1985,44,f) 5,847,875,7239,7373,29,3.2,123,13.4,1221,61,1160,0.8,16.6,1488,771,717,10.5,20.2,-267,-3.6,33.2,0,82,82,533
1985,44,g) 6 to 10,2530,2698,28960,28990,94,3.4,287,10.3,4761,340,4421,1.2,16.4,4820,2161,2659,7.5,16.6,-59,-0.2,32.8,0,198,198,1455
1985,44,l) Left Censored,9121,10977,271266,274005,317,2.8,848,7.5,27633,4375,23258,1.6,10.1,33111,9786,23325,3.6,12.1,-5478,-2,20.2,0,532,532,5048
1985,45,a) 0,6830,6909,38792,19492,6854,198.4,0,0,38601,38601,0,198,198,0,0,0,0,0,38601,198,0,0,,,
1985,45,b) 1,5537,5633,41425,41245,42,0.7,1295,20.5,11033,702,10331,1.7,26.7,10672,5235,5437,12.7,25.9,361,0.8,51.8,0,985,985,4200
1985,45,c) 2,3543,3631,30014,31423,104,2.6,770,19.4,6258,736,5522,2.3,19.9,9076,4103,4973,13.1,28.9,-2818,-9,39.8,0,619,619,3451
1985,45,d) 3,3022,3163,30133,30315,115,3.4,523,15.6,6273,797,5476,2.6,20.7,6636,3317,3319,10.9,21.9,-363,-1.2,41.4,0,402,404,2716
1985,45,e) 4,2622,2784,28431,28700,95,3.3,371,12.7,5386,876,4510,3.1,18.8,5923,2705,3218,9.4,20.6,-537,-1.8,37.6,0,263,263,2178
1985,45,f) 5,2462,2592,24055,24050,100,3.7,309,11.5,4805,615,4190,2.6,20,4795,1807,2988,7.5,19.9,10,0.1,39.8,0,233,233,1260
1985,45,g) 6 to 10,6761,7609,76685,72731,322,4.1,833,10.6,20913,2854,18059,3.9,28.8,13004,5524,7480,7.6,17.9,7909,10.9,35.8,0,547,552,3458
1985,45,l) Left Censored,19441,28597,762539,764971,1225,4.2,2174,7.5,89499,22932,66567,3,11.7,94363,30053,64310,3.9,12.3,-4864,-0.6,23.4,0,1088,1095,9592
1985,46,a) 0,1586,1600,7882,3956,1585,198.1,0,0,7853,,,,198.5,0,0,0,0,0,7853,198.5,0,1,,,
1985,46,b) 1,1316,1320,7039,7275,3,0.2,296,20,1630,,,,22.4,2101,920,1181,12.6,28.9,-471,-6.5,44.8,1,190,190,634
1985,46,c) 2,859,946,6641,6939,41,4,177,17.4,1026,161,865,2.3,14.8,1621,797,824,11.5,23.4,-595,-8.6,29.6,0,141,141,690
1985,46,d) 3,760,786,4847,5048,31,3.7,141,16.8,866,150,716,3,17.2,1267,729,538,14.4,25.1,-401,-7.9,34.4,0,95,96,454
1985,46,e) 4,741,761,6626,6302,26,3.3,88,11.1,1553,112,1441,1.8,24.6,904,383,521,6.1,14.3,649,10.3,28.6,0,67,67,348
1985,46,f) 5,724,737,4700,4784,64,8.3,127,16.5,962,410,552,8.6,20.1,1129,643,486,13.4,23.6,-167,-3.5,40.2,0,83,85,496
1985,46,g) 6 to 10,2081,2272,16025,16412,117,5,272,11.6,2422,464,1958,2.8,14.8,3195,1320,1875,8,19.5,-773,-4.7,29.6,0,189,190,933
1985,46,l) Left Censored,6784,8436,138914,138857,315,3.7,633,7.4,15508,4847,10661,3.5,11.2,15394,4508,10886,3.2,11.1,114,0.1,22.2,0,335,336,1819
1985,47,a) 0,9232,9337,53987,27055,9286,198.9,0,0,53864,53864,0,199.1,199.1,0,0,0,0,0,53864,199.1,0,0,,,
1985,47,b) 1,8172,8265,62312,61505,56,0.6,1879,20.3,17803,1606,16197,2.6,28.9,16189,8502,7687,13.8,26.3,1614,2.6,52.6,0,1431,1431,6244
1985,47,c) 2,5040,5155,42670,44041,250,4.4,1160,20.6,9263,1427,7836,3.2,21,12004,5923,6081,13.4,27.3,-2741,-6.3,42,0,909,909,4815
1985,47,d) 3,4221,4405,44290,44410,141,3,767,16.3,8547,1166,7381,2.6,19.2,8787,4323,4464,9.7,19.8,-240,-0.6,38.4,0,592,600,2969
1985,47,e) 4,3655,3858,43551,43134,154,3.8,541,13.4,8951,1350,7601,3.1,20.8,8116,3849,4267,8.9,18.8,835,2,37.6,0,407,407,2824
1985,47,f) 5,3463,3633,32571,33004,138,3.6,529,13.8,5409,756,4653,2.3,16.4,6275,2860,3415,8.7,19,-866,-2.6,32.8,0,416,416,2159
1985,47,g) 6 to 10,10159,11525,127530,128613,486,4.1,1360,11.4,21899,3440,18459,2.7,17,24064,9732,14332,7.6,18.7,-2165,-1.7,34,0,903,909,6250
1985,47,l) Left Censored,29640,42961,1164411,1160079,1880,4.3,3650,8.3,140940,32750,108190,2.8,12.1,132275,46094,86181,4,11.4,8665,0.7,22.8,0,1839,1876,11428
1985,48,a) 0,39768,40341,244178,122843,40118,198.9,0,0,242670,242670,0,197.5,197.5,0,0,0,0,0,242670,197.5,0,0,,,
1985,48,b) 1,31846,32614,270809,268151,224,0.6,7312,20.1,88886,5509,83377,2.1,33.1,83569,38759,44810,14.5,31.2,5317,1.9,62.4,0,5346,5350,29364
1985,48,c) 2,22844,23432,208300,216519,1032,4,5389,21,50751,6369,44382,2.9,23.4,67189,32074,35115,14.8,31,-16438,-7.6,46.8,0,4175,4184,25173
1985,48,d) 3,20523,21615,197776,206538,917,3.9,4426,18.9,43332,6985,36347,3.4,21,60856,32216,28640,15.6,29.5,-17524,-8.5,42,0,3303,3332,23142
1985,48,e) 4,25860,27294,282037,291372,930,3.2,4494,15.5,54468,8025,46443,2.8,18.7,73137,35485,37652,12.2,25.1,-18669,-6.4,37.4,0,3387,3397,20905
1985,48,f) 5,8348,9077,89094,92279,388,4.1,1355,14.2,16839,3528,13311,3.8,18.2,23208,10388,12820,11.3,25.1,-6369,-6.9,36.4,0,941,954,6704
1985,48,g) 6 to 10,39047,45291,511370,520184,2117,4.5,5982,12.7,101356,24462,76894,4.7,19.5,118983,46941,72042,9,22.9,-17627,-3.4,39,0,3899,3963,28811
1985,48,l) Left Censored,85686,143411,3763538,3764344,7508,5.1,12859,8.8,544437,175972,368465,4.7,14.5,546050,176187,369863,4.7,14.5,-1613,0,29,0,5808,5857,46470
1985,49,a) 0,3308,3340,20097,10087,3317,198.6,0,0,20020,20020,0,198.5,198.5,0,0,0,0,0,20020,198.5,0,0,,,
1985,49,b) 1,2444,2498,22242,21853,18,0.6,808,27.7,6860,523,6337,2.4,31.4,6081,3574,2507,16.4,27.8,779,3.6,55.6,0,609,609,2900
1985,49,c) 2,1746,1828,18623,19200,91,4.5,454,22.5,3755,530,3225,2.8,19.6,4909,2337,2572,12.2,25.6,-1154,-6,39.2,0,343,343,1835
1985,49,d) 3,1636,1723,15043,15988,72,3.8,404,21.4,2864,280,2584,1.8,17.9,4754,2458,2296,15.4,29.7,-1890,-11.8,35.8,0,303,306,1707
1985,49,e) 4,1471,1571,17976,17751,75,4.5,280,16.7,3883,315,3568,1.8,21.9,3433,1926,1507,10.9,19.3,450,2.6,38.6,0,197,198,1303
1985,49,f) 5,1334,1424,12268,12624,68,4.5,226,15,2252,378,1874,3,17.8,2964,1599,1365,12.7,23.5,-712,-5.7,35.6,0,163,163,1312
1985,49,g) 6 to 10,3831,4231,43254,43552,200,4.5,615,13.9,8015,915,7100,2.1,18.4,8610,4178,4432,9.6,19.8,-595,-1.4,36.8,0,384,384,2362
1985,49,l) Left Censored,9108,13024,319469,318788,579,4.3,1169,8.8,40290,9521,30769,3,12.6,38927,11916,27011,3.7,12.2,1363,0.4,24.4,0,575,582,4742
1985,50,a) 0,1745,1753,8347,4209,1736,198.1,0,0,8276,8276,0,196.6,196.6,0,0,0,0,0,8276,196.6,0,0,,,
1985,50,b) 1,1371,1387,7779,7886,11,0.7,249,16.4,1949,93,1856,1.2,24.7,2162,1301,861,16.5,27.4,-213,-2.7,49.4,0,160,160,592
1985,50,c) 2,948,958,5471,5537,39,3.8,160,15.6,1162,117,1045,2.1,21,1293,616,677,11.1,23.4,-131,-2.4,42,0,128,128,524
1985,50,d) 3,829,849,6037,6215,21,2.3,129,14.3,1026,57,969,0.9,16.5,1382,656,726,10.6,22.2,-356,-5.7,33,0,93,93,484
1985,50,e) 4,718,732,5452,5660,17,2.2,106,13.7,829,123,706,2.2,14.6,1244,524,720,9.3,22,-415,-7.4,29.2,0,75,75,327
1985,50,f) 5,635,649,4590,4698,25,3.7,81,11.9,704,99,605,2.1,15,920,424,496,9,19.6,-216,-4.6,30,0,52,52,283
1985,50,g) 6 to 10,1837,2016,18417,18964,96,4.6,255,12.2,2524,493,2031,2.6,13.3,3617,1835,1782,9.7,19.1,-1093,-5.8,26.6,0,191,191,919
1985,50,l) Left Censored,5116,6247,132870,133199,174,2.7,487,7.6,13444,1626,11818,1.2,10.1,14101,5375,8726,4,10.6,-657,-0.5,20.2,0,275,276,1430
1985,51,a) 0,12079,12191,67278,33941,12027,197.3,0,0,66675,66675,0,196.4,196.4,0,0,0,0,0,66675,196.4,0,0,,,
1985,51,b) 1,9430,9557,69322,63623,54,0.5,672,6.8,21844,797,21047,1.3,34.3,10445,2919,7526,4.6,16.4,11399,17.9,32.8,1,36,36,
1985,51,c) 2,6070,6199,49667,47985,282,4.4,683,10.7,13011,2795,10216,5.8,27.1,9646,3362,6284,7,20.1,3365,7,40.2,0,18,18,133
1985,51,d) 3,5312,5547,56158,54793,220,3.9,585,10.3,11689,1462,10227,2.7,21.3,8958,3280,5678,6,16.3,2731,5,32.6,0,25,45,541
1985,51,e) 4,4734,5012,53104,53865,157,3.1,434,8.5,8856,854,8002,1.6,16.4,10378,5263,5115,9.8,19.3,-1522,-2.9,32.8,1,20,21,
1985,51,f) 5,4469,4654,43966,42739,139,3,273,5.8,8341,611,7730,1.4,19.5,5887,1380,4507,3.2,13.8,2454,5.7,27.6,0,20,23,138
1985,51,g) 6 to 10,11886,13675,157309,155666,544,4,957,7,27663,5377,22286,3.5,17.8,24377,9458,14919,6.1,15.7,3286,2.1,31.4,0,54,58,944
1985,51,l) Left Censored,34344,51981,1351304,1341695,2134,4.1,2748,5.3,173156,50119,123037,3.7,12.9,153939,45923,108016,3.4,11.5,19217,1.4,23,0,125,142,3346
1985,53,a) 0,10900,11006,55018,27661,10907,198.2,0,0,54715,54715,0,197.8,197.8,0,0,0,0,0,54715,197.8,0,0,,,
1985,53,b) 1,9087,9228,60827,60954,40,0.4,2423,23.1,17038,502,16536,0.8,28,17292,9305,7987,15.3,28.4,-254,-0.4,56,0,1741,1741,7323
1985,53,c) 2,6304,6579,58121,57404,360,5,1537,21.3,16438,6254,10184,10.9,28.6,15004,8109,6895,14.1,26.1,1434,2.5,52.2,0,1185,1185,6162
1985,53,d) 3,5500,5742,47167,49746,244,4,1096,17.8,9144,1096,8048,2.2,18.4,14302,8305,5997,16.7,28.8,-5158,-10.4,36.8,0,842,846,5567
1985,53,e) 4,4887,5140,43940,45844,215,4,812,14.9,7683,1037,6646,2.3,16.8,11490,4893,6597,10.7,25.1,-3807,-8.3,33.6,0,577,577,2880
1985,53,f) 5,4688,4911,39710,40651,190,3.7,713,13.8,7524,1620,5904,4,18.5,9405,3670,5735,9,23.1,-1881,-4.6,37,0,526,526,2732
1985,53,g) 6 to 10,12519,13950,137048,134263,620,4.3,1855,12.8,31750,12436,19314,9.3,23.6,26180,10773,15407,8,19.5,5570,4.1,39,0,1113,1123,6403
1985,53,l) Left Censored,28992,41316,909193,914556,1768,4.2,3747,8.9,112593,22430,90163,2.5,12.3,123319,39797,83522,4.4,13.5,-10726,-1.2,24.6,0,1854,1893,13810
1985,54,a) 0,2974,3012,17888,9013,2960,196.5,0,0,17750,17750,0,196.9,196.9,0,0,0,0,0,17750,196.9,0,0,,,
1985,54,b) 1,2480,2501,14681,14496,11,0.4,238,9.1,3282,233,3049,1.6,22.6,2912,914,1998,6.3,20.1,370,2.5,40.2,0,23,23,63
1985,54,c) 2,1495,1528,10862,11010,56,3.5,218,13.6,2349,445,1904,4,21.3,2645,1132,1513,10.3,24,-296,-2.7,42.6,0,13,13,78
1985,54,d) 3,1487,1526,14703,14883,49,3.1,170,10.8,2322,548,1774,3.7,15.6,2681,899,1782,6,18,-359,-2.4,31.2,0,17,17,157
1985,54,e) 4,1321,1359,12280,12700,41,2.9,145,10.4,1655,219,1436,1.7,13,2495,1116,1379,8.8,19.6,-840,-6.6,26,0,8,9,318
1985,54,f) 5,1182,1256,9222,9372,52,4.1,94,7.4,1322,230,1092,2.5,14.1,1622,496,1126,5.3,17.3,-300,-3.2,28.2,0,9,9,56
1985,54,g) 6 to 10,3494,3944,33748,34293,140,3.5,354,8.8,5073,822,4251,2.4,14.8,6162,1990,4172,5.8,18,-1089,-3.2,29.6,0,17,20,199
1985,54,l) Left Censored,12488,16817,330633,334052,577,3.4,1020,6,32413,8890,23523,2.7,9.7,39251,10308,28943,3.1,11.7,-6838,-2,19.4,0,45,48,422
1985,55,a) 0,8637,8715,47199,23663,8669,198.9,0,0,47073,47073,0,198.9,198.9,0,0,0,0,0,47073,198.9,0,0,,,
1985,55,b) 1,7335,7417,53595,52828,47,0.6,1543,18.7,13162,1061,12101,2,24.9,11628,6183,5445,11.7,22,1534,2.9,44,0,1187,1187,4825
1985,55,c) 2,4935,5066,39786,40141,200,3.7,904,16.6,8204,1245,6959,3.1,20.4,8914,4471,4443,11.1,22.2,-710,-1.8,40.8,0,740,741,3912
1985,55,d) 3,4544,4731,38987,39908,163,3.2,759,15.1,6317,947,5370,2.4,15.8,8159,4101,4058,10.3,20.4,-1842,-4.6,31.6,0,606,607,3253
1985,55,e) 4,4256,4431,40645,41076,167,3.6,554,12,6386,1134,5252,2.8,15.5,7248,3039,4209,7.4,17.6,-862,-2.1,31,0,426,427,2201
1985,55,f) 5,4010,4162,35966,35274,163,3.8,496,11.4,6970,1498,5472,4.2,19.8,5585,2487,3098,7.1,15.8,1385,4,31.6,0,377,377,1845
1985,55,g) 6 to 10,12182,13599,124937,126416,578,4.1,1425,10.2,19343,2840,16503,2.2,15.3,22300,8318,13982,6.6,17.6,-2957,-2.3,30.6,0,953,954,5237
1985,55,l) Left Censored,38532,50636,1227507,1234221,1570,3,3840,7.4,127034,24894,102140,2,10.3,140462,53539,86923,4.3,11.4,-13428,-1.1,20.6,0,2135,2186,19397
1985,56,a) 0,1358,1361,6693,3360,1349,198.2,0,0,6667,,,,198.4,0,0,0,0,0,6667,198.4,0,1,,,
1985,56,b) 1,1096,1099,6355,6594,2,0.2,329,25.9,1543,,,,23.4,2020,1179,841,17.9,30.6,-477,-7.2,46.8,1,246,246,919
1985,56,c) 2,891,939,6839,7203,59,5.6,254,24.3,1404,310,1094,4.3,19.5,2132,1150,982,16,29.6,-728,-10.1,39,0,195,195,939
1985,56,d) 3,870,921,6116,6513,50,5.1,151,15.5,1169,215,954,3.3,17.9,1963,869,1094,13.3,30.1,-794,-12.2,35.8,0,116,116,690
1985,56,e) 4,840,866,5599,5700,48,5.3,138,15.2,972,218,754,3.8,17.1,1174,527,647,9.2,20.6,-202,-3.5,34.2,0,96,97,398
1985,56,f) 5,665,708,4613,4877,29,3.9,100,13.4,722,72,650,1.5,14.8,1250,613,637,12.6,25.6,-528,-10.8,29.6,0,76,76,453
1985,56,g) 6 to 10,1837,2019,17501,18252,81,3.8,310,14.5,2583,246,2337,1.3,14.2,4084,1830,2254,10,22.4,-1501,-8.2,28.4,0,196,197,1270
1985,56,l) Left Censored,4050,5347,82383,83760,243,4.4,529,9.6,11005,3071,7934,3.7,13.1,13759,4525,9234,5.4,16.4,-2754,-3.3,26.2,0,247,247,1531
1986,01,a) 0,7505,7571,45384,22975,7548,199.4,0,0,44819,44819,0,195.1,195.1,0,0,0,0,0,44819,195.1,0,0,,,
1986,01,b) 1,5559,5657,43835,42710,116,1.8,1611,25,14532,2853,11679,6.7,34,12282,7515,4767,17.6,28.8,2250,5.2,57.6,0,1192,1208,6074
1986,01,c) 2,5249,5358,44501,46764,229,4,1033,17.9,8685,1270,7415,2.7,18.6,13211,6341,6870,13.6,28.3,-4526,-9.7,37.2,0,798,799,4443
1986,01,d) 3,3192,3286,26764,27736,162,4.6,594,16.9,6365,1286,5079,4.6,22.9,8308,3311,4997,11.9,30,-1943,-7.1,45.8,0,441,441,2487
1986,01,e) 4,2751,2921,31009,31718,131,4.2,451,14.6,5726,744,4982,2.3,18.1,7143,2435,4708,7.7,22.5,-1417,-4.4,36.2,0,346,346,1767
1986,01,f) 5,2659,2788,38316,36513,98,3.3,366,12.5,8710,561,8149,1.5,23.9,5104,2163,2941,5.9,14,3606,9.9,28,0,272,272,1396
1986,01,g) 6 to 10,10104,11683,129804,129457,590,4.9,1305,10.8,24507,4953,19554,3.8,18.9,23813,8659,15154,6.7,18.4,694,0.5,36.8,0,892,896,5356
1986,01,l) Left Censored,21622,32205,824739,819585,1527,4.7,2558,7.8,112206,29166,83040,3.6,13.7,101897,30742,71155,3.8,12.4,10309,1.3,24.8,0,1361,1364,12057
1986,02,a) 0,1727,1745,9368,4697,1738,199.2,0,0,9343,9343,0,198.9,198.9,0,0,0,0,0,9343,198.9,0,0,,,
1986,02,b) 1,1275,1291,8908,9271,21,1.3,546,34.8,2876,575,2301,6.2,31,3602,2185,1417,23.6,38.9,-726,-7.9,62,0,396,396,1440
1986,02,c) 2,1087,1095,7502,8116,40,3.2,359,28.5,1961,161,1800,2,24.2,3189,1725,1464,21.3,39.3,-1228,-15.1,48.4,0,268,268,1379
1986,02,d) 3,834,879,6521,6973,56,5.8,232,23.9,1761,444,1317,6.4,25.3,2665,1116,1549,16,38.2,-904,-12.9,50.6,0,172,172,803
1986,02,e) 4,646,686,5385,6299,27,3.6,129,17.4,944,124,820,2,15,2771,1316,1455,20.9,44,-1827,-29,30,0,97,97,1111
1986,02,f) 5,485,530,5019,5547,21,3.7,81,14.4,863,142,721,2.6,15.6,1918,464,1454,8.4,34.6,-1055,-19,31.2,0,60,60,298
1986,02,g) 6 to 10,1798,2069,22949,24568,111,5.2,265,12.3,3342,765,2577,3.1,13.6,6580,1624,4956,6.6,26.8,-3238,-13.2,27.2,0,177,177,1162
1986,02,l) Left Censored,2481,3767,82281,84726,265,6.9,447,11.6,12978,4056,8922,4.8,15.3,17867,5638,12229,6.7,21.1,-4889,-5.8,30.6,0,144,144,1040
1986,04,a) 0,9185,9278,58194,29168,9251,199.4,0,0,58053,58053,0,199,199,0,0,0,0,0,58053,199,0,0,,,
1986,04,b) 1,6821,6908,62516,62214,97,1.2,2128,26.6,20718,2460,18258,4,33.3,20113,11148,8965,17.9,32.3,605,1,64.6,0,1599,1599,8982
1986,04,c) 2,5493,5653,51967,53359,310,5,1308,21.2,14554,3032,11522,5.7,27.3,17338,8813,8525,16.5,32.5,-2784,-5.2,54.6,0,985,985,6397
1986,04,d) 3,3914,4215,50473,51292,233,5.2,798,17.7,13402,4466,8936,8.7,26.1,15040,6532,8508,12.7,29.3,-1638,-3.2,52.2,0,606,606,4960
1986,04,e) 4,3671,3935,43190,43753,198,4.8,624,15,10196,2000,8196,4.6,23.3,11321,5849,5472,13.4,25.9,-1125,-2.6,46.6,0,454,457,4303
1986,04,f) 5,3029,3248,36146,37173,157,4.6,509,14.9,7350,1306,6044,3.5,19.8,9403,3379,6024,9.1,25.3,-2053,-5.5,39.6,0,361,362,2320
1986,04,g) 6 to 10,9875,11192,142133,145298,587,5.1,1365,11.8,28260,6712,21548,4.6,19.4,34589,9750,24839,6.7,23.8,-6329,-4.4,38.8,0,917,919,6390
1986,04,l) Left Censored,14021,23536,660944,655054,1457,6.1,1902,8,108814,37712,71102,5.8,16.6,97035,29860,67175,4.6,14.8,11779,1.8,29.6,0,868,869,8317
1986,05,a) 0,4711,4734,25262,12643,4722,199.5,0,0,25238,25238,0,199.6,199.6,0,0,0,0,0,25238,199.6,0,0,,,
1986,05,b) 1,3613,3677,26347,25305,76,1.8,1166,27.4,9671,3332,6339,13.2,38.2,7586,4342,3244,17.2,30,2085,8.2,60,0,888,888,3518
1986,05,c) 2,3463,3506,21291,23234,119,3.1,740,19.3,4393,576,3817,2.5,18.9,8279,3610,4669,15.5,35.6,-3886,-16.7,37.8,0,561,564,2969
1986,05,d) 3,2261,2329,17980,18510,95,3.8,429,17.1,3385,459,2926,2.5,18.3,4445,2269,2176,12.3,24,-1060,-5.7,36.6,0,342,342,1781
1986,05,e) 4,2021,2082,17946,18491,73,3.3,330,14.9,3252,365,2887,2,17.6,4342,1942,2400,10.5,23.5,-1090,-5.9,35.2,0,263,263,1572
1986,05,f) 5,1832,1893,17305,18431,59,2.9,271,13.5,2732,236,2496,1.3,14.8,4984,3109,1875,16.9,27,-2252,-12.2,29.6,0,218,218,1101
1986,05,g) 6 to 10,7313,8125,77475,78499,334,4,944,11.2,12635,3027,9608,3.9,16.1,14683,5578,9105,7.1,18.7,-2048,-2.6,32.2,0,665,670,4085
1986,05,l) Left Censored,14137,19177,484076,476973,689,3.5,1525,7.8,69369,17359,52010,3.6,14.5,55164,17011,38153,3.6,11.6,14205,2.9,23.2,0,839,849,5419
1986,06,a) 0,66574,67348,414394,207938,67097,199.3,0,0,412913,412913,0,198.6,198.6,0,0,0,0,0,412913,198.6,0,0,,,
1986,06,b) 1,49813,50684,403442,395388,1169,2,13361,23.3,139564,27017,112547,6.8,35.3,123455,66456,56999,16.8,31.2,16109,4.1,62.4,0,9289,9298,49989
1986,06,c) 2,41502,42480,385049,392242,2123,4.6,8511,18.5,99875,16835,83040,4.3,25.5,114261,57797,56464,14.7,29.1,-14386,-3.6,51,0,6180,6181,43029
1986,06,d) 3,30934,32515,381252,389845,1496,4.3,5845,16.8,80369,12962,67407,3.3,20.6,97554,45556,51998,11.7,25,-17185,-4.4,41.2,0,4282,4285,33016
1986,06,e) 4,29612,31529,312760,323466,1367,4.1,4672,14.1,63946,11502,52444,3.6,19.8,85358,37912,47446,11.7,26.4,-21412,-6.6,39.6,0,3188,3190,24108
1986,06,f) 5,28548,30437,382794,391572,1337,4.2,4016,12.6,70874,11038,59836,2.8,18.1,88429,31361,57068,8,22.6,-17555,-4.5,36.2,0,2677,2679,21211
1986,06,g) 6 to 10,92995,104696,1185041,1196771,5140,4.7,12558,11.6,222767,45978,176789,3.8,18.6,246226,85252,160974,7.1,20.6,-23459,-2,37.2,0,8037,8059,51416
1986,06,l) Left Censored,141380,218546,6140573,6127985,12270,5.5,19273,8.7,931133,292584,638549,4.8,15.2,905958,285696,620262,4.7,14.8,25175,0.4,29.6,0,9157,9224,76789
1986,08,a) 0,9712,9775,59327,29701,9742,199.3,0,0,59253,59253,0,199.5,199.5,0,0,0,0,0,59253,199.5,0,0,,,
1986,08,b) 1,7630,7746,57296,57721,146,1.6,2496,27.8,19727,4621,15106,8,34.2,20577,12301,8276,21.3,35.6,-850,-1.4,68.4,0,1872,1872,10023
1986,08,c) 2,6372,6510,49618,52983,299,4.2,1595,22.2,12255,1500,10755,2.8,23.1,18985,10709,8276,20.2,35.8,-6730,-12.7,46.2,0,1247,1248,8699
1986,08,d) 3,4551,4938,58693,60446,297,5.6,977,18.5,12315,4058,8257,6.7,20.4,15820,5586,10234,9.2,26.2,-3505,-5.8,40.8,0,757,757,4522
1986,08,e) 4,4173,4364,37950,39990,151,3.2,847,17.9,6439,803,5636,2,16.1,10519,4920,5599,12.3,26.3,-4080,-10.2,32.2,0,641,643,3810
1986,08,f) 5,3831,4088,43724,46382,185,4.2,699,16.1,7770,1567,6203,3.4,16.8,13085,7226,5859,15.6,28.2,-5315,-11.4,33.6,0,513,513,6068
1986,08,g) 6 to 10,12660,14094,135053,141995,671,4.5,2036,13.8,21208,4716,16492,3.3,14.9,35091,13325,21766,9.4,24.7,-13883,-9.8,29.8,0,1345,1348,8938
1986,08,l) Left Censored,19531,29466,744026,743351,1907,6.4,2838,9.5,113421,39525,73896,5.3,15.3,112071,39794,72277,5.4,15.1,1350,0.2,30.2,0,1269,1283,9846
1986,09,a) 0,7598,7639,43805,21927,7628,199.7,0,0,43756,43756,0,199.6,199.6,0,0,0,0,0,43756,199.6,0,0,,,
1986,09,b) 1,5828,5883,43727,40255,138,2.1,1206,18.7,16836,4684,12152,11.6,41.8,9891,5357,4534,13.3,24.6,6945,17.2,49.2,0,832,832,3695
1986,09,c) 2,4835,4909,40145,40932,186,3.6,774,14.8,8413,1108,7305,2.7,20.6,9987,4131,5856,10.1,24.4,-1574,-3.8,41.2,0,560,560,2904
1986,09,d) 3,3550,3609,32293,31777,139,3.6,537,14,7549,2635,4914,8.3,23.8,6516,2691,3825,8.5,20.5,1033,3.3,41,0,383,383,1933
1986,09,e) 4,3328,3460,39305,42929,100,2.7,475,13,5267,918,4349,2.1,12.3,12515,4024,8491,9.4,29.2,-7248,-16.9,24.6,0,326,326,3097
1986,09,f) 5,3109,3286,31809,32204,104,3,378,11,4942,602,4340,1.9,15.3,5731,2574,3157,8,17.8,-789,-2.5,30.6,0,270,270,1769
1986,09,g) 6 to 10,10681,11619,130406,129476,447,3.7,1193,9.9,22756,3206,19550,2.5,17.6,20895,7998,12897,6.2,16.1,1861,1.5,32.2,0,830,832,4535
1986,09,l) Left Censored,26731,34735,1062786,1065416,1238,3.5,2544,7.2,117795,34717,83078,3.3,11.1,123054,37296,85758,3.5,11.5,-5259,-0.4,22.2,0,1439,1443,16465
1986,10,a) 0,1421,1440,25450,12730,1436,199.4,0,0,25440,25440,0,199.8,199.8,0,0,0,0,0,25440,199.8,0,0,,,
1986,10,b) 1,1056,1067,7565,7188,38,3.2,259,21.8,2596,629,1967,8.8,36.1,1841,1078,763,15,25.6,755,10.5,51.2,0,162,162,786
1986,10,c) 2,917,927,7485,7394,38,3.9,146,14.8,1614,217,1397,2.9,21.8,1432,791,641,10.7,19.4,182,2.4,38.8,0,106,106,595
1986,10,d) 3,659,671,5659,5540,42,6,99,14.1,1427,412,1015,7.4,25.8,1189,476,713,8.6,21.5,238,4.3,43,0,81,81,390
1986,10,e) 4,553,562,5728,5653,17,2.9,73,12.4,1111,130,981,2.3,19.7,961,338,623,6,17,150,2.7,34,0,44,44,235
1986,10,f) 5,545,569,5305,5334,31,5.3,68,11.6,776,119,657,2.2,14.5,833,428,405,8,15.6,-57,-1.1,29,0,45,45,303
1986,10,g) 6 to 10,1872,2092,25416,25692,96,4.5,193,9,5048,1101,3947,4.3,19.6,5599,1436,4163,5.6,21.8,-551,-2.2,39.2,0,121,121,861
1986,10,l) Left Censored,4596,6084,187969,187722,324,5.3,453,7.4,25761,6537,19224,3.5,13.7,25267,7822,17445,4.2,13.5,494,0.2,27,0,234,235,1277
1986,11,a) 0,1398,1403,9560,4796,1390,198.1,0,0,9529,9529,0,198.7,198.7,0,0,0,0,0,9529,198.7,0,0,,,
1986,11,b) 1,1137,1144,14633,13114,37,3,230,18.5,5660,2462,3198,18.8,43.2,2621,953,1668,7.3,20,3039,23.2,40,0,155,155,572
1986,11,c) 2,1050,1061,11427,11440,45,3.9,196,17.2,2329,191,2138,1.7,20.4,2355,1016,1339,8.9,20.6,-26,-0.2,40.8,0,140,140,753
1986,11,d) 3,929,943,8315,8434,37,3.7,130,13.2,1809,254,1555,3,21.4,2047,1037,1010,12.3,24.3,-238,-2.9,42.8,0,94,94,606
1986,11,e) 4,792,807,8159,8058,36,4.2,125,14.7,1844,451,1393,5.6,22.9,1642,982,660,12.2,20.4,202,2.5,40.8,0,76,77,539
1986,11,f) 5,713,736,10812,10639,30,3.9,89,11.6,2101,402,1699,3.8,19.7,1754,715,1039,6.7,16.5,347,3.2,33,0,69,69,473
1986,11,g) 6 to 10,2339,2575,53817,53320,112,4.2,251,9.5,8236,945,7291,1.8,15.4,7241,3841,3400,7.2,13.6,995,1.8,27.2,0,155,155,1474
1986,11,l) Left Censored,6273,8270,270257,272757,448,5.4,621,7.4,33905,13112,20793,4.8,12.4,38905,9028,29877,3.3,14.3,-5000,-1.9,24.8,0,292,294,2879
1986,12,a) 0,36464,36807,212172,106304,36729,199.6,0,0,211736,211736,0,199.2,199.2,0,0,0,0,0,211736,199.2,0,0,,,
1986,12,b) 1,26616,27084,205711,202369,442,1.4,8074,26,70550,10666,59884,5.3,34.9,63866,37006,26860,18.3,31.6,6684,3.3,63.2,0,6062,6062,28621
1986,12,c) 2,21306,21677,183777,190624,1021,4.3,4918,20.7,45470,6574,38896,3.4,23.9,59163,31119,28044,16.3,31,-13693,-7.1,47.8,0,3886,3886,24681
1986,12,d) 3,15756,16241,141718,151860,723,4.1,3126,17.9,30919,5001,25918,3.3,20.4,51203,20896,30307,13.8,33.7,-20284,-13.3,40.8,0,2450,2450,16960
1986,12,e) 4,14312,15006,152504,154953,594,3.7,2354,14.8,30490,4630,25860,3,19.7,35387,14311,21076,9.2,22.8,-4897,-3.1,39.4,0,1781,1781,10713
1986,12,f) 5,12610,13299,137160,140763,570,4.1,1944,13.9,25240,4013,21227,2.9,17.9,32446,12869,19577,9.1,23.1,-7206,-5.2,35.8,0,1437,1439,9107
1986,12,g) 6 to 10,39373,44215,470463,476354,2035,4.4,5527,12,89227,20466,68761,4.3,18.7,101008,36702,64306,7.7,21.2,-11781,-2.5,37.4,0,3772,3777,22646
1986,12,l) Left Censored,59421,97575,2379971,2364357,5538,5.6,8169,8.3,362327,116740,245587,4.9,15.3,331099,106838,224261,4.5,14,31228,1.3,28,0,3892,3921,34482
1986,13,a) 0,14317,14449,87599,43838,14415,199.5,0,0,87523,87523,0,199.7,199.7,0,0,0,0,0,87523,199.7,0,0,,,
1986,13,b) 1,10700,10858,86949,85953,208,1.7,2995,24.3,27570,4618,22952,5.4,32.1,25577,14692,10885,17.1,29.8,1993,2.3,59.6,0,2200,2200,10578
1986,13,c) 2,8954,9148,80851,82276,394,4,1735,17.6,19389,3817,15572,4.6,23.6,22238,11043,11195,13.4,27,-2849,-3.4,47.2,0,1281,1281,7773
1986,13,d) 3,6122,6316,56522,57670,313,4.6,1155,17.1,12676,1934,10742,3.4,22,14971,7689,7282,13.3,26,-2295,-4,44,0,868,868,5791
1986,13,e) 4,5348,5702,62262,63141,227,3.8,842,14,12016,1280,10736,2,19,13773,6625,7148,10.5,21.8,-1757,-2.8,38,0,624,625,4798
1986,13,f) 5,4780,5089,58981,59184,215,4,669,12.6,11088,2144,8944,3.6,18.7,11493,3898,7595,6.6,19.4,-405,-0.7,37.4,0,484,484,2673
1986,13,g) 6 to 10,16740,18941,221086,223303,988,5.1,2119,10.8,43514,10647,32867,4.8,19.5,47948,21856,26092,9.8,21.5,-4434,-2,39,0,1353,1355,9297
1986,13,l) Left Censored,33798,53704,1553052,1536998,2950,5.4,4251,7.8,217904,58455,159449,3.8,14.2,185796,60285,125511,3.9,12.1,32108,2.1,24.2,0,1951,1954,15356
1986,15,a) 0,2100,2133,13108,6558,2128,199.5,0,0,13101,13101,0,199.8,199.8,0,0,0,0,0,13101,199.8,0,0,,,
1986,15,b) 1,1744,1776,14316,13945,64,3.2,424,21.5,4215,1149,3066,8.2,30.2,3473,2077,1396,14.9,24.9,742,5.3,49.8,0,296,296,1432
1986,15,c) 2,1276,1299,10316,10551,59,4.2,247,17.6,2187,328,1859,3.1,20.7,2657,1300,1357,12.3,25.2,-470,-4.5,41.4,0,207,207,1098
1986,15,d) 3,1237,1263,9826,10527,50,3.7,241,17.7,1759,190,1569,1.8,16.7,3160,1273,1887,12.1,30,-1401,-13.3,33.4,0,167,167,912
1986,15,e) 4,1144,1200,10089,10214,63,5,156,12.5,1898,301,1597,2.9,18.6,2148,717,1431,7,21,-250,-2.4,37.2,0,109,109,537
1986,15,f) 5,1122,1195,12347,12832,47,3.8,166,13.3,1671,265,1406,2.1,13,2640,1392,1248,10.8,20.6,-969,-7.6,26,0,112,112,610
1986,15,g) 6 to 10,3551,4102,47896,46383,184,4.4,371,8.8,10277,1325,8952,2.9,22.2,7251,2014,5237,4.3,15.6,3026,6.6,31.2,0,254,254,1244
1986,15,l) Left Censored,6786,10045,223323,219780,438,4.3,705,6.9,31563,9744,21819,4.4,14.4,24476,7215,17261,3.3,11.1,7087,3.3,22.2,0,356,356,1969
1986,16,a) 0,2120,2133,11418,5724,2121,198.9,0,0,11389,11389,0,199,199,0,0,0,0,0,11389,199,0,0,,,
1986,16,b) 1,1758,1780,10806,10829,36,1.8,352,18,2996,525,2471,4.8,27.7,3041,1490,1551,13.8,28.1,-45,-0.4,55.4,0,216,216,1075
1986,16,c) 2,1466,1488,9831,10168,55,3.4,325,19.9,2232,327,1905,3.2,22,2906,1599,1307,15.7,28.6,-674,-6.6,44,0,235,235,1151
1986,16,d) 3,1078,1152,9846,10035,65,5.3,208,17,2099,657,1442,6.5,20.9,2476,934,1542,9.3,24.7,-377,-3.8,41.8,0,164,164,785
1986,16,e) 4,958,1027,8285,8641,43,3.9,188,17.1,1475,110,1365,1.3,17.1,2186,1108,1078,12.8,25.3,-711,-8.2,34.2,0,147,147,957
1986,16,f) 5,889,924,7193,7717,32,3.3,140,14.3,976,126,850,1.6,12.6,2023,901,1122,11.7,26.2,-1047,-13.6,25.2,0,99,99,598
1986,16,g) 6 to 10,3514,3828,34836,35101,185,4.7,455,11.5,5885,991,4894,2.8,16.8,6415,2417,3998,6.9,18.3,-530,-1.5,33.6,0,296,299,1693
1986,16,l) Left Censored,6263,8878,163265,164366,321,3.5,751,8.2,18668,3580,15088,2.2,11.4,20871,4976,15895,3,12.7,-2203,-1.3,22.8,0,398,400,2079
1986,17,a) 0,19654,19850,115836,58256,19795,199.4,0,0,115160,115160,0,197.7,197.7,0,0,0,0,0,115160,197.7,0,0,,,
1986,17,b) 1,16321,16529,136539,127316,437,2.4,3105,17.3,50213,19024,31189,14.9,39.4,31767,15132,16635,11.9,25,18446,14.4,50,0,2115,2118,11043
1986,17,c) 2,14072,14395,128464,128704,537,3.5,2256,14.7,29011,4861,24150,3.8,22.5,29491,13690,15801,10.6,22.9,-480,-0.4,45,0,1685,1685,11071
1986,17,d) 3,10181,10481,105580,105516,401,3.6,1553,14,20507,3385,17122,3.2,19.4,20378,9193,11185,8.7,19.3,129,0.1,38.6,0,1175,1175,6494
1986,17,e) 4,9890,10305,111174,113763,330,3,1402,12.9,18663,2719,15944,2.4,16.4,23840,9014,14826,7.9,21,-5177,-4.6,32.8,0,1049,1050,6481
1986,17,f) 5,8741,9174,107404,107953,290,3,1172,12.2,17678,2829,14849,2.6,16.4,18776,8260,10516,7.7,17.4,-1098,-1,32.8,0,853,853,5955
1986,17,g) 6 to 10,31808,35176,367412,371166,1340,3.7,3742,10.3,57091,10158,46933,2.7,15.4,64598,25964,38634,7,17.4,-7507,-2,30.8,0,2454,2454,16843
1986,17,l) Left Censored,78170,107901,3138462,3138123,4583,4.2,8973,8.1,392356,113595,278761,3.6,12.5,391678,130676,261002,4.2,12.5,678,0,25,0,4803,4837,41025
1986,18,a) 0,9633,9708,57718,28890,9684,199.5,0,0,57657,57657,0,199.6,199.6,0,0,0,0,0,57657,199.6,0,0,,,
1986,18,b) 1,7793,7960,62306,58220,218,2.5,1859,21,22312,7493,14819,12.9,38.3,14140,7840,6300,13.5,24.3,8172,14,48.6,0,1374,1374,6026
1986,18,c) 2,6912,7092,60082,60003,275,3.6,1184,15.6,14510,4315,10195,7.2,24.2,14352,6994,7358,11.7,23.9,158,0.3,47.8,0,900,900,5393
1986,18,d) 3,4797,4925,44915,44943,201,3.8,824,15.7,9394,1947,7447,4.3,20.9,9450,4790,4660,10.7,21,-56,-0.1,41.8,0,612,612,3336
1986,18,e) 4,4055,4327,40489,41844,168,3.7,596,13.1,6541,1315,5226,3.1,15.6,9251,4168,5083,10,22.1,-2710,-6.5,31.2,0,442,442,3094
1986,18,f) 5,3642,3873,45325,45387,132,3.2,510,12.5,7670,1977,5693,4.4,16.9,7794,3116,4678,6.9,17.2,-124,-0.3,33.8,0,374,374,2335
1986,18,g) 6 to 10,14599,16501,171724,172327,722,4.3,1615,9.5,28527,5625,22902,3.3,16.6,29732,10705,19027,6.2,17.3,-1205,-0.7,33.2,0,1122,1123,6900
1986,18,l) Left Censored,35427,51354,1394207,1392868,2105,4,3813,7.3,159072,42550,116522,3.1,11.4,156394,48054,108340,3.5,11.2,2678,0.2,22.4,0,2031,2061,18347
1986,19,a) 0,4798,4831,30130,15145,4820,199.5,0,0,29971,29971,0,197.9,197.9,0,0,0,0,0,29971,197.9,0,0,,,
1986,19,b) 1,3949,4017,28368,26657,132,2.9,1013,22.6,10677,4765,5912,17.9,40.1,7255,3787,3468,14.2,27.2,3422,12.9,54.4,0,763,763,2985
1986,19,c) 2,4034,4079,24152,24987,167,3.8,736,16.8,4939,820,4119,3.3,19.8,6608,3393,3215,13.6,26.4,-1669,-6.6,39.6,0,573,573,2836
1986,19,d) 3,2657,2853,20947,22246,116,3.8,480,15.8,3277,1026,2251,4.6,14.7,5874,2483,3391,11.2,26.4,-2597,-11.7,29.4,0,372,372,2018
1986,19,e) 4,2488,2583,19125,20122,79,2.9,396,14.4,2668,398,2270,2,13.3,4662,1965,2697,9.8,23.2,-1994,-9.9,26.6,0,317,317,1683
1986,19,f) 5,2479,2632,23520,24075,70,2.5,342,12.3,3038,369,2669,1.5,12.6,4147,1395,2752,5.8,17.2,-1109,-4.6,25.2,0,246,246,991
1986,19,g) 6 to 10,9478,10705,82855,86352,406,3.6,1298,11.6,11610,2303,9307,2.7,13.4,18603,8287,10316,9.6,21.5,-6993,-8.1,26.8,0,890,890,4628
1986,19,l) Left Censored,23618,32291,636317,637353,1057,3.2,2695,8.1,72390,16619,55771,2.6,11.4,74461,23547,50914,3.7,11.7,-2071,-0.3,22.8,0,1468,1468,9065
1986,20,a) 0,5294,5343,30643,15337,5329,199.5,0,0,30613,30613,0,199.6,199.6,0,0,0,0,0,30613,199.6,0,0,,,
1986,20,b) 1,4344,4407,30031,30419,118,2.4,1235,24.7,10176,4313,5863,14.2,33.5,10951,5742,5209,18.9,36,-775,-2.5,67,0,903,903,4354
1986,20,c) 2,4069,4134,29727,31254,139,3.1,843,18.6,5540,967,4573,3.1,17.7,8593,4162,4431,13.3,27.5,-3053,-9.8,35.4,0,666,666,3470
1986,20,d) 3,2780,2877,18718,20304,131,4.2,572,18.4,3760,981,2779,4.8,18.5,6932,3480,3452,17.1,34.1,-3172,-15.6,37,0,451,451,2317
1986,20,e) 4,2512,2641,22396,23151,75,2.6,460,16.2,3593,321,3272,1.4,15.5,5102,2337,2765,10.1,22,-1509,-6.5,31,0,360,360,1494
1986,20,f) 5,2376,2534,23682,23732,103,3.9,366,13.7,4303,1152,3151,4.9,18.1,4403,1699,2704,7.2,18.6,-100,-0.5,36.2,0,262,272,1335
1986,20,g) 6 to 10,8099,9137,80880,81677,405,4.2,1176,12.3,13765,3558,10207,4.4,16.9,15358,5767,9591,7.1,18.8,-1593,-1.9,33.8,0,861,866,4118
1986,20,l) Left Censored,19400,26477,568041,570113,1001,3.7,2215,8.2,68082,16782,51300,2.9,11.9,72226,24904,47322,4.4,12.7,-4144,-0.8,23.8,0,1224,1235,7618
1986,21,a) 0,6251,6312,42052,21060,6298,199.6,0,0,41985,41985,0,199.4,199.4,0,0,0,0,0,41985,199.4,0,0,,,
1986,21,b) 1,5050,5119,40646,38764,108,1.9,993,17.8,12677,3724,8953,9.6,32.7,8912,4405,4507,11.4,23,3765,9.7,46,0,704,704,3451
1986,21,c) 2,4793,4888,39214,39359,169,3.2,800,15.3,9588,1723,7865,4.4,24.4,9878,4373,5505,11.1,25.1,-290,-0.7,48.8,0,641,642,3707
1986,21,d) 3,3082,3161,39437,40954,113,3.3,599,17.5,5215,853,4362,2.1,12.7,8249,2986,5263,7.3,20.1,-3034,-7.4,25.4,0,487,487,2405
1986,21,e) 4,2854,2948,28227,28631,92,2.9,452,14.4,5196,690,4506,2.4,18.1,6003,3198,2805,11.2,21,-807,-2.9,36.2,0,354,360,2423
1986,21,f) 5,2465,2590,33789,34212,86,3.2,338,12.4,5174,794,4380,2.3,15.1,6020,2536,3484,7.4,17.6,-846,-2.5,30.2,0,275,275,1438
1986,21,g) 6 to 10,8998,9898,105421,106057,369,3.6,1209,11.7,16716,2380,14336,2.2,15.8,17987,7255,10732,6.8,17,-1271,-1.2,31.6,0,877,880,5321
1986,21,l) Left Censored,21856,30857,752626,751247,1268,4,2448,7.8,84735,20083,64652,2.7,11.3,81977,24704,57273,3.3,10.9,2758,0.4,21.8,0,1380,1384,9159
1986,22,a) 0,7922,7967,47769,23903,7952,199.6,0,0,47732,47732,0,199.7,199.7,0,0,0,0,0,47732,199.7,0,0,,,
1986,22,b) 1,6269,6380,48090,49770,134,1.8,2052,27.8,14350,3114,11236,6.3,28.8,17710,10661,7049,21.4,35.6,-3360,-6.8,57.6,0,1627,1628,8550
1986,22,c) 2,5728,5829,49620,53220,195,3,1290,20.1,8485,1478,7007,2.8,15.9,15684,7920,7764,14.9,29.5,-7199,-13.6,31.8,0,1024,1024,6325
1986,22,d) 3,4276,4425,38885,40159,185,3.9,884,18.4,7978,1548,6430,3.9,19.9,10525,4703,5822,11.7,26.2,-2547,-6.3,39.8,0,712,712,3872
1986,22,e) 4,4296,4553,37392,39901,143,2.9,788,16.1,6408,1034,5374,2.6,16.1,11425,3999,7426,10,28.6,-5017,-12.5,32.2,0,615,615,3081
1986,22,f) 5,3693,3881,42051,45226,139,3.4,635,15.3,5937,854,5083,1.9,13.1,12287,4038,8249,8.9,27.2,-6350,-14.1,26.2,0,468,470,3056
1986,22,g) 6 to 10,12315,13633,151347,156514,543,3.8,1894,13.2,24116,5532,18584,3.5,15.4,34450,12093,22357,7.7,22,-10334,-6.6,30.8,0,1364,1370,8346
1986,22,l) Left Censored,24576,36593,807951,825400,1771,4.7,3350,9,107107,35606,71501,4.3,13,142005,40182,101823,4.9,17.2,-34898,-4.2,26,0,1721,1726,12545
1986,23,a) 0,3147,3162,14091,7051,3156,199.6,0,0,14081,14081,0,199.7,199.7,0,0,0,0,0,14081,199.7,0,0,,,
1986,23,b) 1,2291,2309,13553,12995,34,1.3,474,18.6,4302,557,3745,4.3,33.1,3186,1616,1570,12.4,24.5,1116,8.6,49,0,327,327,1181
1986,23,c) 2,1859,1889,13071,13243,67,3.3,313,15.5,2498,309,2189,2.3,18.9,2841,1343,1498,10.1,21.5,-343,-2.6,37.8,0,219,219,969
1986,23,d) 3,1317,1337,9867,9954,45,3.2,206,14.5,2129,139,1990,1.4,21.4,2303,1028,1275,10.3,23.1,-174,-1.7,42.8,0,157,157,804
1986,23,e) 4,1099,1146,10003,10076,29,2.4,146,12.1,1456,97,1359,1,14.5,1602,665,937,6.6,15.9,-146,-1.4,29,0,110,110,531
1986,23,f) 5,1013,1058,10662,10715,33,3,134,12.1,1685,253,1432,2.4,15.7,1790,704,1086,6.6,16.7,-105,-1,31.4,0,99,99,533
1986,23,g) 6 to 10,3939,4317,41852,42168,215,4.8,472,10.6,6659,1450,5209,3.4,15.8,7291,2797,4494,6.6,17.3,-632,-1.5,31.6,0,294,294,1485
1986,23,l) Left Censored,8356,11099,251463,250032,439,3.9,895,7.9,32152,8162,23990,3.3,12.9,29290,11036,18254,4.4,11.7,2862,1.2,23.4,0,503,520,4129
1986,24,a) 0,9636,9728,63655,31912,9681,199,0,0,63487,63487,0,198.9,198.9,0,0,0,0,0,63487,198.9,0,0,,,
1986,24,b) 1,7233,7427,63537,59853,193,2.4,1555,19.1,22912,4452,18460,7.4,38.3,15544,7770,7774,13,26,7368,12.3,52,0,1068,1068,5564
1986,24,c) 2,5750,5858,54159,56944,209,3.4,901,14.5,13337,1609,11728,2.8,23.4,18907,7481,11426,13.1,33.2,-5570,-9.8,46.8,0,622,622,4616
1986,24,d) 3,4332,4500,42532,42991,181,3.8,676,14.2,9327,1833,7494,4.3,21.7,10244,4874,5370,11.3,23.8,-917,-2.1,43.4,0,491,491,3395
1986,24,e) 4,3719,3930,45070,45651,129,3.1,538,13,8604,1015,7589,2.2,18.8,9765,3718,6047,8.1,21.4,-1161,-2.6,37.6,0,366,366,2610
1986,24,f) 5,3387,3568,40744,41763,135,3.6,413,11.2,7284,1208,6076,2.9,17.4,9322,3844,5478,9.2,22.3,-2038,-4.9,34.8,0,300,302,2778
1986,24,g) 6 to 10,11798,13153,161630,161592,560,4.1,1323,9.8,31149,4949,26200,3.1,19.3,31072,10307,20765,6.4,19.2,77,0.1,38.4,0,881,887,6703
1986,24,l) Left Censored,26629,39003,1094873,1082999,2019,5.1,2996,7.6,161035,49821,111214,4.6,14.9,137286,45721,91565,4.2,12.7,23749,2.2,25.4,0,1471,1586,13162
1986,25,a) 0,13344,13457,99541,49825,13427,199.6,0,0,99433,99433,0,199.6,199.6,0,0,0,0,0,99433,199.6,0,0,,,
1986,25,b) 1,10391,10555,97039,89652,252,2.2,2028,17.6,35637,9356,26281,10.4,39.8,20863,10559,10304,11.8,23.3,14774,16.5,46.6,0,1369,1369,7885
1986,25,c) 2,8330,8459,80528,87110,306,3.4,1330,14.8,18025,2073,15952,2.4,20.7,31188,21474,9714,24.7,35.8,-13163,-15.1,41.4,0,964,964,7825
1986,25,d) 3,6159,6310,62091,62285,220,3.3,946,14.2,13272,1576,11696,2.5,21.3,13659,6181,7478,9.9,21.9,-387,-0.6,42.6,0,661,661,4383
1986,25,e) 4,5623,5906,80499,81112,209,3.4,741,12,12850,1115,11735,1.4,15.8,14076,6210,7866,7.7,17.4,-1226,-1.6,31.6,0,527,527,4671
1986,25,f) 5,5020,5242,69819,70789,177,3.2,607,11.1,12902,1361,11541,1.9,18.2,14842,6173,8669,8.7,21,-1940,-2.8,36.4,0,441,441,5185
1986,25,g) 6 to 10,17501,19700,264884,266386,830,4.1,2048,10.1,41939,6511,35428,2.4,15.7,44943,18053,26890,6.8,16.9,-3004,-1.2,31.4,0,1368,1382,12359
1986,25,l) Left Censored,46390,62020,1922787,1932791,2345,3.7,4941,7.8,241429,60008,181421,3.1,12.5,261436,73732,187704,3.8,13.5,-20007,-1,25,0,2757,2766,25222
1986,26,a) 0,15759,15920,96140,48162,15868,199.3,0,0,95957,95957,0,199.2,199.2,0,0,0,0,0,95957,199.2,0,0,,,
1986,26,b) 1,12771,13041,107103,98996,383,2.7,2908,20.2,39780,11764,28016,11.9,40.2,23566,14528,9038,14.7,23.8,16214,16.4,47.6,0,2070,2070,9963
1986,26,c) 2,11005,11255,100406,99476,402,3.3,1987,16.4,24362,4948,19414,5,24.5,22502,10873,11629,10.9,22.6,1860,1.9,45.2,0,1494,1494,8839
1986,26,d) 3,7827,8049,74419,74128,301,3.5,1306,15.2,15801,2140,13661,2.9,21.3,15218,7691,7527,10.4,20.5,583,0.8,41,0,1015,1015,6061
1986,26,e) 4,6821,7185,70984,71452,244,3.2,1078,14.1,14367,1485,12882,2.1,20.1,15302,7965,7337,11.1,21.4,-935,-1.3,40.2,0,827,827,6223
1986,26,f) 5,6526,6884,75974,76664,224,3.1,870,12.1,12678,2307,10371,3,16.5,14057,6050,8007,7.9,18.3,-1379,-1.8,33,0,630,630,4602
1986,26,g) 6 to 10,23903,27069,293718,290267,1177,4.2,2931,10.5,52775,10426,42349,3.6,18.2,45872,17920,27952,6.2,15.8,6903,2.4,31.6,0,1949,1953,11223
1986,26,l) Left Censored,53846,78073,2270731,2243641,3161,4,6124,7.7,294543,74422,220121,3.3,13.1,240363,75296,165067,3.4,10.7,54180,2.4,21.4,0,3299,3317,24913
1986,27,a) 0,8384,8468,51972,26166,8442,199.4,0,0,51613,51613,0,197.3,197.3,0,0,0,0,0,51613,197.3,0,0,,,
1986,27,b) 1,6901,7073,58998,56222,213,2.7,1688,21.5,20615,7325,13290,13,36.7,15062,8406,6656,15,26.8,5553,9.9,53.6,0,1175,1175,6045
1986,27,c) 2,6041,6215,54383,55686,209,3.1,1194,17.7,13041,2165,10876,3.9,23.4,15647,9436,6211,16.9,28.1,-2606,-4.7,46.8,0,889,889,7643
1986,27,d) 3,4148,4438,44294,45651,168,3.5,805,16.9,7778,942,6836,2.1,17,10491,4810,5681,10.5,23,-2713,-6,34,0,630,631,3276
1986,27,e) 4,3694,3919,38993,40123,132,3.2,563,13.6,6490,815,5675,2,16.2,8749,3675,5074,9.2,21.8,-2259,-5.6,32.4,0,413,415,2371
1986,27,f) 5,3596,3778,41407,43216,133,3.4,473,12,6626,1127,5499,2.6,15.3,10244,3945,6299,9.1,23.7,-3618,-8.4,30.6,0,329,329,2582
1986,27,g) 6 to 10,13376,15051,160421,161897,605,3.9,1730,11.1,27909,5061,22848,3.1,17.2,30861,11550,19311,7.1,19.1,-2952,-1.9,34.4,0,1124,1143,7716
1986,27,l) Left Censored,30315,41741,1171198,1173969,1690,4,3354,7.9,149422,33651,115771,2.9,12.7,154963,49812,105151,4.2,13.2,-5541,-0.5,25.4,0,1636,1641,18023
1986,28,a) 0,4422,4445,22647,11455,4430,199.3,0,0,22384,22384,0,195.4,195.4,0,0,0,0,0,22384,195.4,0,0,,,
1986,28,b) 1,3489,3530,25116,24267,81,2,943,23.6,9346,2747,6599,11.3,38.5,7648,4901,2747,20.2,31.5,1698,7,63,0,692,692,3185
1986,28,c) 2,3254,3283,22743,23260,138,3.9,616,17.4,5294,946,4348,4.1,22.8,6328,3035,3293,13,27.2,-1034,-4.4,45.6,0,447,448,2288
1986,28,d) 3,2115,2159,15206,16351,104,4.5,391,16.9,3138,507,2631,3.1,19.2,5427,2037,3390,12.5,33.2,-2289,-14,38.4,0,288,288,1522
1986,28,e) 4,1869,1935,16114,15909,63,3.1,293,14.3,3494,744,2750,4.7,22,3084,1346,1738,8.5,19.4,410,2.6,38.8,0,224,225,1051
1986,28,f) 5,1764,1846,21087,21545,67,3.4,276,14.1,3337,551,2786,2.6,15.5,4252,2014,2238,9.3,19.7,-915,-4.2,31,0,194,194,1365
1986,28,g) 6 to 10,6801,7590,73105,73751,283,3.6,845,10.7,11377,1945,9432,2.6,15.4,12669,4695,7974,6.4,17.2,-1292,-1.8,30.8,0,567,567,3034
1986,28,l) Left Censored,14597,20829,490301,485296,906,4.3,1634,7.7,70935,16370,54565,3.4,14.6,60925,18624,42301,3.8,12.6,10010,2,25.2,0,862,873,7368
1986,29,a) 0,10573,10673,61066,30631,10640,199.4,0,0,60870,60870,0,198.7,198.7,0,0,0,0,0,60870,198.7,0,0,,,
1986,29,b) 1,9016,9157,69702,64747,216,2.2,1367,14,23724,5709,18015,8.8,36.6,13814,6277,7537,9.7,21.3,9910,15.3,42.6,0,521,521,2861
1986,29,c) 2,7053,7210,57503,58083,268,3.5,1186,15.4,13482,2579,10903,4.4,23.2,14641,7646,6995,13.2,25.2,-1159,-2,46.4,0,884,884,5830
1986,29,d) 3,4927,5091,46188,46870,202,3.7,832,15.3,8684,1434,7250,3.1,18.5,10047,4958,5089,10.6,21.4,-1363,-2.9,37,0,619,624,3696
1986,29,e) 4,4272,4571,42499,42944,162,3.3,684,14.1,7886,914,6972,2.1,18.4,8776,4095,4681,9.5,20.4,-890,-2,36.8,0,505,514,3173
1986,29,f) 5,4108,4447,45922,45210,152,3.3,565,12.1,9029,2605,6424,5.8,20,7604,3064,4540,6.8,16.8,1425,3.2,33.6,0,393,398,2065
1986,29,g) 6 to 10,14752,16466,165373,166233,746,4.4,1836,10.8,30499,6617,23882,4,18.3,32218,12084,20134,7.3,19.4,-1719,-1.1,36.6,0,1233,1243,8572
1986,29,l) Left Censored,34767,49403,1346104,1344415,2206,4.4,3858,7.7,173906,50464,123442,3.8,12.9,170528,55440,115088,4.1,12.7,3378,0.2,25.4,0,1911,1922,16377
1986,30,a) 0,2216,2224,10390,5206,2218,199.5,0,0,10369,10369,0,199.2,199.2,0,0,0,0,0,10369,199.2,0,0,,,
1986,30,b) 1,1789,1800,10361,10499,36,1.7,531,25.6,2967,693,2274,6.6,28.3,3242,1791,1451,17.1,30.9,-275,-2.6,56.6,0,399,399,1445
1986,30,c) 2,1537,1558,7997,8799,75,4.3,404,23.3,1650,243,1407,2.8,18.8,3253,1816,1437,20.6,37,-1603,-18.2,37.6,0,310,310,1529
1986,30,d) 3,1171,1276,8951,9455,56,4.1,221,16.2,1520,503,1017,5.3,16.1,2527,1176,1351,12.4,26.7,-1007,-10.6,32.2,0,161,161,881
1986,30,e) 4,1002,1029,6262,6890,36,3.2,200,18,994,123,871,1.8,14.4,2249,1036,1213,15,32.6,-1255,-18.2,28.8,0,157,157,774
1986,30,f) 5,959,994,7212,7815,41,3.8,175,16.4,1120,203,917,2.6,14.3,2326,976,1350,12.5,29.8,-1206,-15.5,28.6,0,130,130,763
1986,30,g) 6 to 10,3768,4102,30516,31700,204,4.8,534,12.5,4570,911,3659,2.9,14.4,6939,2603,4336,8.2,21.9,-2369,-7.5,28.8,0,359,361,1762
1986,30,l) Left Censored,6612,8639,134004,136527,293,3.3,752,8.5,12592,2536,10056,1.9,9.2,17638,5324,12314,3.9,12.9,-5046,-3.7,18.4,0,404,404,2258
1986,31,a) 0,2956,2979,17115,8572,2971,199.5,0,0,17086,17086,0,199.3,199.3,0,0,0,0,0,17086,199.3,0,0,,,
1986,31,b) 1,2775,2798,19656,19107,70,2.3,533,17.5,6175,1672,4503,8.8,32.3,5077,2539,2538,13.3,26.6,1098,5.7,53.2,0,379,379,2160
1986,31,c) 2,2353,2390,15436,15862,88,3.5,357,14.1,3011,664,2347,4.2,19,3862,1846,2016,11.6,24.3,-851,-5.3,38,0,246,246,1249
1986,31,d) 3,1775,1903,17288,18009,75,3.7,323,15.9,2582,771,1811,4.3,14.3,4024,1737,2287,9.6,22.3,-1442,-8,28.6,0,230,230,968
1986,31,e) 4,1599,1670,13165,13662,56,3.1,270,15.1,1935,233,1702,1.7,14.2,2929,1254,1675,9.2,21.4,-994,-7.2,28.4,0,200,200,827
1986,31,f) 5,1507,1589,11554,11825,53,3.2,230,13.7,1751,168,1583,1.4,14.8,2293,912,1381,7.7,19.4,-542,-4.6,29.6,0,163,164,666
1986,31,g) 6 to 10,5812,6325,49423,50861,219,3.3,741,11.2,7465,2085,5380,4.1,14.7,10341,4240,6101,8.3,20.3,-2876,-5.6,29.4,0,534,534,2788
1986,31,l) Left Censored,14061,18433,374400,376534,594,3.1,1529,8.1,41060,12650,28410,3.4,10.9,45328,12478,32850,3.3,12,-4268,-1.1,21.8,0,828,834,4928
1986,32,a) 0,2731,2767,18800,9429,2758,199.3,0,0,18743,18743,0,198.8,198.8,0,0,0,0,0,18743,198.8,0,0,,,
1986,32,b) 1,1867,1891,18908,18042,38,1.7,637,28.8,6902,1466,5436,8.1,38.3,5170,3159,2011,17.5,28.7,1732,9.6,57.4,0,486,486,2365
1986,32,c) 2,1604,1639,16294,17299,76,4.2,435,23.8,3417,528,2889,3.1,19.8,5426,2626,2800,15.2,31.4,-2009,-11.6,39.6,0,340,340,2281
1986,32,d) 3,1135,1196,12611,13397,54,4.2,238,18.4,2527,310,2217,2.3,18.9,4098,2290,1808,17.1,30.6,-1571,-11.7,37.8,0,188,188,2049
1986,32,e) 4,1164,1220,14883,15400,58,4.5,198,15.3,2675,545,2130,3.5,17.4,3708,2111,1597,13.7,24.1,-1033,-6.7,34.8,0,146,146,1015
1986,32,f) 5,1067,1133,11453,11646,53,4.4,173,14.5,2013,406,1607,3.5,17.3,2398,990,1408,8.5,20.6,-385,-3.3,34.6,0,122,122,638
1986,32,g) 6 to 10,3535,3890,52459,52304,196,4.8,543,13.4,10803,2177,8626,4.2,20.7,10492,4590,5902,8.8,20.1,311,0.6,40.2,0,340,340,2794
1986,32,l) Left Censored,5119,7433,249112,247422,430,5.7,664,8.8,34963,11239,23724,4.5,14.1,31584,12784,18800,5.2,12.8,3379,1.3,25.6,0,296,306,3191
1986,33,a) 0,3750,3768,21980,11208,3762,199.7,0,0,21545,21545,0,192.2,192.2,0,0,0,0,0,21545,192.2,0,0,,,
1986,33,b) 1,2619,2640,19327,18019,40,1.4,578,19.8,6836,1181,5655,6.6,37.9,4220,2507,1713,13.9,23.4,2616,14.5,46.8,0,425,425,2021
1986,33,c) 2,2045,2089,18632,18462,71,3.2,317,14.3,4448,543,3905,2.9,24.1,4108,1874,2234,10.2,22.3,340,1.8,44.6,0,233,233,1580
1986,33,d) 3,1375,1406,12833,12366,56,3.8,193,13.1,3178,987,2191,8,25.7,2244,878,1366,7.1,18.1,934,7.6,36.2,0,148,148,686
1986,33,e) 4,1175,1213,13381,12995,35,2.7,169,13.2,2856,566,2290,4.4,22,2084,1015,1069,7.8,16,772,6,32,0,126,126,621
1986,33,f) 5,1000,1033,11037,11208,42,3.9,126,11.7,2234,292,1942,2.6,19.9,2575,1205,1370,10.8,23,-341,-3.1,39.8,0,94,94,1065
1986,33,g) 6 to 10,3758,4177,46237,46417,220,5.1,468,10.9,7891,1768,6123,3.8,17,8250,3002,5248,6.5,17.8,-359,-0.8,34,0,319,319,1965
1986,33,l) Left Censored,7650,9954,290034,291706,505,5,797,7.9,39230,11473,27757,3.9,13.4,42575,17721,24854,6.1,14.6,-3345,-1.2,26.8,0,445,447,4122
1986,34,a) 0,18136,18221,100885,50552,18178,199.5,0,0,100666,100666,0,199.1,199.1,0,0,0,0,0,100666,199.1,0,0,,,
1986,34,b) 1,13603,13740,99247,91661,286,1.9,3154,20.7,37761,9854,27907,10.8,41.2,22589,12486,10103,13.6,24.6,15172,16.6,49.2,0,2148,2148,9276
1986,34,c) 2,10991,11152,103975,105549,413,3.5,1941,16.2,21092,2627,18465,2.5,20,24240,12128,12112,11.5,23,-3148,-3,40,0,1394,1395,9074
1986,34,d) 3,8635,8757,76535,77961,325,3.5,1447,15.5,14907,1455,13452,1.9,19.1,17758,8049,9709,10.3,22.8,-2851,-3.7,38.2,0,1076,1076,5875
1986,34,e) 4,7863,8107,82924,82127,255,3,1139,13.3,17869,1726,16143,2.1,21.8,16276,5986,10290,7.3,19.8,1593,2,39.6,0,811,813,4022
1986,34,f) 5,7113,7346,74021,74696,258,3.4,853,11.1,12331,1641,10690,2.2,16.5,13680,5424,8256,7.3,18.3,-1349,-1.8,33,0,613,619,3460
1986,34,g) 6 to 10,25100,26704,277642,277554,989,3.6,2826,10.2,52442,9136,43306,3.3,18.9,52267,19085,33182,6.9,18.8,175,0.1,37.6,0,1938,1951,11649
1986,34,l) Left Censored,58910,77204,2171555,2184875,2957,3.7,6260,7.9,296346,86824,209522,4,13.6,322986,97278,225708,4.5,14.8,-26640,-1.2,27.2,0,3511,3516,26795
1986,35,a) 0,3390,3420,19688,9867,3409,199.4,0,0,19643,19643,0,199.1,199.1,0,0,0,0,0,19643,199.1,0,0,,,
1986,35,b) 1,2550,2586,18836,18817,58,2,752,25.4,6109,1272,4837,6.8,32.5,6071,3353,2718,17.8,32.3,38,0.2,64.6,0,532,532,2442
1986,35,c) 2,2223,2260,14947,15608,111,4.5,472,19.2,3295,600,2695,3.8,21.1,4617,2200,2417,14.1,29.6,-1322,-8.5,42.2,0,342,342,1654
1986,35,d) 3,1678,1803,16804,17494,114,5.9,365,18.8,3352,913,2439,5.2,19.2,4731,2051,2680,11.7,27,-1379,-7.8,38.4,0,263,263,1525
1986,35,e) 4,1385,1440,21210,21580,65,4.2,242,15.8,2969,515,2454,2.4,13.8,3709,1827,1882,8.5,17.2,-740,-3.4,27.6,0,185,185,1439
1986,35,f) 5,1392,1444,12495,13172,60,3.9,236,15.3,2228,299,1929,2.3,16.9,3581,1600,1981,12.1,27.2,-1353,-10.3,33.8,0,159,159,856
1986,35,g) 6 to 10,4901,5420,51062,52240,281,5,684,12.1,9163,1568,7595,3,17.5,11519,4249,7270,8.1,22.1,-2356,-4.6,35,0,431,431,2768
1986,35,l) Left Censored,8078,11517,231702,234599,636,5.4,963,8.2,30105,10600,19505,4.5,12.8,35898,7840,28058,3.3,15.3,-5793,-2.5,25.6,0,491,494,3176
1986,36,a) 0,39301,39497,200888,100711,39399,199.5,0,0,200354,200354,0,198.9,198.9,0,0,0,0,0,200354,198.9,0,0,,,
1986,36,b) 1,31317,31598,222938,208142,707,2,7092,20.3,82773,24487,58286,11.8,39.8,53180,28979,24201,13.9,25.5,29593,14.3,51,0,4999,5000,20665
1986,36,c) 2,25406,25805,199983,203554,870,3.1,4709,16.9,45121,5315,39806,2.6,22.2,52263,25667,26596,12.6,25.7,-7142,-3.5,44.4,0,3512,3513,19438
1986,36,d) 3,19975,20349,170107,170904,753,3.5,3503,16.1,36678,4631,32047,2.7,21.5,38271,19004,19267,11.1,22.4,-1593,-0.9,43,0,2650,2650,14064
1986,36,e) 4,17613,18184,164485,168334,565,2.9,2580,13.4,27960,3055,24905,1.8,16.6,35658,14600,21058,8.7,21.2,-7698,-4.6,33.2,0,1970,1971,11605
1986,36,f) 5,15787,16325,174421,176227,491,2.9,2137,12.4,28729,4012,24717,2.3,16.3,32341,11458,20883,6.5,18.4,-3612,-2.1,32.6,0,1573,1574,7893
1986,36,g) 6 to 10,54248,58832,656341,654751,2002,3.3,6745,11,115605,18306,97299,2.8,17.7,112425,39553,72872,6,17.2,3180,0.5,34.4,0,4721,4755,25601
1986,36,l) Left Censored,137029,175270,4805220,4818473,5517,3.1,14683,8.2,592402,154337,438065,3.2,12.3,618909,203363,415546,4.2,12.8,-26507,-0.5,24.6,0,8907,8951,63503
1986,37,a) 0,13842,13973,73044,36791,13941,199.5,0,0,72506,72506,0,197.1,197.1,0,0,0,0,0,72506,197.1,0,0,,,
1986,37,b) 1,10982,11147,81807,77565,245,2,2749,22,30187,10949,19238,14.1,38.9,21703,12689,9014,16.4,28,8484,10.9,56,0,1984,2018,9886
1986,37,c) 2,10383,10619,78996,80067,387,3.4,1768,15.6,18701,3504,15197,4.4,23.4,20842,11309,9533,14.1,26,-2141,-2.6,46.8,0,1331,1331,8872
1986,37,d) 3,6156,6344,56529,57905,234,3.5,1015,15,11209,1958,9251,3.4,19.4,13962,6645,7317,11.5,24.1,-2753,-4.7,38.8,0,774,774,5333
1986,37,e) 4,5180,5448,52444,53386,223,3.9,769,13.4,9392,1459,7933,2.7,17.6,11275,5223,6052,9.8,21.1,-1883,-3.5,35.2,0,554,563,3666
1986,37,f) 5,4721,4998,79737,70992,195,3.7,637,12.2,27535,1834,25701,2.6,38.8,10044,5023,5021,7.1,14.1,17491,24.7,28.2,0,471,471,3778
1986,37,g) 6 to 10,17330,19247,199303,199077,803,4,1930,9.7,34155,6845,27310,3.4,17.2,33702,11264,22438,5.7,16.9,453,0.3,33.8,0,1292,1299,7422
1986,37,l) Left Censored,37977,58136,1734880,1724532,2722,4.6,4113,7,215196,71932,143264,4.2,12.5,194500,56453,138047,3.3,11.3,20696,1.2,22.6,0,2079,2121,14103
1986,38,a) 0,1351,1359,6808,3409,1356,199.6,0,0,6798,6798,0,199.4,199.4,0,0,0,0,0,6798,199.4,0,0,,,
1986,38,b) 1,1183,1200,6801,7101,31,2.3,301,22.3,1626,451,1175,6.4,22.9,2226,1114,1112,15.7,31.3,-600,-8.4,45.8,0,221,221,952
1986,38,c) 2,1076,1087,5545,5963,32,2.7,219,18.4,1074,128,946,2.1,18,1910,1066,844,17.9,32,-836,-14,36,0,167,167,909
1986,38,d) 3,807,888,6911,7670,27,2.8,139,14.7,790,89,701,1.2,10.3,2308,756,1552,9.9,30.1,-1518,-19.8,20.6,0,109,109,601
1986,38,e) 4,764,786,5216,5416,21,2.5,121,14.5,739,90,649,1.7,13.6,1139,489,650,9,21,-400,-7.4,27.2,0,94,94,374
1986,38,f) 5,721,746,6881,6739,25,3.2,90,11.6,1224,64,1160,0.9,18.2,939,390,549,5.8,13.9,285,4.3,27.8,0,55,55,229
1986,38,g) 6 to 10,2660,2858,20978,22124,118,4,307,10.4,2941,648,2293,2.9,13.3,5233,1494,3739,6.8,23.7,-2292,-10.4,26.6,0,211,214,972
1986,38,l) Left Censored,6101,7951,129520,130831,260,3.2,596,7.3,12219,2752,9467,2.1,9.3,14841,4358,10483,3.3,11.3,-2622,-2,18.6,0,309,309,1904
1986,39,a) 0,17334,17517,106152,53132,17478,199.6,0,0,106040,106040,0,199.6,199.6,0,0,0,0,0,106040,199.6,0,0,,,
1986,39,b) 1,13755,14043,118558,109606,470,3,3102,20.1,46990,15916,31074,14.5,42.9,29085,14066,15019,12.8,26.5,17905,16.4,53,0,2256,2256,11138
1986,39,c) 2,12163,12458,109892,111816,412,3.1,2128,15.9,23572,3089,20483,2.8,21.1,27419,13772,13647,12.3,24.5,-3847,-3.4,42.2,0,1599,1599,11258
1986,39,d) 3,8546,8876,79404,80105,336,3.6,1382,14.7,15244,2486,12758,3.1,19,16645,7948,8697,9.9,20.8,-1401,-1.8,38,0,1063,1063,6314
1986,39,e) 4,7857,8239,74292,75059,278,3.2,1187,13.6,14471,2720,11751,3.6,19.3,16005,8372,7633,11.2,21.3,-1534,-2,38.6,0,882,890,5777
1986,39,f) 5,7475,7966,95823,95526,245,2.9,946,11.4,15942,1920,14022,2,16.7,15348,6861,8487,7.2,16.1,594,0.6,32.2,0,678,680,4104
1986,39,g) 6 to 10,27348,31304,331313,330744,1275,3.9,3268,10.1,56179,10404,45775,3.1,17,55040,22940,32100,6.9,16.6,1139,0.4,33.2,0,2120,2121,13740
1986,39,l) Left Censored,70331,105402,2858867,2869329,4401,4.1,7904,7.4,337542,89008,248534,3.1,11.8,358466,118856,239610,4.1,12.5,-20924,-0.7,23.6,0,4019,4046,56311
1986,40,a) 0,6750,6788,39127,19609,6765,199.3,0,0,39036,39036,0,199.1,199.1,0,0,0,0,0,39036,199.1,0,0,,,
1986,40,b) 1,5484,5575,36887,38210,115,1.8,1974,30.1,12250,3289,8961,8.6,32.1,14896,8834,6062,23.1,39,-2646,-6.9,64.2,0,1577,1577,7362
1986,40,c) 2,5189,5258,35215,37518,202,3.5,1223,21.1,7405,1362,6043,3.6,19.7,12011,6287,5724,16.8,32,-4606,-12.3,39.4,0,1006,1006,5122
1986,40,d) 3,3593,3718,27150,29078,182,4.5,879,21.5,5044,1082,3962,3.7,17.3,8900,4797,4103,16.5,30.6,-3856,-13.3,34.6,0,677,677,3781
1986,40,e) 4,3648,3823,35412,37396,140,3.4,795,19.1,5087,832,4255,2.2,13.6,9055,3987,5068,10.7,24.2,-3968,-10.6,27.2,0,625,625,3053
1986,40,f) 5,3108,3270,32677,33981,92,2.6,595,16.9,5059,826,4233,2.4,14.9,7666,3460,4206,10.2,22.6,-2607,-7.7,29.8,0,454,454,2439
1986,40,g) 6 to 10,10249,11368,107073,112575,463,3.9,1693,14.1,15092,3513,11579,3.1,13.4,26095,9344,16751,8.3,23.2,-11003,-9.8,26.8,0,1210,1218,6305
1986,40,l) Left Censored,19551,28474,621881,636028,1382,4.7,2681,9.2,73288,22762,50526,3.6,11.5,101581,31627,69954,5,16,-28293,-4.5,23,0,1354,1364,9267
1986,41,a) 0,7339,7385,37234,18658,7351,199.1,0,0,37152,37152,0,199.1,199.1,0,0,0,0,0,37152,199.1,0,0,,,
1986,41,b) 1,5415,5483,36112,36316,108,1.7,1577,25.1,11158,2323,8835,6.4,30.7,11566,6971,4595,19.2,31.8,-408,-1.1,61.4,0,1160,1160,5003
1986,41,c) 2,4590,4675,33948,35378,230,4.5,1036,20.3,7491,1441,6050,4.1,21.2,10351,5229,5122,14.8,29.3,-2860,-8.1,42.4,0,819,819,4323
1986,41,d) 3,3201,3452,34428,35640,182,4.9,629,17.1,6521,1411,5110,4,18.3,8945,4105,4840,11.5,25.1,-2424,-6.8,36.6,0,467,467,2555
1986,41,e) 4,3117,3275,29769,30724,108,3.1,483,13.9,5316,715,4601,2.3,17.3,7225,3634,3591,11.8,23.5,-1909,-6.2,34.6,0,372,372,2956
1986,41,f) 5,2993,3163,26782,27843,138,4.1,457,13.7,4598,935,3663,3.4,16.5,6719,2536,4183,9.1,24.1,-2121,-7.6,33,0,332,332,1851
1986,41,g) 6 to 10,10380,11448,106669,107540,587,4.9,1474,12.4,19346,4650,14696,4.3,18,21088,8842,12246,8.2,19.6,-1742,-1.6,36,0,969,969,5301
1986,41,l) Left Censored,18410,25902,551716,552648,1118,4.2,2143,8.1,67547,16828,50719,3,12.2,69410,22333,47077,4,12.6,-1863,-0.4,24.4,0,1107,1112,8173
1986,42,a) 0,20650,20852,142119,71199,20784,199.3,0,0,141840,141840,0,199.2,199.2,0,0,0,0,0,141840,199.2,0,0,,,
1986,42,b) 1,15877,16213,141503,131851,458,2.6,3159,17.9,48882,15243,33639,11.6,37.1,29578,14031,15547,10.6,22.4,19304,14.7,44.8,0,2175,2175,10116
1986,42,c) 2,13894,14409,131700,132992,674,4.4,2066,13.6,29328,7393,21935,5.6,22.1,31911,16227,15684,12.2,24,-2583,-1.9,44.2,0,1519,1519,13146
1986,42,d) 3,9898,10166,91376,93328,423,3.9,1518,14.1,17555,2893,14662,3.1,18.8,21458,9465,11993,10.1,23,-3903,-4.2,37.6,0,1156,1156,7451
1986,42,e) 4,8989,9460,102230,103128,349,3.5,1188,12,16661,3461,13200,3.4,16.2,18457,7993,10464,7.8,17.9,-1796,-1.7,32.4,0,844,844,5438
1986,42,f) 5,8109,8530,99661,99470,311,3.5,979,11,17849,2512,15337,2.5,17.9,17467,7242,10225,7.3,17.6,382,0.3,35.2,0,683,694,4736
1986,42,g) 6 to 10,30784,34412,368301,370265,1474,4.2,3503,9.9,60619,12580,48039,3.4,16.4,64547,25235,39312,6.8,17.4,-3928,-1,32.8,0,2318,2326,15016
1986,42,l) Left Censored,81092,114680,3062288,3075334,4665,4,8805,7.5,356707,90665,266042,2.9,11.6,382798,116818,265980,3.8,12.4,-26091,-0.8,23.2,0,4736,4750,43501
1986,44,a) 0,2337,2345,12676,6343,2340,199.6,0,0,12667,12667,0,199.7,199.7,0,0,0,0,0,12667,199.7,0,0,,,
1986,44,b) 1,1782,1794,13250,12153,44,2.2,368,18.7,4877,1032,3845,8.5,40.1,2682,1551,1131,12.8,22.1,2195,18,44.2,0,257,257,1135
1986,44,c) 2,1439,1451,12478,12573,56,3.6,249,16,2441,276,2165,2.2,19.4,2630,1217,1413,9.7,20.9,-189,-1.5,38.8,0,170,170,945
1986,44,d) 3,1033,1049,8803,8829,38,3.4,163,14.6,1718,264,1454,3,19.5,1769,921,848,10.4,20,-51,-0.5,39,0,117,117,560
1986,44,e) 4,874,906,9755,9650,22,2.3,145,14.9,1794,147,1647,1.5,18.6,1584,604,980,6.3,16.4,210,2.2,32.8,0,108,108,469
1986,44,f) 5,847,867,9505,9468,26,2.9,90,10,1350,252,1098,2.7,14.3,1275,608,667,6.4,13.5,75,0.8,27,0,68,68,451
1986,44,g) 6 to 10,3166,3392,36864,36764,146,4.2,334,9.6,5767,907,4860,2.5,15.7,5566,1790,3776,4.9,15.1,201,0.6,30.2,0,235,235,1268
1986,44,l) Left Censored,8649,10542,276347,273778,396,3.7,792,7.4,34210,8936,25274,3.3,12.5,29071,10664,18407,3.9,10.6,5139,1.9,21.2,0,480,484,5750
1986,45,a) 0,6750,6797,38779,19413,6774,199.3,0,0,38732,38732,0,199.5,199.5,0,0,0,0,0,38732,199.5,0,0,,,
1986,45,b) 1,5474,5568,42676,40999,106,1.7,1341,21.5,13666,3220,10446,7.9,33.3,10311,5628,4683,13.7,25.1,3355,8.2,50.2,0,981,982,4225
1986,45,c) 2,4838,4968,41258,41392,217,4.1,814,15.4,9026,1812,7214,4.4,21.8,9293,4413,4880,10.7,22.5,-267,-0.7,43.6,0,588,588,3253
1986,45,d) 3,3054,3157,29207,29579,130,3.8,571,16.8,6140,1104,5036,3.7,20.8,6884,2942,3942,9.9,23.3,-744,-2.5,41.6,0,420,420,2243
1986,45,e) 4,2722,2861,27323,28775,100,3.3,384,12.8,5080,668,4412,2.3,17.7,7983,3577,4406,12.4,27.7,-2903,-10,35.4,0,280,280,2214
1986,45,f) 5,2376,2530,27156,27642,85,3.2,323,12.2,5154,1139,4015,4.1,18.6,6126,3212,2914,11.6,22.2,-972,-3.6,37.2,0,241,241,2427
1986,45,g) 6 to 10,8504,9501,96979,101431,408,4.1,1082,11,15610,2296,13314,2.3,15.4,24513,7126,17387,7,24.2,-8903,-8.8,30.8,0,715,715,4281
1986,45,l) Left Censored,18452,27793,755428,755508,1322,4.7,2058,7.3,96151,26659,69492,3.5,12.7,96311,32210,64101,4.3,12.7,-160,0,25.4,0,1025,1027,7998
1986,46,a) 0,1432,1437,7390,3703,1430,199,0,0,7374,7374,0,199.1,199.1,0,0,0,0,0,7374,199.1,0,0,,,
1986,46,b) 1,1274,1284,7218,7529,29,2,310,21.5,1934,513,1421,6.8,25.7,2556,1470,1086,19.5,33.9,-622,-8.2,51.4,0,202,202,1184
1986,46,c) 2,1134,1144,6246,6610,47,3.8,202,16.4,1178,173,1005,2.6,17.8,1905,1097,808,16.6,28.8,-727,-11,35.6,0,154,154,970
1986,46,d) 3,754,838,6371,6423,33,3.7,139,15.6,1459,163,1296,2.5,22.7,1562,672,890,10.5,24.3,-103,-1.6,45.4,0,100,100,459
1986,46,e) 4,688,710,4943,5034,28,3.7,105,14,849,219,630,4.4,16.9,1030,566,464,11.2,20.5,-181,-3.6,33.8,0,77,77,439
1986,46,f) 5,662,683,6431,6586,19,2.6,98,13.6,715,93,622,1.4,10.9,1024,475,549,7.2,15.5,-309,-4.6,21.8,0,66,66,401
1986,46,g) 6 to 10,2590,2819,20593,21006,112,3.8,315,10.8,3059,605,2454,2.9,14.6,3885,1615,2270,7.7,18.5,-826,-3.9,29.2,0,198,198,987
1986,46,l) Left Censored,6412,8045,133961,136073,240,2.9,597,7.3,13175,3274,9901,2.4,9.7,17399,4745,12654,3.5,12.8,-4224,-3.1,19.4,0,318,319,2283
1986,47,a) 0,9550,9649,59776,29943,9618,199.4,0,0,59667,59667,0,199.3,199.3,0,0,0,0,0,59667,199.3,0,0,,,
1986,47,b) 1,7208,7337,55914,54802,143,1.7,2043,24.5,19112,4652,14460,8.5,34.9,16888,10421,6467,19,30.8,2224,4.1,61.6,0,1552,1552,7648
1986,47,c) 2,7018,7122,57552,59451,245,3.2,1294,16.8,13376,2227,11149,3.7,22.5,17174,9858,7316,16.6,28.9,-3798,-6.4,45,0,1019,1019,8388
1986,47,d) 3,4370,4508,40319,41468,212,4.4,824,17.1,8696,1459,7237,3.5,21,10993,6003,4990,14.5,26.5,-2297,-5.5,42,0,647,647,4565
1986,47,e) 4,3736,3918,40956,42395,130,3.1,587,14.1,6937,1102,5835,2.6,16.4,9815,5211,4604,12.3,23.2,-2878,-6.8,32.8,0,436,436,3877
1986,47,f) 5,3317,3530,42749,42980,149,4,457,12.4,7532,1293,6239,3,17.5,7993,2766,5227,6.4,18.6,-461,-1.1,35,0,337,337,1913
1986,47,g) 6 to 10,12576,14179,160618,162041,615,4.2,1637,11.1,27273,4922,22351,3,16.8,30119,12752,17367,7.9,18.6,-2846,-1.8,33.6,0,1104,1112,8799
1986,47,l) Left Censored,28012,41549,1179916,1170039,1952,4.6,3175,7.5,156691,40657,116034,3.5,13.4,136938,40652,96286,3.5,11.7,19753,1.7,23.4,0,1595,1600,11945
1986,48,a) 0,38614,39130,247101,123890,38994,199.3,0,0,246422,246422,0,198.9,198.9,0,0,0,0,0,246422,198.9,0,0,,,
1986,48,b) 1,29906,30602,241333,242225,688,1.9,9890,27.9,82929,17256,65673,7.1,34.2,84712,49168,35544,20.3,35,-1783,-0.8,68.4,0,7748,7748,39202
1986,48,c) 2,26024,26914,232768,249289,1049,3.5,6387,21.5,55190,8149,47041,3.3,22.1,88231,47900,40331,19.2,35.4,-33041,-13.3,44.2,0,5070,5070,37162
1986,48,d) 3,19237,19904,181304,194969,835,3.9,4172,19.3,37942,6432,31510,3.3,19.5,65272,35115,30157,18,33.5,-27330,-14,39,0,3298,3298,25096
1986,48,e) 4,17754,18827,177560,188428,711,3.5,3406,16.8,32136,4855,27281,2.6,17.1,53871,23037,30834,12.2,28.6,-21735,-11.5,34.2,0,2560,2562,17455
1986,48,f) 5,23051,24531,254586,268651,888,3.4,3599,13.9,42173,8634,33539,3.2,15.7,70303,30794,39509,11.5,26.2,-28130,-10.5,31.4,0,2702,2704,21395
1986,48,g) 6 to 10,43036,50258,564426,584942,2456,4.7,6476,12.4,97434,23530,73904,4,16.7,138466,49613,88853,8.5,23.7,-41032,-7,33.4,0,4246,4283,30390
1986,48,l) Left Censored,80116,138089,3662147,3707146,7315,5.2,12230,8.7,497707,158339,339368,4.3,13.4,587704,164822,422882,4.4,15.9,-89997,-2.5,26.8,0,5436,5538,41037
1986,49,a) 0,3197,3238,22116,11066,3229,199.4,0,0,22101,22101,0,199.7,199.7,0,0,0,0,0,22101,199.7,0,0,,,
1986,49,b) 1,2484,2517,19956,19977,46,1.6,827,28.2,6976,985,5991,4.9,34.9,7017,4411,2606,22.1,35.1,-41,-0.2,69.8,0,606,606,3395
1986,49,c) 2,2023,2076,18916,20272,123,5.4,508,22.2,4412,788,3624,3.9,21.8,7124,4127,2997,20.4,35.1,-2712,-13.3,43.6,0,392,392,3149
1986,49,d) 3,1465,1590,17399,18095,121,7.1,346,20.2,5102,2630,2472,14.5,28.2,6493,2441,4052,13.5,35.9,-1391,-7.7,56.4,0,269,269,2048
1986,49,e) 4,1465,1545,14590,14786,74,4.5,249,15.2,2640,500,2140,3.4,17.9,3032,1435,1597,9.7,20.5,-392,-2.6,35.8,0,178,184,1086
1986,49,f) 5,1344,1445,18625,18289,75,5,201,13.3,3697,721,2976,3.9,20.2,3024,1134,1890,6.2,16.5,673,3.7,33,0,140,140,781
1986,49,g) 6 to 10,4727,5205,53891,55002,254,4.7,695,12.8,9659,1591,8068,2.9,17.6,11881,4947,6934,9,21.6,-2222,-4,35.2,0,450,450,3064
1986,49,l) Left Censored,8551,12542,322052,323586,650,5.1,1110,8.7,43270,14068,29202,4.3,13.4,46339,12807,33532,4,14.3,-3069,-0.9,26.8,0,516,519,4321
1986,50,a) 0,1876,1881,9406,4709,1877,199.6,0,0,9395,9395,0,199.5,199.5,0,0,0,0,0,9395,199.5,0,0,,,
1986,50,b) 1,1432,1446,8746,8512,24,1.5,308,19.3,2520,299,2221,3.5,29.6,2051,1008,1043,11.8,24.1,469,5.5,48.2,0,212,212,818
1986,50,c) 2,1192,1221,7969,7896,48,3.7,204,15.6,1838,208,1630,2.6,23.3,1692,780,912,9.9,21.4,146,1.9,42.8,0,157,157,667
1986,50,d) 3,830,842,5053,5366,27,3,145,16.1,971,103,868,1.9,18.1,1597,1013,584,18.9,29.8,-626,-11.7,36.2,0,118,118,697
1986,50,e) 4,736,754,6135,6120,21,2.6,116,14.4,1160,109,1051,1.8,19,1129,555,574,9.1,18.4,31,0.6,36.8,0,86,86,420
1986,50,f) 5,646,669,5651,5766,20,2.8,94,13.3,743,41,702,0.7,12.9,973,399,574,6.9,16.9,-230,-4,25.8,0,68,68,295
1986,50,g) 6 to 10,2263,2463,23846,23802,108,4.2,310,12.1,3920,515,3405,2.2,16.5,3831,1733,2098,7.3,16.1,89,0.4,32.2,0,214,214,1315
1986,50,l) Left Censored,4791,5960,132814,132012,209,3.4,447,7.3,14547,3002,11545,2.3,11,12942,4072,8870,3.1,9.8,1605,1.2,19.6,0,265,265,1513
1986,51,a) 0,12735,12835,76559,38393,12785,199.2,0,0,76333,76333,0,198.8,198.8,0,0,0,0,0,76333,198.8,0,0,,,
1986,51,b) 1,9848,10032,95803,85385,212,1.9,2265,20.4,38540,6145,32395,7.2,45.1,17704,9236,8468,10.8,20.7,20836,24.4,41.4,0,1628,1628,7020
1986,51,c) 2,8213,8378,64920,66688,272,3,1364,15.2,14515,1973,12542,3,21.8,18050,8071,9979,12.1,27.1,-3535,-5.3,43.6,0,1002,1002,6327
1986,51,d) 3,5330,5491,49774,49947,188,3.2,872,14.9,10657,1875,8782,3.8,21.3,11002,5678,5324,11.4,22,-345,-0.7,42.6,0,646,652,4406
1986,51,e) 4,4753,4987,55511,55824,164,3.1,702,13.3,10611,1299,9312,2.3,19,11236,5430,5806,9.7,20.1,-625,-1.1,38,0,491,493,3639
1986,51,f) 5,4343,4628,56064,56385,184,3.8,584,12.1,9220,1811,7409,3.2,16.4,9862,4305,5557,7.6,17.5,-642,-1.1,32.8,0,389,389,2254
1986,51,g) 6 to 10,15150,17242,204226,202556,717,4,1814,10.2,37016,8245,28771,4.1,18.3,33675,12245,21430,6,16.6,3341,1.7,33.2,0,1176,1179,7150
1986,51,l) Left Censored,32646,50997,1383268,1360691,2630,5.1,3510,6.8,191141,61598,129543,4.5,14,145987,44406,101581,3.3,10.7,45154,3.3,21.4,0,1733,1737,11686
1986,53,a) 0,11541,11677,61457,30805,11643,199.4,0,0,61304,61304,0,199,199,0,0,0,0,0,61304,199,0,0,,,
1986,53,b) 1,8531,8669,59678,57296,188,1.9,2334,23.7,20536,4649,15887,8.1,35.8,15772,9064,6708,15.8,27.5,4764,8.3,55,0,1631,1635,6649
1986,53,c) 2,7656,7826,57417,59206,369,4.3,1676,19.7,13389,2047,11342,3.5,22.6,16966,9496,7470,16,28.7,-3577,-6.1,45.2,0,1234,1234,7865
1986,53,d) 3,5496,5796,55943,57400,290,4.7,1027,16.6,11401,3385,8016,5.9,19.9,14315,6295,8020,11,24.9,-2914,-5,39.8,0,788,788,4438
1986,53,e) 4,4876,5106,44594,45463,192,3.5,810,14.9,8768,1257,7511,2.8,19.3,10505,5162,5343,11.4,23.1,-1737,-3.8,38.6,0,567,567,3725
1986,53,f) 5,4419,4665,44867,44655,203,4.1,652,13.3,9357,1365,7992,3.1,21,8933,4115,4818,9.2,20,424,1,40,0,475,476,3163
1986,53,g) 6 to 10,15869,17571,176449,181718,888,4.9,2291,12.5,30893,4952,25941,2.7,17,41431,12388,29043,6.8,22.8,-10538,-5.8,34,0,1453,1453,7874
1986,53,l) Left Censored,27233,39610,909355,903330,1945,4.8,3373,8.4,133948,32217,101731,3.6,14.8,121898,43239,78659,4.8,13.5,12050,1.3,27,0,1663,1700,13504
1986,54,a) 0,2916,2934,15429,7721,2925,199.4,0,0,15416,,,,199.7,0,0,0,0,0,15416,199.7,0,1,,,
1986,54,b) 1,2303,2350,26666,22535,58,2.2,682,25.4,13875,,,,61.6,5613,2887,2726,12.8,24.9,8262,36.7,49.8,1,516,518,2275
1986,54,c) 2,2177,2202,13676,14182,72,3.1,357,15.2,2569,318,2251,2.2,18.1,3580,1929,1651,13.6,25.2,-1011,-7.1,36.2,0,273,273,1509
1986,54,d) 3,1309,1335,9648,10242,47,3.3,234,16.4,1587,182,1405,1.8,15.5,2775,1442,1333,14.1,27.1,-1188,-11.6,31,0,160,160,1027
1986,54,e) 4,1309,1349,13756,14199,48,3.3,226,15.7,2250,228,2022,1.6,15.8,3136,1471,1665,10.4,22.1,-886,-6.3,31.6,0,158,158,1184
1986,54,f) 5,1193,1228,11810,12032,42,3.2,172,13.3,1756,209,1547,1.7,14.6,2200,1111,1089,9.2,18.3,-444,-3.7,29.2,0,126,126,643
1986,54,g) 6 to 10,4381,4912,43483,43853,240,4.7,603,11.9,7231,2068,5163,4.7,16.5,7970,3180,4790,7.3,18.2,-739,-1.7,33,0,361,361,1618
1986,54,l) Left Censored,11629,15902,313775,321386,566,3.5,1381,8.5,34574,9583,24991,3,10.8,49796,21274,28522,6.6,15.5,-15222,-4.7,21.6,0,708,712,4173
1986,55,a) 0,7427,7496,44228,22114,7496,200,0,0,44228,44228,0,200,200,0,0,0,0,0,44228,200,0,0,,,
1986,55,b) 1,6206,6299,43770,44582,136,1.8,2256,30.1,14363,4595,9768,10.3,32.2,15987,11892,4095,26.7,35.9,-1624,-3.7,64.4,0,1200,1200,6269
1986,55,c) 2,5739,5820,44710,48096,154,2.3,1583,23.9,8635,1376,7259,2.9,18,15406,10742,4664,22.3,32,-6771,-14,36,0,864,864,4639
1986,55,d) 3,3838,3953,34130,37011,95,2.1,1079,24,5558,714,4844,1.9,15,11319,7513,3806,20.3,30.6,-5761,-15.6,30,0,564,564,3392
1986,55,e) 4,3703,3879,35330,37094,108,2.5,888,20.6,5275,903,4372,2.4,14.2,8803,5599,3204,15.1,23.7,-3528,-9.5,28.4,0,467,469,2401
1986,55,f) 5,3573,3728,35924,38119,90,2.2,725,17.8,5264,647,4617,1.7,13.8,9653,5626,4027,14.8,25.3,-4389,-11.5,27.6,0,384,384,2427
1986,55,g) 6 to 10,14234,15813,151350,154903,573,3.4,2277,13.6,23646,4829,18817,3.1,15.3,30752,16016,14736,10.3,19.9,-7106,-4.6,30.6,0,1346,1348,7556
1986,55,l) Left Censored,35906,48103,1213274,1217827,1783,3.6,4074,8.3,138495,35158,103337,2.9,11.4,147600,52818,94782,4.3,12.1,-9105,-0.7,22.8,0,2083,2114,15012
1986,56,a) 0,1167,1170,5976,2991,1167,199.5,0,0,5970,,,,199.6,0,0,0,0,0,5970,199.6,0,1,,,
1986,56,b) 1,1050,1054,6196,6452,13,1.1,303,25.1,1832,,,,28.4,2343,1454,889,22.5,36.3,-511,-7.9,56.8,1,215,215,1034
1986,56,c) 2,903,908,6220,6627,42,4.2,214,21.3,1113,273,840,4.1,16.8,1927,980,947,14.8,29.1,-814,-12.3,33.6,0,163,163,752
1986,56,d) 3,733,799,6339,6590,52,6,188,21.6,1534,525,1009,8,23.3,2036,803,1233,12.2,30.9,-502,-7.6,46.6,0,153,153,712
1986,56,e) 4,770,821,5254,5707,40,4.6,145,16.6,827,198,629,3.5,14.5,1733,827,906,14.5,30.4,-906,-15.9,29,0,111,111,648
1986,56,f) 5,725,751,5044,5398,23,2.8,136,16.8,760,136,624,2.5,14.1,1468,682,786,12.6,27.2,-708,-13.1,28.2,0,101,101,481
1986,56,g) 6 to 10,2267,2504,21028,22072,115,4.4,342,13,3201,807,2394,3.7,14.5,5288,2042,3246,9.3,24,-2087,-9.5,29,0,236,236,1193
1986,56,l) Left Censored,3743,5003,75993,77762,213,4.1,516,10,9631,2861,6770,3.7,12.4,13168,3671,9497,4.7,16.9,-3537,-4.5,24.8,0,261,262,1722
1987,01,a) 0,7922,8108,54273,30825,8060,198.8,0,0,46897,46897,0,152.1,152.1,0,0,0,0,0,46897,152.1,0,0,,,
1987,01,b) 1,5679,5842,49802,49868,108,1.6,1649,24.6,13751,1652,12099,3.3,27.6,13883,7294,6589,14.6,27.8,-132,-0.2,55.2,0,1281,1281,5445
1987,01,c) 2,4584,4763,38652,40715,273,5.2,1059,20.3,8368,2173,6195,5.3,20.6,12493,5944,6549,14.6,30.7,-4125,-10.1,41.2,0,769,769,4029
1987,01,d) 3,4610,4763,41204,42501,196,3.9,737,14.6,8505,982,7523,2.3,20,11098,4540,6558,10.7,26.1,-2593,-6.1,40,0,550,550,3082
1987,01,e) 4,2847,3021,26388,27057,171,5.4,448,14.1,5347,1383,3964,5.1,19.8,6684,2767,3917,10.2,24.7,-1337,-4.9,39.6,0,355,355,2023
1987,01,f) 5,2479,2648,29386,29786,101,3.6,361,13,6131,870,5261,2.9,20.6,6931,3241,3690,10.9,23.3,-800,-2.7,41.2,0,266,267,2454
1987,01,g) 6 to 10,11813,13599,155358,158331,673,4.8,1548,11,26312,4986,21326,3.1,16.6,32257,10627,21630,6.7,20.4,-5945,-3.8,33.2,0,1014,1022,5638
1987,01,l) Left Censored,20326,31070,813014,820619,1697,5.4,2826,8.9,101123,26664,74459,3.2,12.3,116332,36256,80076,4.4,14.2,-15209,-1.9,24.6,0,1326,1360,11064
1987,02,a) 0,1382,1417,8889,5252,1399,197.5,0,0,7275,7275,0,138.5,138.5,0,0,0,0,0,7275,138.5,0,0,,,
1987,02,b) 1,1123,1158,8767,9683,28,1.9,553,38.2,2241,404,1837,4.2,23.1,4073,2118,1955,21.9,42.1,-1832,-19,46.2,0,423,423,1740
1987,02,c) 2,975,1018,7472,8167,76,6.6,325,28.1,1800,369,1431,4.5,22,3189,1753,1436,21.5,39,-1389,-17,44,0,250,250,1475
1987,02,d) 3,852,882,5641,6548,56,5.7,248,25,1216,453,763,6.9,18.6,3029,1650,1379,25.2,46.3,-1813,-27.7,37.2,0,201,201,1490
1987,02,e) 4,672,741,5053,5689,54,6.6,189,23.2,1265,363,902,6.4,22.2,2537,1077,1460,18.9,44.6,-1272,-22.4,44.4,0,144,146,813
1987,02,f) 5,535,571,4256,4751,26,4.2,132,21.1,758,168,590,3.5,16,1747,903,844,19,36.8,-989,-20.8,32,0,91,91,604
1987,02,g) 6 to 10,2040,2319,24076,25942,122,5,385,15.7,3690,773,2917,3,14.2,7422,2957,4465,11.4,28.6,-3732,-14.4,28.4,0,214,220,2010
1987,02,l) Left Censored,2330,3578,75800,79050,246,6.7,448,12.2,10679,3013,7666,3.8,13.5,17179,5631,11548,7.1,21.7,-6500,-8.2,27,0,130,136,1001
1987,04,a) 0,9464,9722,61006,32842,9644,198.4,0,0,56329,56329,0,171.5,171.5,0,0,0,0,0,56329,171.5,0,0,,,
1987,04,b) 1,6833,7066,60773,62227,166,2,2166,26.5,17884,2665,15219,4.3,28.7,20792,11746,9046,18.9,33.4,-2908,-4.7,57.4,0,1669,1670,9154
1987,04,c) 2,5609,5780,56985,61696,385,6.1,1399,22.1,12611,3060,9551,5,20.4,22032,10916,11116,17.7,35.7,-9421,-15.3,40.8,0,1029,1029,6578
1987,04,d) 3,4664,4934,43684,47172,307,5.8,974,18.4,10483,2807,7676,6,22.2,17458,8412,9046,17.8,37,-6975,-14.8,44.4,0,730,730,6191
1987,04,e) 4,3449,3871,47105,48261,287,7.1,620,15.3,9791,3060,6731,6.3,20.3,12103,5614,6489,11.6,25.1,-2312,-4.8,40.6,0,458,462,3712
1987,04,f) 5,3236,3537,43931,43653,179,4.8,553,14.8,9991,1419,8572,3.3,22.9,9435,4097,5338,9.4,21.6,556,1.3,43.2,0,402,404,3138
1987,04,g) 6 to 10,11834,13491,164528,170613,851,6.1,1735,12.4,29333,6384,22949,3.7,17.2,41502,15525,25977,9.1,24.3,-12169,-7.1,34.4,0,1075,1104,8962
1987,04,l) Left Censored,13216,23088,655447,657905,1734,7.4,2215,9.5,98964,39643,59321,6,15,103881,41295,62586,6.3,15.8,-4917,-0.8,30,0,823,845,7845
1987,05,a) 0,4845,4925,29049,16306,4883,198.3,0,0,25487,25487,0,156.3,156.3,0,0,0,0,0,25487,156.3,0,0,,,
1987,05,b) 1,3486,3559,29953,30557,54,1.3,1111,26.8,7257,735,6522,2.4,23.7,8464,5148,3316,16.8,27.7,-1207,-4,47.4,0,937,937,4506
1987,05,c) 2,3018,3086,27803,27932,173,5.1,680,20.2,7784,1474,6310,5.3,27.9,8042,4244,3798,15.2,28.8,-258,-0.9,55.8,0,553,554,3094
1987,05,d) 3,3043,3118,18713,19838,159,4.8,503,15.2,3612,797,2815,4,18.2,5862,3243,2619,16.3,29.5,-2250,-11.3,36.4,0,423,423,2183
1987,05,e) 4,2017,2135,18573,18408,107,4.8,296,13.2,4720,1400,3320,7.6,25.6,4390,1865,2525,10.1,23.8,330,1.8,47.6,0,224,224,1374
1987,05,f) 5,1764,1834,16409,17092,59,3,279,14.3,2788,469,2319,2.7,16.3,4154,2047,2107,12,24.3,-1366,-8,32.6,0,216,217,1307
1987,05,g) 6 to 10,8375,9255,91168,92749,426,4.4,1144,11.9,15908,2740,13168,3,17.2,19069,8512,10557,9.2,20.6,-3161,-3.4,34.4,0,763,772,5286
1987,05,l) Left Censored,13348,18554,471129,476807,988,5.2,1650,8.7,52789,13754,39035,2.9,11.1,64144,21840,42304,4.6,13.5,-11355,-2.4,22.2,0,831,851,8465
1987,06,a) 0,70630,72423,474825,248501,72006,198.8,0,0,452649,452649,0,182.2,182.2,0,0,0,0,0,452649,182.2,0,0,,,
1987,06,b) 1,51165,52871,513817,511903,1045,1.7,13844,23,140637,15473,125164,3,27.5,136808,77512,59296,15.1,26.7,3829,0.8,53.4,0,10430,10437,58641
1987,06,c) 2,42244,43795,395590,403520,2964,6.3,8920,18.9,109252,22974,86278,5.7,27.1,125111,66376,58735,16.4,31,-15859,-3.9,54.2,0,6606,6622,43615
1987,06,d) 3,36391,38039,370973,375256,2211,5.5,6314,15.7,93128,16404,76724,4.4,24.8,101693,51829,49864,13.8,27.1,-8565,-2.3,49.6,0,4765,4770,41521
1987,06,e) 4,27552,29710,374096,375246,1780,5.7,4391,14.1,84648,15867,68781,4.2,22.6,86947,33810,53137,9,23.2,-2299,-0.6,45.2,0,3327,3356,24793
1987,06,f) 5,26683,28642,317037,316730,1429,4.7,4149,13.8,68538,11546,56992,3.6,21.6,67924,29812,38112,9.4,21.4,614,0.2,42.8,0,2810,2861,18509
1987,06,g) 6 to 10,112136,126328,1561435,1568526,7258,5.5,15655,12,305590,64234,241356,4.1,19.5,319773,131219,188554,8.4,20.4,-14183,-0.9,39,0,9790,9967,78396
1987,06,l) Left Censored,131839,209985,6017615,6077103,12379,5.8,21025,9.8,885515,245598,639917,4,14.6,1004492,383143,621349,6.3,16.5,-118977,-1.9,29.2,0,9299,9568,99140
1987,08,a) 0,9627,9851,59508,31413,9786,198.7,0,0,56191,56191,0,178.9,178.9,0,0,0,0,0,56191,178.9,0,0,,,
1987,08,b) 1,7092,7275,56101,60215,154,1.8,2480,29.1,14991,2109,12882,3.5,24.9,23218,13940,9278,23.2,38.6,-8227,-13.7,49.8,0,1922,1922,11231
1987,08,c) 2,6258,6432,49497,52689,386,5.5,1547,21.9,11910,3109,8801,5.9,22.6,18294,10002,8292,19,34.7,-6384,-12.1,45.2,0,1223,1235,7994
1987,08,d) 3,5332,5538,42944,46579,289,4.8,1220,20.2,9079,2908,6171,6.2,19.5,16348,7463,8885,16,35.1,-7269,-15.6,39,0,937,937,5700
1987,08,e) 4,3896,4403,58543,61691,300,6.4,808,17.3,11217,4934,6283,8,18.2,17512,9208,8304,14.9,28.4,-6295,-10.2,36.4,0,605,609,7768
1987,08,f) 5,3610,3816,33003,35133,161,3.9,705,17.2,5696,1118,4578,3.2,16.2,9956,4699,5257,13.4,28.3,-4260,-12.1,32.4,0,511,512,3248
1987,08,g) 6 to 10,14835,16594,161629,169812,949,5.4,2490,14.3,28100,6955,21145,4.1,16.5,44465,18819,25646,11.1,26.2,-16365,-9.7,33,0,1594,1663,11553
1987,08,l) Left Censored,18120,27998,695783,719904,1833,6.4,3243,11.3,92364,33024,59340,4.6,12.8,140608,51653,88955,7.2,19.5,-48244,-6.7,25.6,0,1197,1244,10619
1987,09,a) 0,8603,8748,50755,26655,8685,198.6,0,0,48200,48200,0,180.8,180.8,0,0,0,0,0,48200,180.8,0,0,,,
1987,09,b) 1,6218,6349,54784,51561,89,1.3,1250,17.9,17459,2743,14716,5.3,33.9,11012,4923,6089,9.5,21.4,6447,12.5,42.8,0,930,931,3579
1987,09,c) 2,5111,5222,42151,42403,265,4.8,834,15,9689,1528,8161,3.6,22.8,10193,4880,5313,11.5,24,-504,-1.2,45.6,0,624,624,3568
1987,09,d) 3,4360,4499,41235,40515,210,4.5,579,12.3,10290,1668,8622,4.1,25.4,8849,3877,4972,9.6,21.8,1441,3.6,43.6,0,455,455,3310
1987,09,e) 4,3160,3291,32961,33272,172,5,475,13.8,7167,1700,5467,5.1,21.5,7788,3185,4603,9.6,23.4,-621,-1.9,43,0,367,367,2398
1987,09,f) 5,3020,3174,39370,39402,120,3.6,399,12,5942,700,5242,1.8,15.1,6005,2736,3269,6.9,15.2,-63,-0.1,30.2,0,305,306,2037
1987,09,g) 6 to 10,12731,13934,164356,163120,587,4.1,1536,10.6,28816,4466,24350,2.7,17.7,26343,10106,16237,6.2,16.1,2473,1.6,32.2,0,1061,1067,7316
1987,09,l) Left Censored,25143,33426,1063876,1062978,1621,4.8,2916,8.5,125390,30716,94674,2.9,11.8,123594,44270,79324,4.2,11.6,1796,0.2,23.2,0,1541,1556,14491
1987,10,a) 0,1533,1567,11179,6462,1557,198.7,0,0,9434,9434,0,146,146,0,0,0,0,0,9434,146,0,0,,,
1987,10,b) 1,1114,1156,7665,16372,33,2.5,281,21.7,2773,146,2627,0.9,16.9,20186,1218,18968,7.4,123.3,-17413,-106.4,33.8,0,210,210,992
1987,10,c) 2,933,959,7479,7477,59,5.8,151,14.9,1909,430,1479,5.8,25.5,1904,912,992,12.2,25.5,5,0,51,0,117,117,648
1987,10,d) 3,836,860,8266,8156,47,5.2,119,13.3,1777,266,1511,3.3,21.8,1556,936,620,11.5,19.1,221,2.7,38.2,0,86,86,416
1987,10,e) 4,589,615,5793,5857,24,3.7,80,12.4,1087,168,919,2.9,18.6,1214,339,875,5.8,20.7,-127,-2.1,37.2,0,54,54,260
1987,10,f) 5,510,522,5664,5601,28,5.2,64,11.8,1063,94,969,1.7,19,937,316,621,5.6,16.7,126,2.3,33.4,0,53,53,285
1987,10,g) 6 to 10,2225,2478,30244,30471,120,4.7,282,11,5244,729,4515,2.4,17.2,5697,2372,3325,7.8,18.7,-453,-1.5,34.4,0,174,175,1363
1987,10,l) Left Censored,4407,5983,194458,191919,372,6.1,499,8.2,28890,5274,23616,2.7,15.1,23812,8538,15274,4.4,12.4,5078,2.7,24.8,0,234,235,1449
1987,11,a) 0,1419,1437,10315,5209,1429,198.9,0,0,10212,10212,0,196,196,0,0,0,0,0,10212,196,0,0,,,
1987,11,b) 1,1145,1162,14395,14129,25,1.9,244,19,3275,367,2908,2.6,23.2,2742,1631,1111,11.5,19.4,533,3.8,38.8,0,180,180,1306
1987,11,c) 2,1008,1023,15670,15012,63,5.8,161,14.9,3753,406,3347,2.7,25,2438,1193,1245,7.9,16.2,1315,8.8,32.4,0,128,128,953
1987,11,d) 3,953,975,10749,11021,47,4.6,125,12.3,1892,303,1589,2.7,17.2,2435,988,1447,9,22.1,-543,-4.9,34.4,0,101,101,776
1987,11,e) 4,838,864,7975,8649,30,3.3,121,13.3,1809,300,1509,3.5,20.9,3157,1437,1720,16.6,36.5,-1348,-15.6,41.8,0,84,84,1186
1987,11,f) 5,708,728,8884,8490,35,4.5,109,14.2,2372,939,1433,11.1,27.9,1583,646,937,7.6,18.6,789,9.3,37.2,0,74,74,396
1987,11,g) 6 to 10,2847,3123,68903,66562,156,4.8,364,11.3,12224,2800,9424,4.2,18.4,7542,2493,5049,3.7,11.3,4682,7.1,22.6,0,182,183,1068
1987,11,l) Left Censored,5915,7915,272241,271326,417,5.1,776,9.6,34473,8843,25630,3.3,12.7,32643,12035,20608,4.4,12,1830,0.7,24,0,316,325,3155
1987,12,a) 0,38641,39523,239560,124582,39317,199,0,0,229957,229957,0,184.6,184.6,0,0,0,0,0,229957,184.6,0,0,,,
1987,12,b) 1,27361,28100,225148,228755,449,1.4,8341,25.7,64831,5822,59009,2.5,28.3,72045,39236,32809,17.2,31.5,-7214,-3.2,56.6,0,6714,6717,31079
1987,12,c) 2,22019,22807,184503,193394,1403,5.6,5167,20.7,43775,9094,34681,4.7,22.6,61557,30465,31092,15.8,31.8,-17782,-9.2,45.2,0,4252,4254,25881
1987,12,d) 3,18400,19056,166827,174066,1025,5,3439,16.9,36071,7267,28804,4.2,20.7,50549,25739,24810,14.8,29,-14478,-8.3,41.4,0,2805,2806,20752
1987,12,e) 4,13713,14471,131542,137726,734,4.8,2474,16.1,28592,6639,21953,4.8,20.8,40960,19790,21170,14.4,29.7,-12368,-8.9,41.6,0,1949,1963,15182
1987,12,f) 5,12808,13552,144383,148222,549,3.8,1944,13.6,25874,3377,22497,2.3,17.5,33551,13751,19800,9.3,22.6,-7677,-5.1,35,0,1476,1487,9925
1987,12,g) 6 to 10,47262,53160,586317,600908,2826,5.1,7027,12.7,109022,25208,83814,4.2,18.1,138204,57133,81071,9.5,23,-29182,-4.9,36.2,0,4714,4793,36697
1987,12,l) Left Censored,55392,95388,2374593,2377329,6690,6.9,9037,9.3,358812,128634,230178,5.4,15.1,364286,133862,230424,5.6,15.3,-5474,-0.2,30.2,0,3897,3977,35856
1987,13,a) 0,14623,15057,104038,57016,14958,198.7,0,0,94045,94045,0,164.9,164.9,0,0,0,0,0,94045,164.9,0,0,,,
1987,13,b) 1,10971,11291,108229,106887,219,1.7,3098,24.1,29104,3247,25857,3,27.2,26419,15367,11052,14.4,24.7,2685,2.5,49.4,0,2421,2421,12363
1987,13,c) 2,9023,9314,75250,79007,550,5.5,1917,19,19932,4523,15409,5.7,25.2,27446,15460,11986,19.6,34.7,-7514,-9.5,50.4,0,1480,1480,9000
1987,13,d) 3,7872,8207,76267,78568,460,5.3,1318,15.2,16625,4264,12361,5.4,21.2,21226,10543,10683,13.4,27,-4601,-5.8,42.4,0,1030,1030,7900
1987,13,e) 4,5390,5779,54397,55166,355,5.8,892,14.7,13301,4227,9074,7.7,24.1,14839,6631,8208,12,26.9,-1538,-2.8,48.2,0,674,675,5104
1987,13,f) 5,4802,5189,57581,59243,221,4.1,694,12.7,10675,2246,8429,3.8,18,13998,5569,8429,9.4,23.6,-3323,-5.6,36,0,473,475,3804
1987,13,g) 6 to 10,19821,22484,271308,275218,1202,5.2,2659,11.4,50202,14548,35654,5.3,18.2,58021,23356,34665,8.5,21.1,-7819,-2.9,36.4,0,1683,1699,12551
1987,13,l) Left Censored,31742,52442,1551053,1553290,3417,6.4,4771,9,225653,75153,150500,4.8,14.5,230127,74487,155640,4.8,14.8,-4474,-0.3,29,0,1967,2023,16877
1987,15,a) 0,2306,2400,17978,10330,2378,198.2,0,0,15296,15296,0,148.1,148.1,0,0,0,0,0,15296,148.1,0,0,,,
1987,15,b) 1,1635,1725,17256,16493,68,3.5,422,21.9,5060,1034,4026,6.3,30.7,3534,2120,1414,12.9,21.4,1526,9.3,42.8,0,340,342,1817
1987,15,c) 2,1516,1578,11991,12512,106,6.3,257,15.4,2746,709,2037,5.7,21.9,3787,1840,1947,14.7,30.3,-1041,-8.4,43.8,0,207,207,1474
1987,15,d) 3,1122,1167,10042,10243,58,4.7,188,15.2,1889,472,1417,4.6,18.4,2290,1117,1173,10.9,22.4,-401,-4,36.8,0,151,151,980
1987,15,e) 4,1103,1154,9519,9596,74,6.1,174,14.4,1822,389,1433,4.1,19,1976,1021,955,10.6,20.6,-154,-1.6,38,0,137,137,781
1987,15,f) 5,1035,1082,10492,10346,50,4.4,155,13.6,2379,367,2012,3.5,23,2086,999,1087,9.7,20.2,293,2.8,40.4,0,105,106,618
1987,15,g) 6 to 10,4375,5041,57187,59020,297,5.7,534,10.3,10249,3265,6984,5.5,17.4,13914,3748,10166,6.4,23.6,-3665,-6.2,34.8,0,323,328,2091
1987,15,l) Left Censored,6406,9666,227278,224689,480,4.9,865,8.8,36921,8494,28427,3.8,16.4,31743,14189,17554,6.3,14.1,5178,2.3,28.2,0,360,363,3332
1987,16,a) 0,2193,2243,13130,7382,2218,197.8,0,0,11496,11496,0,155.7,155.7,0,0,0,0,0,11496,155.7,0,0,,,
1987,16,b) 1,1682,1713,10564,10912,31,1.6,388,20.2,2976,411,2565,3.8,27.3,3672,2121,1551,19.4,33.7,-696,-6.4,54.6,0,275,275,1407
1987,16,c) 2,1496,1541,9503,10017,92,5.5,281,16.9,2329,725,1604,7.2,23.3,3357,1508,1849,15.1,33.5,-1028,-10.2,46.6,0,200,200,1148
1987,16,d) 3,1317,1358,8785,9330,82,5.8,205,14.4,1692,414,1278,4.4,18.1,2781,1256,1525,13.5,29.8,-1089,-11.7,36.2,0,147,147,967
1987,16,e) 4,961,1056,9010,9629,60,5.4,157,14.2,1421,368,1053,3.8,14.8,2659,1173,1486,12.2,27.6,-1238,-12.8,29.6,0,116,116,568
1987,16,f) 5,826,881,6677,7413,28,2.9,164,17.2,1038,139,899,1.9,14,2509,1311,1198,17.7,33.8,-1471,-19.8,28,0,100,102,1021
1987,16,g) 6 to 10,4033,4387,39236,40655,218,4.8,544,11.9,6829,1190,5639,2.9,16.8,9667,4613,5054,11.3,23.8,-2838,-7,33.6,0,364,366,3487
1987,16,l) Left Censored,5863,8417,156962,159244,449,5.2,900,10.4,19919,5729,14190,3.6,12.5,24483,8112,16371,5.1,15.4,-4564,-2.9,25,0,334,343,1935
1987,17,a) 0,21054,21560,141131,75770,21430,198.8,0,0,130723,130723,0,172.5,172.5,0,0,0,0,0,130723,172.5,0,0,,,
1987,17,b) 1,15815,16298,147205,143709,321,1.8,3423,19,39217,5460,33757,3.8,27.3,32225,17229,14996,12,22.4,6992,4.9,44.8,0,2487,2487,12035
1987,17,c) 2,14196,14652,129317,130615,784,5,2368,15.2,28647,6761,21886,5.2,21.9,31243,15256,15987,11.7,23.9,-2596,-2,43.8,0,1838,1839,10832
1987,17,d) 3,12563,13088,118081,123630,618,4.5,1812,13.2,21812,4875,16937,3.9,17.6,32909,13480,19429,10.9,26.6,-11097,-9,35.2,0,1379,1380,8312
1987,17,e) 4,9087,9617,105599,106557,511,5.1,1365,13.6,21097,6474,14623,6.1,19.8,23013,10034,12979,9.4,21.6,-1916,-1.8,39.6,0,1025,1029,6428
1987,17,f) 5,8903,9372,104037,105230,350,3.6,1219,12.4,18006,2502,15504,2.4,17.1,20392,9037,11355,8.6,19.4,-2386,-2.3,34.2,0,908,912,6886
1987,17,g) 6 to 10,37415,41436,487941,485885,2011,4.7,4850,11.3,85694,18340,67354,3.8,17.6,81582,33289,48293,6.9,16.8,4112,0.8,33.6,0,3099,3137,18920
1987,17,l) Left Censored,72996,102966,2996131,3060193,4887,4.6,9836,9.3,342230,90475,251755,3,11.2,470354,175994,294360,5.8,15.4,-128124,-4.2,22.4,0,4649,4707,41571
1987,18,a) 0,10078,10321,68353,37161,10268,199,0,0,62385,62385,0,167.9,167.9,0,0,0,0,0,62385,167.9,0,0,,,
1987,18,b) 1,7744,7974,69931,67825,178,2,1735,19.6,22058,3049,19009,4.5,32.5,17845,10221,7624,15.1,26.3,4213,6.2,52.6,0,1373,1373,6575
1987,18,c) 2,6714,6988,79054,70199,370,5,1210,16.2,33772,3247,30525,4.6,48.1,16061,7725,8336,11,22.9,17711,25.2,45.8,0,954,955,5733
1987,18,d) 3,6156,6466,58756,59622,345,5.1,920,13.6,13400,4596,8804,7.7,22.5,15131,7612,7519,12.8,25.4,-1731,-2.9,45,0,703,704,5435
1987,18,e) 4,4278,4430,44627,44642,147,3.1,600,12.8,8991,1699,7292,3.8,20.1,9020,4971,4049,11.1,20.2,-29,-0.1,40.2,0,483,483,3813
1987,18,f) 5,3678,3969,39979,40160,162,3.9,521,12.6,7566,1462,6104,3.6,18.8,7927,3912,4015,9.7,19.7,-361,-0.9,37.6,0,398,402,2982
1987,18,g) 6 to 10,16941,19176,213567,214158,927,4.7,2075,10.5,37526,7495,30031,3.5,17.5,38708,17623,21085,8.2,18.1,-1182,-0.6,35,0,1361,1374,10462
1987,18,l) Left Censored,33246,49488,1386228,1390534,2508,5,4462,8.8,167441,42538,124903,3.1,12,176055,60781,115274,4.4,12.7,-8614,-0.7,24,0,2051,2082,15512
1987,19,a) 0,5031,5164,32897,18122,5132,198.8,0,0,29551,29551,0,163.1,163.1,0,0,0,0,0,29551,163.1,0,0,,,
1987,19,b) 1,3711,3795,36029,36896,69,1.6,965,22.4,6797,1118,5679,3,18.4,8530,5201,3329,14.1,23.1,-1733,-4.7,36.8,0,763,765,4232
1987,19,c) 2,3375,3507,26981,27375,204,5.4,647,17.2,5542,1756,3786,6.4,20.2,6329,2918,3411,10.7,23.1,-787,-2.9,40.4,0,516,517,2252
1987,19,d) 3,3586,3674,23679,23738,176,4.6,532,13.8,5640,988,4652,4.2,23.8,5757,2617,3140,11,24.3,-117,-0.5,47.6,0,389,389,1846
1987,19,e) 4,2336,2585,20976,21496,114,4.2,401,14.7,4001,1330,2671,6.2,18.6,5041,2503,2538,11.6,23.5,-1040,-4.9,37.2,0,292,294,1585
1987,19,f) 5,2212,2325,20008,20254,99,4,358,14.6,3576,1057,2519,5.2,17.7,4068,2048,2020,10.1,20.1,-492,-2.4,35.4,0,242,243,1484
1987,19,g) 6 to 10,11026,12535,105739,106171,651,5,1407,10.9,17286,4108,13178,3.9,16.3,18149,7363,10786,6.9,17.1,-863,-0.8,32.6,0,935,948,4866
1987,19,l) Left Censored,22201,30766,619432,624892,1339,4.2,2862,9.1,71661,18628,53033,3,11.5,82583,27024,55559,4.3,13.2,-10922,-1.7,23,0,1354,1388,8731
1987,20,a) 0,5297,5408,37024,20879,5355,198,0,0,32291,32291,0,154.7,154.7,0,0,0,0,0,32291,154.7,0,0,,,
1987,20,b) 1,4017,4113,34534,36139,74,1.6,1190,25.2,7587,968,6619,2.7,21,10797,6518,4279,18,29.9,-3210,-8.9,42,0,921,924,4965
1987,20,c) 2,3643,3756,26011,27435,219,5.4,776,19.1,5478,1470,4008,5.4,20,8326,4454,3872,16.2,30.3,-2848,-10.3,40,0,612,612,3408
1987,20,d) 3,3504,3620,27176,28191,151,3.9,643,16.6,5357,921,4436,3.3,19,7386,3583,3803,12.7,26.2,-2029,-7.2,38,0,510,510,3180
1987,20,e) 4,2448,2605,18938,19003,131,4.8,397,14.5,4252,1404,2848,7.4,22.4,4381,1861,2520,9.8,23.1,-129,-0.7,44.8,0,314,316,1394
1987,20,f) 5,2226,2308,19189,20036,85,3.5,331,13.5,2534,417,2117,2.1,12.6,4228,1846,2382,9.2,21.1,-1694,-8.5,25.2,0,251,256,1469
1987,20,g) 6 to 10,9629,10869,100389,102609,531,4.7,1306,11.6,17347,4809,12538,4.7,16.9,21787,9305,12482,9.1,21.2,-4440,-4.3,33.8,0,863,879,6089
1987,20,l) Left Censored,18142,25204,522169,543747,1179,4.6,2488,9.6,61057,17410,43647,3.2,11.2,104212,55471,48741,10.2,19.2,-43155,-8,22.4,0,1171,1197,7444
1987,21,a) 0,6751,6867,41890,21930,6832,199,0,0,39920,39920,0,182,182,0,0,0,0,0,39920,182,0,0,,,
1987,21,b) 1,5128,5279,52888,52801,80,1.4,1036,17.8,11728,1162,10566,2.2,22.2,11553,6287,5266,11.9,21.9,175,0.3,43.8,0,787,787,4403
1987,21,c) 2,4259,4374,37327,38245,208,4.4,861,18.2,8138,1440,6698,3.8,21.3,9973,5463,4510,14.3,26.1,-1835,-4.8,42.6,0,687,687,4357
1987,21,d) 3,4173,4303,36072,36619,160,3.5,679,14.8,7090,1618,5472,4.4,19.4,8183,3978,4205,10.9,22.3,-1093,-2.9,38.8,0,502,502,2912
1987,21,e) 4,2682,2806,40024,40225,116,3.9,466,15.6,6455,1051,5404,2.6,16,6856,3414,3442,8.5,17,-401,-1,32,0,346,346,2094
1987,21,f) 5,2537,2651,26103,26258,98,3.5,383,13.7,4714,972,3742,3.7,18,5024,2416,2608,9.2,19.1,-310,-1.1,36,0,287,287,1712
1987,21,g) 6 to 10,10419,11504,134614,136484,505,4.2,1431,11.9,22932,4036,18896,3,16.8,26672,10189,16483,7.5,19.5,-3740,-2.7,33.6,0,920,926,5708
1987,21,l) Left Censored,20422,29531,746492,751081,1386,4.6,2762,9.1,84892,21151,63741,2.8,11.3,94069,34924,59145,4.6,12.5,-9177,-1.2,22.6,0,1315,1324,8932
1987,22,a) 0,7120,7281,53323,30169,7212,198.1,0,0,46308,46308,0,153.5,153.5,0,0,0,0,0,46308,153.5,0,0,,,
1987,22,b) 1,5731,5855,45566,48646,105,1.5,1976,28.7,11737,1618,10119,3.3,24.1,17897,9417,8480,19.4,36.8,-6160,-12.7,48.2,0,1643,1644,8014
1987,22,c) 2,4894,5058,36933,40935,246,4.3,1423,24.9,8109,1850,6259,4.5,19.8,16112,8496,7616,20.8,39.4,-8003,-19.6,39.6,0,1176,1178,7190
1987,22,d) 3,4782,4933,42445,45400,212,3.9,1011,18.8,7555,1910,5645,4.2,16.6,13465,5787,7678,12.7,29.7,-5910,-13.1,33.2,0,789,794,3988
1987,22,e) 4,3637,3852,32460,35542,187,4.5,733,17.7,6606,2795,3811,7.9,18.6,12770,5310,7460,14.9,35.9,-6164,-17.3,37.2,0,552,555,4306
1987,22,f) 5,3688,3956,30713,33746,156,3.7,732,17.2,4805,1042,3763,3.1,14.2,10870,5019,5851,14.9,32.2,-6065,-18,28.4,0,550,551,3202
1987,22,g) 6 to 10,13980,15424,170184,180556,701,4.3,2624,15.9,26568,6083,20485,3.4,14.7,47312,19574,27738,10.8,26.2,-20744,-11.5,29.4,0,1660,1680,11453
1987,22,l) Left Censored,22581,34301,748507,779449,1796,5.1,4138,11.6,92836,28980,63856,3.7,11.9,154720,55212,99508,7.1,19.8,-61884,-7.9,23.8,0,1746,1797,14543
1987,23,a) 0,3587,3655,21059,11872,3638,199.1,0,0,18374,18374,0,154.8,154.8,0,0,0,0,0,18374,154.8,0,0,,,
1987,23,b) 1,2533,2586,14949,14487,40,1.4,562,19.5,4477,405,4072,2.8,30.9,3552,2137,1415,14.8,24.5,925,6.4,49,0,403,403,1560
1987,23,c) 2,1974,2022,13624,13506,94,4.3,349,16.1,3357,719,2638,5.3,24.9,3121,1461,1660,10.8,23.1,236,1.8,46.2,0,254,254,1102
1987,23,d) 3,1678,1727,14787,13942,90,5,233,12.9,4146,492,3654,3.5,29.7,2456,1184,1272,8.5,17.6,1690,12.1,35.2,0,176,176,997
1987,23,e) 4,1190,1230,9626,9794,51,4,160,12.4,2103,536,1567,5.5,21.5,2439,1451,988,14.8,24.9,-336,-3.4,43,0,120,120,843
1987,23,f) 5,1001,1046,10510,10323,38,3.5,129,11.8,1858,280,1578,2.7,18,1484,719,765,7,14.4,374,3.6,28.8,0,89,89,507
1987,23,g) 6 to 10,4608,5107,53683,53444,285,5.4,559,10.6,10059,2061,7998,3.9,18.8,9581,4641,4940,8.7,17.9,478,0.9,35.8,0,373,375,2456
1987,23,l) Left Censored,7896,10760,253987,252406,583,5.3,928,8.5,31332,8769,22563,3.5,12.4,28169,10507,17662,4.2,11.2,3163,1.2,22.4,0,498,502,3276
1987,24,a) 0,9940,10145,67482,35936,10091,198.9,0,0,63093,63093,0,175.6,175.6,0,0,0,0,0,63093,175.6,0,0,,,
1987,24,b) 1,7676,7863,68922,68571,146,1.7,1833,20.9,18760,1774,16986,2.6,27.4,18057,9592,8465,14,26.3,703,1.1,52.6,0,1390,1390,7399
1987,24,c) 2,6277,6554,60415,60950,398,5.7,1143,16.4,15815,3095,12720,5.1,25.9,16884,8086,8798,13.3,27.7,-1069,-1.8,51.8,0,889,891,6089
1987,24,d) 3,5121,5316,54099,54440,240,4.3,739,13.2,11912,2989,8923,5.5,21.9,12593,5401,7192,9.9,23.1,-681,-1.2,43.8,0,569,569,4437
1987,24,e) 4,3926,4125,41188,41973,188,4.3,577,13.3,9236,1928,7308,4.6,22,10806,5296,5510,12.6,25.7,-1570,-3.7,44,0,411,423,3439
1987,24,f) 5,3360,3608,42995,43354,140,3.7,476,12.6,8490,2021,6469,4.7,19.6,9207,4162,5045,9.6,21.2,-717,-1.6,39.2,0,329,331,2304
1987,24,g) 6 to 10,14106,15777,207017,205713,749,4.6,1773,10.9,39952,7453,32499,3.6,19.4,37344,14593,22751,7.1,18.2,2608,1.2,36.4,0,1107,1127,8465
1987,24,l) Left Censored,25201,38353,1128812,1114579,2507,6.5,3162,8.2,181402,76317,105085,6.8,16.3,152936,48841,104095,4.4,13.7,28466,2.6,27.4,0,1415,1444,12357
1987,25,a) 0,14574,14883,107148,57827,14781,198.6,0,0,98642,98642,0,170.6,170.6,0,0,0,0,0,98642,170.6,0,0,,,
1987,25,b) 1,10850,11111,99160,103361,136,1.1,2250,18.3,27576,3713,23863,3.6,26.7,35978,12898,23080,12.5,34.8,-8402,-8.1,53.4,0,1665,1666,9083
1987,25,c) 2,9020,9259,92522,92646,442,4.5,1547,15.7,21825,3903,17922,4.2,23.6,22073,10221,11852,11,23.8,-248,-0.2,47.2,0,1176,1177,7178
1987,25,d) 3,7467,7704,85526,82307,367,4.5,1021,12.6,24486,3352,21134,4.1,29.7,18048,6652,11396,8.1,21.9,6438,7.8,43.8,0,791,791,5541
1987,25,e) 4,5554,5808,60074,60328,292,4.8,773,12.7,13582,3802,9780,6.3,22.5,14089,5621,8468,9.3,23.4,-507,-0.9,45,0,570,570,4307
1987,25,f) 5,5103,5381,77896,78140,208,3.7,664,11.8,12000,2008,9992,2.6,15.4,12488,4741,7747,6.1,16,-488,-0.6,30.8,0,491,494,3716
1987,25,g) 6 to 10,20808,23440,337178,337122,1078,4.5,2517,10.4,56378,10885,45493,3.2,16.7,56265,21112,35153,6.3,16.7,113,0,33.4,0,1690,1710,14027
1987,25,l) Left Censored,43466,59461,1874153,1901581,2518,4.1,5126,8.4,219904,51362,168542,2.7,11.6,274760,97510,177250,5.1,14.4,-54856,-2.8,23.2,0,2741,2765,27657
1987,26,a) 0,17334,17729,117708,65390,17610,198.7,0,0,104637,104637,0,160,160,0,0,0,0,0,104637,160,0,0,,,
1987,26,b) 1,12574,12953,112131,109068,245,1.7,2812,19.5,31760,5296,26464,4.9,29.1,25633,12408,13225,11.4,23.5,6127,5.6,47,0,2121,2121,9789
1987,26,c) 2,10959,11357,98015,100790,598,4.9,1989,16.4,24420,4884,19536,4.8,24.2,29969,14702,15267,14.6,29.7,-5549,-5.5,48.4,0,1543,1545,10099
1987,26,d) 3,9779,10246,98138,98560,544,5.1,1459,13.6,21526,5162,16364,5.2,21.8,22369,10181,12188,10.3,22.7,-843,-0.9,43.6,0,1121,1121,7235
1987,26,e) 4,7028,7478,71953,72920,378,4.8,956,12.3,14286,3535,10751,4.8,19.6,16220,6699,9521,9.2,22.2,-1934,-2.6,39.2,0,753,754,5238
1987,26,f) 5,6181,6578,69796,70254,269,3.9,817,11.9,12287,2177,10110,3.1,17.5,13203,5344,7859,7.6,18.8,-916,-1.3,35,0,595,596,3631
1987,26,g) 6 to 10,28072,31814,364275,366193,1645,5,3666,11.1,65978,15011,50967,4.1,18,69813,26670,43143,7.3,19.1,-3835,-1.1,36,0,2440,2473,16814
1987,26,l) Left Censored,50666,75388,2244690,2262120,3611,4.7,6463,8.4,260963,64471,196492,2.9,11.5,295822,92953,202869,4.1,13.1,-34859,-1.6,23,0,3122,3182,24019
1987,27,a) 0,8447,8655,58391,31615,8572,198.1,0,0,53552,53552,0,169.4,169.4,0,0,0,0,0,53552,169.4,0,0,,,
1987,27,b) 1,6703,6933,66543,65892,153,2,1507,19.6,16188,3140,13048,4.8,24.6,14886,7993,6893,12.1,22.6,1302,2,45.2,0,1155,1155,5973
1987,27,c) 2,5940,6193,56555,56771,325,4.9,1054,15.9,12773,2652,10121,4.7,22.5,13205,6831,6374,12,23.3,-432,-0.8,45,0,840,841,5208
1987,27,d) 3,5349,5622,53089,53396,275,4.6,808,13.7,11041,3222,7819,6,20.7,11654,5888,5766,11,21.8,-613,-1.1,41.4,0,623,623,4560
1987,27,e) 4,3672,4042,43927,44218,212,5,594,14,9515,2116,7399,4.8,21.5,10096,5002,5094,11.3,22.8,-581,-1.3,43,0,440,440,3462
1987,27,f) 5,3321,3559,36701,37465,170,4.5,523,14,6181,1013,5168,2.7,16.5,7708,3729,3979,10,20.6,-1527,-4.1,33,0,388,393,2949
1987,27,g) 6 to 10,15631,17629,201532,202690,938,5.1,2075,11.4,36390,8244,28146,4.1,18,38708,17888,20820,8.8,19.1,-2318,-1.1,36,0,1281,1294,9953
1987,27,l) Left Censored,28654,40202,1150214,1160623,2033,5,3570,8.7,143040,35663,107377,3.1,12.3,163858,65590,98268,5.7,14.1,-20818,-1.8,24.6,0,1565,1594,30703
1987,28,a) 0,4615,4686,27463,14917,4646,198.3,0,0,25093,25093,0,168.2,168.2,0,0,0,0,0,25093,168.2,0,0,,,
1987,28,b) 1,3257,3315,28308,29528,47,1.2,1058,27.3,6257,716,5541,2.4,21.2,8696,5102,3594,17.3,29.5,-2439,-8.3,42.4,0,860,863,4213
1987,28,c) 2,2898,2983,22291,23550,179,5.5,656,20.2,4953,1416,3537,6,21,7470,3671,3799,15.6,31.7,-2517,-10.7,42,0,525,525,2656
1987,28,d) 3,2895,2941,20544,21612,132,4.2,440,14.1,3951,1104,2847,5.1,18.3,6087,2767,3320,12.8,28.2,-2136,-9.9,36.6,0,342,342,2239
1987,28,e) 4,1857,1937,14515,14843,100,4.9,305,14.8,3441,1336,2105,9,23.2,4096,2178,1918,14.7,27.6,-655,-4.4,46.4,0,222,222,1598
1987,28,f) 5,1656,1727,14830,15691,77,4.2,261,14.3,1987,404,1583,2.6,12.7,3709,1100,2609,7,23.6,-1722,-10.9,25.4,0,192,192,775
1987,28,g) 6 to 10,7887,8770,92243,93697,411,4.5,1045,11.5,14371,3432,10939,3.7,15.3,17278,6848,10430,7.3,18.4,-2907,-3.1,30.6,0,685,691,3852
1987,28,l) Left Censored,13681,19976,470478,478124,965,4.7,1795,8.8,57559,14514,43045,3,12,72850,21321,51529,4.5,15.2,-15291,-3.2,24,0,888,913,7804
1987,29,a) 0,11327,11603,77349,43362,11496,198.2,0,0,67974,67974,0,156.8,156.8,0,0,0,0,0,67974,156.8,0,0,,,
1987,29,b) 1,8236,8497,69626,70755,214,2.2,2171,22.7,18597,2916,15681,4.1,26.3,20854,11155,9699,15.8,29.5,-2257,-3.2,52.6,0,1690,1693,8824
1987,29,c) 2,7569,7788,63566,65657,344,4.1,1544,18.3,13796,2394,11402,3.6,21,17978,9744,8234,14.8,27.4,-4182,-6.4,42,0,1239,1242,8373
1987,29,d) 3,6185,6433,52896,54751,288,4.2,1003,14.7,9858,2366,7492,4.3,18,13567,6328,7239,11.6,24.8,-3709,-6.8,36,0,780,780,4287
1987,29,e) 4,4399,4662,43927,45000,251,5.2,621,12.7,8464,2330,6134,5.2,18.8,10609,5137,5472,11.4,23.6,-2145,-4.8,37.6,0,478,483,3169
1987,29,f) 5,3843,4154,39516,40926,160,3.7,572,13.1,6417,831,5586,2,15.7,9236,4475,4761,10.9,22.6,-2819,-6.9,31.4,0,420,431,3284
1987,29,g) 6 to 10,17571,19858,215657,216630,1132,5.5,2222,10.9,39356,10269,29087,4.7,18.2,41302,17903,23399,8.3,19.1,-1946,-0.9,36.4,0,1425,1437,8761
1987,29,l) Left Censored,32632,47637,1329679,1332770,2627,5.4,4450,9.2,180620,49316,131304,3.7,13.6,186802,65045,121757,4.9,14,-6182,-0.4,27.2,0,2040,2081,17474
1987,30,a) 0,2241,2269,12102,7005,2249,198.2,0,0,10195,10195,0,145.5,145.5,0,0,0,0,0,10195,145.5,0,0,,,
1987,30,b) 1,1645,1669,9331,9785,24,1.2,529,27.2,2451,315,2136,3.2,25,3359,1827,1532,18.7,34.3,-908,-9.3,50,0,375,375,1378
1987,30,c) 2,1440,1472,9854,10057,78,4.8,369,22.6,2654,346,2308,3.4,26.4,3060,1581,1479,15.7,30.4,-406,-4,52.8,0,278,278,1208
1987,30,d) 3,1354,1401,7457,7901,77,5.2,236,15.9,1561,266,1295,3.4,19.8,2449,1084,1365,13.7,31,-888,-11.2,39.6,0,169,169,688
1987,30,e) 4,1036,1170,8451,8858,70,5.7,172,14,1516,382,1134,4.3,17.1,2330,1183,1147,13.4,26.3,-814,-9.2,34.2,0,122,126,725
1987,30,f) 5,867,890,5512,5837,35,3.6,161,16.8,1005,274,731,4.7,17.2,1654,692,962,11.9,28.3,-649,-11.1,34.4,0,115,117,511
1987,30,g) 6 to 10,4270,4667,35427,36425,243,5,624,12.8,5774,1245,4529,3.4,15.9,7769,2828,4941,7.8,21.3,-1995,-5.4,31.8,0,414,416,1860
1987,30,l) Left Censored,6152,8185,130916,132161,405,4.8,841,10,16087,4277,11810,3.2,12.2,18576,6580,11996,5,14.1,-2489,-1.9,24.4,0,406,414,2449
1987,31,a) 0,3062,3111,21969,13473,3082,198.1,0,0,16993,16993,0,126.1,126.1,0,0,0,0,0,16993,126.1,0,0,,,
1987,31,b) 1,2368,2437,17997,17657,50,1.8,525,19.4,5769,974,4795,5.5,32.7,5088,2519,2569,14.3,28.8,681,3.9,57.6,0,379,379,1608
1987,31,c) 2,2431,2483,18776,19132,99,3.7,366,13.9,3843,565,3278,3,20.1,4554,2447,2107,12.8,23.8,-711,-3.7,40.2,0,291,291,1872
1987,31,d) 3,2136,2204,15219,15300,110,4.8,263,11.5,3290,837,2453,5.5,21.5,3451,1525,1926,10,22.6,-161,-1.1,43,0,195,195,1177
1987,31,e) 4,1573,1730,17409,17274,93,5.1,241,13.3,3137,808,2329,4.7,18.2,2867,1126,1741,6.5,16.6,270,1.6,33.2,0,190,192,784
1987,31,f) 5,1444,1519,12128,12617,61,3.8,202,12.7,2032,470,1562,3.7,16.1,3009,1866,1143,14.8,23.8,-977,-7.7,32.2,0,161,162,1478
1987,31,g) 6 to 10,6741,7416,59718,60525,341,4.4,822,10.7,9463,2139,7324,3.5,15.6,11077,4766,6311,7.9,18.3,-1614,-2.7,31.2,0,568,571,2934
1987,31,l) Left Censored,13315,17727,368527,370428,792,4.4,1503,8.3,42659,9680,32979,2.6,11.5,46460,17183,29277,4.6,12.5,-3801,-1,23,0,743,765,4908
1987,32,a) 0,2948,3033,23560,12494,3008,198.4,0,0,22132,22132,0,177.1,177.1,0,0,0,0,0,22132,177.1,0,0,,,
1987,32,b) 1,2037,2106,19884,19575,49,2,624,25.6,6809,1174,5635,6,34.8,6191,2884,3307,14.7,31.6,618,3.2,63.2,0,503,503,2438
1987,32,c) 2,1555,1622,17261,17771,116,6.6,362,20.6,5028,1879,3149,10.6,28.3,6048,2959,3089,16.7,34,-1020,-5.7,56.6,0,293,293,2656
1987,32,d) 3,1395,1456,17130,17268,89,5.7,262,16.9,3728,676,3052,3.9,21.6,4003,2102,1901,12.2,23.2,-275,-1.6,43.2,0,194,194,1197
1987,32,e) 4,1008,1091,13023,12719,78,6.8,186,16.3,3365,849,2516,6.7,26.5,2757,1154,1603,9.1,21.7,608,4.8,43.4,0,132,135,848
1987,32,f) 5,1039,1129,17776,17299,70,5.9,173,14.6,3921,487,3434,2.8,22.7,2967,968,1999,5.6,17.2,954,5.5,34.4,0,123,124,753
1987,32,g) 6 to 10,4281,4675,66524,64909,290,6,593,12.3,15063,1836,13227,2.8,23.2,11832,6287,5545,9.7,18.2,3231,5,36.4,0,355,365,2446
1987,32,l) Left Censored,4871,7196,258713,253667,516,7,772,10.5,42553,13122,29431,5.2,16.8,32461,10123,22338,4,12.8,10092,4,25.6,0,272,278,4329
1987,33,a) 0,4131,4186,22127,11496,4165,199,0,0,21263,21263,0,185,185,0,0,0,0,0,21263,185,0,0,,,
1987,33,b) 1,3034,3107,26097,25532,52,1.5,663,19.2,7034,532,6502,2.1,27.5,5903,3180,2723,12.5,23.1,1131,4.4,46.2,0,481,482,2469
1987,33,c) 2,2277,2314,18721,18822,101,4.1,384,15.5,4206,424,3782,2.3,22.3,4408,1816,2592,9.6,23.4,-202,-1.1,44.6,0,290,290,1305
1987,33,d) 3,1818,1887,18222,18056,92,4.6,259,13.1,4354,783,3571,4.3,24.1,4021,1967,2054,10.9,22.3,333,1.8,44.6,0,209,211,1738
1987,33,e) 4,1218,1279,12315,12509,65,4.8,184,13.7,2984,1209,1775,9.7,23.9,3371,1125,2246,9,26.9,-387,-3,47.8,0,142,142,844
1987,33,f) 5,1092,1142,12707,12909,52,4.4,132,11.2,2344,379,1965,2.9,18.2,2748,983,1765,7.6,21.3,-404,-3.1,36.4,0,102,103,670
1987,33,g) 6 to 10,4433,4937,57867,58211,297,5.9,552,10.9,10639,2354,8285,4,18.3,11327,4619,6708,7.9,19.5,-688,-1.2,36.6,0,383,383,2893
1987,33,l) Left Censored,7253,9712,285496,286381,584,5.9,852,8.6,36311,9712,26599,3.4,12.7,38081,12865,25216,4.5,13.3,-1770,-0.6,25.4,0,425,426,4499
1987,34,a) 0,19384,19601,118402,62391,19487,198.8,0,0,112022,112022,0,179.5,179.5,0,0,0,0,0,112022,179.5,0,0,,,
1987,34,b) 1,14503,14743,116439,114549,195,1.2,3307,20.1,32647,3422,29225,3,28.5,28866,14610,14256,12.8,25.2,3781,3.3,50.4,0,2439,2439,10710
1987,34,c) 2,11927,12170,96714,98518,605,4.7,2003,15.5,24358,5068,19290,5.1,24.7,27966,12736,15230,12.9,28.4,-3608,-3.7,49.4,0,1521,1524,8903
1987,34,d) 3,9839,10092,104909,104051,465,4.4,1442,13.6,23066,4116,18950,4,22.2,21350,9217,12133,8.9,20.5,1716,1.7,41,0,1114,1114,7092
1987,34,e) 4,7863,8177,77259,77053,428,5,1035,12.2,20671,6707,13964,8.7,26.8,20258,11021,9237,14.3,26.3,413,0.5,52.6,0,794,794,9164
1987,34,f) 5,7107,7399,80981,81919,301,3.9,962,12.4,14499,1846,12653,2.3,17.7,16375,6403,9972,7.8,20,-1876,-2.3,35.4,0,726,732,4415
1987,34,g) 6 to 10,29819,31830,339535,344443,1360,4.1,3465,10.5,60769,11935,48834,3.5,17.6,70585,25280,45305,7.3,20.5,-9816,-2.9,35.2,0,2404,2415,15954
1987,34,l) Left Censored,55221,74056,2170844,2170500,3550,4.7,6752,8.9,332395,107304,225091,4.9,15.3,331707,118859,212848,5.5,15.3,688,0,30.6,0,3495,3538,30223
1987,35,a) 0,3289,3369,24511,14006,3337,198.1,0,0,21010,21010,0,150,150,0,0,0,0,0,21010,150,0,0,,,
1987,35,b) 1,2548,2594,18989,19775,38,1.3,752,25.1,4833,729,4104,3.7,24.4,6405,3365,3040,17,32.4,-1572,-8,48.8,0,611,611,2790
1987,35,c) 2,2118,2207,16930,17651,159,6.6,473,19.8,3799,993,2806,5.6,21.5,5240,2564,2676,14.5,29.7,-1441,-8.2,43,0,367,367,2016
1987,35,d) 3,1940,1995,15798,16585,111,5.2,353,16.6,3414,582,2832,3.5,20.6,4987,2381,2606,14.4,30.1,-1573,-9.5,41.2,0,259,259,1869
1987,35,e) 4,1477,1650,15560,16169,115,6.6,264,15.2,3110,1077,2033,6.7,19.2,4328,1709,2619,10.6,26.8,-1218,-7.6,38.4,0,201,204,1338
1987,35,f) 5,1233,1289,19003,19914,55,4,195,14.3,1933,327,1606,1.6,9.7,3754,1753,2001,8.8,18.9,-1821,-9.2,19.4,0,142,144,1487
1987,35,g) 6 to 10,5751,6348,60816,62452,352,5.3,827,12.5,11911,2990,8921,4.8,19.1,15183,5891,9292,9.4,24.3,-3272,-5.2,38.2,0,551,552,3806
1987,35,l) Left Censored,7581,11007,223851,226703,603,5.3,1122,9.9,30806,9216,21590,4.1,13.6,36510,11941,24569,5.3,16.1,-5704,-2.5,27.2,0,479,487,3195
1987,36,a) 0,41264,41777,261050,153202,41544,198.9,0,0,215697,215697,0,140.8,140.8,0,0,0,0,0,215697,140.8,0,0,,,
1987,36,b) 1,31427,31945,282763,280774,288,0.8,7102,19.9,63019,5096,57923,1.8,22.4,59041,29419,29622,10.5,21,3978,1.4,42,0,5337,5339,22546
1987,36,c) 2,26823,27308,209906,213487,1286,4.4,5075,17.3,52486,10036,42450,4.7,24.6,59647,29198,30449,13.7,27.9,-7161,-3.3,49.2,0,4029,4031,22904
1987,36,d) 3,22535,23181,196790,199492,1034,4.2,3485,14.2,42517,6738,35779,3.4,21.3,47923,22383,25540,11.2,24,-5406,-2.7,42.6,0,2791,2792,18398
1987,36,e) 4,17879,18515,162484,167113,912,4.7,2695,13.8,33464,7824,25640,4.7,20,42721,17537,25184,10.5,25.6,-9257,-5.6,40,0,2091,2096,11221
1987,36,f) 5,15780,16405,161394,161784,563,3.3,2250,13,29498,3890,25608,2.4,18.2,30278,12523,17755,7.7,18.7,-780,-0.5,36.4,0,1727,1730,9032
1987,36,g) 6 to 10,63958,69431,820709,824114,2615,3.6,8122,11.2,140720,20668,120052,2.5,17.1,147529,59916,87613,7.3,17.9,-6809,-0.8,34.2,0,5809,5841,46163
1987,36,l) Left Censored,126992,165884,4722839,4761986,6278,3.7,15625,9.2,570880,127132,443748,2.7,12,649174,210676,438498,4.4,13.6,-78294,-1.6,24,0,9200,9285,71660
1987,37,a) 0,14095,14476,82660,44085,14390,198.8,0,0,77151,77151,0,175,175,0,0,0,0,0,77151,175,0,0,,,
1987,37,b) 1,10776,11114,85438,85285,192,1.5,2774,22.1,22892,3474,19418,4.1,26.8,22586,13273,9313,15.6,26.5,306,0.3,53,0,2191,2192,10537
1987,37,c) 2,9255,9570,77190,79555,522,5,1883,18.2,18415,3975,14440,5,23.1,23145,10492,12653,13.2,29.1,-4730,-6,46.2,0,1507,1507,8462
1987,37,d) 3,9364,9820,76068,76892,483,4.7,1252,12.2,15764,4273,11491,5.6,20.5,17412,7552,9860,9.8,22.6,-1648,-2.1,41,0,963,963,5508
1987,37,e) 4,5546,5759,53368,54359,204,3.4,727,12,9612,1176,8436,2.2,17.7,11594,5158,6436,9.5,21.3,-1982,-3.6,35.4,0,580,582,3919
1987,37,f) 5,4692,4995,50920,50854,210,4,641,12.3,10088,1583,8505,3.1,19.8,9955,4617,5338,9.1,19.6,133,0.2,39.2,0,466,467,2971
1987,37,g) 6 to 10,20452,23008,260906,271107,1177,5,2438,10.3,43905,9563,34342,3.5,16.2,64307,18439,45868,6.8,23.7,-20402,-7.5,32.4,0,1541,1551,12478
1987,37,l) Left Censored,35729,56895,1719334,1724635,3503,6.1,4716,8.2,220708,59877,160831,3.5,12.8,231309,79182,152127,4.6,13.4,-10601,-0.6,25.6,0,2026,2045,17909
1987,38,a) 0,1453,1471,8462,4735,1461,198.6,0,0,7454,7454,0,157.4,157.4,0,0,0,0,0,7454,157.4,0,0,,,
1987,38,b) 1,1048,1063,6025,6372,15,1.2,275,22.8,1293,301,992,4.7,20.3,1987,1130,857,17.7,31.2,-694,-10.9,40.6,0,214,217,920
1987,38,c) 2,1013,1044,6265,6514,40,3.6,177,15.8,1238,274,964,4.2,19,1736,889,847,13.6,26.7,-498,-7.7,38,0,144,144,669
1987,38,d) 3,946,968,4826,5135,42,4.1,151,14.7,929,218,711,4.2,18.1,1546,706,840,13.7,30.1,-617,-12,36.2,0,122,122,629
1987,38,e) 4,703,800,6128,6289,40,4.7,120,14.2,944,320,624,5.1,15,1265,436,829,6.9,20.1,-321,-5.1,30,0,91,94,348
1987,38,f) 5,681,709,4500,4834,29,3.9,98,13.1,721,142,579,2.9,14.9,1389,801,588,16.6,28.7,-668,-13.8,29.8,0,78,78,404
1987,38,g) 6 to 10,3125,3363,26017,26492,170,4.9,403,11.6,3725,889,2836,3.4,14.1,4674,2044,2630,7.7,17.6,-949,-3.5,28.2,0,262,263,1312
1987,38,l) Left Censored,5784,7635,129424,130160,323,4.1,645,8.3,14443,3827,10616,2.9,11.1,15914,4828,11086,3.7,12.2,-1471,-1.1,22.2,0,286,288,1770
1987,39,a) 0,18603,19109,126583,69226,18973,198.6,0,0,114714,114714,0,165.7,165.7,0,0,0,0,0,114714,165.7,0,0,,,
1987,39,b) 1,13935,14478,126922,123902,420,2.6,3041,19,37177,6043,31134,4.9,30,31136,17536,13600,14.2,25.1,6041,4.9,50.2,0,2293,2293,12492
1987,39,c) 2,11870,12340,119915,118976,656,5,2107,16,31585,7775,23810,6.5,26.5,29706,14249,15457,12,25,1879,1.5,50,0,1656,1659,10591
1987,39,d) 3,10837,11320,98874,102614,541,4.6,1545,13,20212,4309,15903,4.2,19.7,27693,14430,13263,14.1,27,-7481,-7.3,39.4,0,1209,1209,10497
1987,39,e) 4,7614,8153,79619,80515,422,4.9,1130,13.2,15699,4303,11396,5.3,19.5,17490,8125,9365,10.1,21.7,-1791,-2.2,39,0,815,817,5336
1987,39,f) 5,7071,7668,73289,73829,445,5.6,1004,12.6,14025,2762,11263,3.7,19,15105,6699,8406,9.1,20.5,-1080,-1.5,38,0,753,755,4535
1987,39,g) 6 to 10,32420,37230,428297,426719,1866,4.9,3800,9.9,78251,16701,61550,3.9,18.3,75094,27440,47654,6.4,17.6,3157,0.7,35.2,0,2412,2433,16367
1987,39,l) Left Censored,66051,101664,2816154,2836675,5078,4.9,8817,8.5,352619,96852,255767,3.4,12.4,393661,150436,243225,5.3,13.9,-41042,-1.5,24.8,0,3933,4032,34394
1987,40,a) 0,6265,6429,48565,28832,6366,198,0,0,39467,39467,0,136.9,136.9,0,0,0,0,0,39467,136.9,0,0,,,
1987,40,b) 1,4868,4967,38730,42099,68,1.2,1708,29.1,8600,835,7765,2,20.4,15338,8947,6391,21.3,36.4,-6738,-16,40.8,0,1404,1404,7330
1987,40,c) 2,4341,4455,30318,33108,242,4.8,1240,24.8,7020,1909,5111,5.8,21.2,12599,6980,5619,21.1,38.1,-5579,-16.9,42.4,0,1007,1011,5987
1987,40,d) 3,4378,4531,32101,33183,195,4,868,17.7,8075,1367,6708,4.1,24.3,10239,5352,4887,16.1,30.9,-2164,-6.6,48.6,0,707,707,4076
1987,40,e) 4,3062,3261,23530,25337,216,6.2,643,18.4,4667,1685,2982,6.7,18.4,8281,3134,5147,12.4,32.7,-3614,-14.3,36.8,0,507,512,2602
1987,40,f) 5,3092,3278,29762,32259,151,4.3,626,17.7,3462,931,2531,2.9,10.7,8456,3478,4978,10.8,26.2,-4994,-15.5,21.4,0,474,480,2850
1987,40,g) 6 to 10,11808,13069,125796,133252,555,4,2007,14.5,16811,3817,12994,2.9,12.6,31722,12874,18848,9.7,23.8,-14911,-11.2,25.2,0,1374,1381,7908
1987,40,l) Left Censored,18094,26924,575917,597362,1535,5.5,3064,11,66121,22910,43211,3.8,11.1,109011,37240,71771,6.2,18.2,-42890,-7.1,22.2,0,1254,1310,9896
1987,41,a) 0,7668,7842,42647,21878,7799,198.9,0,0,41538,41538,0,189.9,189.9,0,0,0,0,0,41538,189.9,0,0,,,
1987,41,b) 1,5465,5584,40172,40683,89,1.4,1684,26,10654,1024,9630,2.5,26.2,11676,7383,4293,18.1,28.7,-1022,-2.5,52.4,0,1252,1252,5757
1987,41,c) 2,4532,4650,32711,34029,269,5.3,998,19.7,7893,1497,6396,4.4,23.2,10528,5422,5106,15.9,30.9,-2635,-7.7,46.4,0,756,758,4217
1987,41,d) 3,3980,4136,32841,33384,235,5.3,712,16.2,7988,1875,6113,5.6,23.9,9074,4477,4597,13.4,27.2,-1086,-3.3,47.8,0,564,564,3799
1987,41,e) 4,2859,3188,35249,35165,204,6.1,472,14.2,6585,1920,4665,5.5,18.7,6416,2937,3479,8.4,18.2,169,0.5,36.4,0,356,359,2160
1987,41,f) 5,2728,2876,25992,27215,118,3.9,477,15.6,4261,749,3512,2.8,15.7,6707,3373,3334,12.4,24.6,-2446,-8.9,31.4,0,343,347,2429
1987,41,g) 6 to 10,12298,13584,130580,132381,782,5.5,1796,12.7,23636,5163,18473,3.9,17.9,27237,13528,13709,10.2,20.6,-3601,-2.7,35.8,0,1184,1191,8092
1987,41,l) Left Censored,17289,25040,552311,552139,1486,5.8,2406,9.4,72818,18227,54591,3.3,13.2,72474,24878,47596,4.5,13.1,344,0.1,26.2,0,1170,1183,8443
1987,42,a) 0,21874,22387,148386,82410,22241,198.7,0,0,131952,131952,0,160.1,160.1,0,0,0,0,0,131952,160.1,0,0,,,
1987,42,b) 1,16706,17149,162792,161747,282,1.5,3556,18.7,40580,4602,35978,2.8,25.1,38489,21427,17062,13.2,23.8,2091,1.3,47.6,0,2663,2664,16587
1987,42,c) 2,14006,14507,135527,137060,733,4.8,2161,14.1,31034,6706,24328,4.9,22.6,34099,17522,16577,12.8,24.9,-3065,-2.3,45.2,0,1596,1599,12919
1987,42,d) 3,12667,13402,132082,132503,659,4.7,1605,11.5,26544,5679,20865,4.3,20,27386,12556,14830,9.5,20.7,-842,-0.7,40,0,1202,1205,9080
1987,42,e) 4,8895,9344,89664,90773,458,4.7,1279,13.1,17447,4062,13385,4.5,19.2,19665,8473,11192,9.3,21.7,-2218,-2.5,38.4,0,955,955,5942
1987,42,f) 5,8203,8728,101052,101767,322,3.5,1001,11,16980,2769,14211,2.7,16.7,18410,7782,10628,7.6,18.1,-1430,-1.4,33.4,0,766,768,6152
1987,42,g) 6 to 10,36255,40588,465948,466552,1879,4.5,4206,10.1,79701,15684,64017,3.4,17.1,80909,32723,48186,7,17.3,-1208,-0.2,34.2,0,2744,2788,17637
1987,42,l) Left Censored,76091,110591,3019810,3039313,5336,4.7,9436,8.4,366324,97525,268799,3.2,12.1,405332,142325,263007,4.7,13.3,-39008,-1.2,24.2,0,4738,4806,39902
1987,44,a) 0,2663,2707,15785,8506,2691,198.8,0,0,14559,14559,0,171.2,171.2,0,0,0,0,0,14559,171.2,0,0,,,
1987,44,b) 1,1848,1875,13168,13256,18,0.9,445,21.1,3677,297,3380,2.2,27.7,3853,2374,1479,17.9,29.1,-176,-1.4,55.4,0,342,342,1978
1987,44,c) 2,1537,1554,12316,12495,66,3.9,272,16.3,3134,426,2708,3.4,25.1,3491,1788,1703,14.3,27.9,-357,-2.8,50.2,0,205,205,1451
1987,44,d) 3,1316,1343,12317,12340,74,5.3,174,12.5,2417,396,2021,3.2,19.6,2463,970,1493,7.9,20,-46,-0.4,39.2,0,137,137,770
1987,44,e) 4,931,956,8600,8679,49,4.9,138,13.8,1687,229,1458,2.6,19.4,1845,971,874,11.2,21.3,-158,-1.9,38.8,0,108,108,540
1987,44,f) 5,813,851,9311,9518,46,5.2,97,11.1,1560,242,1318,2.5,16.4,1973,931,1042,9.8,20.7,-413,-4.3,32.8,0,78,78,765
1987,44,g) 6 to 10,3787,4043,46971,46820,167,4,392,9.4,7818,1257,6561,2.7,16.7,7515,2890,4625,6.2,16.1,303,0.6,32.2,0,272,281,2195
1987,44,l) Left Censored,8092,10047,277640,277054,395,3.8,872,8.5,32823,7007,25816,2.5,11.8,31651,10524,21127,3.8,11.4,1172,0.4,22.8,0,495,499,3257
1987,45,a) 0,7127,7321,46602,25700,7280,198.9,0,0,41804,41804,0,162.7,162.7,0,0,0,0,0,41804,162.7,0,0,,,
1987,45,b) 1,5154,5306,52400,48547,104,1.7,1474,24.3,19338,1376,17962,2.8,39.8,11632,6400,5232,13.2,24,7706,15.8,48,0,1077,1077,4571
1987,45,c) 2,4534,4687,38678,40142,236,4.6,1005,19.6,8552,2108,6444,5.3,21.3,11479,6001,5478,14.9,28.6,-2927,-7.3,42.6,0,751,751,4145
1987,45,d) 3,4327,4608,40576,41213,277,5.8,645,13.4,8131,2404,5727,5.8,19.7,9405,4199,5206,10.2,22.8,-1274,-3.1,39.4,0,449,449,2854
1987,45,e) 4,2673,2774,27959,28487,97,3.3,433,14.6,5541,897,4644,3.1,19.5,6596,2842,3754,10,23.2,-1055,-3.7,39,0,309,309,2025
1987,45,f) 5,2450,2605,25640,26065,90,3.3,335,12.3,4667,932,3735,3.6,17.9,5516,2808,2708,10.8,21.2,-849,-3.3,35.8,0,236,249,2259
1987,45,g) 6 to 10,10052,11279,123607,124242,584,5,1278,11,21046,4104,16942,3.3,16.9,22315,8644,13671,7,18,-1269,-1.1,33.8,0,808,827,5545
1987,45,l) Left Censored,17465,27252,756708,755619,1624,5.9,2202,8,101559,29351,72208,3.9,13.4,99381,34097,65284,4.5,13.2,2178,0.2,26.4,0,1020,1027,9078
1987,46,a) 0,1526,1556,10966,7098,1528,196.4,0,0,7736,7736,0,109,109,0,0,0,0,0,7736,109,0,0,,,
1987,46,b) 1,1076,1098,6346,6815,21,1.7,328,25.9,1644,117,1527,1.7,24.1,2582,1608,974,23.6,37.9,-938,-13.8,48.2,0,224,224,1157
1987,46,c) 2,1067,1089,6247,6676,64,5.4,235,19.8,1205,320,885,4.8,18,2063,1118,945,16.7,30.9,-858,-12.9,36,0,172,172,833
1987,46,d) 3,1016,1037,6195,6219,48,4.4,151,13.8,1230,340,890,5.5,19.8,1278,610,668,9.8,20.5,-48,-0.7,39.6,0,114,114,486
1987,46,e) 4,689,799,5636,5985,53,6.5,93,11.3,840,385,455,6.4,14,1537,345,1192,5.8,25.7,-697,-11.7,28,0,69,70,259
1987,46,f) 5,625,657,4398,4669,33,4.8,89,13,605,123,482,2.6,13,1147,534,613,11.4,24.6,-542,-11.6,26,0,57,57,343
1987,46,g) 6 to 10,3042,3293,28407,28310,178,5.2,381,11.2,4670,1365,3305,4.8,16.5,4475,1894,2581,6.7,15.8,195,0.7,31.6,0,237,239,1089
1987,46,l) Left Censored,6068,7666,132025,132389,290,3.7,659,8.4,14140,2743,11397,2.1,10.7,14868,5188,9680,3.9,11.2,-728,-0.5,21.4,0,329,333,2242
1987,47,a) 0,10090,10346,69416,38478,10282,198.8,0,0,61876,61876,0,160.8,160.8,0,0,0,0,0,61876,160.8,0,0,,,
1987,47,b) 1,7333,7540,67943,67879,119,1.4,1992,23.2,18198,1428,16770,2.1,26.8,18070,10950,7120,16.1,26.6,128,0.2,53.2,0,1609,1610,8491
1987,47,c) 2,5972,6174,51525,53019,322,4.8,1339,19.9,13636,2640,10996,5,25.7,16623,8733,7890,16.5,31.4,-2987,-5.7,51.4,0,1089,1090,7106
1987,47,d) 3,6190,6376,56328,57254,277,4.1,935,13.9,11843,2136,9707,3.7,20.7,13695,6875,6820,12,23.9,-1852,-3.2,41.4,0,741,742,5447
1987,47,e) 4,3870,4077,38574,38863,201,4.7,585,13.6,8528,1698,6830,4.4,21.9,9106,4225,4881,10.9,23.4,-578,-1.5,43.8,0,467,468,3270
1987,47,f) 5,3370,3589,38969,39473,177,4.7,479,12.8,7387,1168,6219,3,18.7,8394,3955,4439,10,21.3,-1007,-2.6,37.4,0,363,365,3068
1987,47,g) 6 to 10,14725,16735,188880,196135,910,5.3,1883,10.9,34890,8723,26167,4.4,17.8,49400,27731,21669,14.1,25.2,-14510,-7.4,35.6,0,1265,1273,9969
1987,47,l) Left Censored,26514,40581,1182139,1181529,2409,5.9,3432,8.3,153345,38606,114739,3.3,13,152124,48624,103500,4.1,12.9,1221,0.1,25.8,0,1559,1578,11855
1987,48,a) 0,35777,36900,243608,128402,36648,198.6,0,0,230412,230412,0,179.4,179.4,0,0,0,0,0,230412,179.4,0,0,,,
1987,48,b) 1,28022,29016,245485,260327,562,1.7,9649,28.4,63928,8795,55133,3.4,24.6,93611,53112,40499,20.4,36,-29683,-11.4,49.2,0,7892,7906,43256
1987,48,c) 2,23574,24619,193014,215170,1425,5.2,6757,24.5,43250,11558,31692,5.4,20.1,87562,45176,42386,21,40.7,-44312,-20.6,40.2,0,5475,5481,34389
1987,48,d) 3,21641,22879,192808,209642,1175,4.7,4876,19.6,37962,9619,28343,4.6,18.1,71630,34071,37559,16.3,34.2,-33668,-16.1,36.2,0,3926,3932,26937
1987,48,e) 4,16312,17483,155265,168603,1077,5.7,3377,18,31196,10012,21184,5.9,18.5,57871,26806,31065,15.9,34.3,-26675,-15.8,37,0,2671,2695,19564
1987,48,f) 5,15297,16346,152234,165970,745,4.2,3093,17.6,26739,5512,21227,3.3,16.1,54210,22616,31594,13.6,32.7,-27471,-16.6,32.2,0,2212,2240,15294
1987,48,g) 6 to 10,58429,67207,726287,773174,3338,4.7,10428,14.7,116715,31736,84979,4.1,15.1,210488,83141,127347,10.8,27.2,-93773,-12.1,30.2,0,6785,6926,50124
1987,48,l) Left Censored,74334,131994,3453736,3556616,8589,6.3,14886,11,462732,158054,304678,4.4,13,668492,238674,429818,6.7,18.8,-205760,-5.8,26,0,5501,5690,47596
1987,49,a) 0,3378,3449,20888,10562,3431,199,0,0,20653,20653,0,195.5,195.5,0,0,0,0,0,20653,195.5,0,0,,,
1987,49,b) 1,2376,2441,23355,24385,36,1.3,746,26.3,5972,540,5432,2.2,24.5,8033,4850,3183,19.9,32.9,-2061,-8.4,49,0,569,570,3685
1987,49,c) 2,2071,2145,17822,18667,153,6.6,464,20,4292,1222,3070,6.5,23,5982,2559,3423,13.7,32,-1690,-9,46,0,364,364,1956
1987,49,d) 3,1719,1785,16703,17717,104,5.4,375,19.4,4069,991,3078,5.6,23,6096,3236,2860,18.3,34.4,-2027,-11.4,46,0,279,279,2422
1987,49,e) 4,1318,1488,17422,17903,121,7.9,218,14.1,3590,1255,2335,7,20.1,4552,2042,2510,11.4,25.4,-962,-5.3,40.2,0,154,156,1159
1987,49,f) 5,1275,1373,13261,13773,69,4.7,225,15.4,2564,666,1898,4.8,18.6,3588,1966,1622,14.3,26.1,-1024,-7.5,37.2,0,150,153,1360
1987,49,g) 6 to 10,5538,6141,74226,74782,357,5.6,838,13.1,13300,2916,10384,3.9,17.8,14411,5201,9210,7,19.3,-1111,-1.5,35.6,0,543,575,3516
1987,49,l) Left Censored,8031,12042,316195,319179,737,6,1271,10.3,42953,10606,32347,3.3,13.5,48921,17899,31022,5.6,15.3,-5968,-1.8,27,0,460,466,3534
1987,50,a) 0,2006,2026,10019,5309,2011,198.5,0,0,9421,9421,0,177.5,177.5,0,0,0,0,0,9421,177.5,0,0,,,
1987,50,b) 1,1568,1586,11822,11481,17,1,272,15.7,2662,274,2388,2.4,23.2,1980,1041,939,9.1,17.2,682,6,34.4,0,200,200,850
1987,50,c) 2,1242,1271,8216,8323,59,4.3,208,15.3,1831,395,1436,4.7,22,2045,954,1091,11.5,24.6,-214,-2.6,44,0,161,163,751
1987,50,d) 3,1102,1139,7896,7939,61,5.2,137,11.6,1573,411,1162,5.2,19.8,1659,606,1053,7.6,20.9,-86,-1.1,39.6,0,103,104,453
1987,50,e) 4,735,760,4832,4908,39,4.9,111,13.8,1083,272,811,5.5,22.1,1234,614,620,12.5,25.1,-151,-3,44.2,0,85,85,484
1987,50,f) 5,671,698,5573,5846,28,3.8,88,12.1,817,94,723,1.6,14,1363,582,781,10,23.3,-546,-9.3,28,0,73,73,547
1987,50,g) 6 to 10,2686,2917,30064,30025,136,4.5,345,11.4,5116,954,4162,3.2,17,5037,2049,2988,6.8,16.8,79,0.2,33.6,0,271,271,1669
1987,50,l) Left Censored,4595,5848,135806,133670,303,5.1,419,7.1,17499,5787,11712,4.3,13.1,13227,4941,8286,3.7,9.9,4272,3.2,19.8,0,228,238,2006
1987,51,a) 0,13155,13439,81758,42271,13386,199.2,0,0,78974,78974,0,186.8,186.8,0,0,0,0,0,78974,186.8,0,0,,,
1987,51,b) 1,10061,10373,77152,76135,229,2,2452,21.1,24710,3605,21105,4.7,32.5,22675,12266,10409,16.1,29.8,2035,2.7,59.6,0,1892,1894,9153
1987,51,c) 2,8476,8869,85293,90554,557,5.9,1604,17,20190,4491,15699,5,22.3,30712,20346,10366,22.5,33.9,-10522,-11.6,44.6,0,1250,1252,7558
1987,51,d) 3,7273,7493,62847,63571,304,3.8,1073,13.5,13588,2650,10938,4.2,21.4,15035,6505,8530,10.2,23.7,-1447,-2.3,42.8,0,833,834,5044
1987,51,e) 4,4777,5045,46224,48066,273,5.2,720,13.6,8897,2193,6704,4.6,18.5,12581,6115,6466,12.7,26.2,-3684,-7.7,37,0,535,537,3989
1987,51,f) 5,4343,4655,53342,54217,243,5,582,12.1,9480,2029,7451,3.7,17.5,11229,4552,6677,8.4,20.7,-1749,-3.2,35,0,411,417,2930
1987,51,g) 6 to 10,18003,20556,264962,263490,1122,5.3,2431,11.4,47686,9047,38639,3.4,18.1,44742,18169,26573,6.9,17,2944,1.1,34,0,1459,1479,9867
1987,51,l) Left Censored,30818,50485,1411571,1398214,3463,6.8,4038,7.9,208192,70608,137584,5,14.9,181477,59194,122283,4.2,13,26715,1.9,26,0,1830,1877,15176
1987,53,a) 0,11927,12196,66387,34767,12123,198.8,0,0,63240,63240,0,181.9,181.9,0,0,0,0,0,63240,181.9,0,0,,,
1987,53,b) 1,8869,9163,68890,69243,188,1.8,2417,23.2,19816,2221,17595,3.2,28.6,20521,11758,8763,17,29.6,-705,-1,57.2,0,1816,1816,9197
1987,53,c) 2,7208,7454,55446,56705,480,6,1503,18.7,14242,3465,10777,6.1,25.1,16760,8722,8038,15.4,29.6,-2518,-4.5,50.2,0,1146,1146,6463
1987,53,d) 3,6727,7023,56672,57137,427,5.7,1161,15.6,13772,3250,10522,5.7,24.1,14702,6411,8291,11.2,25.7,-930,-1.6,48.2,0,894,894,5167
1987,53,e) 4,4807,5232,55525,56139,308,5.6,838,15.2,10253,3195,7058,5.7,18.3,11480,5128,6352,9.1,20.4,-1227,-2.1,36.6,0,620,622,3690
1987,53,f) 5,4393,4662,43916,44281,266,5.4,680,13.9,8968,1769,7199,4,20.3,9698,4279,5419,9.7,21.9,-730,-1.6,40.6,0,493,506,3248
1987,53,g) 6 to 10,18728,20665,216245,218899,1148,5.3,2657,12.4,40610,8318,32292,3.8,18.6,45917,17820,28097,8.1,21,-5307,-2.4,37.2,0,1655,1688,11123
1987,53,l) Left Censored,25379,38191,893024,886365,2400,6.2,3811,9.8,134561,40264,94297,4.5,15.2,121243,44676,76567,5,13.7,13318,1.5,27.4,0,1727,1766,14150
1987,54,a) 0,3089,3140,19615,11063,3110,198.1,0,0,17105,17105,0,154.6,154.6,0,0,0,0,0,17105,154.6,0,0,,,
1987,54,b) 1,2261,2333,16858,16777,61,2.3,581,22.1,4558,1096,3462,6.5,27.2,4396,2239,2157,13.3,26.2,162,1,52.4,0,452,452,1749
1987,54,c) 2,1932,2024,25287,25785,129,5.9,402,18.4,3843,1289,2554,5,14.9,4838,2293,2545,8.9,18.8,-995,-3.9,29.8,0,309,309,1885
1987,54,d) 3,1896,1921,12286,12689,60,2.9,290,14.1,2136,361,1775,2.8,16.8,2942,1502,1440,11.8,23.2,-806,-6.4,33.6,0,225,225,1160
1987,54,e) 4,1174,1237,8858,9221,62,4.8,163,12.6,1444,330,1114,3.6,15.7,2170,1143,1027,12.4,23.5,-726,-7.8,31.4,0,129,129,813
1987,54,f) 5,1177,1243,12868,13346,66,5.1,165,12.7,2045,411,1634,3.1,15.3,3000,1460,1540,10.9,22.5,-955,-7.2,30.6,0,120,120,923
1987,54,g) 6 to 10,5096,5701,52668,53766,308,5.2,719,12.1,8344,1858,6486,3.5,15.5,10539,4351,6188,8.1,19.6,-2195,-4.1,31,0,501,503,2667
1987,54,l) Left Censored,10920,15333,305665,309752,817,5.2,1358,8.7,35801,9833,25968,3.2,11.6,43974,15198,28776,4.9,14.2,-8173,-2.6,23.2,0,667,678,5167
1987,55,a) 0,9499,9889,66006,36058,9745,197.1,0,0,59897,59897,0,166.1,166.1,0,0,0,0,0,59897,166.1,0,0,,,
1987,55,b) 1,7020,7145,67211,64202,74,1,462,6.3,13960,1504,12456,2.3,21.7,7942,1891,6051,2.9,12.4,6018,9.3,24.8,0,45,45,162
1987,55,c) 2,6204,6478,50701,47372,508,8,347,5.4,13108,5100,8008,10.8,27.7,6450,1828,4622,3.9,13.6,6658,14.1,27.2,0,30,31,170
1987,55,d) 3,5745,6006,52491,48853,431,7.3,336,5.7,13881,7164,6717,14.7,28.4,6605,1910,4695,3.9,13.5,7276,14.9,27,0,24,24,292
1987,55,e) 4,3835,4152,41087,38252,354,8.7,223,5.5,10343,4841,5502,12.7,27,4673,1372,3301,3.6,12.2,5670,14.8,24.4,0,19,19,123
1987,55,f) 5,3618,3789,35308,35795,97,2.5,250,6.5,5258,679,4579,1.9,14.7,6231,2548,3683,7.1,17.4,-973,-2.7,29.4,0,27,32,465
1987,55,g) 6 to 10,17084,18907,190963,189560,818,4.3,1734,9,30458,5335,25123,2.8,16.1,27651,10357,17294,5.5,14.6,2807,1.5,29.2,0,158,171,1177
1987,55,l) Left Censored,33964,46658,1216252,1212554,2372,5,3833,8.1,139198,35908,103290,3,11.5,131803,40262,91541,3.3,10.9,7395,0.6,21.8,0,1554,1598,15197
1987,56,a) 0,1179,1197,7157,4546,1179,197,0,0,5223,5223,0,114.9,114.9,0,0,0,0,0,5223,114.9,0,0,,,
1987,56,b) 1,902,912,4667,5083,12,1.2,238,22.9,1014,136,878,2.7,19.9,1845,1058,787,20.8,36.3,-831,-16.4,39.8,0,158,158,787
1987,56,c) 2,871,887,5258,5595,49,5,184,19,1287,285,1002,5.1,23,1960,929,1031,16.6,35,-673,-12,46,0,128,128,663
1987,56,d) 3,762,785,5128,5597,45,5.3,153,18.1,863,366,497,6.5,15.4,1800,840,960,15,32.2,-937,-16.8,30.8,0,127,127,748
1987,56,e) 4,600,685,5069,5717,28,3.8,143,19.2,492,76,416,1.3,8.6,1787,662,1125,11.6,31.3,-1295,-22.7,17.2,0,120,121,612
1987,56,f) 5,656,701,4453,4850,21,2.7,145,19,663,87,576,1.8,13.7,1456,549,907,11.3,30,-793,-16.3,27.4,0,96,96,383
1987,56,g) 6 to 10,2624,2862,22027,23598,130,4.3,476,15.6,3154,841,2313,3.6,13.4,6296,2151,4145,9.1,26.7,-3142,-13.3,26.8,0,315,319,1418
1987,56,l) Left Censored,3432,4627,67919,72374,213,4.4,592,12.3,6957,2100,4857,2.9,9.6,15866,6093,9773,8.4,21.9,-8909,-12.3,19.2,0,245,248,1602
1988,01,a) 0,6844,6909,43977,22084,6855,198.4,0,0,43787,43787,0,198.3,198.3,0,0,0,0,0,43787,198.3,0,0,,,
1988,01,b) 1,5831,6046,57702,58103,49,0.7,1940,27.4,14436,1976,12460,3.4,24.8,15238,9561,5677,16.5,26.2,-802,-1.4,49.6,0,1610,1610,7670
1988,01,c) 2,4663,4849,42752,43842,222,4.2,1133,21.2,10236,2283,7953,5.2,23.3,12415,6115,6300,13.9,28.3,-2179,-5,46.6,0,889,889,4336
1988,01,d) 3,3945,4125,35927,37017,205,4.6,793,17.9,7739,1969,5770,5.3,20.9,9918,4906,5012,13.3,26.8,-2179,-5.9,41.8,0,574,574,3727
1988,01,e) 4,4146,4326,41508,42272,182,4,610,13.4,7558,1488,6070,3.5,17.9,9086,3868,5218,9.2,21.5,-1528,-3.6,35.8,0,441,441,2760
1988,01,f) 5,2550,2719,24676,25490,83,2.9,371,12.9,4114,540,3574,2.1,16.1,5741,2462,3279,9.7,22.5,-1627,-6.4,32.2,0,257,257,1700
1988,01,g) 6 to 10,10852,12020,153769,156019,433,3.5,1351,10.8,22653,3950,18703,2.5,14.5,27153,9442,17711,6.1,17.4,-4500,-2.9,29,0,902,902,5518
1988,01,h) 11 to 15,2325,3181,42215,41582,147,4.5,245,7.6,7381,1501,5880,3.6,17.8,6115,1865,4250,4.5,14.7,1266,3.1,29.4,0,121,121,632
1988,01,l) Left Censored,18976,29915,782322,781987,1674,5.5,2449,8.1,104222,35295,68927,4.5,13.3,103551,35556,67995,4.5,13.2,671,0.1,26.4,0,1044,1044,6918
1988,02,a) 0,1209,1223,7026,3607,1202,196.6,0,0,6839,,,,189.6,0,0,0,0,0,6839,189.6,0,1,,,
1988,02,b) 1,958,989,8468,9163,4,0.3,390,32.4,2005,,,,21.9,3394,2485,909,27.1,37,-1389,-15.1,43.8,1,303,303,1456
1988,02,c) 2,911,948,6785,7049,41,3.9,234,22.3,1951,173,1778,2.5,27.7,2479,1339,1140,19,35.2,-528,-7.5,55.4,0,182,182,1176
1988,02,d) 3,822,868,6480,6910,45,4.8,176,18.7,1433,115,1318,1.7,20.7,2293,702,1591,10.2,33.2,-860,-12.5,41.4,0,138,138,625
1988,02,e) 4,722,758,5139,5379,43,5.2,159,19.4,1080,224,856,4.2,20.1,1560,763,797,14.2,29,-480,-8.9,40.2,0,117,117,578
1988,02,f) 5,560,634,4542,4790,38,5.5,134,19.5,1000,210,790,4.4,20.9,1496,558,938,11.6,31.2,-496,-10.3,41.8,0,102,102,438
1988,02,g) 6 to 10,1944,2147,18404,18868,108,4.8,284,12.7,3763,672,3091,3.6,19.9,4690,1826,2864,9.7,24.9,-927,-5,39.8,0,195,195,1217
1988,02,h) 11 to 15,381,521,5766,5852,30,5.6,47,8.9,888,184,704,3.1,15.2,1059,234,825,4,18.1,-171,-2.9,30.4,0,22,22,127
1988,02,l) Left Censored,2218,3415,68865,71587,301,8.6,434,12.5,11148,3966,7182,5.5,15.6,16591,7487,9104,10.5,23.2,-5443,-7.6,31.2,0,89,89,795
1988,04,a) 0,8217,8342,54206,27215,8278,198.5,0,0,53982,53982,0,198.4,198.4,0,0,0,0,0,53982,198.4,0,0,,,
1988,04,b) 1,6835,7087,66915,66625,62,0.7,2464,29.3,19557,2445,17112,3.7,29.4,18976,12296,6680,18.5,28.5,581,0.9,57,0,2010,2010,9710
1988,04,c) 2,5631,5866,48533,51389,259,4,1389,21.5,11302,1841,9461,3.6,22,17013,8775,8238,17.1,33.1,-5711,-11.1,44,0,1104,1104,7049
1988,04,d) 3,4802,4983,51820,54290,255,4.7,1019,18.9,11748,2900,8848,5.3,21.6,16687,8624,8063,15.9,30.7,-4939,-9.1,43.2,0,809,809,6745
1988,04,e) 4,4105,4419,40263,41926,266,5.7,773,16.5,8897,2345,6552,5.6,21.2,12223,6078,6145,14.5,29.2,-3326,-8,42.4,0,595,595,4696
1988,04,f) 5,3066,3525,45772,46525,174,4.7,516,14,7440,1806,5634,3.9,16,8946,3567,5379,7.7,19.2,-1506,-3.2,32,0,409,409,3009
1988,04,g) 6 to 10,11962,13226,155003,158871,599,4.4,1586,11.5,26962,4765,22197,3,17,34697,12651,22046,8,21.8,-7735,-4.8,34,0,1072,1072,7186
1988,04,h) 11 to 15,1849,2612,43562,43355,154,5.8,259,9.7,8202,2221,5981,5.1,18.9,7787,2712,5075,6.3,18,415,0.9,36,0,135,135,904
1988,04,l) Left Censored,12347,22712,660896,651422,1853,8.1,2145,9.4,116924,44218,72706,6.8,17.9,97976,32417,65559,5,15,18948,2.9,30,0,632,632,5008
1988,05,a) 0,4097,4147,24299,12314,4107,198.1,0,0,23971,23971,0,194.7,194.7,0,0,0,0,0,23971,194.7,0,0,,,
1988,05,b) 1,3450,3540,33494,34611,31,0.7,1268,30,5892,659,5233,1.9,17,8126,5172,2954,14.9,23.5,-2234,-6.5,34,0,1039,1039,4364
1988,05,c) 2,2759,2839,21185,22443,86,2.7,724,22.7,4351,476,3875,2.1,19.4,6867,3211,3656,14.3,30.6,-2516,-11.2,38.8,0,611,611,2832
1988,05,d) 3,2566,2643,22972,25174,85,3,480,16.8,3955,844,3111,3.4,15.7,8359,2433,5926,9.7,33.2,-4404,-17.5,31.4,0,407,407,2159
1988,05,e) 4,2668,2745,18027,18181,66,2.3,384,13.1,3602,301,3301,1.7,19.8,3909,1849,2060,10.2,21.5,-307,-1.7,39.6,0,296,296,1409
1988,05,f) 5,1804,1927,18425,18520,78,3.9,263,13,3209,712,2497,3.8,17.3,3398,1611,1787,8.7,18.3,-189,-1,34.6,0,192,192,933
1988,05,g) 6 to 10,7813,8396,80223,80978,317,3.6,860,9.9,13901,3091,10810,3.8,17.2,15411,5181,10230,6.4,19,-1510,-1.8,34.4,0,627,627,3603
1988,05,h) 11 to 15,1536,2002,25158,25227,91,4.5,164,8.1,4464,861,3603,3.4,17.7,4602,1677,2925,6.6,18.2,-138,-0.5,35.4,0,87,87,586
1988,05,l) Left Censored,12106,17398,441933,439408,899,5.1,1540,8.7,56976,14707,42269,3.3,13,51927,19920,32007,4.5,11.8,5049,1.2,23.6,0,656,656,3746
1988,06,a) 0,62867,63822,421532,212104,63158,197.9,0,0,418856,418856,0,197.5,197.5,0,0,0,0,0,418856,197.5,0,0,,,
1988,06,b) 1,52764,54513,575300,571145,420,0.7,16516,26,159587,13563,146024,2.4,27.9,151277,86376,64901,15.1,26.5,8310,1.4,53,0,12842,12842,65181
1988,06,c) 2,43051,44902,400056,406723,1961,4,9326,19.1,104540,16315,88225,4,25.7,117874,59453,58421,14.6,29,-13334,-3.3,51.4,0,7315,7315,47567
1988,06,d) 3,36968,38659,382221,387613,1777,4.3,6674,16.2,89302,16295,73007,4.2,23,100086,44848,55238,11.6,25.8,-10784,-2.8,46,0,5142,5142,34481
1988,06,e) 4,32399,34181,356061,362838,1398,3.9,5149,14.3,76033,11183,64850,3.1,21,89586,37225,52361,10.3,24.7,-13553,-3.7,42,0,3874,3874,28191
1988,06,f) 5,24794,27031,359023,362287,1040,3.7,3649,12.9,67653,9717,57936,2.7,18.7,74181,29365,44816,8.1,20.5,-6528,-1.8,37.4,0,2570,2570,20401
1988,06,g) 6 to 10,109105,118932,1394732,1413406,5185,4.2,13978,11.3,249609,46900,202709,3.3,17.7,286958,107155,179803,7.6,20.3,-37349,-2.6,35.4,0,9179,9179,66276
1988,06,h) 11 to 15,19139,25619,433124,426314,1332,5.1,2631,10,85463,23252,62211,5.5,20,71843,23898,47945,5.6,16.9,13620,3.1,33.8,0,1264,1264,7475
1988,06,l) Left Censored,123928,204815,6039363,6007329,13308,6.4,17841,8.6,976439,265723,710716,4.4,16.3,912370,298091,614279,5,15.2,64069,1.1,30.4,0,7369,7370,49704
1988,08,a) 0,8452,8533,49044,24637,8446,198,0,0,48814,48814,0,198.1,198.1,0,0,0,0,0,48814,198.1,0,0,,,
1988,08,b) 1,6846,7070,58770,61170,76,0.9,2634,31.1,15818,2115,13703,3.5,25.9,20617,13623,6994,22.3,33.7,-4799,-7.8,51.8,0,2154,2154,10168
1988,08,c) 2,5722,5912,44382,47199,268,4.1,1541,23.4,10242,1594,8648,3.4,21.7,15875,9292,6583,19.7,33.6,-5633,-11.9,43.4,0,1282,1282,8144
1988,08,d) 3,5191,5366,43799,46621,227,3.9,1243,21.1,8159,1166,6993,2.5,17.5,13803,7328,6475,15.7,29.6,-5644,-12.1,35,0,1008,1008,5278
1988,08,e) 4,4595,4803,39446,41485,203,3.9,932,18,7553,1268,6285,3.1,18.2,11630,6285,5345,15.2,28,-4077,-9.8,36.4,0,732,732,4385
1988,08,f) 5,3411,3962,55783,56602,196,4.7,609,14.6,8182,2015,6167,3.6,14.5,9819,4077,5742,7.2,17.3,-1637,-2.8,29,0,495,495,2625
1988,08,g) 6 to 10,14356,15559,149711,153008,639,3.9,2109,12.9,24977,5003,19974,3.3,16.3,31570,12188,19382,8,20.6,-6593,-4.3,32.6,0,1453,1453,7752
1988,08,h) 11 to 15,2366,3213,35804,36649,197,6,342,10.4,6270,2285,3985,6.2,17.1,7959,2706,5253,7.4,21.7,-1689,-4.6,34.2,0,181,181,1382
1988,08,l) Left Censored,17031,27089,684434,688629,1957,7.1,2725,9.9,97207,29175,68032,4.2,14.1,105597,37374,68223,5.4,15.3,-8390,-1.2,28.2,0,1016,1016,5910
1988,09,a) 0,8077,8132,44873,22663,8067,198.4,0,0,44421,44421,0,196,196,0,0,0,0,0,44421,196,0,0,,,
1988,09,b) 1,6696,6854,55143,55043,56,0.7,1777,22.8,15194,1154,14040,2.1,27.6,14994,8217,6777,14.9,27.2,200,0.4,54.4,0,1422,1422,5631
1988,09,c) 2,5296,5449,46756,47425,191,3.2,996,16.9,10632,1152,9480,2.4,22.4,11969,5569,6400,11.7,25.2,-1337,-2.8,44.8,0,787,787,3706
1988,09,d) 3,4528,4663,41660,41801,168,3.4,693,14,8693,1381,7312,3.3,20.8,8974,3481,5493,8.3,21.5,-281,-0.7,41.6,0,543,543,2777
1988,09,e) 4,3906,4037,37690,39093,126,3,578,13.6,6888,928,5960,2.4,17.6,9694,3749,5945,9.6,24.8,-2806,-7.2,35.2,0,440,440,2789
1988,09,f) 5,2905,3039,28226,29534,108,3.4,359,11.3,4722,897,3825,3,16,7337,1852,5485,6.3,24.8,-2615,-8.8,32,0,261,261,1411
1988,09,g) 6 to 10,12289,13057,148094,153864,431,3.2,1288,9.6,22270,3713,18557,2.4,14.5,33809,17010,16799,11.1,22,-11539,-7.5,29,0,946,946,13563
1988,09,h) 11 to 15,2449,3083,45253,45141,145,4.6,256,8.2,7840,1445,6395,3.2,17.4,7616,3099,4517,6.9,16.9,224,0.5,33.8,0,134,134,1046
1988,09,l) Left Censored,23891,32555,1046370,1047687,1761,5.3,2484,7.5,141147,51255,89892,4.9,13.5,143781,52965,90816,5.1,13.7,-2634,-0.2,27,0,1172,1172,8026
1988,10,a) 0,1385,1390,8413,4350,1374,197.7,0,0,8126,8126,0,186.8,186.8,0,0,0,0,0,8126,186.8,0,0,,,
1988,10,b) 1,1159,1187,11166,11100,11,0.8,354,25.7,2771,152,2619,1.4,25,2639,1717,922,15.5,23.8,132,1.2,47.6,0,229,229,939
1988,10,c) 2,928,964,7312,7465,35,3.3,215,20.3,1916,407,1509,5.5,25.7,2221,1255,966,16.8,29.8,-305,-4.1,51.4,0,147,147,1053
1988,10,d) 3,800,827,6737,7052,31,3.5,155,17.4,1508,417,1091,5.9,21.4,2137,1058,1079,15,30.3,-629,-8.9,42.8,0,104,104,706
1988,10,e) 4,724,747,7610,7936,23,2.9,132,16.4,1472,260,1212,3.3,18.5,2124,1268,856,16,26.8,-652,-8.3,37,0,90,90,556
1988,10,f) 5,523,551,5262,5453,16,2.7,80,13.7,714,46,668,0.8,13.1,1096,571,525,10.5,20.1,-382,-7,26.2,0,50,50,243
1988,10,g) 6 to 10,2088,2230,27055,26543,93,4,248,10.8,5414,1321,4093,5,20.4,4390,2043,2347,7.7,16.5,1024,3.9,33,0,166,166,1248
1988,10,h) 11 to 15,466,602,11036,10562,28,4.6,37,6.1,1939,182,1757,1.7,18.4,990,264,726,2.5,9.4,949,9,18.8,0,24,24,143
1988,10,l) Left Censored,4231,5891,200675,197448,347,5.8,439,7.4,30602,9147,21455,4.6,15.5,24147,7731,16416,3.9,12.2,6455,3.3,24.4,0,172,172,1196
1988,11,a) 0,1275,1293,9794,5130,1287,199.1,0,0,9328,9328,0,181.8,181.8,0,0,0,0,0,9328,181.8,0,0,,,
1988,11,b) 1,1069,1093,18752,18695,14,1.1,334,26.4,3385,248,3137,1.3,18.1,3271,1815,1456,9.7,17.5,114,0.6,35,0,247,247,1452
1988,11,c) 2,964,982,9447,9738,36,3.4,213,19.9,2106,231,1875,2.4,21.6,2687,1513,1174,15.5,27.6,-581,-6,43.2,0,167,167,1189
1988,11,d) 3,917,933,12245,13978,31,3.2,119,12.2,2412,441,1971,3.2,17.3,5878,3889,1989,27.8,42.1,-3466,-24.8,34.6,0,92,92,3786
1988,11,e) 4,840,866,11277,10973,21,2.3,120,13.1,2578,482,2096,4.4,23.5,1969,756,1213,6.9,17.9,609,5.6,35.8,0,86,86,551
1988,11,f) 5,757,791,7357,7672,37,4.5,110,13.3,1638,479,1159,6.2,21.4,2267,931,1336,12.1,29.5,-629,-8.1,42.8,0,76,76,675
1988,11,g) 6 to 10,2701,2820,42491,42465,101,3.4,335,11.4,6364,935,5429,2.2,15,6314,2396,3918,5.6,14.9,50,0.1,29.8,0,210,210,1281
1988,11,h) 11 to 15,591,754,32318,33890,36,4.7,70,9.1,3302,794,2508,2.3,9.7,6446,1052,5394,3.1,19,-3144,-9.3,19.4,0,18,18,122
1988,11,l) Left Censored,5681,7908,270427,271267,577,7.3,584,7.4,39424,9407,30017,3.5,14.5,41103,8363,32740,3.1,15.2,-1679,-0.7,29,0,229,229,1368
1988,12,a) 0,35876,36407,211724,106631,36059,198.1,0,0,210186,210186,0,197.1,197.1,0,0,0,0,0,210186,197.1,0,0,,,
1988,12,b) 1,28115,29026,252683,257001,223,0.7,9921,28.9,69306,7481,61825,2.9,27,77942,48091,29851,18.7,30.3,-8636,-3.3,54,0,8280,8280,40890
1988,12,c) 2,22201,23009,183363,192492,900,3.5,5766,22.6,43162,6052,37110,3.1,22.4,61419,34142,27277,17.7,31.9,-18257,-9.5,44.8,0,4680,4680,27976
1988,12,d) 3,18731,19488,169074,176135,733,3.5,3956,18.7,34194,3961,30233,2.2,19.4,48316,24212,24104,13.7,27.4,-14122,-8,38.8,0,3215,3215,18788
1988,12,e) 4,16124,16798,153085,158402,623,3.5,2811,15.7,28323,4727,23596,3,17.9,38956,17336,21620,10.9,24.6,-10633,-6.7,35.8,0,2244,2244,13486
1988,12,f) 5,12270,13126,131082,131249,544,3.9,1874,13.6,27848,5933,21915,4.5,21.2,28181,11755,16426,9,21.5,-333,-0.3,42.4,0,1515,1515,9621
1988,12,g) 6 to 10,47245,51127,559226,567285,1936,3.6,6220,11.7,98349,20603,77746,3.6,17.3,114467,44693,69774,7.9,20.2,-16118,-2.9,34.6,0,4572,4572,29549
1988,12,h) 11 to 15,7882,10846,160471,157758,613,5.5,1058,9.6,37077,9343,27734,5.9,23.5,31651,10820,20831,6.9,20.1,5426,3.4,40.2,0,560,560,4237
1988,12,l) Left Censored,52396,94266,2403939,2382765,7076,7.5,8007,8.4,371589,121516,250073,5.1,15.6,329241,114904,214337,4.8,13.8,42348,1.8,27.6,0,3119,3121,21351
1988,13,a) 0,13360,13507,90583,45774,13383,198.2,0,0,89619,89619,0,195.8,195.8,0,0,0,0,0,89619,195.8,0,0,,,
1988,13,b) 1,10745,11177,120110,119632,110,0.8,3682,28.1,32552,2940,29612,2.5,27.2,31596,19166,12430,16,26.4,956,0.8,52.8,0,2973,2973,15280
1988,13,c) 2,8997,9406,84699,88309,406,3.9,2161,20.9,18309,3021,15288,3.4,20.7,25529,13551,11978,15.3,28.9,-7220,-8.2,41.4,0,1767,1767,11364
1988,13,d) 3,7902,8215,71991,73318,325,3.7,1419,16.2,16061,3105,12956,4.2,21.9,18715,9165,9550,12.5,25.5,-2654,-3.6,43.8,0,1141,1141,7128
1988,13,e) 4,7075,7425,73821,74440,282,3.6,1012,13,15099,3298,11801,4.4,20.3,16337,6268,10069,8.4,21.9,-1238,-1.6,40.6,0,760,760,4746
1988,13,f) 5,4897,5303,52361,52696,214,3.9,683,12.3,10475,1356,9119,2.6,19.9,11145,4769,6376,9.1,21.1,-670,-1.2,39.8,0,524,524,3334
1988,13,g) 6 to 10,19189,21141,261348,260811,872,4,2225,10.2,49702,13503,36199,5.2,19.1,48628,17635,30993,6.8,18.6,1074,0.5,37.2,0,1484,1484,10776
1988,13,h) 11 to 15,3755,4886,69609,69641,275,5.5,462,9.3,13333,3248,10085,4.7,19.1,13397,4267,9130,6.1,19.2,-64,-0.1,38.2,0,234,234,1344
1988,13,l) Left Censored,29990,51629,1565568,1549273,3624,7,4177,8,245543,84141,161402,5.4,15.8,212952,73219,139733,4.7,13.7,32591,2.1,27.4,0,1583,1586,11352
1988,15,a) 0,2134,2175,14217,7145,2153,198,0,0,14145,14145,0,198,198,0,0,0,0,0,14145,198,0,0,,,
1988,15,b) 1,1736,1818,20375,20624,16,0.8,533,25.3,3942,321,3621,1.6,19.1,4440,2900,1540,14.1,21.5,-498,-2.4,38.2,0,423,423,1801
1988,15,c) 2,1381,1476,13076,13507,57,3.6,274,17.2,2464,429,2035,3.2,18.2,3325,1341,1984,9.9,24.6,-861,-6.4,36.4,0,229,229,1150
1988,15,d) 3,1356,1428,14664,13866,53,3.5,201,13.4,4096,376,3720,2.7,29.5,2500,1152,1348,8.3,18,1596,11.5,36,0,164,164,953
1988,15,e) 4,1014,1086,9437,9857,30,2.6,148,13,1435,194,1241,2,14.6,2274,876,1398,8.9,23.1,-839,-8.5,29.2,0,108,108,639
1988,15,f) 5,1016,1076,8993,9229,35,3.1,117,10.5,1299,210,1089,2.3,14.1,1770,620,1150,6.7,19.2,-471,-5.1,28.2,0,95,95,494
1988,15,g) 6 to 10,4281,4734,51984,51698,223,4.6,505,10.4,9212,1572,7640,3,17.8,8640,2829,5811,5.5,16.7,572,1.1,33.4,0,356,356,2030
1988,15,h) 11 to 15,748,1095,17291,17105,49,4.4,79,7.1,2446,734,1712,4.3,14.3,2073,663,1410,3.9,12.1,373,2.2,24.2,0,30,30,109
1988,15,l) Left Censored,6126,9427,231974,229845,486,5.1,701,7.4,32265,8202,24063,3.6,14,28006,10290,17716,4.5,12.2,4259,1.8,24.4,0,283,283,1791
1988,16,a) 0,1925,1938,11785,5957,1909,197,0,0,11656,11656,0,195.7,195.7,0,0,0,0,0,11656,195.7,0,0,,,
1988,16,b) 1,1591,1639,12175,12540,8,0.4,541,27.9,3141,250,2891,2,25,3871,2607,1264,20.8,30.9,-730,-5.9,50,0,424,424,1966
1988,16,c) 2,1405,1439,9552,10014,49,3.1,287,18.2,1967,356,1611,3.6,19.6,2890,1328,1562,13.3,28.9,-923,-9.3,39.2,0,226,226,1076
1988,16,d) 3,1289,1339,8889,9158,54,3.8,233,16.2,1830,250,1580,2.7,20,2368,1167,1201,12.7,25.9,-538,-5.9,40,0,180,180,881
1988,16,e) 4,1155,1198,8203,8491,45,3.5,188,14.7,1638,179,1459,2.1,19.3,2213,1205,1008,14.2,26.1,-575,-6.8,38.6,0,148,148,1033
1988,16,f) 5,830,933,9084,9034,31,3.1,147,14.8,1734,398,1336,4.4,19.2,1633,806,827,8.9,18.1,101,1.1,36.2,0,108,108,642
1988,16,g) 6 to 10,3746,3971,34742,35205,143,3.5,448,10.8,6260,1165,5095,3.3,17.8,7186,2751,4435,7.8,20.4,-926,-2.6,35.6,0,324,324,1757
1988,16,h) 11 to 15,699,890,11547,10829,36,3.9,89,9.7,2998,1681,1317,15.5,27.7,1562,455,1107,4.2,14.4,1436,13.3,28.8,0,47,47,230
1988,16,l) Left Censored,5489,8120,154025,153319,486,5.9,632,7.7,20849,5735,15114,3.7,13.6,19438,6546,12892,4.3,12.7,1411,0.9,25.4,0,269,269,1685
1988,17,a) 0,19106,19296,130289,66954,19109,198.1,0,0,126670,126670,0,189.2,189.2,0,0,0,0,0,126670,189.2,0,0,,,
1988,17,b) 1,16350,16870,177309,171718,146,0.8,4371,22.8,48563,6219,42344,3.6,28.3,37381,22163,15218,12.9,21.8,11182,6.5,43.6,0,3428,3428,16843
1988,17,c) 2,13592,14125,123229,124573,557,3.7,2596,17.1,30192,5568,24624,4.5,24.2,32880,17656,15224,14.2,26.4,-2688,-2.2,48.4,0,2062,2062,14331
1988,17,d) 3,12605,13082,125626,127204,425,3.1,1920,13.9,23033,3259,19774,2.6,18.1,26188,11629,14559,9.1,20.6,-3155,-2.5,36.2,0,1511,1511,8956
1988,17,e) 4,11367,11967,118680,118592,421,3.4,1481,11.8,22288,3369,18919,2.8,18.8,22111,9018,13093,7.6,18.6,177,0.2,37.2,0,1076,1076,5776
1988,17,f) 5,8205,8763,113947,112309,340,3.7,1137,12.4,20590,3253,17337,2.9,18.3,17313,7488,9825,6.7,15.4,3277,2.9,30.8,0,815,815,4954
1988,17,g) 6 to 10,35838,38337,434825,439223,1339,3.4,3744,9.5,68888,15446,53442,3.5,15.7,77685,26449,51236,6,17.7,-8797,-2,31.4,0,2611,2611,16162
1988,17,h) 11 to 15,7350,9585,146724,145423,469,4.8,757,7.8,21831,4906,16925,3.4,15,19229,4668,14561,3.2,13.2,2602,1.8,26.4,0,410,410,1921
1988,17,l) Left Censored,68227,99253,2964706,2935628,5381,5.4,7726,7.7,405822,111893,293929,3.8,13.8,347665,119211,228454,4.1,11.8,58157,2,23.6,0,3589,3589,26976
1988,18,a) 0,8809,8913,58513,29388,8836,198.3,0,0,58250,58250,0,198.2,198.2,0,0,0,0,0,58250,198.2,0,0,,,
1988,18,b) 1,7629,7896,75421,75296,85,0.9,2298,25.2,18853,2663,16190,3.5,25,18602,11515,7087,15.3,24.7,251,0.3,49.4,0,1807,1807,8702
1988,18,c) 2,6530,6799,60922,61703,210,2.8,1294,17.5,13189,1448,11741,2.3,21.4,14751,6493,8258,10.5,23.9,-1562,-2.5,42.8,0,1080,1080,5726
1988,18,d) 3,5902,6204,55785,66649,191,2.9,927,14.1,10629,1263,9366,1.9,15.9,32356,25430,6926,38.2,48.5,-21727,-32.6,31.8,0,745,745,24503
1988,18,e) 4,5622,5950,57155,57818,185,3,672,10.8,9840,2125,7715,3.7,17,11166,4890,6276,8.5,19.3,-1326,-2.3,34,0,492,492,3163
1988,18,f) 5,3886,4059,45038,44677,117,2.8,475,11.2,7634,909,6725,2,17.1,6912,2793,4119,6.3,15.5,722,1.6,31,0,377,377,2093
1988,18,g) 6 to 10,15884,17319,185769,187709,575,3.2,1719,9.6,28320,4633,23687,2.5,15.1,32200,10443,21757,5.6,17.2,-3880,-2.1,30.2,0,1190,1190,6294
1988,18,h) 11 to 15,3333,4615,68995,68067,252,5.4,365,7.8,12537,3451,9086,5.1,18.4,10681,3523,7158,5.2,15.7,1856,2.7,31.4,0,226,226,1602
1988,18,l) Left Censored,31510,47897,1371636,1359338,2528,5.2,3589,7.4,175591,48269,127322,3.6,12.9,150995,49162,101833,3.6,11.1,24596,1.8,22.2,0,1506,1506,9972
1988,19,a) 0,4361,4401,25932,13069,4365,198.4,0,0,25727,25727,0,196.9,196.9,0,0,0,0,0,25727,196.9,0,0,,,
1988,19,b) 1,3825,3967,40446,40951,51,1.1,1137,24.9,8021,1750,6271,4.3,19.6,9031,5680,3351,13.9,22.1,-1010,-2.5,39.2,0,884,884,3882
1988,19,c) 2,3113,3188,24061,24998,98,2.8,649,18.6,4358,511,3847,2,17.4,6231,3612,2619,14.4,24.9,-1873,-7.5,34.8,0,526,526,3060
1988,19,d) 3,2936,3074,25014,25987,91,2.8,510,15.5,3564,332,3232,1.3,13.7,5510,2416,3094,9.3,21.2,-1946,-7.5,27.4,0,355,355,1491
1988,19,e) 4,3218,3325,23810,23739,110,3.1,439,12.6,4709,788,3921,3.3,19.8,4566,2336,2230,9.8,19.2,143,0.6,38.4,0,292,292,1698
1988,19,f) 5,2085,2349,22081,21497,97,3.9,328,13.3,4538,778,3760,3.6,21.1,3370,1592,1778,7.4,15.7,1168,5.4,31.4,0,265,265,1369
1988,19,g) 6 to 10,10129,11019,94887,94271,435,3.8,1056,9.3,14739,2756,11983,2.9,15.6,13507,4815,8692,5.1,14.3,1232,1.3,28.6,0,753,754,3277
1988,19,h) 11 to 15,2257,3090,32808,32255,118,3.7,240,7.6,5150,991,4159,3.1,16,4044,1395,2649,4.3,12.5,1106,3.5,25,0,129,129,489
1988,19,l) Left Censored,20772,29397,630568,616995,1226,4.1,2205,7.4,88100,18675,69425,3,14.3,60954,22287,38667,3.6,9.9,27146,4.4,19.8,0,1100,1100,5269
1988,20,a) 0,4646,4702,27933,14162,4656,198,0,0,27542,27542,0,194.5,194.5,0,0,0,0,0,27542,194.5,0,0,,,
1988,20,b) 1,3927,4040,42190,43073,32,0.7,1278,27.1,7373,689,6684,1.6,17.1,9139,5775,3364,13.4,21.2,-1766,-4.1,34.2,0,1037,1037,4629
1988,20,c) 2,3343,3440,25818,26398,138,3.7,756,20,5738,1039,4699,3.9,21.7,6898,3545,3353,13.4,26.1,-1160,-4.4,43.4,0,612,612,2712
1988,20,d) 3,3201,3311,24821,25432,112,3.2,549,15.6,4298,758,3540,3,16.9,5519,2669,2850,10.5,21.7,-1221,-4.8,33.8,0,423,423,2226
1988,20,e) 4,3179,3280,25773,26394,102,3,430,12.5,4281,718,3563,2.7,16.2,5522,2566,2956,9.7,20.9,-1241,-4.7,32.4,0,320,320,1527
1988,20,f) 5,2188,2355,17744,18272,104,4.2,337,13.6,3198,734,2464,4,17.5,4254,1966,2288,10.8,23.3,-1056,-5.8,35,0,258,258,1445
1988,20,g) 6 to 10,9082,9791,88554,89334,341,3.4,991,9.8,15140,3404,11736,3.8,16.9,16700,5882,10818,6.6,18.7,-1560,-1.8,33.8,0,748,748,4421
1988,20,h) 11 to 15,1877,2603,30285,29508,150,5.7,210,8,6113,2222,3891,7.5,20.7,4558,1461,3097,5,15.4,1555,5.3,30.8,0,115,115,435
1988,20,l) Left Censored,17141,24528,514834,514194,1370,5.5,1825,7.4,65916,20607,45309,4,12.8,64636,22457,42179,4.4,12.6,1280,0.2,25.2,0,817,817,6971
1988,21,a) 0,5699,5761,36292,18413,5709,198.2,0,0,35758,35758,0,194.2,194.2,0,0,0,0,0,35758,194.2,0,0,,,
1988,21,b) 1,5054,5180,52364,52388,36,0.6,1608,26.7,12555,882,11673,1.7,24,12602,7753,4849,14.8,24.1,-47,-0.1,48,0,1339,1339,6039
1988,21,c) 2,4233,4401,38381,39789,152,3.1,947,19.6,7632,1161,6471,2.9,19.2,10447,5414,5033,13.6,26.3,-2815,-7.1,38.4,0,789,789,4275
1988,21,d) 3,3735,3874,35636,36152,161,3.9,637,15.4,7188,1265,5923,3.5,19.9,8220,4021,4199,11.1,22.7,-1032,-2.8,39.8,0,515,515,3396
1988,21,e) 4,3775,3910,33464,33211,149,3.6,507,12.4,7646,1608,6038,4.8,23,7140,3159,3981,9.5,21.5,506,1.5,43,0,413,413,2352
1988,21,f) 5,2446,2572,22183,23443,113,4.2,341,12.7,4540,942,3598,4,19.4,7059,3700,3359,15.8,30.1,-2519,-10.7,38.8,0,271,271,2864
1988,21,g) 6 to 10,9964,10698,124890,123817,467,4.2,1066,9.7,21671,3897,17774,3.1,17.5,19525,7296,12229,5.9,15.8,2146,1.7,31.6,0,792,792,5299
1988,21,h) 11 to 15,2098,2685,36016,35988,131,4.8,235,8.6,5462,1485,3977,4.1,15.2,5406,1726,3680,4.8,15,56,0.2,30,0,138,138,654
1988,21,l) Left Censored,19075,28493,716385,709176,1712,6,2241,7.8,96059,30573,65486,4.3,13.5,81641,26924,54717,3.8,11.5,14418,2,23,0,1068,1068,5816
1988,22,a) 0,6072,6145,45262,22931,6083,198,0,0,44663,44663,0,194.8,194.8,0,0,0,0,0,44663,194.8,0,0,,,
1988,22,b) 1,5022,5175,52144,54879,46,0.7,1960,31.5,13396,1300,12096,2.4,24.4,18866,13191,5675,24,34.4,-5470,-10,48.8,0,1638,1638,9029
1988,22,c) 2,4634,4760,37660,39178,167,3.1,1178,22.2,8679,929,7750,2.4,22.2,11714,6002,5712,15.3,29.9,-3035,-7.7,44.4,0,983,983,5174
1988,22,d) 3,4151,4318,34865,35615,148,3.2,850,18.2,7535,1090,6445,3.1,21.2,9034,4483,4551,12.6,25.4,-1499,-4.2,42.4,0,701,701,3596
1988,22,e) 4,4241,4411,42863,42875,143,3.1,653,14,8974,1016,7958,2.4,20.9,8997,4041,4956,9.4,21,-23,-0.1,41.8,0,513,513,3352
1988,22,f) 5,3218,3441,31061,31783,122,3.3,522,14.3,5795,930,4865,2.9,18.2,7239,3259,3980,10.3,22.8,-1444,-4.6,36.4,0,376,376,2218
1988,22,g) 6 to 10,13665,14706,145070,146787,648,4.2,1962,12.7,25646,5101,20545,3.5,17.5,29080,11793,17287,8,19.8,-3434,-2.3,35,0,1393,1393,6973
1988,22,h) 11 to 15,2420,3132,42044,42505,201,6.3,335,10.5,7576,2962,4614,7,17.8,8497,2668,5829,6.3,20,-921,-2.2,35.6,0,183,183,1069
1988,22,l) Left Censored,21053,32956,738323,741472,2048,6.1,3140,9.3,99524,26961,72563,3.6,13.4,105822,36357,69465,4.9,14.3,-6298,-0.9,26.8,0,1369,1369,9390
1988,23,a) 0,3315,3346,17680,8945,3310,197.8,0,0,17470,17470,0,195.3,195.3,0,0,0,0,0,17470,195.3,0,0,,,
1988,23,b) 1,2715,2787,24755,22816,18,0.6,802,24.9,8752,517,8235,2.3,38.4,4873,2630,2243,11.5,21.4,3879,17,42.8,0,607,607,2040
1988,23,c) 2,2170,2224,14193,14504,84,3.5,423,17.6,3250,324,2926,2.2,22.4,3871,2010,1861,13.9,26.7,-621,-4.3,44.8,0,325,325,1604
1988,23,d) 3,1751,1802,13897,13620,53,2.8,247,12.9,2969,288,2681,2.1,21.8,2414,878,1536,6.4,17.7,555,4.1,35.4,0,199,199,718
1988,23,e) 4,1516,1571,13757,14248,49,3,193,11.7,2214,197,2017,1.4,15.5,3196,993,2203,7,22.4,-982,-6.9,31,0,151,151,754
1988,23,f) 5,1087,1138,9906,9754,42,3.6,133,11.2,2364,525,1839,5.4,24.2,2060,803,1257,8.2,21.1,304,3.1,42.2,0,101,101,665
1988,23,g) 6 to 10,4307,4613,48485,48701,180,3.8,491,10.3,7506,1118,6388,2.3,15.4,7937,2896,5041,5.9,16.3,-431,-0.9,30.8,0,363,363,1943
1988,23,h) 11 to 15,866,1149,16542,15800,54,4.6,96,8.2,4170,411,3759,2.6,26.4,2686,1423,1263,9,17,1484,9.4,34,0,64,64,266
1988,23,l) Left Censored,7421,10278,253824,251324,462,4.4,801,7.7,30977,5976,25001,2.4,12.3,25976,7704,18272,3.1,10.3,5001,2,20.6,0,383,383,2600
1988,24,a) 0,9380,9513,63179,32033,9426,198.2,0,0,62293,62293,0,194.5,194.5,0,0,0,0,0,62293,194.5,0,0,,,
1988,24,b) 1,7566,7776,79418,78231,73,0.8,2263,25.2,22579,2191,20388,2.8,28.9,20204,12749,7455,16.3,25.8,2375,3.1,51.6,0,1743,1743,9960
1988,24,c) 2,6556,6733,59777,59688,226,3.1,1298,17.8,15403,2087,13316,3.5,25.8,15225,7696,7529,12.9,25.5,178,0.3,51,0,1009,1009,5826
1988,24,d) 3,5528,5838,57772,58997,190,3.1,900,14.5,11325,1269,10056,2.2,19.2,13774,6811,6963,11.5,23.3,-2449,-4.1,38.4,0,711,711,5794
1988,24,e) 4,4611,4813,52703,67185,158,3.1,643,12.7,9707,1349,8358,2,14.4,38671,5763,32908,8.6,57.6,-28964,-43.2,28.8,0,467,467,3523
1988,24,f) 5,3579,3813,39891,40619,159,4,470,11.8,7479,1365,6114,3.4,18.4,8934,3165,5769,7.8,22,-1455,-3.6,36.8,0,342,342,2067
1988,24,g) 6 to 10,13586,14623,184879,187388,545,3.6,1483,9.8,31910,7160,24750,3.8,17,36927,15589,21338,8.3,19.7,-5017,-2.7,34,0,1036,1036,11747
1988,24,h) 11 to 15,2713,3661,60141,60515,180,4.8,314,8.4,8847,2522,6325,4.2,14.6,9594,2792,6802,4.6,15.9,-747,-1.3,29.2,0,163,163,879
1988,24,l) Left Censored,24088,37937,1130470,1113003,2545,6.7,2882,7.6,176378,54588,121790,4.9,15.8,141444,42637,98807,3.8,12.7,34934,3.1,25.4,0,1127,1127,7377
1988,25,a) 0,13183,13286,88166,44510,13167,198.2,0,0,87312,87312,0,196.2,196.2,0,0,0,0,0,87312,196.2,0,0,,,
1988,25,b) 1,11412,11715,114454,116502,96,0.7,2939,22.1,26434,2798,23636,2.4,22.7,30530,17541,12989,15.1,26.2,-4096,-3.5,45.4,0,2215,2215,10764
1988,25,c) 2,9343,9603,87386,88789,314,3,1720,16.6,18478,2516,15962,2.8,20.8,21283,10062,11221,11.3,24,-2805,-3.2,41.6,0,1351,1351,8263
1988,25,d) 3,8034,8308,92114,92163,275,3.1,1211,13.8,18136,4446,13690,4.8,19.7,18234,7871,10363,8.5,19.8,-98,-0.1,39.4,0,957,957,6367
1988,25,e) 4,6694,6905,73218,79128,177,2.4,951,13,12664,2061,10603,2.6,16,24483,15510,8973,19.6,30.9,-11819,-14.9,32,0,728,728,13737
1988,25,f) 5,5088,5387,58187,58962,206,3.7,622,11.1,10127,2141,7986,3.6,17.2,11676,4092,7584,6.9,19.8,-1549,-2.6,34.4,0,495,495,3429
1988,25,g) 6 to 10,20320,21858,295451,297660,710,3.1,2112,9.4,46642,7893,38749,2.7,15.7,51060,18491,32569,6.2,17.2,-4418,-1.5,31.4,0,1422,1422,11000
1988,25,h) 11 to 15,3923,5404,115987,116720,262,4.8,455,8.3,14089,2994,11095,2.6,12.1,15554,4691,10863,4,13.3,-1465,-1.2,24.2,0,237,237,1370
1988,25,l) Left Censored,41322,57615,1885647,1879514,2703,4.6,4401,7.5,262902,65591,197311,3.5,14,250636,74752,175884,4,13.3,12266,0.7,26.6,0,2135,2135,18426
1988,26,a) 0,15228,15437,98606,49610,15276,197.9,0,0,97992,97992,0,197.5,197.5,0,0,0,0,0,97992,197.5,0,0,,,
1988,26,b) 1,13448,13858,130780,130537,124,0.8,3662,23.2,30342,5423,24919,4.2,23.2,29855,15367,14488,11.8,22.9,487,0.3,45.8,0,2853,2853,11776
1988,26,c) 2,10667,11062,96058,97512,341,2.8,2127,17.7,21770,3597,18173,3.7,22.3,24678,12980,11698,13.3,25.3,-2908,-3,44.6,0,1620,1620,9793
1988,26,d) 3,9674,10110,96223,97514,342,3.2,1583,14.8,19196,4300,14896,4.4,19.7,21778,10006,11772,10.3,22.3,-2582,-2.6,39.4,0,1248,1248,7386
1988,26,e) 4,8833,9334,94186,96043,328,3.4,1184,12.1,16869,2713,14156,2.8,17.6,20583,9398,11185,9.8,21.4,-3714,-3.8,35.2,0,946,946,5318
1988,26,f) 5,6398,6895,69649,71156,216,3,819,11.4,12016,2525,9491,3.5,16.9,15030,5253,9777,7.4,21.1,-3014,-4.2,33.8,0,607,607,3817
1988,26,g) 6 to 10,26563,28825,316201,321458,981,3.3,2951,9.9,49014,10320,38694,3.2,15.2,59528,21149,38379,6.6,18.5,-10514,-3.3,30.4,0,2065,2065,14803
1988,26,h) 11 to 15,5279,7266,105169,105195,348,4.7,703,9.5,17344,4321,13023,4.1,16.5,17397,5703,11694,5.4,16.5,-53,0,33,0,308,308,1845
1988,26,l) Left Censored,47914,72935,2202644,2216223,3590,4.8,5856,7.9,272754,77637,195117,3.5,12.3,299913,91970,207943,4.1,13.5,-27159,-1.2,24.6,0,2410,2410,15646
1988,27,a) 0,7754,7848,50055,25160,7780,198.3,0,0,49791,49791,0,197.9,197.9,0,0,0,0,0,49791,197.9,0,0,,,
1988,27,b) 1,6504,6716,72001,72331,62,0.8,1816,23.6,16172,1944,14228,2.7,22.4,16831,10360,6471,14.3,23.3,-659,-0.9,44.8,0,1400,1400,7584
1988,27,c) 2,5711,5951,49796,51825,182,2.8,1126,17.5,9838,1269,8569,2.4,19,13895,5887,8008,11.4,26.8,-4057,-7.8,38,0,899,899,4702
1988,27,d) 3,5258,5515,54647,55739,179,3.1,840,14.4,9867,1579,8288,2.8,17.7,12050,5334,6716,9.6,21.6,-2183,-3.9,35.4,0,669,669,4302
1988,27,e) 4,4789,5043,46941,49796,142,2.7,703,13.2,7785,1105,6680,2.2,15.6,13495,5490,8005,11,27.1,-5710,-11.5,31.2,0,513,513,3766
1988,27,f) 5,3340,3718,43761,43624,132,3.4,436,11.2,7718,1426,6292,3.3,17.7,7443,2697,4746,6.2,17.1,275,0.6,34.2,0,315,315,1875
1988,27,g) 6 to 10,14528,15882,174720,174461,618,3.8,1657,10.1,32742,6617,26125,3.8,18.8,32225,11954,20271,6.9,18.5,517,0.3,37,0,1137,1137,7883
1988,27,h) 11 to 15,3043,4017,67000,64497,182,4.4,359,8.7,14394,1841,12553,2.9,22.3,9387,3368,6019,5.2,14.6,5007,7.7,29.2,0,179,179,1141
1988,27,l) Left Censored,26794,38826,1152216,1141733,2058,5.2,3070,7.8,159508,38552,120956,3.4,14,138542,47514,91028,4.2,12.1,20966,1.9,24.2,0,1266,1266,11860
1988,28,a) 0,3850,3921,22704,11624,3871,197.4,0,0,22160,22160,0,190.6,190.6,0,0,0,0,0,22160,190.6,0,0,,,
1988,28,b) 1,3227,3316,32452,33457,20,0.5,1276,31.8,6271,665,5606,2,18.7,8281,5561,2720,16.6,24.8,-2010,-6.1,37.4,0,1060,1060,4113
1988,28,c) 2,2643,2713,20390,20359,106,3.5,657,21.8,5141,763,4378,3.7,25.3,5079,2737,2342,13.4,24.9,62,0.4,49.8,0,551,551,2444
1988,28,d) 3,2537,2618,21069,21584,90,3.2,435,15.5,4463,994,3469,4.6,20.7,5492,2760,2732,12.8,25.4,-1029,-4.7,41.4,0,347,347,2183
1988,28,e) 4,2546,2593,21007,20700,73,2.6,395,14.3,4668,308,4360,1.5,22.6,4054,1956,2098,9.4,19.6,614,3,39.2,0,308,308,1550
1988,28,f) 5,1688,1782,13561,13794,70,3.8,218,11.7,2602,445,2157,3.2,18.9,3068,1401,1667,10.2,22.2,-466,-3.3,37.8,0,163,163,949
1988,28,g) 6 to 10,7246,7828,84077,83880,305,3.8,880,10.8,14284,2563,11721,3.1,17,13889,4339,9550,5.2,16.6,395,0.4,33.2,0,639,639,3061
1988,28,h) 11 to 15,1501,1939,20018,20151,86,4.3,222,11.1,3260,903,2357,4.5,16.2,3525,1498,2027,7.4,17.5,-265,-1.3,32.4,0,126,127,822
1988,28,l) Left Censored,12756,19102,445971,444419,934,4.8,1562,8,55760,18713,37047,4.2,12.5,52656,17180,35476,3.9,11.8,3104,0.7,23.6,0,702,702,3927
1988,29,a) 0,9747,9826,54525,27410,9750,198.5,0,0,54231,54231,0,197.9,197.9,0,0,0,0,0,54231,197.9,0,0,,,
1988,29,b) 1,8230,8502,85950,87001,79,0.8,2911,29,21033,3885,17148,4.5,24.2,23135,14631,8504,16.8,26.6,-2102,-2.4,48.4,0,2213,2213,9679
1988,29,c) 2,6714,6998,55285,57045,235,3,1630,21.1,11985,1844,10141,3.2,21,15504,7964,7540,14,27.2,-3519,-6.2,42,0,1288,1288,6415
1988,29,d) 3,6580,6792,59467,61419,204,2.8,1153,15.8,10650,1520,9130,2.5,17.3,14554,6350,8204,10.3,23.7,-3904,-6.4,34.6,0,903,903,5140
1988,29,e) 4,5547,5794,51297,52342,192,3.1,767,12.6,8747,1471,7276,2.8,16.7,10837,4619,6218,8.8,20.7,-2090,-4,33.4,0,582,582,3574
1988,29,f) 5,3981,4276,43951,43853,167,3.7,525,11.8,8168,1861,6307,4.2,18.6,7972,2980,4992,6.8,18.2,196,0.4,36.4,0,397,397,2357
1988,29,g) 6 to 10,16495,18055,187276,189745,691,3.7,1860,10,31679,6823,24856,3.6,16.7,36616,13547,23069,7.1,19.3,-4937,-2.6,33.4,0,1293,1293,7953
1988,29,h) 11 to 15,3378,4686,68050,66352,263,5.6,339,7.2,13328,3389,9939,5.1,20.1,9932,3012,6920,4.5,15,3396,5.1,30,0,183,183,1081
1988,29,l) Left Censored,30524,45896,1255225,1269504,2641,5.7,3625,7.8,164779,49371,115408,3.9,13,193336,83021,110315,6.5,15.2,-28557,-2.2,26,0,1563,1563,9970
1988,30,a) 0,1925,1934,9536,4813,1907,197.2,0,0,9446,9446,0,196.3,196.3,0,0,0,0,0,9446,196.3,0,0,,,
1988,30,b) 1,1539,1569,9484,10653,12,0.6,638,33.3,2393,157,2236,1.5,22.5,4730,3460,1270,32.5,44.4,-2337,-21.9,45,0,440,440,1392
1988,30,c) 2,1327,1355,8305,8817,60,4,343,22.7,1642,279,1363,3.2,18.6,2666,1359,1307,15.4,30.2,-1024,-11.6,37.2,0,245,245,1060
1988,30,d) 3,1219,1252,8581,9234,54,4,260,19.1,1832,191,1641,2.1,19.8,3137,1282,1855,13.9,34,-1305,-14.2,39.6,0,186,186,995
1988,30,e) 4,1174,1219,6856,7114,52,4,219,16.7,1341,325,1016,4.6,18.9,1856,860,996,12.1,26.1,-515,-7.2,37.8,0,150,150,545
1988,30,f) 5,915,1056,7919,8178,40,3.6,151,13.6,1153,249,904,3,14.1,1671,787,884,9.6,20.4,-518,-6.3,28.2,0,110,110,589
1988,30,g) 6 to 10,3911,4161,29560,30600,162,3.7,512,11.8,4734,763,3971,2.5,15.5,6813,3369,3444,11,22.3,-2079,-6.8,31,0,360,360,2190
1988,30,h) 11 to 15,775,943,8328,8439,48,5,100,10.3,1140,212,928,2.5,13.5,1362,533,829,6.3,16.1,-222,-2.6,27,0,48,48,252
1988,30,l) Left Censored,5496,7564,108688,110375,330,4.3,646,8.4,12301,2723,9578,2.5,11.1,15675,4901,10774,4.4,14.2,-3374,-3.1,22.2,0,324,324,1766
1988,31,a) 0,2907,2967,18011,9094,2931,197.6,0,0,17835,17835,0,196.1,196.1,0,0,0,0,0,17835,196.1,0,0,,,
1988,31,b) 1,2312,2359,19921,20699,11,0.4,668,24.5,4358,309,4049,1.5,21.1,5913,4113,1800,19.9,28.6,-1555,-7.5,42.2,0,516,516,1958
1988,31,c) 2,1991,2064,17649,17761,82,3.6,413,18.4,4779,2132,2647,12,26.9,5002,2479,2523,14,28.2,-223,-1.3,53.8,0,326,326,1715
1988,31,d) 3,2148,2205,19698,19195,54,2.3,312,13.3,4216,542,3674,2.8,22,3210,1667,1543,8.7,16.7,1006,5.3,33.4,0,254,254,1306
1988,31,e) 4,1961,2031,14420,14651,65,3.1,235,11.1,2592,497,2095,3.4,17.7,3054,1324,1730,9,20.8,-462,-3.1,35.4,0,171,171,983
1988,31,f) 5,1416,1581,17637,17471,53,3.2,188,11.4,2801,544,2257,3.1,16,2469,731,1738,4.2,14.1,332,1.9,28.2,0,127,127,499
1988,31,g) 6 to 10,6176,6591,56550,56554,211,3.1,671,9.8,9009,1572,7437,2.8,15.9,9016,3548,5468,6.3,15.9,-7,0,31.8,0,494,494,2491
1988,31,h) 11 to 15,1368,1754,16690,16179,68,3.8,144,8,2988,797,2191,4.9,18.5,1965,711,1254,4.4,12.1,1023,6.4,24.2,0,91,91,363
1988,31,l) Left Censored,12009,16536,354900,350799,717,4.3,1233,7.3,47461,11222,36239,3.2,13.5,39259,14329,24930,4.1,11.2,8202,2.3,22.4,0,558,558,3106
1988,32,a) 0,2696,2724,20696,10423,2700,198.2,0,0,20546,20546,0,197.1,197.1,0,0,0,0,0,20546,197.1,0,0,,,
1988,32,b) 1,2120,2195,22904,22932,22,0.8,800,30.6,7596,185,7411,0.8,33.1,7652,4390,3262,19.1,33.4,-56,-0.3,66.2,0,604,604,3067
1988,32,c) 2,1673,1739,21432,20854,61,3.2,413,21.6,6353,294,6059,1.4,30.5,5196,2532,2664,12.1,24.9,1157,5.6,49.8,0,331,331,1933
1988,32,d) 3,1312,1384,15771,16430,59,3.9,274,18.3,3620,433,3187,2.6,22,4937,2327,2610,14.2,30,-1317,-8,44,0,204,204,1959
1988,32,e) 4,1246,1320,17059,17097,74,5.3,208,15,3659,799,2860,4.7,21.4,3734,1960,1774,11.5,21.8,-75,-0.4,42.8,0,154,154,1568
1988,32,f) 5,914,1003,12882,12969,55,5.2,144,13.7,2424,387,2037,3,18.7,2598,877,1721,6.8,20,-174,-1.3,37.4,0,108,108,775
1988,32,g) 6 to 10,4264,4593,66534,67139,220,4.6,515,10.9,11769,1751,10018,2.6,17.5,12978,4478,8500,6.7,19.3,-1209,-1.8,35,0,354,354,3064
1988,32,h) 11 to 15,696,916,19345,19413,82,9,67,7.4,3047,985,2062,5.1,15.7,3183,891,2292,4.6,16.4,-136,-0.7,31.4,0,34,34,229
1988,32,l) Left Censored,4690,7222,262198,257933,604,8.4,582,8.1,50309,16005,34304,6.2,19.5,41779,18191,23588,7.1,16.2,8530,3.3,32.4,0,223,223,1542
1988,33,a) 0,3620,3637,20486,10311,3602,198.1,0,0,20350,20350,0,197.4,197.4,0,0,0,0,0,20350,197.4,0,0,,,
1988,33,b) 1,3098,3149,22605,23013,15,0.4,971,26.5,5813,424,5389,1.8,25.3,6628,3824,2804,16.6,28.8,-815,-3.5,50.6,0,774,774,2965
1988,33,c) 2,2529,2616,22381,23342,99,3.5,565,19.8,4690,948,3742,4.1,20.1,6611,2857,3754,12.2,28.3,-1921,-8.2,40.2,0,443,443,2298
1988,33,d) 3,1999,2045,17465,18384,70,3.2,350,16,3236,505,2731,2.7,17.6,5073,2515,2558,13.7,27.6,-1837,-10,35.2,0,285,285,2004
1988,33,e) 4,1619,1690,16038,16890,47,2.6,227,12.7,2531,340,2191,2,15,4235,1333,2902,7.9,25.1,-1704,-10.1,30,0,178,178,1087
1988,33,f) 5,1108,1166,11589,11830,42,3.5,136,11.2,1955,228,1727,1.9,16.5,2437,842,1595,7.1,20.6,-482,-4.1,33,0,99,99,535
1988,33,g) 6 to 10,4231,4484,49501,50817,156,3.3,502,10.8,8126,2185,5941,4.3,16,10758,3792,6966,7.5,21.2,-2632,-5.2,32,0,346,346,2187
1988,33,h) 11 to 15,853,1158,18491,18433,61,5.2,112,9.5,2834,611,2223,3.3,15.4,2717,752,1965,4.1,14.7,117,0.7,29.4,0,56,56,391
1988,33,l) Left Censored,6780,9383,271431,266932,549,5.8,670,7.1,40061,11932,28129,4.5,15,31062,9446,21616,3.5,11.6,8999,3.4,23.2,0,324,324,2033
1988,34,a) 0,18273,18380,100947,50865,18204,198.1,0,0,100165,100165,0,196.9,196.9,0,0,0,0,0,100165,196.9,0,0,,,
1988,34,b) 1,14854,15091,132087,132575,103,0.6,4216,24.3,32931,3405,29526,2.6,24.8,33907,18119,15788,13.7,25.6,-976,-0.8,49.6,0,3243,3243,14164
1988,34,c) 2,12415,12688,97746,100680,476,3.5,2405,17.6,21259,3880,17379,3.9,21.1,27126,11811,15315,11.7,26.9,-5867,-5.8,42.2,0,1880,1880,9448
1988,34,d) 3,10597,10862,93589,95078,365,3.2,1626,14.1,19762,2948,16814,3.1,20.8,22740,9964,12776,10.5,23.9,-2978,-3.1,41.6,0,1289,1289,7424
1988,34,e) 4,8925,9179,100333,101789,301,3.1,1192,12.4,17480,2308,15172,2.3,17.2,20392,7171,13221,7,20,-2912,-2.8,34.4,0,922,922,5085
1988,34,f) 5,7150,7466,76589,76993,192,2.5,903,11.6,18859,1076,17783,1.4,24.5,19666,5314,14352,6.9,25.5,-807,-1,49,0,658,658,3759
1988,34,g) 6 to 10,28804,30212,326166,325586,980,3.1,3004,9.6,58439,8464,49975,2.6,17.9,57278,17937,39341,5.5,17.6,1161,0.3,35.2,0,2188,2188,11685
1988,34,h) 11 to 15,5647,6641,93973,93754,261,3.8,579,8.5,17003,4127,12876,4.4,18.1,16565,5809,10756,6.2,17.7,438,0.4,35.4,0,345,345,1669
1988,34,l) Left Censored,51927,71679,2133914,2135341,3665,5,5576,7.7,303700,90394,213306,4.2,14.2,306554,90287,216267,4.2,14.4,-2854,-0.2,28.4,0,2806,2806,17559
1988,35,a) 0,2847,2887,15976,8073,2854,197.7,0,0,15806,15806,0,195.8,195.8,0,0,0,0,0,15806,195.8,0,0,,,
1988,35,b) 1,2334,2407,22387,24027,16,0.6,879,30.4,4510,358,4152,1.5,18.8,7790,4954,2836,20.6,32.4,-3280,-13.6,37.6,0,700,700,3433
1988,35,c) 2,2063,2118,15887,16756,68,2.9,517,21.9,3436,303,3133,1.8,20.5,5174,2581,2593,15.4,30.9,-1738,-10.4,41,0,413,413,2122
1988,35,d) 3,1797,1895,15110,15746,92,4.5,369,18,2862,524,2338,3.3,18.2,4134,2276,1858,14.5,26.3,-1272,-8.1,36.4,0,286,286,1882
1988,35,e) 4,1676,1747,14175,15037,82,4.4,310,16.6,2678,661,2017,4.4,17.8,4402,2114,2288,14.1,29.3,-1724,-11.5,35.6,0,238,238,1770
1988,35,f) 5,1316,1498,14366,14671,64,4.1,216,13.7,2627,564,2063,3.8,17.9,3237,1349,1888,9.2,22.1,-610,-4.2,35.8,0,152,152,1011
1988,35,g) 6 to 10,5380,5779,53557,55154,252,4.2,720,12,9138,1786,7352,3.2,16.6,12331,4188,8143,7.6,22.4,-3193,-5.8,33.2,0,515,515,3066
1988,35,h) 11 to 15,996,1276,14044,13752,72,5.5,143,10.9,3631,696,2935,5.1,26.4,3047,949,2098,6.9,22.2,584,4.2,44.4,0,67,67,361
1988,35,l) Left Censored,7129,10689,220416,219781,678,6.3,919,8.5,31541,9189,22352,4.2,14.4,30271,9901,20370,4.5,13.8,1270,0.6,27.6,0,383,383,2336
1988,36,a) 0,38247,38469,212996,107167,38139,198.3,0,0,211658,211658,0,197.5,197.5,0,0,0,0,0,211658,197.5,0,0,,,
1988,36,b) 1,31878,32419,346146,344601,151,0.4,8748,23.6,69246,6009,63237,1.7,20.1,66156,39334,26822,11.4,19.2,3090,0.9,38.4,0,6889,6889,30216
1988,36,c) 2,26758,27314,203338,207060,877,3,5256,17.8,47841,6217,41624,3,23.1,55285,28174,27111,13.6,26.7,-7444,-3.6,46.2,0,4245,4245,22761
1988,36,d) 3,23546,24087,202275,206584,773,3,3919,15.3,39721,6762,32959,3.3,19.2,48339,22010,26329,10.7,23.4,-8618,-4.2,38.4,0,3130,3130,18095
1988,36,e) 4,20147,20838,190213,193415,667,3,2971,13.5,35375,5604,29771,2.9,18.3,41780,17921,23859,9.3,21.6,-6405,-3.3,36.6,0,2323,2323,12965
1988,36,f) 5,16031,16731,157328,159948,553,3.1,2287,13,28865,4458,24407,2.8,18,34104,13346,20758,8.3,21.3,-5239,-3.3,36,0,1749,1749,10129
1988,36,g) 6 to 10,61495,64885,723778,737694,1996,3,7454,11,116009,16088,99921,2.2,15.7,143841,43595,100246,5.9,19.5,-27832,-3.8,31.4,0,5500,5500,29282
1988,36,h) 11 to 15,11716,14845,245070,240757,590,3.9,1339,8.8,48157,10539,37618,4.4,20,39531,10756,28775,4.5,16.4,8626,3.6,32.8,0,806,806,4319
1988,36,l) Left Censored,118817,158972,4584226,4615525,7008,4.3,13043,8,601762,133971,467791,2.9,13,664360,193343,471017,4.2,14.4,-62598,-1.4,26,0,7114,7114,43598
1988,37,a) 0,13023,13209,83518,41978,13079,198,0,0,83081,83081,0,197.9,197.9,0,0,0,0,0,83081,197.9,0,0,,,
1988,37,b) 1,10528,10966,93928,93607,144,1.1,3303,26,26831,5245,21586,5.6,28.7,26189,13861,12328,14.8,28,642,0.7,56,0,2661,2661,10736
1988,37,c) 2,8965,9338,70269,72003,314,3.1,1939,19,14722,2195,12527,3,20.4,18190,8622,9568,12,25.3,-3468,-4.9,40.8,0,1567,1567,6474
1988,37,d) 3,8090,8444,76625,76724,302,3.4,1390,15.4,15817,2539,13278,3.3,20.6,16014,8171,7843,10.6,20.9,-197,-0.3,41.2,0,1094,1094,6531
1988,37,e) 4,8580,9048,71507,72872,279,3,990,10.5,12113,1978,10135,2.7,16.6,14843,5763,9080,7.9,20.4,-2730,-3.8,33.2,0,719,719,3680
1988,37,f) 5,5019,5272,50336,51883,160,2.9,619,11.2,7758,1321,6437,2.5,15,10852,3893,6959,7.5,20.9,-3094,-5.9,30,0,463,463,2497
1988,37,g) 6 to 10,19622,21424,252480,251200,837,3.8,2179,9.9,43432,12314,31118,4.9,17.3,40872,15479,25393,6.2,16.3,2560,1,32.6,0,1518,1518,9431
1988,37,h) 11 to 15,3818,5113,74363,72057,282,5.4,403,7.8,14492,4263,10229,5.9,20.1,9880,3243,6637,4.5,13.7,4612,6.4,27.4,0,233,233,1236
1988,37,l) Left Censored,34021,55941,1731507,1710487,3545,6.3,4305,7.6,235892,65618,170274,3.8,13.8,193852,64798,129054,3.8,11.3,42040,2.5,22.6,0,1562,1562,10322
1988,38,a) 0,1253,1264,7075,3551,1250,197.8,0,0,7048,7048,0,198.5,198.5,0,0,0,0,0,7048,198.5,0,0,,,
1988,38,b) 1,1088,1104,7712,8041,4,0.3,338,26.3,1705,23,1682,0.3,21.2,2363,1641,722,20.4,29.4,-658,-8.2,42.4,0,244,244,1082
1988,38,c) 2,893,911,5814,5924,27,2.7,169,17.2,1107,276,831,4.7,18.7,1326,602,724,10.2,22.4,-219,-3.7,37.4,0,121,121,496
1988,38,d) 3,873,909,5726,5881,32,3.3,160,16.4,953,120,833,2,16.2,1263,616,647,10.5,21.5,-310,-5.3,32.4,0,122,122,492
1988,38,e) 4,852,873,5210,5011,24,2.6,112,12.2,1150,63,1087,1.3,22.9,751,282,469,5.6,15,399,7.9,30,0,83,83,209
1988,38,f) 5,626,741,6293,6207,36,4.7,92,12,1214,257,957,4.1,19.6,1042,380,662,6.1,16.8,172,2.8,33.6,0,73,73,344
1988,38,g) 6 to 10,2897,3074,22826,23384,117,3.7,319,10,3235,692,2543,3,13.8,4350,1761,2589,7.5,18.6,-1115,-4.8,27.6,0,217,217,1100
1988,38,h) 11 to 15,597,703,5857,5891,23,3.2,57,7.9,684,73,611,1.2,11.6,751,231,520,3.9,12.7,-67,-1.1,23.2,0,32,32,111
1988,38,l) Left Censored,5264,7058,116774,116567,264,3.7,556,7.7,13448,2909,10539,2.5,11.5,13033,4908,8125,4.2,11.2,415,0.3,22.4,0,250,250,1388
1988,39,a) 0,16545,16796,109079,55407,16606,197.7,0,0,107344,107344,0,193.7,193.7,0,0,0,0,0,107344,193.7,0,0,,,
1988,39,b) 1,14241,14766,147455,146146,221,1.3,4155,24.5,38073,8817,29256,6,26.1,35454,21089,14365,14.4,24.3,2619,1.8,48.6,0,3105,3105,13832
1988,39,c) 2,11760,12359,110203,111649,471,3.5,2528,18.9,24030,4391,19639,3.9,21.5,26921,13682,13239,12.3,24.1,-2891,-2.6,43,0,1839,1839,9849
1988,39,d) 3,10452,10961,111499,115417,343,2.9,1683,14.5,20825,3097,17728,2.7,18,28661,10845,17816,9.4,24.8,-7836,-6.8,36,0,1231,1231,7577
1988,39,e) 4,9872,10404,97095,97832,359,3.3,1267,11.7,18233,2954,15279,3,18.6,19707,8943,10764,9.1,20.1,-1474,-1.5,37.2,0,944,944,6329
1988,39,f) 5,6965,7596,78635,79100,337,4.3,892,11.3,14756,3242,11514,4.1,18.7,15685,5657,10028,7.2,19.8,-929,-1.1,37.4,0,674,674,3575
1988,39,g) 6 to 10,30677,33642,387858,383299,1170,3.4,3166,9.1,72222,23557,48665,6.1,18.8,63104,21240,41864,5.5,16.5,9118,2.3,33,0,2171,2171,13157
1988,39,h) 11 to 15,6439,9070,137510,131769,441,4.8,720,7.8,31780,4335,27445,3.3,24.1,20297,5719,14578,4.3,15.4,11483,8.7,30.8,0,335,335,2264
1988,39,l) Left Censored,63208,99103,2828560,2816490,5216,5.2,7724,7.7,361485,99241,262244,3.5,12.8,337346,107151,230195,3.8,12,24139,0.8,24,0,3182,3183,19655
1988,40,a) 0,5479,5515,34035,17112,5459,198,0,0,33847,33847,0,197.8,197.8,0,0,0,0,0,33847,197.8,0,0,,,
1988,40,b) 1,4368,4538,48214,48948,38,0.7,1746,31.8,11655,885,10770,1.8,23.8,13122,8562,4560,17.5,26.8,-1467,-3,47.6,0,1455,1455,7187
1988,40,c) 2,3894,4002,29850,31436,164,3.7,1071,23.9,6378,1293,5085,4.1,20.3,9550,5474,4076,17.4,30.4,-3172,-10.1,40.6,0,882,882,4256
1988,40,d) 3,3624,3738,27064,28474,135,3.3,818,20,5279,673,4606,2.4,18.5,8099,4464,3635,15.7,28.4,-2820,-9.9,37,0,620,620,3638
1988,40,e) 4,3740,3907,35047,34342,123,2.9,730,17.3,7986,1037,6949,3,23.3,6575,3113,3462,9.1,19.1,1411,4.2,38.2,0,498,498,1984
1988,40,f) 5,2625,2832,20625,21217,126,4.2,508,16.8,4452,766,3686,3.6,21,5636,3269,2367,15.4,26.6,-1184,-5.6,42,0,369,369,2258
1988,40,g) 6 to 10,11316,12058,104512,107352,476,3.7,1724,13.6,17473,3914,13559,3.6,16.3,23153,10907,12246,10.2,21.6,-5680,-5.3,32.6,0,1158,1158,6122
1988,40,h) 11 to 15,1923,2659,31769,32331,153,5.6,291,10.6,5146,1538,3608,4.8,15.9,6270,2370,3900,7.3,19.4,-1124,-3.5,31.8,0,157,157,614
1988,40,l) Left Censored,16632,25584,544928,546174,1465,5.6,2389,9.2,74551,21323,53228,3.9,13.6,77042,25623,51419,4.7,14.1,-2491,-0.5,27.2,0,1055,1055,5871
1988,41,a) 0,6679,6722,36433,18357,6652,197.9,0,0,36152,36152,0,196.9,196.9,0,0,0,0,0,36152,196.9,0,0,,,
1988,41,b) 1,5603,5798,46377,46654,51,0.7,1899,27.9,12806,1027,11779,2.2,27.4,13360,7677,5683,16.5,28.6,-554,-1.2,54.8,0,1538,1538,6317
1988,41,c) 2,4581,4708,34926,34891,247,4.8,1058,20.6,9687,1454,8233,4.2,27.8,9617,5437,4180,15.6,27.6,70,0.2,55.2,0,831,831,4659
1988,41,d) 3,3861,3997,31708,32230,203,4.7,804,18.6,6805,1502,5303,4.7,21.1,7848,3974,3874,12.3,24.3,-1043,-3.2,42.2,0,643,643,3116
1988,41,e) 4,3486,3635,33235,33137,132,3.4,611,15.8,6928,709,6219,2.1,20.9,6732,3303,3429,10,20.3,196,0.6,40.6,0,460,460,2213
1988,41,f) 5,2531,2866,34125,34486,103,3.4,406,13.4,5266,738,4528,2.1,15.3,5988,2376,3612,6.9,17.4,-722,-2.1,30.6,0,271,271,1434
1988,41,g) 6 to 10,11685,12543,112909,113871,533,4.1,1491,11.4,19863,3624,16239,3.2,17.4,21787,9050,12737,7.9,19.1,-1924,-1.7,34.8,0,984,984,5554
1988,41,h) 11 to 15,2173,2807,40052,39417,171,6,249,8.8,6976,1349,5627,3.4,17.7,5707,2224,3483,5.6,14.5,1269,3.2,29,0,139,139,722
1988,41,l) Left Censored,16128,24202,540565,534471,1435,5.9,1939,7.9,81073,21915,59158,4.1,15.2,68884,24710,44174,4.6,12.9,12189,2.3,25.8,0,857,857,5229
1988,42,a) 0,19883,20145,124305,62567,19947,198,0,0,123477,123477,0,197.4,197.4,0,0,0,0,0,123477,197.4,0,0,,,
1988,42,b) 1,17119,17625,165365,164059,142,0.7,4484,22.4,41675,7674,34001,4.7,25.4,39062,22447,16615,13.7,23.8,2613,1.6,47.6,0,3520,3523,16746
1988,42,c) 2,14397,14877,129611,138779,542,3.4,2639,16.5,28169,4614,23555,3.3,20.3,46504,30278,16226,21.8,33.5,-18335,-13.2,40.6,0,2102,2102,27704
1988,42,d) 3,12510,13028,133192,134414,443,3.2,1857,13.5,24897,4176,20721,3.1,18.5,27341,11618,15723,8.6,20.3,-2444,-1.8,37,0,1466,1466,8613
1988,42,e) 4,11516,12268,128755,130202,370,2.9,1466,11.4,21232,2569,18663,2,16.3,24125,8931,15194,6.9,18.5,-2893,-2.2,32.6,0,1088,1088,6337
1988,42,f) 5,8183,8659,87802,88805,271,3,942,10.5,14121,2211,11910,2.5,15.9,16126,5459,10667,6.1,18.2,-2005,-2.3,31.8,0,706,706,4028
1988,42,g) 6 to 10,34393,37106,417573,421047,1260,3.3,3546,9.3,62623,10547,52076,2.5,14.9,69571,25373,44198,6,16.5,-6948,-1.6,29.8,0,2441,2441,15406
1988,42,h) 11 to 15,7235,9516,150792,148877,501,5.2,788,8.2,24317,5857,18460,3.9,16.3,20486,6094,14392,4.1,13.8,3831,2.5,27.6,0,388,388,2272
1988,42,l) Left Censored,72017,107168,3018955,3009327,5119,4.7,8254,7.6,388752,100010,288742,3.3,12.9,369497,121933,247564,4.1,12.3,19255,0.6,24.6,0,3763,3763,25238
1988,44,a) 0,2468,2483,13045,6661,2457,197.9,0,0,12769,12769,0,191.7,191.7,0,0,0,0,0,12769,191.7,0,0,,,
1988,44,b) 1,2009,2054,16410,16841,14,0.6,606,25.5,3962,617,3345,3.7,23.5,4824,3001,1823,17.8,28.6,-862,-5.1,47,0,472,472,1955
1988,44,c) 2,1577,1609,11216,11608,57,3.3,306,17.6,2556,476,2080,4.1,22,3339,1891,1448,16.3,28.8,-783,-6.8,44,0,246,246,1506
1988,44,d) 3,1380,1398,13009,12663,49,3.3,210,14.2,3162,190,2972,1.5,25,2470,1080,1390,8.5,19.5,692,5.5,39,0,163,163,926
1988,44,e) 4,1187,1212,12086,12171,31,2.4,156,12.3,1904,145,1759,1.2,15.6,2074,862,1212,7.1,17,-170,-1.4,31.2,0,115,115,566
1988,44,f) 5,855,884,8355,8450,32,3.5,93,10.1,1497,474,1023,5.6,17.7,1687,560,1127,6.6,20,-190,-2.3,35.4,0,68,68,322
1988,44,g) 6 to 10,3481,3650,42890,42393,102,2.7,371,9.8,8175,718,7457,1.7,19.3,7181,2816,4365,6.6,16.9,994,2.4,33.8,0,253,253,1545
1988,44,h) 11 to 15,783,919,14270,14472,37,4,67,7.2,1925,314,1611,2.2,13.3,2329,415,1914,2.9,16.1,-404,-2.8,26.6,0,47,47,248
1988,44,l) Left Censored,7617,9560,269844,272571,388,4,852,8.7,32226,7451,24775,2.7,11.8,37681,12921,24760,4.7,13.8,-5455,-2,23.6,0,403,403,2790
1988,45,a) 0,6522,6605,55058,27655,6549,198.3,0,0,54807,54807,0,198.2,198.2,0,0,0,0,0,54807,198.2,0,0,,,
1988,45,b) 1,5283,5484,59336,57717,49,0.8,1744,27.2,16588,3678,12910,6.4,28.7,13350,7513,5837,13,23.1,3238,5.6,46.2,0,1392,1392,5968
1988,45,c) 2,4374,4551,35043,35667,239,4.9,935,19,8473,1298,7175,3.6,23.8,9720,4452,5268,12.5,27.3,-1247,-3.5,47.6,0,773,773,3748
1988,45,d) 3,4032,4204,36250,36740,215,4.8,681,15.3,7692,1613,6079,4.4,20.9,8672,3853,4819,10.5,23.6,-980,-2.7,41.8,0,545,545,2818
1988,45,e) 4,3955,4250,38706,38905,173,3.9,512,11.6,6862,1291,5571,3.3,17.6,7259,2828,4431,7.3,18.7,-397,-1.1,35.2,0,387,387,2222
1988,45,f) 5,2436,2531,25467,26020,95,3.6,333,12.6,4702,1329,3373,5.1,18.1,5807,2131,3676,8.2,22.3,-1105,-4.2,36.2,0,251,251,1546
1988,45,g) 6 to 10,9739,10657,121866,122439,409,3.7,1156,10.5,20077,4642,15435,3.8,16.4,21223,8152,13071,6.7,17.3,-1146,-0.9,32.8,0,797,797,5757
1988,45,h) 11 to 15,1861,2408,28567,27759,117,4.8,195,8,5456,1259,4197,4.5,19.7,3840,1177,2663,4.2,13.8,1616,5.9,27.6,0,98,98,383
1988,45,l) Left Censored,16324,26437,757510,748093,1579,5.9,2212,8.3,104312,32367,71945,4.3,13.9,85479,30990,54489,4.1,11.4,18833,2.5,22.8,0,886,886,4764
1988,46,a) 0,1349,1381,7396,3800,1362,197.2,0,0,7192,7192,0,189.3,189.3,0,0,0,0,0,7192,189.3,0,0,,,
1988,46,b) 1,1154,1185,10346,10624,9,0.7,351,25.6,1804,128,1676,1.2,17,2360,1405,955,13.2,22.2,-556,-5.2,34,0,268,268,960
1988,46,c) 2,926,947,5747,5983,54,5.3,191,18.7,1316,449,867,7.5,22,1788,818,970,13.7,29.9,-472,-7.9,44,0,149,149,643
1988,46,d) 3,958,976,5898,6033,45,4.4,154,14.9,1055,201,854,3.3,17.5,1324,630,694,10.4,21.9,-269,-4.4,35,0,107,107,492
1988,46,e) 4,928,949,5585,5847,34,3.4,124,12.5,874,152,722,2.6,14.9,1398,649,749,11.1,23.9,-524,-9,29.8,0,92,92,508
1988,46,f) 5,622,732,5307,5436,24,3.1,87,11.4,896,232,664,4.3,16.5,1154,725,429,13.3,21.2,-258,-4.7,33,0,63,63,242
1988,46,g) 6 to 10,2819,2977,27132,26766,127,4.1,288,9.4,4243,720,3523,2.7,15.9,3511,1284,2227,4.8,13.1,732,2.8,26.2,0,189,189,796
1988,46,h) 11 to 15,603,746,6051,5967,44,5.8,77,10.2,911,208,703,3.5,15.3,743,289,454,4.8,12.5,168,2.8,25,0,42,42,99
1988,46,l) Left Censored,5589,7166,120695,120216,269,3.7,586,8,14308,3475,10833,2.9,11.9,13350,4992,8358,4.2,11.1,958,0.8,22.2,0,293,293,1779
1988,47,a) 0,8946,9047,55880,28117,8968,198.3,0,0,55526,55526,0,197.5,197.5,0,0,0,0,0,55526,197.5,0,0,,,
1988,47,b) 1,7328,7629,74561,75913,96,1.1,2571,28.6,18425,3444,14981,4.5,24.3,21128,13351,7777,17.6,27.8,-2703,-3.5,48.6,0,2133,2133,11151
1988,47,c) 2,6073,6295,58892,58791,216,3.1,1396,20.2,15370,3096,12274,5.3,26.1,15167,8173,6994,13.9,25.8,203,0.3,51.6,0,1134,1134,6633
1988,47,d) 3,5169,5379,54829,52935,206,3.6,962,16.7,17594,7409,10185,14,33.2,13806,7202,6604,13.6,26.1,3788,7.1,52.2,0,765,765,4738
1988,47,e) 4,5674,5872,51599,53323,196,3.2,679,11.1,8376,1378,6998,2.6,15.7,11824,5363,6461,10.1,22.2,-3448,-6.5,31.4,0,528,528,3363
1988,47,f) 5,3508,3727,36291,37417,122,3.1,462,11.8,6104,1037,5067,2.8,16.3,8355,3225,5130,8.6,22.3,-2251,-6,32.6,0,360,360,2385
1988,47,g) 6 to 10,13870,15168,179498,178722,620,4,1556,9.9,31866,7941,23925,4.4,17.8,30313,10613,19700,5.9,17,1553,0.8,34,0,1096,1096,7177
1988,47,h) 11 to 15,2938,4307,70003,61485,487,11.5,357,8.4,26317,19944,6373,32.4,42.8,9280,3242,6038,5.3,15.1,17037,27.7,30.2,0,188,188,947
1988,47,l) Left Censored,24935,39394,1161194,1155864,2472,6.2,3086,7.8,167191,53195,113996,4.6,14.5,156530,56353,100177,4.9,13.5,10661,1,27,0,1198,1198,7594
1988,48,a) 0,31018,31703,211759,107271,31391,198,0,0,208977,208977,0,194.8,194.8,0,0,0,0,0,208977,194.8,0,0,,,
1988,48,b) 1,25247,26381,262687,269661,378,1.2,9920,31.4,69469,11846,57623,4.4,25.8,83416,51375,32041,19.1,30.9,-13947,-5.1,51.6,0,8300,8300,43208
1988,48,c) 2,22141,23208,191410,200222,950,3.6,6394,24.5,48925,8599,40326,4.3,24.4,66548,36204,30344,18.1,33.2,-17623,-8.8,48.8,0,5389,5389,30497
1988,48,d) 3,19591,20734,178412,187019,934,4.1,4672,20.6,40057,7768,32289,4.2,21.4,57271,27988,29283,15,30.6,-17214,-9.2,42.8,0,3886,3886,23457
1988,48,e) 4,18606,19781,171493,180253,697,3.3,3662,17.2,33102,5649,27453,3.1,18.4,50622,24440,26182,13.6,28.1,-17520,-9.7,36.8,0,2872,2872,18184
1988,48,f) 5,14287,15478,146112,150669,633,3.8,2603,15.8,27848,5280,22568,3.5,18.5,36961,16758,20203,11.1,24.5,-9113,-6,37,0,1988,1988,11150
1988,48,g) 6 to 10,57362,63070,650690,666830,2546,3.8,8761,13.2,115437,21977,93460,3.3,17.3,147716,60829,86887,9.1,22.2,-32279,-4.9,34.6,0,6106,6106,39195
1988,48,h) 11 to 15,9258,13293,177781,181326,822,6,1613,11.8,32918,9616,23302,5.3,18.2,40008,14448,25560,8,22.1,-7090,-3.9,36.4,0,793,793,5051
1988,48,l) Left Censored,69390,127806,3414890,3422355,8940,6.9,12477,9.6,526602,176899,349703,5.2,15.4,541533,193156,348377,5.6,15.8,-14931,-0.4,30.8,0,4626,4626,28207
1988,49,a) 0,3037,3096,23072,11615,3069,198.3,0,0,22914,22914,0,197.3,197.3,0,0,0,0,0,22914,197.3,0,0,,,
1988,49,b) 1,2346,2413,19767,20836,17,0.6,971,33.1,5449,508,4941,2.4,26.2,7586,5506,2080,26.4,36.4,-2137,-10.2,52.4,0,795,795,4234
1988,49,c) 2,1899,1960,20418,21105,84,3.8,525,23.9,4235,570,3665,2.7,20.1,5610,3047,2563,14.4,26.6,-1375,-6.5,40.2,0,419,419,2246
1988,49,d) 3,1744,1825,16873,17205,71,3.6,371,18.7,3590,604,2986,3.5,20.9,4253,2153,2100,12.5,24.7,-663,-3.8,41.8,0,301,301,1907
1988,49,e) 4,1468,1533,14576,15606,53,3.2,302,18.2,3134,560,2574,3.6,20.1,5194,2730,2464,17.5,33.3,-2060,-13.2,40.2,0,243,243,1987
1988,49,f) 5,1141,1318,15986,16537,57,4.1,213,15.3,2300,344,1956,2.1,13.9,3402,1315,2087,8,20.6,-1102,-6.7,27.8,0,164,164,1013
1988,49,g) 6 to 10,5279,5798,66508,67559,253,4.2,692,11.5,12485,2747,9738,4.1,18.5,14586,6521,8065,9.7,21.6,-2101,-3.1,37,0,456,456,3643
1988,49,h) 11 to 15,989,1254,17860,17635,98,7.7,133,10.4,3699,1258,2441,7.1,21,3249,1336,1913,7.6,18.4,450,2.6,36.8,0,67,67,353
1988,49,l) Left Censored,7614,11663,304544,304407,815,6.9,1039,8.8,42821,13002,29819,4.3,14.1,42547,14138,28409,4.6,14,274,0.1,28,0,391,391,3352
1988,50,a) 0,1895,1898,8919,4496,1875,197.6,0,0,8846,8846,0,196.8,196.8,0,0,0,0,0,8846,196.8,0,0,,,
1988,50,b) 1,1547,1570,10273,10877,12,0.7,425,23.6,2251,178,2073,1.6,20.7,3458,2358,1100,21.7,31.8,-1207,-11.1,41.4,0,332,332,1573
1988,50,c) 2,1357,1376,9148,9336,42,2.8,242,16.4,1841,170,1671,1.8,19.7,2216,1047,1169,11.2,23.7,-375,-4,39.4,0,199,199,804
1988,50,d) 3,1087,1114,8443,8310,36,3,185,15.5,1835,105,1730,1.3,22.1,1568,744,824,9,18.9,267,3.2,37.8,0,147,147,621
1988,50,e) 4,1001,1041,7951,7921,31,2.8,129,11.8,1476,287,1189,3.6,18.6,1416,604,812,7.6,17.9,60,0.7,35.8,0,100,100,454
1988,50,f) 5,668,697,4408,4606,28,3.9,87,12,665,161,504,3.5,14.4,1060,432,628,9.4,23,-395,-8.6,28.8,0,66,66,357
1988,50,g) 6 to 10,2582,2709,25379,25527,86,3.1,272,9.7,3798,471,3327,1.8,14.9,4094,1659,2435,6.5,16,-296,-1.1,29.8,0,203,203,989
1988,50,h) 11 to 15,515,648,7950,8190,19,2.8,57,8.5,957,82,875,1,11.7,1436,411,1025,5,17.5,-479,-5.8,23.4,0,28,28,301
1988,50,l) Left Censored,4137,5434,123426,124912,241,4.4,420,7.6,13962,4057,9905,3.2,11.2,16934,5502,11432,4.4,13.6,-2972,-2.4,22.4,0,206,206,1831
1988,51,a) 0,12369,12496,76701,38564,12389,198.3,0,0,76275,76275,0,197.8,197.8,0,0,0,0,0,76275,197.8,0,0,,,
1988,51,b) 1,9988,10285,86305,85372,104,0.9,3022,25.5,25898,3183,22715,3.7,30.3,24032,14424,9608,16.9,28.1,1866,2.2,56.2,0,2386,2386,10865
1988,51,c) 2,8565,8909,74169,74129,352,3.7,1737,18,18545,3197,15348,4.3,25,18464,9480,8984,12.8,24.9,81,0.1,49.8,0,1381,1381,7695
1988,51,d) 3,7430,7843,75182,74366,271,3.3,1238,14.8,17027,1795,15232,2.4,22.9,15394,6564,8830,8.8,20.7,1633,2.2,41.4,0,982,982,5252
1988,51,e) 4,6538,6764,60040,60961,206,2.9,903,12.7,11227,1697,9530,2.8,18.4,13069,5490,7579,9,21.4,-1842,-3,36.8,0,689,689,4335
1988,51,f) 5,4256,4538,46218,45487,160,3.3,636,13.3,10581,3951,6630,8.7,23.3,9118,4090,5028,9,20,1463,3.3,40,0,463,463,2480
1988,51,g) 6 to 10,17674,19283,242017,241423,856,4.3,1869,9.4,42636,11776,30860,4.9,17.7,41448,13226,28222,5.5,17.2,1188,0.5,34.4,0,1255,1255,7478
1988,51,h) 11 to 15,3322,4746,77365,76949,309,6.5,393,8.2,14233,5011,9222,6.5,18.5,13401,4526,8875,5.9,17.4,832,1.1,34.8,0,173,173,1224
1988,51,l) Left Censored,29290,49772,1420593,1407789,3233,6.5,3728,7.4,202318,62684,139634,4.5,14.4,176711,61397,115314,4.4,12.6,25607,1.8,25.2,0,1402,1402,8252
1988,53,a) 0,10730,10872,60096,30329,10756,197.9,0,0,59534,59534,0,196.3,196.3,0,0,0,0,0,59534,196.3,0,0,,,
1988,53,b) 1,8694,8975,75299,75568,70,0.7,2901,27.4,19661,1659,18002,2.2,26,20199,11467,8732,15.2,26.7,-538,-0.7,52,0,2234,2234,8891
1988,53,c) 2,7381,7689,57200,58880,333,4,1671,19.9,13971,2266,11705,3.8,23.7,17330,8376,8954,14.2,29.4,-3359,-5.7,47.4,0,1298,1298,6909
1988,53,d) 3,6262,6534,54556,54711,298,4.3,1172,16.8,12241,2234,10007,4.1,22.4,12551,5875,6676,10.7,22.9,-310,-0.5,44.8,0,907,907,4339
1988,53,e) 4,5942,6247,54147,55040,251,3.8,979,14.8,11279,1643,9636,3,20.5,13065,5620,7445,10.2,23.7,-1786,-3.2,41,0,686,686,4294
1988,53,f) 5,4365,4799,54005,54139,211,4.2,593,11.8,9989,1931,8058,3.6,18.5,10257,3913,6344,7.2,18.9,-268,-0.4,37,0,441,441,2503
1988,53,g) 6 to 10,18049,19441,190988,192218,796,4,2116,10.5,33243,5197,28046,2.7,17.3,35702,13153,22549,6.8,18.6,-2459,-1.3,34.6,0,1441,1441,8947
1988,53,h) 11 to 15,3378,4313,57294,56832,263,6,424,9.7,9991,2337,7654,4.1,17.6,9066,3068,5998,5.4,16,925,1.6,32,0,191,191,1004
1988,53,l) Left Censored,23976,37111,896712,883271,2516,6.7,3234,8.6,152515,36324,116191,4.1,17.3,125633,46232,79401,5.2,14.2,26882,3.1,28.4,0,1302,1304,9448
1988,54,a) 0,2750,2775,16173,8129,2741,197.5,0,0,16088,16088,0,197.9,197.9,0,0,0,0,0,16088,197.9,0,0,,,
1988,54,b) 1,2270,2327,19828,20233,14,0.5,749,27.4,4484,82,4402,0.4,22.2,5294,3398,1896,16.8,26.2,-810,-4,44.4,0,624,624,3065
1988,54,c) 2,1894,1976,16117,15726,76,3.5,404,18.8,4296,648,3648,4.1,27.3,3513,1854,1659,11.8,22.3,783,5,44.6,0,332,332,1587
1988,54,d) 3,1738,1852,25626,25500,86,4.4,269,13.9,3410,606,2804,2.4,13.4,3158,1247,1911,4.9,12.4,252,1,24.8,0,217,217,1040
1988,54,e) 4,1716,1744,11566,11926,49,2.7,215,11.8,1707,344,1363,2.9,14.3,2427,990,1437,8.3,20.4,-720,-6.1,28.6,0,174,174,867
1988,54,f) 5,1064,1123,8393,8619,40,3.4,153,13,1462,353,1109,4.1,17,1913,586,1327,6.8,22.2,-451,-5.2,34,0,112,112,418
1988,54,g) 6 to 10,4768,5146,46587,47584,178,3.3,530,10,6693,1477,5216,3.1,14.1,8687,3004,5683,6.3,18.3,-1994,-4.2,28.2,0,357,357,2132
1988,54,h) 11 to 15,1043,1337,16323,16482,62,4.5,138,10.1,2528,619,1909,3.8,15.3,2845,833,2012,5.1,17.3,-317,-2,30.6,0,69,69,223
1988,54,l) Left Censored,10273,14687,291864,293749,675,4.5,1161,7.8,36611,10377,26234,3.5,12.5,40380,13735,26645,4.7,13.7,-3769,-1.2,25,0,511,511,3275
1988,55,a) 0,8205,8328,49756,25005,8251,198.2,0,0,49503,49503,0,198,198,0,0,0,0,0,49503,198,0,0,,,
1988,55,b) 1,7402,7793,76694,76745,73,0.8,1969,22.3,16104,1729,14375,2.3,21,16206,9870,6336,12.9,21.1,-102,-0.1,42,0,1459,1459,6704
1988,55,c) 2,6027,6162,55207,55242,170,2.6,1048,15.8,11763,1384,10379,2.5,21.3,11832,5732,6100,10.4,21.4,-69,-0.1,42.6,0,819,819,4409
1988,55,d) 3,5542,5840,48432,49714,155,2.5,779,12.6,9149,1677,7472,3.4,18.4,11712,5970,5742,12,23.6,-2563,-5.2,36.8,0,618,618,5050
1988,55,e) 4,5232,5510,49804,50753,122,2.1,620,10.8,8077,971,7106,1.9,15.9,9975,3897,6078,7.7,19.7,-1898,-3.8,31.8,0,489,489,2961
1988,55,f) 5,3486,3808,40113,40433,93,2.3,427,10.7,6000,485,5515,1.2,14.8,6640,2708,3932,6.7,16.4,-640,-1.6,29.6,0,332,332,2003
1988,55,g) 6 to 10,15958,16955,176129,174500,518,3,1611,9.2,27758,5456,22302,3.1,15.9,24499,8439,16060,4.8,14,3259,1.9,28,0,1174,1174,5927
1988,55,h) 11 to 15,3344,4546,56660,55690,258,5.6,359,7.8,8966,1830,7136,3.3,16.1,7026,2026,5000,3.6,12.6,1940,3.5,25.2,0,209,209,916
1988,55,l) Left Censored,32442,45348,1243666,1227636,1958,4.3,3132,6.8,157491,41106,116385,3.3,12.8,125431,37211,88220,3,10.2,32060,2.6,20.4,0,1565,1565,10182
1988,56,a) 0,1000,1006,4918,2475,997,198.2,0,0,4887,,,,197.5,0,0,0,0,0,4887,197.5,0,1,,,
1988,56,b) 1,819,839,6099,6486,8,0.8,333,32.7,1096,,,,16.9,1869,1212,657,18.7,28.8,-773,-11.9,33.8,1,266,266,995
1988,56,c) 2,762,774,4234,4370,36,4.3,158,18.8,907,174,733,4,20.8,1178,558,620,12.8,27,-271,-6.2,41.6,0,115,115,407
1988,56,d) 3,745,759,4990,5112,34,4.1,158,19.2,1072,87,985,1.7,21,1315,652,663,12.8,25.7,-243,-4.7,42,0,127,127,529
1988,56,e) 4,685,707,4889,5014,23,3.1,108,14.5,776,73,703,1.5,15.5,1025,551,474,11,20.4,-249,-4.9,31,0,83,83,424
1988,56,f) 5,528,618,4884,4989,26,4,83,12.8,892,336,556,6.7,17.9,1102,618,484,12.4,22.1,-210,-4.2,35.8,0,60,60,325
1988,56,g) 6 to 10,2564,2727,18669,19328,107,3.8,343,12,3030,380,2650,2,15.7,4348,1647,2701,8.5,22.5,-1318,-6.8,31.4,0,230,230,1106
1988,56,h) 11 to 15,429,529,5581,5754,21,3.8,63,11.5,898,105,793,1.8,15.6,1244,357,887,6.2,21.6,-346,-6,31.2,0,29,29,106
1988,56,l) Left Censored,3231,4429,65172,66061,239,5.3,402,8.9,8535,2672,5863,4,12.9,10313,3697,6616,5.6,15.6,-1778,-2.7,25.8,0,150,150,860
1989,01,a) 0,6752,6854,41020,20612,6797,198.3,0,0,40817,40817,0,198,198,0,0,0,0,0,40817,198,0,0,,,
1989,01,b) 1,5201,5297,45040,44746,43,0.7,1579,25.9,12850,1170,11680,2.6,28.7,12261,7841,4420,17.5,27.4,589,1.3,54.8,0,1276,1276,6574
1989,01,c) 2,4919,5143,54186,56125,200,3.6,1092,19.5,9689,1972,7717,3.5,17.3,13566,8434,5132,15,24.2,-3877,-6.9,34.6,0,847,849,6330
1989,01,d) 3,4137,4334,41634,42109,205,4.5,733,16,8091,1987,6104,4.7,19.2,9040,3754,5286,8.9,21.5,-949,-2.3,38.4,0,563,563,3010
1989,01,e) 4,3561,3754,35942,35917,210,5.3,591,15,7265,1662,5603,4.6,20.2,7215,3821,3394,10.6,20.1,50,0.1,40.2,0,453,454,3000
1989,01,f) 5,3887,4078,38520,38353,176,4.2,428,10.2,6065,1556,4509,4.1,15.8,5731,2065,3666,5.4,14.9,334,0.9,29.8,0,332,332,1457
1989,01,g) 6 to 10,10531,11527,156740,154481,504,4.2,1195,10.1,26150,6259,19891,4.1,16.9,21632,7383,14249,4.8,14,4518,2.9,28,0,882,893,5020
1989,01,h) 11 to 15,4251,5532,70264,70217,253,4.5,454,8.1,11066,2050,9016,2.9,15.8,10971,3151,7820,4.5,15.6,95,0.2,31.2,0,277,277,1538
1989,01,l) Left Censored,18059,29497,806860,797254,1603,5.4,2078,7,112183,34214,77969,4.3,14.1,92971,24478,68493,3.1,11.7,19212,2.4,23.4,0,1032,1043,8009
1989,02,a) 0,977,984,9766,4927,977,198.6,0,0,9678,9678,0,196.4,196.4,0,0,0,0,0,9678,196.4,0,0,,,
1989,02,b) 1,728,755,6540,6953,11,1.1,466,47,1808,212,1596,3,26,2633,1893,740,27.2,37.9,-825,-11.9,52,0,207,207,805
1989,02,c) 2,678,708,11071,9897,37,4.3,314,36.9,4824,529,4295,5.3,48.7,2475,1787,688,18.1,25,2349,23.7,50,0,126,126,862
1989,02,d) 3,674,709,5720,6287,33,4,274,33.1,1164,143,1021,2.3,18.5,2298,1299,999,20.7,36.6,-1134,-18.1,37,0,114,114,492
1989,02,e) 4,626,674,5935,6210,37,4.8,233,30.2,1138,126,1012,2,18.3,1688,1111,577,17.9,27.2,-550,-8.9,36.6,0,88,88,270
1989,02,f) 5,576,613,4695,4887,38,5.5,178,26,1097,271,826,5.5,22.4,1481,918,563,18.8,30.3,-384,-7.9,44.8,0,68,68,333
1989,02,g) 6 to 10,1737,1989,16187,17958,71,3.2,515,23.4,2900,655,2245,3.6,16.1,6441,3706,2735,20.6,35.9,-3541,-19.8,32.2,0,156,156,819
1989,02,h) 11 to 15,595,783,8546,8968,50,6,160,19.1,1397,369,1028,4.1,15.6,2241,1392,849,15.5,25,-844,-9.4,31.2,0,36,36,154
1989,02,l) Left Censored,1930,3164,68759,68457,241,7.3,483,14.7,12003,4361,7642,6.4,17.5,11399,5638,5761,8.2,16.7,604,0.8,33.4,0,90,93,483
1989,04,a) 0,7923,8059,52681,26444,8019,199,0,0,52474,52474,0,198.4,198.4,0,0,0,0,0,52474,198.4,0,0,,,
1989,04,b) 1,6055,6205,52915,53399,64,0.9,2085,28.7,17278,1018,16260,1.9,32.4,18245,10613,7632,19.9,34.2,-967,-1.8,64.8,0,1620,1620,8998
1989,04,c) 2,5512,5790,59866,63226,257,4,1516,23.6,13042,2478,10564,3.9,20.6,19763,12441,7322,19.7,31.3,-6721,-10.7,41.2,0,1197,1201,10644
1989,04,d) 3,4747,4980,43680,46276,208,3.8,1078,19.9,8998,1399,7599,3,19.4,14190,7615,6575,16.5,30.7,-5192,-11.3,38.8,0,845,846,5992
1989,04,e) 4,4150,4361,50844,51674,176,3.8,804,17.2,10952,3448,7504,6.7,21.2,12612,6184,6428,12,24.4,-1660,-3.2,42.4,0,591,591,4772
1989,04,f) 5,3629,3967,37627,38732,179,4.3,627,15,7648,1532,6116,4,19.7,9858,5032,4826,13,25.5,-2210,-5.8,39.4,0,441,445,3623
1989,04,g) 6 to 10,11978,13614,172689,175996,626,4.4,1783,12.6,29319,6616,22703,3.8,16.7,35933,15545,20388,8.8,20.4,-6614,-3.7,33.4,0,1215,1220,9941
1989,04,h) 11 to 15,3437,4366,65198,65991,247,5.5,508,11.3,10057,2294,7763,3.5,15.2,11643,4506,7137,6.8,17.6,-1586,-2.4,30.4,0,292,304,2424
1989,04,l) Left Censored,11932,22514,670373,665698,1720,7.6,1898,8.4,106870,37653,69217,5.7,16.1,97519,27554,69965,4.1,14.6,9351,1.5,29.2,0,627,637,5807
1989,05,a) 0,3956,3983,25216,12679,3958,198.7,0,0,25075,25075,0,197.8,197.8,0,0,0,0,0,25075,197.8,0,0,,,
1989,05,b) 1,3127,3200,24552,25128,28,0.8,935,25.4,6923,419,6504,1.7,27.6,8074,4973,3101,19.8,32.1,-1151,-4.5,55.2,0,728,732,4283
1989,05,c) 2,2902,3013,28117,30505,119,3.6,660,20.1,4499,772,3727,2.5,14.7,9274,6509,2765,21.3,30.4,-4775,-15.7,29.4,0,515,515,5927
1989,05,d) 3,2437,2518,19369,20200,103,3.8,443,16.5,3246,635,2611,3.1,16.1,4908,2236,2672,11.1,24.3,-1662,-8.2,32.2,0,351,351,1784
1989,05,e) 4,2293,2385,22800,23578,79,3.1,372,14.7,3634,643,2991,2.7,15.4,5190,2380,2810,10.1,22,-1556,-6.6,30.8,0,290,291,2071
1989,05,f) 5,2434,2517,19807,18987,90,3.4,333,12.7,5308,2805,2503,14.8,28,3667,1939,1728,10.2,19.3,1641,8.7,38.6,0,244,244,1490
1989,05,g) 6 to 10,7494,8130,83661,84128,235,2.8,864,10.3,13380,2731,10649,3.2,15.9,14314,6002,8312,7.1,17,-934,-1.1,31.8,0,629,661,3815
1989,05,h) 11 to 15,2865,3460,41460,40482,148,4.2,305,8.6,7736,1939,5797,4.8,19.1,5779,1899,3880,4.7,14.3,1957,4.8,28.6,0,183,186,1059
1989,05,l) Left Censored,11693,17245,453975,447467,976,5.6,1139,6.6,58720,18450,40270,4.1,13.1,45703,13443,32260,3,10.2,13017,2.9,20.4,0,626,646,4989
1989,06,a) 0,61809,62564,412604,207124,62141,198.6,0,0,410961,410961,0,198.4,198.4,0,0,0,0,0,410961,198.4,0,0,,,
1989,06,b) 1,48707,49918,436963,432217,383,0.7,13569,23.8,150486,9244,141242,2.1,34.8,140995,74865,66130,17.3,32.6,9491,2.2,65.2,0,9773,9777,58062
1989,06,c) 2,44062,45803,522624,544194,1853,3.7,10284,20.5,104491,12350,92141,2.3,19.2,147631,87019,60612,16,27.1,-43140,-7.9,38.4,0,7515,7534,70641
1989,06,d) 3,37447,39385,404477,404474,1666,4,7140,17,97884,14018,83866,3.5,24.2,97877,47640,50237,11.8,24.2,7,0,48.4,0,5195,5203,35746
1989,06,e) 4,32642,34445,371601,375828,1352,3.7,5676,15.5,78912,11030,67882,2.9,21,87366,39474,47892,10.5,23.2,-8454,-2.2,42,0,3932,3952,28005
1989,06,f) 5,28389,30247,345036,349216,1207,3.7,5140,16,72774,12133,60641,3.5,20.8,81134,36582,44552,10.5,23.2,-8360,-2.4,41.6,0,3209,3217,23048
1989,06,g) 6 to 10,100135,110551,1457357,1488596,4497,3.8,19863,16.8,262745,41877,220868,2.8,17.7,325223,161786,163437,10.9,21.8,-62478,-4.1,35.4,0,9256,9282,70319
1989,06,h) 11 to 15,33267,42126,670866,674881,2151,4.9,6157,14,124432,33209,91223,4.9,18.4,132462,54187,78275,8,19.6,-8030,-1.2,36.8,0,2450,2478,22184
1989,06,l) Left Censored,110878,195141,6050063,6038847,12471,6.2,22265,11.1,912625,280202,632423,4.6,15.1,890194,305375,584819,5.1,14.7,22431,0.4,29.4,0,7604,7822,63483
1989,08,a) 0,8136,8215,47481,23862,8149,198.4,0,0,47238,47238,0,198,198,0,0,0,0,0,47238,198,0,0,,,
1989,08,b) 1,6333,6443,47383,48434,47,0.6,2068,27.6,14900,1973,12927,4.1,30.8,17002,10862,6140,22.4,35.1,-2102,-4.3,61.6,0,1580,1580,8975
1989,08,c) 2,5578,5811,54429,56500,225,3.5,1444,22.4,10962,1732,9230,3.1,19.4,15104,8631,6473,15.3,26.7,-4142,-7.3,38.8,0,1128,1129,7006
1989,08,d) 3,4783,4970,40296,42196,170,3.1,1103,20.3,7657,851,6806,2,18.1,11456,6308,5148,14.9,27.1,-3799,-9,36.2,0,875,881,5492
1989,08,e) 4,4541,4711,40748,42065,198,3.9,845,16.8,7698,1267,6431,3,18.3,10332,5111,5221,12.2,24.6,-2634,-6.3,36.6,0,649,649,3940
1989,08,f) 5,4047,4255,37407,38314,142,3.1,688,15.2,7512,2428,5084,6.3,19.6,9325,4572,4753,11.9,24.3,-1813,-4.7,39.2,0,511,513,3762
1989,08,g) 6 to 10,13955,15520,178178,179536,653,4,2012,12.4,28113,5543,22570,3.1,15.7,30829,13613,17216,7.6,17.2,-2716,-1.5,31.4,0,1345,1348,8325
1989,08,h) 11 to 15,4560,5627,64263,63419,253,4.4,551,9.5,12066,1755,10311,2.8,19,10378,4261,6117,6.7,16.4,1688,2.6,32.8,0,341,341,2217
1989,08,l) Left Censored,16078,26177,690851,688013,1475,5.5,2347,8.8,99805,32172,67633,4.7,14.5,94130,34140,59990,5,13.7,5675,0.8,27.4,0,940,960,8948
1989,09,a) 0,7475,7540,40549,20362,7484,198.5,0,0,40375,40375,0,198.3,198.3,0,0,0,0,0,40375,198.3,0,0,,,
1989,09,b) 1,6359,6475,52926,51550,35,0.5,1660,22.7,16264,1300,14964,2.5,31.5,13512,7698,5814,14.9,26.2,2752,5.3,52.4,0,1282,1282,6323
1989,09,c) 2,5623,5786,50525,52749,180,2.9,1207,19.1,9207,1481,7726,2.8,17.5,13655,6627,7028,12.6,25.9,-4448,-8.4,35,0,939,939,5217
1989,09,d) 3,4656,4823,43062,45015,166,3.2,794,15.5,6831,1107,5724,2.5,15.2,10737,4293,6444,9.5,23.9,-3906,-8.7,30.4,0,608,608,3165
1989,09,e) 4,4111,4281,39929,40802,142,3.2,539,12,6886,903,5983,2.2,16.9,8631,2559,6072,6.3,21.2,-1745,-4.3,33.8,0,404,404,1971
1989,09,f) 5,3560,3692,36547,37174,104,2.7,453,11.7,5701,943,4758,2.5,15.3,6955,2809,4146,7.6,18.7,-1254,-3.4,30.6,0,337,337,2214
1989,09,g) 6 to 10,12089,12888,137708,139468,375,2.8,1315,9.9,20285,3581,16704,2.6,14.5,23805,8506,15299,6.1,17.1,-3520,-2.6,29,0,940,942,5864
1989,09,h) 11 to 15,4326,5084,68042,69430,180,3.4,448,8.6,7984,1297,6687,1.9,11.5,10760,3501,7259,5,15.5,-2776,-4,23,0,287,288,2112
1989,09,l) Left Censored,22618,31481,1042290,1043241,1409,4.4,2540,7.9,133578,38621,94957,3.7,12.8,135480,43071,92409,4.1,13,-1902,-0.2,25.6,0,1306,1347,12179
1989,10,a) 0,1539,1552,8642,4334,1544,199,0,0,8617,8617,0,198.8,198.8,0,0,0,0,0,8617,198.8,0,0,,,
1989,10,b) 1,1124,1131,8924,8900,5,0.4,258,20.4,2416,31,2385,0.3,27.1,2368,1105,1263,12.4,26.6,48,0.5,53.2,0,183,183,893
1989,10,c) 2,1031,1058,10881,10931,68,6.1,196,17.5,2236,559,1677,5.1,20.5,2336,1363,973,12.5,21.4,-100,-0.9,41,0,138,140,1054
1989,10,d) 3,844,883,7453,7402,56,6.1,140,15.2,1733,617,1116,8.3,23.4,1630,627,1003,8.5,22,103,1.4,44,0,94,94,431
1989,10,e) 4,750,796,7427,7260,61,7.5,104,12.8,1692,275,1417,3.8,23.3,1358,510,848,7,18.7,334,4.6,37.4,0,78,78,397
1989,10,f) 5,670,692,7185,7410,26,3.6,88,12.2,1090,297,793,4,14.7,1540,587,953,7.9,20.8,-450,-6.1,29.4,0,69,69,449
1989,10,g) 6 to 10,2131,2273,27314,27943,79,3.4,213,9.1,4294,727,3567,2.6,15.4,5551,1370,4181,4.9,19.9,-1257,-4.5,30.8,0,141,141,814
1989,10,h) 11 to 15,798,973,15791,15619,49,5,71,7.2,2342,575,1767,3.7,15,1998,554,1444,3.5,12.8,344,2.2,25.6,0,37,37,184
1989,10,l) Left Censored,4088,5874,210216,204936,388,6.6,393,6.7,33575,13837,19738,6.8,16.4,23014,4841,18173,2.4,11.2,10561,5.2,22.4,0,197,199,2102
1989,11,a) 0,1148,1172,8789,4404,1165,198.8,0,0,8771,8771,0,199.2,199.2,0,0,0,0,0,8771,199.2,0,0,,,
1989,11,b) 1,1015,1036,13258,13364,9,0.8,265,22.7,2706,108,2598,0.8,20.2,2918,1789,1129,13.4,21.8,-212,-1.6,40.4,0,185,185,1233
1989,11,c) 2,909,932,9167,9676,38,3.8,194,19.2,2151,278,1873,2.9,22.2,3168,1873,1295,19.4,32.7,-1017,-10.5,44.4,0,136,136,1693
1989,11,d) 3,861,883,8900,9180,35,3.8,135,14.5,1546,151,1395,1.6,16.8,2105,814,1291,8.9,22.9,-559,-6.1,33.6,0,100,100,653
1989,11,e) 4,837,858,12810,12244,24,2.7,102,11.4,3345,1226,2119,10,27.3,2213,1044,1169,8.5,18.1,1132,9.2,36.2,0,71,71,573
1989,11,f) 5,761,808,10917,11067,44,5.3,103,12.3,2161,621,1540,5.6,19.5,2461,754,1707,6.8,22.2,-300,-2.7,39,0,75,76,651
1989,11,g) 6 to 10,2734,2886,38942,39821,137,4.6,367,12.2,6037,1735,4302,4.4,15.2,7796,3493,4303,8.8,19.6,-1759,-4.4,30.4,0,251,251,1882
1989,11,h) 11 to 15,1020,1227,45118,43425,68,5.5,98,7.9,6907,612,6295,1.4,15.9,3520,849,2671,2,8.1,3387,7.8,16.2,0,42,42,202
1989,11,l) Left Censored,5473,7897,264447,264402,540,6.8,576,7.3,35364,8111,27253,3.1,13.4,35273,10768,24505,4.1,13.3,91,0.1,26.6,0,235,236,3019
1989,12,a) 0,34277,34602,199387,99997,34388,198.8,0,0,198781,198781,0,198.8,198.8,0,0,0,0,0,198781,198.8,0,0,,,
1989,12,b) 1,27447,28222,213954,213393,244,0.8,8181,25.3,68771,5222,63549,2.4,32.2,67648,38442,29206,18,31.7,1123,0.5,63.4,0,6395,6397,31435
1989,12,c) 2,23059,23983,237041,243678,878,3.3,5864,22.1,49347,6474,42873,2.7,20.3,62620,35226,27394,14.5,25.7,-13273,-5.4,40.6,0,4706,4720,29046
1989,12,d) 3,19074,19938,172797,178062,886,4.1,3981,18.5,38030,6714,31316,3.8,21.4,48559,25648,22911,14.4,27.3,-10529,-5.9,42.8,0,3208,3211,20571
1989,12,e) 4,16451,17264,165020,168633,639,3.5,2934,16,32070,4759,27311,2.8,19,39295,19279,20016,11.4,23.3,-7225,-4.3,38,0,2243,2258,15238
1989,12,f) 5,14429,15161,150210,152640,530,3.3,2211,13.8,27202,3593,23609,2.4,17.8,32062,13835,18227,9.1,21,-4860,-3.2,35.6,0,1717,1732,10723
1989,12,g) 6 to 10,47505,51315,581882,589306,1732,3.2,6031,11.3,96524,16061,80463,2.7,16.4,111372,44342,67030,7.5,18.9,-14848,-2.5,32.8,0,4409,4476,31259
1989,12,h) 11 to 15,14605,18628,255234,256370,936,4.9,1835,9.6,43974,11625,32349,4.5,17.2,46245,15763,30482,6.1,18,-2271,-0.8,34.4,0,1106,1117,8299
1989,12,l) Left Censored,49281,92797,2468351,2440881,5804,6.2,7386,7.9,384191,129842,254349,5.3,15.7,329251,100165,229086,4.1,13.5,54940,2.2,27,0,2996,3036,27124
1989,13,a) 0,12854,13051,82798,41550,12971,198.8,0,0,82496,82496,0,198.5,198.5,0,0,0,0,0,82496,198.5,0,0,,,
1989,13,b) 1,10103,10379,86836,87995,126,1.1,3141,26.3,25578,2593,22985,2.9,29.1,27895,16678,11217,19,31.7,-2317,-2.6,58.2,0,2496,2498,13809
1989,13,c) 2,8817,9239,108942,113570,337,3.3,2226,21.8,26141,2815,23326,2.5,23,35397,25125,10272,22.1,31.2,-9256,-8.2,46,0,1756,1757,20320
1989,13,d) 3,7805,8226,77601,79537,318,3.6,1504,17.1,15883,2214,13669,2.8,20,19755,9946,9809,12.5,24.8,-3872,-4.8,40,0,1158,1158,7460
1989,13,e) 4,7055,7380,70674,72663,284,3.6,1120,14.4,12268,2138,10130,2.9,16.9,16245,6999,9246,9.6,22.4,-3977,-5.5,33.8,0,835,837,5227
1989,13,f) 5,6428,6803,71949,72792,212,3,849,11.9,13366,1806,11560,2.5,18.4,15054,6386,8668,8.8,20.7,-1688,-2.3,36.8,0,625,626,4694
1989,13,g) 6 to 10,19144,21252,261351,262509,826,3.8,2243,10.2,43903,8879,35024,3.4,16.7,46219,14773,31446,5.6,17.6,-2316,-0.9,33.4,0,1583,1586,9689
1989,13,h) 11 to 15,6806,8278,115492,116575,440,5.2,828,9.8,19412,4879,14533,4.2,16.7,21577,8374,13203,7.2,18.5,-2165,-1.8,33.4,0,465,475,3648
1989,13,l) Left Censored,28563,51148,1588943,1585104,3278,6.4,3887,7.6,252466,95956,156510,6.1,15.9,244789,59872,184917,3.8,15.4,7677,0.5,30.8,0,1481,1514,12391
1989,15,a) 0,2029,2057,16279,8222,2037,198.1,0,0,16114,16114,0,196,196,0,0,0,0,0,16114,196,0,0,,,
1989,15,b) 1,1746,1850,15016,14699,24,1.2,373,18.3,4482,544,3938,3.7,30.5,3847,2181,1666,14.8,26.2,635,4.3,52.4,0,261,261,1531
1989,15,c) 2,1468,1558,19358,19871,57,3.4,315,18.7,2910,639,2271,3.2,14.6,3935,2152,1783,10.8,19.8,-1025,-5.2,29.2,0,249,249,1405
1989,15,d) 3,1220,1321,13328,13257,49,3.5,207,14.8,2681,236,2445,1.8,20.2,2539,1207,1332,9.1,19.2,142,1,38.4,0,144,144,778
1989,15,e) 4,1195,1270,14001,14338,41,3,206,15.3,2872,924,1948,6.4,20,3545,1407,2138,9.8,24.7,-673,-4.7,40,0,164,164,1069
1989,15,f) 5,896,983,8982,8990,44,4.3,141,13.7,1708,502,1206,5.6,19,1724,750,974,8.3,19.2,-16,-0.2,38,0,105,105,575
1989,15,g) 6 to 10,4278,4766,53364,53401,182,3.7,479,9.8,7916,1352,6564,2.5,14.8,7990,3236,4754,6.1,15,-74,-0.2,29.6,0,327,327,2317
1989,15,h) 11 to 15,1371,1765,25186,25102,64,3.5,146,8.1,3596,461,3135,1.8,14.3,3427,1529,1898,6.1,13.7,169,0.6,27.4,0,90,90,871
1989,15,l) Left Censored,5847,9313,238805,235486,468,5,558,6,30402,8249,22153,3.5,12.9,23764,6934,16830,2.9,10.1,6638,2.8,20.2,0,275,275,1678
1989,16,a) 0,1983,2005,11275,5655,1989,198.4,0,0,11240,11240,0,198.8,198.8,0,0,0,0,0,11240,198.8,0,0,,,
1989,16,b) 1,1517,1532,12856,12300,5,0.3,379,21.8,4021,141,3880,1.1,32.7,2908,1818,1090,14.8,23.6,1113,9.1,47.2,0,282,282,1495
1989,16,c) 2,1357,1424,11708,12030,62,4,299,19.4,2600,413,2187,3.4,21.6,3243,1833,1410,15.2,27,-643,-5.4,43.2,0,228,228,1479
1989,16,d) 3,1258,1292,9664,9604,46,3.4,191,14,2083,294,1789,3.1,21.7,1963,930,1033,9.7,20.4,120,1.3,40.8,0,148,148,719
1989,16,e) 4,1142,1194,8956,8979,45,3.5,201,15.8,2140,542,1598,6,23.8,2185,963,1222,10.7,24.3,-45,-0.5,47.6,0,139,139,652
1989,16,f) 5,1029,1070,8016,8154,42,3.7,164,14.5,1722,361,1361,4.4,21.1,1997,949,1048,11.6,24.5,-275,-3.4,42.2,0,111,111,702
1989,16,g) 6 to 10,3538,3838,39373,38728,153,3.8,449,11.3,7615,1268,6347,3.3,19.7,6324,2566,3758,6.6,16.3,1291,3.4,32.6,0,289,289,1569
1989,16,h) 11 to 15,1374,1616,18163,17829,83,5,144,8.7,2956,524,2432,2.9,16.6,2287,796,1491,4.5,12.8,669,3.8,25.6,0,89,89,520
1989,16,l) Left Censored,5191,7860,162737,158499,391,4.9,642,8.1,24425,8706,15719,5.5,15.4,15950,5808,10142,3.7,10.1,8475,5.3,20.2,0,288,310,2249
1989,17,a) 0,19105,19311,122924,61673,19207,198.9,0,0,122502,122502,0,198.6,198.6,0,0,0,0,0,122502,198.6,0,0,,,
1989,17,b) 1,15321,15610,137795,133971,215,1.2,3695,21.2,42522,9153,33369,6.8,31.7,34874,20116,14758,15,26,7648,5.7,52,0,2734,2738,16583
1989,17,c) 2,14105,14689,168233,170124,533,3.4,2664,16.9,29900,3918,25982,2.3,17.6,33682,17989,15693,10.6,19.8,-3782,-2.2,35.2,0,2028,2033,15043
1989,17,d) 3,12102,12639,118356,120809,437,3.3,1895,14.2,22867,2311,20556,1.9,18.9,27772,11788,15984,9.8,23,-4905,-4.1,37.8,0,1404,1404,9150
1989,17,e) 4,11423,12002,124955,126453,417,3.3,1528,12.2,21315,3623,17692,2.9,16.9,24310,9673,14637,7.6,19.2,-2995,-2.3,33.8,0,1173,1175,7852
1989,17,f) 5,10469,11104,116741,117613,385,3.3,1263,11,18668,3934,14734,3.3,15.9,20412,7437,12975,6.3,17.4,-1744,-1.5,31.8,0,931,931,5868
1989,17,g) 6 to 10,35109,37693,475822,476207,1219,3.1,3661,9.4,70862,10149,60713,2.1,14.9,71632,27961,43671,5.9,15,-770,-0.1,29.8,0,2587,2610,19330
1989,17,h) 11 to 15,13050,15941,229908,227849,620,3.8,1371,8.4,33967,6587,27380,2.9,14.9,29848,10280,19568,4.5,13.1,4119,1.8,26.2,0,824,841,5830
1989,17,l) Left Censored,64510,96642,2992020,2978498,4796,4.9,7507,7.7,390312,128775,261537,4.3,13.1,363269,103991,259278,3.5,12.2,27043,0.9,24.4,0,3547,3699,30321
1989,18,a) 0,8967,9104,58848,29511,9050,198.8,0,0,58675,58675,0,198.8,198.8,0,0,0,0,0,58675,198.8,0,0,,,
1989,18,b) 1,7020,7135,66105,63831,59,0.7,1740,21.7,19225,1553,17672,2.4,30.1,14676,8843,5833,13.9,23,4549,7.1,46,0,1371,1371,7332
1989,18,c) 2,6479,6766,69105,71533,291,4,1408,19.2,12144,2146,9998,3,17,16999,8988,8011,12.6,23.8,-4855,-6.8,34,0,1131,1131,7252
1989,18,d) 3,5777,6064,58822,60049,190,3,927,14.4,11826,1921,9905,3.2,19.7,14279,6757,7522,11.3,23.8,-2453,-4.1,39.4,0,732,732,4789
1989,18,e) 4,5384,5753,55839,55889,202,3.4,695,11.6,9836,1506,8330,2.7,17.6,9935,4826,5109,8.6,17.8,-99,-0.2,35.2,0,540,541,3877
1989,18,f) 5,5228,5574,58139,57268,172,3,559,9.7,11083,1854,9229,3.2,19.4,9341,4250,5091,7.4,16.3,1742,3.1,32.6,0,422,424,3372
1989,18,g) 6 to 10,15720,17098,194042,195094,491,2.8,1589,9,29934,4331,25603,2.2,15.3,32037,13129,18908,6.7,16.4,-2103,-1.1,30.6,0,1149,1157,9451
1989,18,h) 11 to 15,5978,7520,107344,105762,278,3.6,563,7.4,16785,3570,13215,3.4,15.9,13621,4421,9200,4.2,12.9,3164,3,25.8,0,363,372,2846
1989,18,l) Left Censored,30060,47232,1417803,1398018,2395,5,3176,6.7,177900,47328,130572,3.4,12.7,138329,42456,95873,3,9.9,39571,2.8,19.8,0,1493,1521,14481
1989,19,a) 0,4474,4535,25681,12863,4512,199,0,0,25637,25637,0,199.3,199.3,0,0,0,0,0,25637,199.3,0,0,,,
1989,19,b) 1,3482,3536,26050,25944,26,0.7,837,21.1,7178,573,6605,2.2,27.7,6965,4099,2866,15.8,26.8,213,0.9,53.6,0,660,660,3423
1989,19,c) 2,3295,3451,50281,45177,141,3.8,642,17.3,17669,12789,4880,28.3,39.1,7461,4264,3197,9.4,16.5,10208,22.6,33,0,490,490,3582
1989,19,d) 3,2762,2844,22121,22237,97,3.2,454,15,4181,518,3663,2.3,18.8,4413,2317,2096,10.4,19.8,-232,-1,37.6,0,355,355,1704
1989,19,e) 4,2699,2839,25315,25180,135,4.6,379,12.8,4278,935,3343,3.7,17,4008,1890,2118,7.5,15.9,270,1.1,31.8,0,298,298,1395
1989,19,f) 5,3090,3201,24285,24037,146,4.5,280,8.6,4629,1366,3263,5.7,19.3,4133,1569,2564,6.5,17.2,496,2.1,34.4,0,200,200,1211
1989,19,g) 6 to 10,9574,10571,98285,98263,349,3.2,1003,9.2,14973,2348,12625,2.4,15.2,14929,5771,9158,5.9,15.2,44,0,30.4,0,745,745,3843
1989,19,h) 11 to 15,3998,5069,53441,52607,170,3.3,401,7.7,7957,1275,6682,2.4,15.1,6289,2113,4176,4,12,1668,3.1,24,0,249,249,1241
1989,19,l) Left Censored,19831,28603,651093,641243,1063,3.7,1853,6.4,80954,22342,58612,3.5,12.6,61253,20734,40519,3.2,9.6,19701,3,19.2,0,996,1001,5995
1989,20,a) 0,4538,4564,25785,12937,4538,198.9,0,0,25696,25696,0,198.6,198.6,0,0,0,0,0,25696,198.6,0,0,,,
1989,20,b) 1,3604,3694,26508,27675,31,0.7,1015,24.1,6201,660,5541,2.4,22.4,8534,5398,3136,19.5,30.8,-2333,-8.4,44.8,0,780,780,4108
1989,20,c) 2,3289,3420,39287,40562,133,3.6,726,19.5,5382,824,4558,2,13.3,7931,4604,3327,11.4,19.6,-2549,-6.3,26.6,0,583,584,4045
1989,20,d) 3,2967,3080,25432,25728,119,3.6,490,15,5081,1020,4061,4,19.7,5672,2405,3267,9.3,22,-591,-2.3,39.4,0,389,390,1999
1989,20,e) 4,2811,2935,23281,24190,110,3.5,503,16.1,3851,769,3082,3.2,15.9,5669,2647,3022,10.9,23.4,-1818,-7.5,31.8,0,408,415,2265
1989,20,f) 5,2890,2996,26238,26045,81,2.6,385,12.3,4519,1107,3412,4.3,17.4,4133,1819,2314,7,15.9,386,1.5,31.8,0,309,310,1528
1989,20,g) 6 to 10,8959,9654,88070,89657,291,2.9,1059,10.6,13270,2435,10835,2.7,14.8,16444,6315,10129,7,18.3,-3174,-3.5,29.6,0,772,772,3883
1989,20,h) 11 to 15,3260,4194,44372,44115,200,4.7,349,8.2,7343,1791,5552,4.1,16.6,6828,2204,4624,5,15.5,515,1.1,31,0,237,237,1351
1989,20,l) Left Censored,16247,23799,551728,533699,1076,4.5,1805,7.5,94701,45922,48779,8.6,17.7,58643,18780,39863,3.5,11,36058,6.7,22,0,906,920,7173
1989,21,a) 0,5887,5939,39134,19632,5905,198.9,0,0,39005,39005,0,198.7,198.7,0,0,0,0,0,39005,198.7,0,0,,,
1989,21,b) 1,4613,4714,38523,37869,53,1,1061,20.2,11704,2600,9104,6.9,30.9,10395,6402,3993,16.9,27.4,1309,3.5,54.8,0,843,843,5523
1989,21,c) 2,4291,4423,46957,47595,148,3.1,870,18.1,8597,812,7785,1.7,18.1,9872,5292,4580,11.1,20.7,-1275,-2.6,36.2,0,744,744,4674
1989,21,d) 3,3671,3846,36090,37137,138,3.4,677,16.4,6501,1154,5347,3.1,17.5,8595,4139,4456,11.1,23.1,-2094,-5.6,35,0,543,544,3467
1989,21,e) 4,3359,3519,37122,37441,132,3.6,499,13.5,6143,1066,5077,2.8,16.4,6780,2626,4154,7,18.1,-637,-1.7,32.8,0,387,387,1900
1989,21,f) 5,3474,3624,32178,33522,97,2.6,386,10.3,4978,802,4176,2.4,14.8,7665,3275,4390,9.8,22.9,-2687,-8.1,29.6,0,299,299,1921
1989,21,g) 6 to 10,9788,10498,127954,127998,335,3.1,1143,10.5,20495,2922,17573,2.3,16,20582,8977,11605,7,16.1,-87,-0.1,32,0,851,852,5286
1989,21,h) 11 to 15,3705,4466,55417,55262,175,3.8,383,8.4,8859,1742,7117,3.2,16,8549,3536,5013,6.4,15.5,310,0.5,31,0,235,238,1388
1989,21,l) Left Censored,18109,27880,727539,721482,1351,4.8,1986,7,90791,24061,66730,3.3,12.6,78678,24033,54645,3.3,10.9,12113,1.7,21.8,0,993,1013,7539
1989,22,a) 0,5673,5729,37243,18718,5681,198.3,0,0,37050,37050,0,197.9,197.9,0,0,0,0,0,37050,197.9,0,0,,,
1989,22,b) 1,4652,4786,43120,44617,67,1.2,1389,25.4,13073,1603,11470,3.6,29.3,16067,8197,7870,18.4,36,-2994,-6.7,58.6,0,1079,1079,6572
1989,22,c) 2,4113,4252,46411,48977,124,2.6,1004,21.3,8375,770,7605,1.6,17.1,13507,8392,5115,17.1,27.6,-5132,-10.5,34.2,0,817,818,6750
1989,22,d) 3,3997,4125,37024,38003,135,3,787,17.7,7391,649,6742,1.7,19.4,9349,5248,4101,13.8,24.6,-1958,-5.2,38.8,0,611,611,4137
1989,22,e) 4,3615,3803,33948,34442,160,3.9,686,16.9,7409,1505,5904,4.4,21.5,8397,4606,3791,13.4,24.4,-988,-2.9,43,0,523,524,3535
1989,22,f) 5,3835,4013,41308,41886,159,3.8,577,13.7,6604,937,5667,2.2,15.8,7759,3663,4096,8.7,18.5,-1155,-2.7,31.6,0,441,441,3067
1989,22,g) 6 to 10,13573,14783,152060,152562,598,3.9,1710,11.2,27479,6530,20949,4.3,18,28483,10900,17583,7.1,18.7,-1004,-0.7,36,0,1239,1242,7948
1989,22,h) 11 to 15,4352,5187,66394,66298,186,3.5,485,9.1,11058,1994,9064,3,16.7,10866,3661,7205,5.5,16.4,192,0.3,32.8,0,292,297,2103
1989,22,l) Left Censored,19833,31841,745377,741220,1527,4.7,2687,8.3,104673,30635,74038,4.1,14.1,96358,29705,66653,4,13,8315,1.1,26,0,1185,1218,8300
1989,23,a) 0,3137,3151,17738,8922,3114,197.7,0,0,17633,17633,0,197.6,197.6,0,0,0,0,0,17633,197.6,0,0,,,
1989,23,b) 1,2605,2643,17358,17490,15,0.5,681,22.7,4805,252,4553,1.4,27.5,5069,2958,2111,16.9,29,-264,-1.5,55,0,516,516,2478
1989,23,c) 2,2320,2406,20363,22592,93,3.6,481,18.5,3691,364,3327,1.6,16.3,8149,2349,5800,10.4,36.1,-4458,-19.8,32.6,0,358,358,1802
1989,23,d) 3,1914,1972,13946,14169,74,3.5,334,15.9,2817,388,2429,2.7,19.9,3263,1444,1819,10.2,23,-446,-3.1,39.8,0,252,252,1069
1989,23,e) 4,1575,1626,13555,13708,50,2.9,229,13.4,2897,254,2643,1.9,21.1,3203,1564,1639,11.4,23.4,-306,-2.3,42.2,0,174,174,1180
1989,23,f) 5,1389,1451,13678,13763,48,3.2,178,11.8,2396,204,2192,1.5,17.4,2566,1286,1280,9.3,18.6,-170,-1.2,34.8,0,140,140,1152
1989,23,g) 6 to 10,4243,4547,50799,51273,165,3.5,471,10,7544,1400,6144,2.7,14.7,8492,3484,5008,6.8,16.6,-948,-1.9,29.4,0,328,331,2668
1989,23,h) 11 to 15,1600,2009,25166,25335,119,5.8,180,8.8,4120,914,3206,3.6,16.3,4457,1716,2741,6.8,17.6,-337,-1.3,32.6,0,120,120,652
1989,23,l) Left Censored,7029,10074,254588,253032,502,4.9,724,7.1,31059,6578,24481,2.6,12.3,27946,8763,19183,3.5,11,3113,1.3,22,0,388,418,3345
1989,24,a) 0,9210,9288,54434,27311,9234,198.8,0,0,54247,54247,0,198.6,198.6,0,0,0,0,0,54247,198.6,0,0,,,
1989,24,b) 1,7410,7557,63419,63776,49,0.6,1940,22.7,18324,1361,16963,2.1,28.7,19037,11161,7876,17.5,29.8,-713,-1.1,57.4,0,1450,1450,9252
1989,24,c) 2,6505,6738,73958,75941,269,3.7,1276,17.6,13542,2406,11136,3.2,17.8,17507,8091,9416,10.7,23.1,-3965,-5.3,35.6,0,1000,1000,6628
1989,24,d) 3,5785,5975,56643,57821,202,3.2,946,14.9,12032,1264,10768,2.2,20.8,14387,6045,8342,10.5,24.9,-2355,-4.1,41.6,0,751,752,4781
1989,24,e) 4,5015,5332,55702,56751,207,3.7,707,12.7,9739,1745,7994,3.1,17.2,11837,4937,6900,8.7,20.9,-2098,-3.7,34.4,0,511,513,3414
1989,24,f) 5,4248,4475,52387,52501,154,3.3,497,10.7,9034,1362,7672,2.6,17.2,9262,3306,5956,6.3,17.6,-228,-0.4,34.4,0,381,385,2661
1989,24,g) 6 to 10,13812,14980,187154,189700,540,3.5,1437,9.3,29762,5183,24579,2.7,15.7,34853,12188,22665,6.4,18.4,-5091,-2.7,31.4,0,996,1000,8726
1989,24,h) 11 to 15,4828,6066,89813,89891,239,3.9,485,7.8,14309,3254,11055,3.6,15.9,14465,3955,10510,4.4,16.1,-156,-0.2,31.8,0,275,278,1892
1989,24,l) Left Censored,22963,37423,1133161,1134696,2164,5.7,2691,7.1,155194,52685,102509,4.6,13.7,158264,43391,114873,3.8,13.9,-3070,-0.2,27.4,0,1108,1121,9401
1989,25,a) 0,11950,12205,76387,38505,12059,197.6,0,0,75765,75765,0,196.8,196.8,0,0,0,0,0,75765,196.8,0,0,,,
1989,25,b) 1,10583,10740,99164,97587,94,0.8,2562,21.3,27669,3633,24036,3.7,28.4,24514,12984,11530,13.3,25.1,3155,3.3,50.2,0,1936,1936,10614
1989,25,c) 2,9784,10119,105416,106185,342,3.1,1947,17.8,22051,5462,16589,5.1,20.8,23588,11684,11904,11,22.2,-1537,-1.4,41.6,0,1533,1536,9278
1989,25,d) 3,8212,8508,84165,86090,254,2.8,1397,15.4,15713,1926,13787,2.2,18.3,19563,8882,10681,10.3,22.7,-3850,-4.4,36.6,0,1103,1108,7400
1989,25,e) 4,7181,7462,83249,85028,264,3.4,1076,13.7,14192,2037,12155,2.4,16.7,17750,7452,10298,8.8,20.9,-3558,-4.2,33.4,0,819,820,5568
1989,25,f) 5,6093,6316,69240,71317,177,2.7,812,12.3,11444,1449,9995,2,16,15597,7208,8389,10.1,21.9,-4153,-5.9,32,0,609,609,5910
1989,25,g) 6 to 10,20351,21894,300453,301823,652,2.9,2214,9.8,48630,8139,40491,2.7,16.1,51369,18703,32666,6.2,17,-2739,-0.9,32.2,0,1560,1578,11703
1989,25,h) 11 to 15,6996,8941,172344,172648,314,3.4,729,8,21465,3434,18031,2,12.4,22073,5816,16257,3.4,12.8,-608,-0.4,24.8,0,452,461,3134
1989,25,l) Left Censored,39161,56213,1867791,1877121,2547,4.5,4108,7.2,242980,67391,175589,3.6,12.9,261639,68157,193482,3.6,13.9,-18659,-1,25.8,0,2194,2330,23384
1989,26,a) 0,14781,14990,94867,47639,14880,198.5,0,0,94456,94456,0,198.3,198.3,0,0,0,0,0,94456,198.3,0,0,,,
1989,26,b) 1,12148,12406,106826,104354,109,0.8,2999,21.5,33376,3596,29780,3.4,32,28432,14259,14173,13.7,27.2,4944,4.8,54.4,0,2290,2290,11018
1989,26,c) 2,11655,12118,124046,126195,420,3.2,2136,16.4,23594,2972,20622,2.4,18.7,27892,13642,14250,10.8,22.1,-4298,-3.4,37.4,0,1649,1650,11052
1989,26,d) 3,9659,10092,91488,93285,405,3.8,1431,13.5,17984,2628,15356,2.8,19.3,21577,9297,12280,10,23.1,-3593,-3.8,38.6,0,1111,1112,6810
1989,26,e) 4,8752,9248,92506,93659,315,3.3,1196,12.3,16341,2305,14036,2.5,17.4,18647,8395,10252,9,19.9,-2306,-2.5,34.8,0,929,933,6650
1989,26,f) 5,8134,8673,91450,92908,251,2.8,955,10.6,15391,2561,12830,2.8,16.6,18307,8320,9987,9,19.7,-2916,-3.1,33.2,0,703,703,4755
1989,26,g) 6 to 10,26192,28625,329993,330533,928,3.2,2669,9.1,52959,9877,43082,3,16,54039,18971,35068,5.7,16.3,-1080,-0.3,32,0,1950,1953,14236
1989,26,h) 11 to 15,9735,12282,165447,164767,526,4.2,945,7.6,23378,4460,18918,2.7,14.2,22017,7067,14950,4.3,13.4,1361,0.8,26.8,0,589,596,3945
1989,26,l) Left Censored,45886,71906,2235930,2219524,3834,5.3,4991,6.9,278124,69321,208803,3.1,12.5,245313,64556,180757,2.9,11.1,32811,1.4,22.2,0,2392,2444,21864
1989,27,a) 0,7714,7791,46976,23541,7749,198.9,0,0,46871,46871,0,199.1,199.1,0,0,0,0,0,46871,199.1,0,0,,,
1989,27,b) 1,6258,6384,50386,50375,52,0.7,1472,20.6,14051,1032,13019,2,27.9,14029,8405,5624,16.7,27.8,22,0.1,55.6,0,1070,1070,6400
1989,27,c) 2,5565,5814,71572,70992,225,3.6,1105,17.6,16052,5016,11036,7.1,22.6,14891,9210,5681,13,21,1161,1.6,42,0,826,829,7090
1989,27,d) 3,5076,5350,48737,49038,208,3.7,810,14.3,9255,1369,7886,2.8,18.9,9856,4596,5260,9.4,20.1,-601,-1.2,37.8,0,636,636,3583
1989,27,e) 4,4740,5035,56113,55369,165,3.1,655,12.4,10815,1753,9062,3.2,19.5,9327,4414,4913,8,16.8,1488,2.7,33.6,0,494,495,3253
1989,27,f) 5,4409,4650,49923,48348,136,2.8,508,10.5,10698,3822,6876,7.9,22.1,7547,3469,4078,7.2,15.6,3151,6.5,31.2,0,367,370,2336
1989,27,g) 6 to 10,14132,15599,185849,184088,536,3.3,1490,9.3,28949,5464,23485,3,15.7,25426,9608,15818,5.2,13.8,3523,1.9,27.6,0,1092,1103,6921
1989,27,h) 11 to 15,5503,6875,96298,100141,300,4.3,516,7.4,13306,3367,9939,3.4,13.3,20992,3810,17182,3.8,21,-7686,-7.7,26.6,0,297,303,2245
1989,27,l) Left Censored,25789,38211,1165140,1159435,2055,5.3,2650,6.9,142278,39557,102721,3.4,12.3,130868,49524,81344,4.3,11.3,11410,1,22.6,0,1192,1206,11682
1989,28,a) 0,3833,3855,24079,12090,3821,198.2,0,0,23979,23979,0,198.3,198.3,0,0,0,0,0,23979,198.3,0,0,,,
1989,28,b) 1,2928,3013,24796,24166,39,1.1,886,25.6,8312,1175,7137,4.9,34.4,7052,4210,2842,17.4,29.2,1260,5.2,58.4,0,709,709,3291
1989,28,c) 2,2603,2715,27552,30004,110,3.6,695,23,3967,663,3304,2.2,13.2,8871,5666,3205,18.9,29.6,-4904,-16.4,26.4,0,562,562,5108
1989,28,d) 3,2308,2374,18836,19540,97,3.8,433,17,3464,488,2976,2.5,17.7,4872,2316,2556,11.9,24.9,-1408,-7.2,35.4,0,329,329,1739
1989,28,e) 4,2281,2370,20384,20790,73,2.9,327,13.1,3283,809,2474,3.9,15.8,4094,1526,2568,7.3,19.7,-811,-3.9,31.6,0,265,265,1265
1989,28,f) 5,2362,2417,17985,18902,73,2.9,268,10.7,2600,393,2207,2.1,13.8,4434,2328,2106,12.3,23.5,-1834,-9.7,27.6,0,196,196,2016
1989,28,g) 6 to 10,7091,7704,82696,84104,300,3.8,858,10.8,12091,2392,9699,2.8,14.4,14907,6537,8370,7.8,17.7,-2816,-3.3,28.8,0,610,629,3499
1989,28,h) 11 to 15,2657,3203,32229,32751,123,3.7,284,8.7,4568,860,3708,2.6,13.9,5611,2398,3213,7.3,17.1,-1043,-3.2,27.8,0,172,172,850
1989,28,l) Left Censored,12093,18765,456216,453412,959,5.1,1306,6.9,56120,15475,40645,3.4,12.4,50512,14849,35663,3.3,11.1,5608,1.3,22.2,0,675,687,4664
1989,29,a) 0,9940,10084,56551,28401,10032,199,0,0,56301,56301,0,198.2,198.2,0,0,0,0,0,56301,198.2,0,0,,,
1989,29,b) 1,7606,7765,59317,59026,63,0.7,2082,23.6,18868,2488,16380,4.2,32,18286,10587,7699,17.9,31,582,1,62,0,1613,1613,8545
1989,29,c) 2,7075,7366,78640,80415,386,4.9,1493,18.8,15474,3419,12055,4.3,19.2,19024,11267,7757,14,23.7,-3550,-4.5,38.4,0,1205,1207,9821
1989,29,d) 3,5944,6219,53299,54615,254,3.8,1044,15.8,10397,1899,8498,3.5,19,13028,6376,6652,11.7,23.9,-2631,-4.9,38,0,820,827,5143
1989,29,e) 4,5889,6136,59558,59488,192,3,873,13.5,11423,1583,9840,2.7,19.2,11282,4845,6437,8.1,19,141,0.2,38,0,672,674,3922
1989,29,f) 5,5090,5348,48096,48667,170,3.1,617,11.1,8293,1957,6336,4,17,9434,4003,5431,8.2,19.4,-1141,-2.4,34,0,458,458,3162
1989,29,g) 6 to 10,16260,17831,195057,196310,600,3.3,1804,9.8,31311,5809,25502,3,15.9,33816,12565,21251,6.4,17.2,-2505,-1.3,31.8,0,1233,1254,8234
1989,29,h) 11 to 15,6067,7752,99780,101102,387,4.9,615,7.8,15090,3068,12022,3,14.9,17733,4418,13315,4.4,17.5,-2643,-2.6,29.8,0,390,393,2586
1989,29,l) Left Censored,29001,44834,1284913,1271120,2182,4.8,3226,7.1,172858,43737,129121,3.4,13.6,145271,42112,103159,3.3,11.4,27587,2.2,22.8,0,1547,1573,12161
1989,30,a) 0,1800,1820,8755,4399,1808,198.7,0,0,8712,8712,0,198,198,0,0,0,0,0,8712,198,0,0,,,
1989,30,b) 1,1468,1491,8707,9108,14,0.8,428,24.9,2085,121,1964,1.3,22.9,2886,1581,1305,17.4,31.7,-801,-8.8,45.8,0,307,307,1226
1989,30,c) 2,1340,1375,10019,9747,123,8.3,306,20.8,3324,1942,1382,19.9,34.1,2780,1351,1429,13.9,28.5,544,5.6,57,0,230,230,1133
1989,30,d) 3,1222,1248,8255,8262,79,6.1,180,13.8,1616,331,1285,4,19.6,1629,844,785,10.2,19.7,-13,-0.1,39.2,0,130,130,563
1989,30,e) 4,1073,1106,7883,8175,59,5,198,16.8,1419,269,1150,3.3,17.4,2003,910,1093,11.1,24.5,-584,-7.1,34.8,0,148,148,589
1989,30,f) 5,1066,1120,7112,6987,64,5.5,155,13.3,1618,411,1207,5.9,23.2,1368,680,688,9.7,19.6,250,3.6,39.2,0,120,120,567
1989,30,g) 6 to 10,3847,4169,32037,32284,197,4.6,524,12.1,5519,1119,4400,3.5,17.1,6013,2846,3167,8.8,18.6,-494,-1.5,34.2,0,324,326,1830
1989,30,h) 11 to 15,1392,1621,14012,13754,82,5,146,8.8,2275,456,1819,3.3,16.5,1758,694,1064,5,12.8,517,3.7,25.6,0,101,101,499
1989,30,l) Left Censored,5236,7286,110815,109651,273,3.7,528,7.1,13354,2901,10453,2.6,12.2,11026,3035,7991,2.8,10.1,2328,2.1,20.2,0,279,279,1265
1989,31,a) 0,2838,2858,16261,8292,2847,199.2,0,0,15939,15939,0,192.2,192.2,0,0,0,0,0,15939,192.2,0,0,,,
1989,31,b) 1,2294,2390,18228,18221,33,1.2,589,21.9,5188,1119,4069,6.1,28.5,5174,3112,2062,17.1,28.4,14,0.1,56.8,0,448,448,2444
1989,31,c) 2,1974,2023,20155,19908,82,3.7,403,18.4,4355,1779,2576,8.9,21.9,3861,2319,1542,11.6,19.4,494,2.5,38.8,0,308,308,2005
1989,31,d) 3,1748,1806,15781,16359,62,3.2,316,16.4,2828,647,2181,4,17.3,3983,2125,1858,13,24.3,-1155,-7,34.6,0,228,235,1412
1989,31,e) 4,1906,1970,20075,19970,52,2.5,282,13.5,3669,494,3175,2.5,18.4,3459,1699,1760,8.5,17.3,210,1.1,34.6,0,223,223,1455
1989,31,f) 5,1817,1916,14330,14479,78,4,193,9.8,2611,977,1634,6.7,18,2909,1083,1826,7.5,20.1,-298,-2.1,36,0,148,148,949
1989,31,g) 6 to 10,5961,6497,61479,61656,234,3.5,650,9.7,8478,1295,7183,2.1,13.8,8831,3779,5052,6.1,14.3,-353,-0.5,27.6,0,468,469,2676
1989,31,h) 11 to 15,2451,2963,29693,29854,134,4.5,227,7.6,4198,1016,3182,3.4,14.1,4520,1838,2682,6.2,15.1,-322,-1,28.2,0,149,149,1050
1989,31,l) Left Censored,11521,16146,362637,358355,758,4.6,1117,6.8,46215,11037,35178,3.1,12.9,37651,11624,26027,3.2,10.5,8564,2.4,21,0,557,561,3690
1989,32,a) 0,3012,3026,21701,10921,3005,198.6,0,0,21560,21560,0,197.4,197.4,0,0,0,0,0,21560,197.4,0,0,,,
1989,32,b) 1,2069,2103,22963,21655,17,0.7,604,25,9217,549,8668,2.5,42.6,6600,2925,3675,13.5,30.5,2617,12.1,61,0,486,487,2399
1989,32,c) 2,1795,1875,23044,22775,103,5.1,408,20.1,6944,848,6096,3.7,30.5,6405,3454,2951,15.2,28.1,539,2.4,56.2,0,316,316,2965
1989,32,d) 3,1475,1547,21004,21053,82,5,264,16.1,4311,572,3739,2.7,20.5,4408,1741,2667,8.3,20.9,-97,-0.4,41,0,186,187,1292
1989,32,e) 4,1186,1254,16285,15964,71,5.4,198,15,3981,896,3085,5.6,24.9,3339,1405,1934,8.8,20.9,642,4,41.8,0,130,134,884
1989,32,f) 5,1141,1233,18485,17910,57,4.5,154,12,4755,1263,3492,7.1,26.5,3605,1467,2138,8.2,20.1,1150,6.4,40.2,0,120,120,1119
1989,32,g) 6 to 10,4195,4618,74097,74482,220,4.6,490,10.3,14842,2310,12532,3.1,19.9,15612,7421,8191,10,21,-770,-1.1,39.8,0,317,317,5717
1989,32,h) 11 to 15,1291,1571,29293,28753,82,5.1,153,9.5,5122,1223,3899,4.3,17.8,4044,1311,2733,4.6,14.1,1078,3.7,28.2,0,89,90,697
1989,32,l) Left Censored,4504,7158,269489,264491,520,7.2,586,8.2,45670,11887,33783,4.5,17.3,35674,13812,21862,5.2,13.5,9996,3.8,27,0,216,217,2024
1989,33,a) 0,3097,3131,20433,10263,3105,198.3,0,0,20341,20341,0,198.2,198.2,0,0,0,0,0,20341,198.2,0,0,,,
1989,33,b) 1,2773,2794,21029,20929,16,0.5,823,25.6,5966,813,5153,3.9,28.5,5765,3609,2156,17.2,27.5,201,1,55,0,646,646,2710
1989,33,c) 2,2610,2669,19923,21244,97,3.3,563,19.4,3626,646,2980,3,17.1,6267,2993,3274,14.1,29.5,-2641,-12.4,34.2,0,454,454,2317
1989,33,d) 3,2136,2229,19851,21144,72,3,461,19,2950,477,2473,2.3,14,5536,3002,2534,14.2,26.2,-2586,-12.2,28,0,360,360,2489
1989,33,e) 4,1735,1784,16402,16971,54,2.8,309,16.2,3252,597,2655,3.5,19.2,4389,2337,2052,13.8,25.9,-1137,-6.7,38.4,0,251,252,1942
1989,33,f) 5,1448,1520,14915,15512,34,2.1,208,13,2204,202,2002,1.3,14.2,3398,1549,1849,10,21.9,-1194,-7.7,28.4,0,156,156,1155
1989,33,g) 6 to 10,4187,4441,46928,48728,142,3.1,512,11.1,7002,1793,5209,3.7,14.4,10602,3656,6946,7.5,21.8,-3600,-7.4,28.8,0,399,399,2528
1989,33,h) 11 to 15,1534,1919,27113,27801,77,3.9,164,8.4,3696,618,3078,2.2,13.3,5072,1604,3468,5.8,18.2,-1376,-4.9,26.6,0,108,108,1035
1989,33,l) Left Censored,6447,9228,273250,273247,481,5.2,668,7.2,30466,8905,21561,3.3,11.1,30460,7433,23027,2.7,11.1,6,0,22.2,0,341,366,2869
1989,34,a) 0,16703,16783,89682,45113,16650,198.4,0,0,89138,89138,0,197.6,197.6,0,0,0,0,0,89138,197.6,0,0,,,
1989,34,b) 1,14491,14646,111783,109084,79,0.5,3688,22.3,34047,3165,30882,2.9,31.2,28649,16136,12513,14.8,26.3,5398,4.9,52.6,0,2697,2697,12766
1989,34,c) 2,12688,12946,120330,124128,443,3.2,2572,18.3,21342,2347,18995,1.9,17.2,28937,14352,14585,11.6,23.3,-7595,-6.1,34.4,0,1959,1959,11026
1989,34,d) 3,10871,11176,96233,98940,374,3.1,1910,16,17477,2068,15409,2.1,17.7,22890,9957,12933,10.1,23.1,-5413,-5.4,35.4,0,1435,1438,7812
1989,34,e) 4,9516,9801,90766,92508,297,2.9,1383,13.4,16743,1811,14932,2,18.1,20226,7979,12247,8.6,21.9,-3483,-3.8,36.2,0,1044,1045,6084
1989,34,f) 5,8067,8308,96593,98987,217,2.5,1094,12.5,13144,1716,11428,1.7,13.3,17931,6340,11591,6.4,18.1,-4787,-4.8,26.6,0,811,811,4401
1989,34,g) 6 to 10,28709,30225,331201,343291,845,2.7,3174,10.1,50356,8340,42016,2.4,14.7,74536,24936,49600,7.3,21.7,-24180,-7,29.4,0,2252,2254,17794
1989,34,h) 11 to 15,9935,11309,147852,149285,416,3.6,988,8.5,21184,4570,16614,3.1,14.2,24050,7144,16906,4.8,16.1,-2866,-1.9,28.4,0,625,626,3845
1989,34,l) Left Censored,48981,69609,2125255,2124838,3640,5.2,5706,8.1,306957,95000,211957,4.5,14.4,306123,83410,222713,3.9,14.4,834,0,28.8,0,2872,2921,25347
1989,35,a) 0,2932,2967,16386,8273,2947,198.7,0,0,16227,16227,0,196.1,196.1,0,0,0,0,0,16227,196.1,0,0,,,
1989,35,b) 1,2162,2221,15462,15712,38,1.5,669,26.2,4775,482,4293,3.1,30.4,5274,2992,2282,19,33.6,-499,-3.2,60.8,0,505,511,2389
1989,35,c) 2,1911,1996,20380,21204,108,4.9,502,22.8,3482,916,2566,4.3,16.4,5129,2906,2223,13.7,24.2,-1647,-7.8,32.8,0,400,400,2214
1989,35,d) 3,1749,1800,14323,15141,80,4.1,401,20.5,3035,722,2313,4.8,20,4671,2793,1878,18.4,30.9,-1636,-10.9,40,0,313,314,2292
1989,35,e) 4,1595,1700,14648,14899,66,3.7,277,15.4,2787,432,2355,2.9,18.7,3288,1410,1878,9.5,22.1,-501,-3.4,37.4,0,200,200,1122
1989,35,f) 5,1523,1600,14149,14375,70,4.2,240,14.3,2530,640,1890,4.5,17.6,2981,1069,1912,7.4,20.7,-451,-3.1,35.2,0,179,179,819
1989,35,g) 6 to 10,5347,5897,57726,58682,263,4.3,698,11.4,9184,1796,7388,3.1,15.7,11095,4026,7069,6.9,18.9,-1911,-3.2,31.4,0,463,463,2588
1989,35,h) 11 to 15,1779,2132,21274,22056,104,4.7,226,10.3,3848,966,2882,4.4,17.4,5412,1518,3894,6.9,24.5,-1564,-7.1,34.8,0,126,132,804
1989,35,l) Left Censored,6778,10404,220129,219909,567,5.4,839,8,30127,8915,21212,4.1,13.7,29686,8769,20917,4,13.5,441,0.2,27,0,384,389,3325
1989,36,a) 0,37356,37593,209081,105076,37310,198.5,0,0,208010,208010,0,198,198,0,0,0,0,0,208010,198,0,0,,,
1989,36,b) 1,30414,30805,234819,229529,204,0.6,7613,22,68388,4628,63760,2,29.8,57808,32853,24955,14.3,25.2,10580,4.6,50.4,0,5704,5704,25582
1989,36,c) 2,27178,27762,320188,326533,924,3.1,5543,18.4,45430,6722,38708,2.1,13.9,58120,29141,28979,8.9,17.8,-12690,-3.9,27.8,0,4338,4340,24142
1989,36,d) 3,23407,23984,189178,194382,737,2.9,4153,16.2,37646,4243,33403,2.2,19.4,48054,22941,25113,11.8,24.7,-10408,-5.3,38.8,0,3263,3263,18769
1989,36,e) 4,21030,21608,192199,197193,685,3,3203,14,33767,4685,29082,2.4,17.1,43755,18294,25461,9.3,22.2,-9988,-5.1,34.2,0,2457,2458,14529
1989,36,f) 5,18239,18822,173921,179599,537,2.7,2472,12.5,27801,2689,25112,1.5,15.5,39156,16447,22709,9.2,21.8,-11355,-6.3,31,0,1903,1926,11646
1989,36,g) 6 to 10,61610,65145,741319,747857,1984,2.9,7262,10.7,114415,17434,96981,2.3,15.3,127491,44409,83082,5.9,17,-13076,-1.7,30.6,0,5318,5320,33218
1989,36,h) 11 to 15,20862,24749,369671,372130,820,3.2,2362,9.3,55097,10615,44482,2.9,14.8,60016,25491,34525,6.9,16.1,-4919,-1.3,29.6,0,1551,1561,12699
1989,36,l) Left Censored,111711,153920,4555138,4570954,7397,4.7,12770,8.2,558954,152439,406515,3.3,12.2,590587,161825,428762,3.5,12.9,-31633,-0.7,24.4,0,7059,7205,55682
1989,37,a) 0,12702,12865,74008,37160,12783,198.7,0,0,73697,73697,0,198.3,198.3,0,0,0,0,0,73697,198.3,0,0,,,
1989,37,b) 1,10097,10319,84557,84601,93,0.8,2846,24.2,27632,3466,24166,4.1,32.7,27720,12283,15437,14.5,32.8,-88,-0.1,65.4,0,2184,2185,10171
1989,37,c) 2,8931,9414,89160,90664,355,3.5,1866,18.3,17932,3461,14471,3.8,19.8,20939,11500,9439,12.7,23.1,-3007,-3.3,39.6,0,1454,1455,9453
1989,37,d) 3,7906,8288,69989,70013,265,3,1323,15,14649,1706,12943,2.4,20.9,14696,6997,7699,10,21,-47,-0.1,41.8,0,1018,1018,5108
1989,37,e) 4,7343,7732,76736,78087,254,3.1,1007,12.4,13946,1998,11948,2.6,17.9,16647,6261,10386,8,21.3,-2701,-3.4,35.8,0,745,745,4194
1989,37,f) 5,7953,8475,69080,70435,275,3.1,862,9.8,10881,2261,8620,3.2,15.4,13591,5437,8154,7.7,19.3,-2710,-3.9,30.8,0,620,622,4110
1989,37,g) 6 to 10,19634,21421,262815,262854,757,3.4,2020,9.2,43063,11459,31604,4.4,16.4,43140,15681,27459,6,16.4,-77,0,32.8,0,1398,1402,11023
1989,37,h) 11 to 15,7117,8834,118598,118979,365,4,739,8.2,16861,3906,12955,3.3,14.2,17622,5639,11983,4.7,14.8,-761,-0.6,28.4,0,434,453,2444
1989,37,l) Left Censored,32722,55242,1747355,1743884,3143,5.7,3891,7,217389,67783,149606,3.9,12.5,210446,55670,154776,3.2,12.1,6943,0.4,24.2,0,1615,1646,12386
1989,38,a) 0,1158,1161,6048,3033,1151,198.3,0,0,6031,6031,0,198.8,198.8,0,0,0,0,0,6031,198.8,0,0,,,
1989,38,b) 1,993,1015,7066,7076,11,1,250,21.9,1771,167,1604,2.4,25,1791,972,819,13.7,25.3,-20,-0.3,50,0,178,178,715
1989,38,c) 2,959,977,6758,7119,44,4.2,164,15.8,985,118,867,1.7,13.8,1706,918,788,12.9,24,-721,-10.2,27.6,0,132,132,780
1989,38,d) 3,795,817,5645,5722,32,3.7,127,14.7,1189,294,895,5.1,20.8,1343,748,595,13.1,23.5,-154,-2.7,41.6,0,104,104,628
1989,38,e) 4,793,828,5237,5464,27,3.1,111,12.8,716,56,660,1,13.1,1169,460,709,8.4,21.4,-453,-8.3,26.2,0,87,87,397
1989,38,f) 5,765,788,4927,5067,24,2.9,104,12.5,665,79,586,1.6,13.1,944,390,554,7.7,18.6,-279,-5.5,26.2,0,81,82,329
1989,38,g) 6 to 10,2794,3081,24952,25254,107,3.4,290,9.1,3218,712,2506,2.8,12.7,3822,1285,2537,5.1,15.1,-604,-2.4,25.4,0,204,204,825
1989,38,h) 11 to 15,1072,1197,9436,9579,39,3.2,101,8.2,1048,122,926,1.3,10.9,1334,522,812,5.4,13.9,-286,-3,21.8,0,62,62,353
1989,38,l) Left Censored,5043,6886,116984,116472,227,3.3,410,5.9,13041,3884,9157,3.3,11.2,12017,4070,7947,3.5,10.3,1024,0.9,20.6,0,221,223,1236
1989,39,a) 0,16149,16391,115894,58179,16281,198.7,0,0,115430,115430,0,198.4,198.4,0,0,0,0,0,115430,198.4,0,0,,,
1989,39,b) 1,13345,13700,121510,118411,141,0.9,3124,20.4,38499,3962,34537,3.3,32.5,32300,18281,14019,15.4,27.3,6199,5.2,54.6,0,2382,2382,14835
1989,39,c) 2,12308,12845,134236,135893,563,4.1,2432,17.6,26472,4697,21775,3.5,19.5,29785,17032,12753,12.5,21.9,-3313,-2.4,39,0,1869,1869,13048
1989,39,d) 3,10577,11121,111105,111147,535,4.6,1775,15.1,21861,3676,18185,3.3,19.7,21944,10315,11629,9.3,19.7,-83,0,39.4,0,1315,1315,8239
1989,39,e) 4,9496,10139,115631,115570,438,4.1,1357,12.8,20852,5505,15347,4.8,18,20730,10305,10425,8.9,17.9,122,0.1,35.8,0,1027,1028,6451
1989,39,f) 5,9112,9657,96878,96620,291,2.9,1073,10.7,17396,3638,13758,3.8,18,16880,7481,9399,7.7,17.5,516,0.5,35,0,800,802,5037
1989,39,g) 6 to 10,29979,33005,398397,399342,1059,3.1,3015,8.9,59102,10619,48483,2.7,14.8,60993,24395,36598,6.1,15.3,-1891,-0.5,29.6,0,2113,2162,16357
1989,39,h) 11 to 15,11484,14720,200609,204932,537,3.6,1153,7.7,31619,6359,25260,3.1,15.4,40264,14423,25841,7,19.6,-8645,-4.2,30.8,0,697,716,4150
1989,39,l) Left Censored,60047,97465,2869595,2854223,4860,4.9,6590,6.7,367150,112166,254984,3.9,12.9,336407,104351,232056,3.7,11.8,30743,1.1,23.6,0,3121,3170,24354
1989,40,a) 0,5474,5518,33802,16990,5481,198.7,0,0,33624,33624,0,197.9,197.9,0,0,0,0,0,33624,197.9,0,0,,,
1989,40,b) 1,4129,4199,35267,34620,24,0.5,1284,26.4,12038,1041,10997,3,34.8,10743,6837,3906,19.7,31,1295,3.8,62,0,1026,1037,5907
1989,40,c) 2,3521,3689,39892,43957,131,3.2,970,23.6,6256,987,5269,2.2,14.2,14385,10390,3995,23.6,32.7,-8129,-18.5,28.4,0,773,775,8784
1989,40,d) 3,3328,3442,29341,29535,128,3.4,678,18.2,6356,1707,4649,5.8,21.5,6743,3318,3425,11.2,22.8,-387,-1.3,43,0,558,558,2872
1989,40,e) 4,3249,3375,25996,26627,172,4.8,555,15.6,4631,787,3844,3,17.4,5892,2545,3347,9.6,22.1,-1261,-4.7,34.8,0,437,438,1909
1989,40,f) 5,3468,3626,36458,35686,191,5.1,474,12.6,6835,1060,5775,3,19.2,5291,2091,3200,5.9,14.8,1544,4.4,29.6,0,364,365,1648
1989,40,g) 6 to 10,11199,12104,108246,108331,577,4.6,1449,11.6,18608,4247,14361,3.9,17.2,18778,7529,11249,6.9,17.3,-170,-0.1,34.4,0,1048,1053,5286
1989,40,h) 11 to 15,3633,4432,49276,48902,202,4.5,416,9.2,8068,1643,6425,3.4,16.5,7320,2798,4522,5.7,15,748,1.5,30,0,262,264,1531
1989,40,l) Left Censored,15830,24816,546117,546632,1307,5.2,2091,8.3,68488,17434,51054,3.2,12.5,69518,23162,46356,4.2,12.7,-1030,-0.2,25,0,967,979,6970
1989,41,a) 0,5634,5660,32294,16176,5636,199.2,0,0,32237,32237,0,199.3,199.3,0,0,0,0,0,32237,199.3,0,0,,,
1989,41,b) 1,4522,4576,36926,36486,41,0.7,2113,37.4,14774,1503,13271,4.1,40.5,13893,10477,3416,28.7,38.1,881,2.4,76.2,0,1019,1019,5213
1989,41,c) 2,4101,4281,40354,43159,168,3.3,1652,32.8,8619,875,7744,2,20,14229,10242,3987,23.7,33,-5610,-13,40,0,802,804,5291
1989,41,d) 3,3481,3605,32036,33438,140,3.4,1239,29.8,9164,755,8409,2.3,27.4,11968,8282,3686,24.8,35.8,-2804,-8.4,54.8,0,569,570,3446
1989,41,e) 4,3028,3177,28590,30350,116,3.2,945,26.3,5700,1058,4642,3.5,18.8,9220,6371,2849,21,30.4,-3520,-11.6,37.6,0,426,426,3051
1989,41,f) 5,2804,2944,29287,31261,132,4,816,24.8,5524,1233,4291,3.9,17.7,9472,5791,3681,18.5,30.3,-3948,-12.6,35.4,0,317,317,2148
1989,41,g) 6 to 10,10015,10976,122379,125545,499,4.1,2640,21.9,23748,3985,19763,3.2,18.9,30079,18775,11304,15,24,-6331,-5.1,37.8,0,946,961,5711
1989,41,h) 11 to 15,3634,4472,57098,57700,235,4.9,850,17.8,11476,1809,9667,3.1,19.9,12679,7087,5592,12.3,22,-1203,-2.1,39.8,0,260,262,1525
1989,41,l) Left Censored,13987,22283,546695,545132,1230,5.3,3196,13.8,89157,24081,65076,4.4,16.4,86031,45116,40915,8.3,15.8,3126,0.6,31.6,0,807,822,5445
1989,42,a) 0,19609,19816,123789,62379,19682,198.6,0,0,122821,122821,0,196.9,196.9,0,0,0,0,0,122821,196.9,0,0,,,
1989,42,b) 1,16193,16526,129308,126930,160,0.9,3614,19.7,38414,4316,34098,3.4,30.3,33657,20365,13292,16,26.5,4757,3.8,53,0,2691,2692,15661
1989,42,c) 2,14899,15413,151319,154377,453,2.7,2588,15.7,26028,2796,23232,1.8,16.9,32143,17232,14911,11.2,20.8,-6115,-3.9,33.8,0,1964,1964,12908
1989,42,d) 3,12870,13353,123319,125304,388,2.8,1898,13.5,21855,2803,19052,2.2,17.4,25824,11868,13956,9.5,20.6,-3969,-3.2,34.8,0,1459,1464,9664
1989,42,e) 4,11377,11975,135453,135014,360,2.9,1466,11.7,23480,3528,19952,2.6,17.4,22602,9677,12925,7.2,16.7,878,0.7,33.4,0,1126,1126,7602
1989,42,f) 5,10736,11410,120417,122068,358,3,1097,9.3,17804,2575,15229,2.1,14.6,21106,7890,13216,6.5,17.3,-3302,-2.7,29.2,0,818,819,6238
1989,42,g) 6 to 10,34102,36787,431745,432330,1233,3.3,3362,8.9,63995,9830,54165,2.3,14.8,65164,24748,40416,5.7,15.1,-1169,-0.3,29.6,0,2372,2389,16484
1989,42,h) 11 to 15,12819,15853,228636,227631,648,4,1256,7.8,33203,8230,24973,3.6,14.6,31192,12274,18918,5.4,13.7,2011,0.9,27.4,0,813,821,5937
1989,42,l) Left Censored,68542,104811,3029603,3023526,4920,4.6,7538,7.1,365598,101931,263667,3.4,12.1,353444,109032,244412,3.6,11.7,12154,0.4,23.4,0,3745,3885,31390
1989,44,a) 0,2302,2330,15910,8015,2301,197.5,0,0,15790,15790,0,197,197,0,0,0,0,0,15790,197,0,0,,,
1989,44,b) 1,1926,1948,13629,13436,6,0.3,512,23.1,4200,454,3746,3.4,31.3,3813,2046,1767,15.2,28.4,387,2.9,56.8,0,406,406,1784
1989,44,c) 2,1723,1769,15105,15356,73,3.8,365,19.1,2884,577,2307,3.8,18.8,3386,1710,1676,11.1,22.1,-502,-3.3,37.6,0,294,294,1416
1989,44,d) 3,1379,1416,10470,10865,38,2.5,234,15.5,1785,129,1656,1.2,16.4,2575,1144,1431,10.5,23.7,-790,-7.3,32.8,0,194,194,1028
1989,44,e) 4,1235,1255,11266,12043,38,2.9,192,14.5,1714,195,1519,1.6,14.2,3268,1332,1936,11.1,27.1,-1554,-12.9,28.4,0,156,156,1183
1989,44,f) 5,1075,1100,11333,11826,27,2.3,146,12.6,1612,269,1343,2.3,13.6,2598,895,1703,7.6,22,-986,-8.4,27.2,0,108,108,696
1989,44,g) 6 to 10,3500,3685,41314,42898,120,3.2,351,9.3,5805,999,4806,2.3,13.5,8972,2472,6500,5.8,20.9,-3167,-7.4,27,0,259,260,1819
1989,44,h) 11 to 15,1305,1470,21210,21617,46,3,150,9.9,2584,472,2112,2.2,12,3398,1340,2058,6.2,15.7,-814,-3.7,24,0,93,93,831
1989,44,l) Left Censored,7352,9384,265779,267795,495,5.2,692,7.3,31823,10605,21218,4,11.9,35854,11748,24106,4.4,13.4,-4031,-1.5,23.8,0,383,409,5762
1989,45,a) 0,6006,6102,37341,18742,6059,198.6,0,0,37198,37198,0,198.5,198.5,0,0,0,0,0,37198,198.5,0,0,,,
1989,45,b) 1,5036,5139,61909,59722,46,0.8,1438,24.5,15796,1079,14717,1.8,26.4,11422,7056,4366,11.8,19.1,4374,7.3,38.2,0,1133,1133,5685
1989,45,c) 2,4468,4704,50521,53275,212,4.2,970,19,10129,2179,7950,4.1,19,15636,8931,6705,16.8,29.3,-5507,-10.3,38,0,763,763,7831
1989,45,d) 3,3801,3977,32860,33872,136,3.2,705,16.5,6412,703,5709,2.1,18.9,8436,4507,3929,13.3,24.9,-2024,-6,37.8,0,556,556,3465
1989,45,e) 4,3653,3845,34502,35360,136,3.4,505,12.5,6797,2018,4779,5.7,19.2,8513,4490,4023,12.7,24.1,-1716,-4.9,38.4,0,389,389,3833
1989,45,f) 5,3649,3963,36957,37388,119,2.9,401,9.8,5826,923,4903,2.5,15.6,6688,2552,4136,6.8,17.9,-862,-2.3,31.2,0,287,289,1849
1989,45,g) 6 to 10,9733,10616,129031,129724,400,3.7,1051,9.6,21518,5015,16503,3.9,16.6,22903,7514,15389,5.8,17.7,-1385,-1.1,33.2,0,741,741,5284
1989,45,h) 11 to 15,3479,4250,48497,49336,219,5.1,361,8.4,7190,1844,5346,3.7,14.6,8867,2903,5964,5.9,18,-1677,-3.4,29.2,0,212,216,1571
1989,45,l) Left Censored,15758,26173,770138,764747,1530,5.8,1822,6.9,98441,30406,68035,4,12.9,87659,29166,58493,3.8,11.5,10782,1.4,23,0,775,786,6944
1989,46,a) 0,1302,1307,5980,2992,1304,199.5,0,0,5977,5977,0,199.8,199.8,0,0,0,0,0,5977,199.8,0,0,,,
1989,46,b) 1,1087,1124,7632,7644,7,0.6,250,20,2005,274,1731,3.6,26.2,2029,1280,749,16.7,26.5,-24,-0.3,52.4,0,194,194,1082
1989,46,c) 2,962,988,10685,10459,48,4.4,214,19.8,2032,462,1570,4.4,19.4,1580,1031,549,9.9,15.1,452,4.3,30.2,0,168,168,913
1989,46,d) 3,822,844,5495,5616,29,3.2,131,14.6,1081,115,966,2,19.2,1323,760,563,13.5,23.6,-242,-4.4,38.4,0,107,107,678
1989,46,e) 4,881,901,5899,5906,34,3.6,111,11.8,1132,267,865,4.5,19.2,1145,444,701,7.5,19.4,-13,-0.2,38.4,0,83,83,376
1989,46,f) 5,873,899,5583,5568,30,3.2,79,8.6,940,134,806,2.4,16.9,909,278,631,5,16.3,31,0.6,32.6,0,57,57,203
1989,46,g) 6 to 10,2703,2936,27250,26896,100,3.3,267,8.8,4285,520,3765,1.9,15.9,3576,1040,2536,3.9,13.3,709,2.6,26.6,0,190,190,733
1989,46,h) 11 to 15,1128,1313,11604,11795,58,4.4,92,6.9,1657,252,1405,2.1,14,2038,587,1451,5,17.3,-381,-3.3,28,0,62,62,311
1989,46,l) Left Censored,5367,7024,122587,121594,285,4,446,6.3,14722,3058,11664,2.5,12.1,12736,4334,8402,3.6,10.5,1986,1.6,21,0,256,256,1389
1989,47,a) 0,8823,8976,62959,31600,8919,198.7,0,0,62719,62719,0,198.5,198.5,0,0,0,0,0,62719,198.5,0,0,,,
1989,47,b) 1,6785,6896,54340,55399,52,0.7,2139,26.8,16276,1217,15059,2.2,29.4,18394,11991,6403,21.6,33.2,-2118,-3.8,58.8,0,1650,1650,10291
1989,47,c) 2,6128,6448,68715,71665,266,3.8,1429,20.3,12490,2087,10403,2.9,17.4,18389,10699,7690,14.9,25.7,-5899,-8.3,34.8,0,1158,1160,8751
1989,47,d) 3,5287,5536,54506,56771,183,3.1,962,16.3,9933,1136,8797,2,17.5,14463,6130,8333,10.8,25.5,-4530,-8,35,0,749,750,4636
1989,47,e) 4,4620,4847,54815,56627,142,2.8,694,13.6,8363,913,7450,1.6,14.8,11986,4582,7404,8.1,21.2,-3623,-6.4,29.6,0,532,540,3757
1989,47,f) 5,5231,5426,50745,50978,147,2.6,591,10.5,8961,1437,7524,2.8,17.6,9426,4457,4969,8.7,18.5,-465,-0.9,35.2,0,445,446,3303
1989,47,g) 6 to 10,13745,15096,180423,180886,558,3.6,1443,9.3,28995,6825,22170,3.8,16,29921,10134,19787,5.6,16.5,-926,-0.5,32,0,1036,1084,6832
1989,47,h) 11 to 15,5313,7048,108477,106444,283,4,529,7.4,17574,3429,14145,3.2,16.5,13507,4099,9408,3.9,12.7,4067,3.8,25.4,0,319,322,2274
1989,47,l) Left Censored,23724,39044,1192752,1179490,2364,6,2819,7.2,172124,49002,123122,4.2,14.6,145599,45194,100405,3.8,12.3,26525,2.3,24.6,0,1309,1390,17030
1989,48,a) 0,30477,30942,213965,107436,30689,198.4,0,0,213059,213059,0,198.3,198.3,0,0,0,0,0,213059,198.3,0,0,,,
1989,48,b) 1,23478,24409,210734,213966,241,0.9,7292,25.9,64553,5032,59521,2.4,30.2,71017,42541,28476,19.9,33.2,-6464,-3,60.4,0,5786,5795,35573
1989,48,c) 2,20445,21528,224551,239490,828,3.5,5511,23,46962,5749,41213,2.4,19.6,76840,50156,26684,20.9,32.1,-29878,-12.5,39.2,0,4437,4457,42584
1989,48,d) 3,18595,19652,183901,189582,753,3.5,4314,20.1,42865,5987,36878,3.2,22.6,54226,28784,25442,15.2,28.6,-11361,-6,45.2,0,3364,3379,22562
1989,48,e) 4,16869,18072,167850,173650,661,3.4,3369,17.4,33530,4615,28915,2.7,19.3,45130,23541,21589,13.6,26,-11600,-6.7,38.6,0,2614,2620,17005
1989,48,f) 5,16443,17592,164553,168338,609,3.3,2845,15.2,33051,4765,28286,2.8,19.6,40620,19924,20696,11.8,24.1,-7569,-4.5,39.2,0,2111,2121,15272
1989,48,g) 6 to 10,57234,63438,667683,682795,2624,4,8094,12.2,116977,25194,91783,3.7,17.1,147201,66298,80903,9.7,21.6,-30224,-4.5,34.2,0,5621,5676,43664
1989,48,h) 11 to 15,16974,21903,280678,283781,987,4.4,2409,10.7,44911,10229,34682,3.6,15.8,51116,18521,32595,6.5,18,-6205,-2.2,31.6,0,1384,1440,9570
1989,48,l) Left Censored,64903,123384,3482263,3449442,7120,5.7,11465,9.1,543729,162580,381149,4.7,15.8,478087,159554,318533,4.6,13.9,65642,1.9,27.8,0,4347,4546,40558
1989,49,a) 0,2883,2917,21976,11080,2899,198.8,0,0,21792,21792,0,196.7,196.7,0,0,0,0,0,21792,196.7,0,0,,,
1989,49,b) 1,2265,2340,24104,23385,25,0.9,756,27.8,7770,424,7346,1.8,33.2,6332,3896,2436,16.7,27.1,1438,6.1,54.2,0,591,591,3295
1989,49,c) 2,1910,1982,18918,19190,87,4,500,22.8,4437,970,3467,5.1,23.1,4980,2829,2151,14.7,26,-543,-2.9,46.2,0,386,388,2280
1989,49,d) 3,1618,1685,20824,20779,59,3.2,327,17.9,4875,261,4614,1.3,23.5,4785,2797,1988,13.5,23,90,0.5,46,0,250,250,2179
1989,49,e) 4,1523,1623,17802,17658,71,4.1,279,16.2,3947,684,3263,3.9,22.4,3658,2031,1627,11.5,20.7,289,1.7,41.4,0,218,219,1668
1989,49,f) 5,1291,1363,13967,14265,61,4.2,226,15.6,3011,531,2480,3.7,21.1,3607,2207,1400,15.5,25.3,-596,-4.2,42.2,0,162,166,1871
1989,49,g) 6 to 10,5024,5635,70766,70839,233,4,693,11.8,13299,2553,10746,3.6,18.8,13445,5711,7734,8.1,19,-146,-0.2,37.6,0,453,458,3339
1989,49,h) 11 to 15,1799,2150,29570,29750,99,4.5,222,10,4175,703,3472,2.4,14,4535,1553,2982,5.2,15.2,-360,-1.2,28,0,126,126,678
1989,49,l) Left Censored,7179,11331,319646,313609,622,5.4,982,8.6,53745,19139,34606,6.1,17.1,41673,13163,28510,4.2,13.3,12072,3.8,26.6,0,390,460,4592
1989,50,a) 0,1918,1931,8739,4384,1921,199,0,0,8710,8710,0,198.7,198.7,0,0,0,0,0,8710,198.7,0,0,,,
1989,50,b) 1,1490,1497,8703,8772,10,0.6,398,23.4,2245,169,2076,1.9,25.6,2383,1540,843,17.6,27.2,-138,-1.6,51.2,0,300,300,1268
1989,50,c) 2,1338,1361,10242,10260,47,3.2,255,17.4,1913,433,1480,4.2,18.6,1949,961,988,9.4,19,-36,-0.4,37.2,0,197,197,790
1989,50,d) 3,1178,1196,8696,8914,27,2.1,204,15.9,1455,84,1371,0.9,16.3,1890,892,998,10,21.2,-435,-4.9,32.6,0,161,161,728
1989,50,e) 4,972,998,7617,8001,27,2.6,143,13.6,1119,120,999,1.5,14,1886,814,1072,10.2,23.6,-767,-9.6,28,0,119,119,624
1989,50,f) 5,891,932,7468,7708,25,2.5,132,13.4,1037,161,876,2.1,13.5,1517,616,901,8,19.7,-480,-6.2,27,0,103,103,534
1989,50,g) 6 to 10,2555,2693,24195,24478,83,3,275,9.9,3783,349,3434,1.4,15.5,4348,1972,2376,8.1,17.8,-565,-2.3,31,0,211,213,1146
1989,50,h) 11 to 15,955,1119,12849,12787,40,3.5,94,8.2,1663,456,1207,3.6,13,1539,484,1055,3.8,12,124,1,24,0,63,63,278
1989,50,l) Left Censored,3975,5365,129153,127036,261,4.8,360,6.7,15111,4373,10738,3.4,11.9,10877,3275,7602,2.6,8.6,4234,3.3,17.2,0,212,235,1750
1989,51,a) 0,11929,12091,74140,37162,12045,199.2,0,0,73956,73956,0,199,199,0,0,0,0,0,73956,199,0,0,,,
1989,51,b) 1,9667,9841,78077,77325,97,0.9,2663,23.8,23541,1610,21931,2.1,30.4,22037,13000,9037,16.8,28.5,1504,1.9,57,0,2064,2067,10953
1989,51,c) 2,8398,8708,81065,83655,320,3.4,1875,19.7,19133,4031,15102,4.8,22.9,24313,12087,12226,14.4,29.1,-5180,-6.2,45.8,0,1448,1448,9704
1989,51,d) 3,7529,7862,69746,71400,273,3.3,1304,15.6,13541,2224,11317,3.1,19,16849,8284,8565,11.6,23.6,-3308,-4.6,38,0,1022,1026,6484
1989,51,e) 4,6647,7159,72531,74226,282,3.8,990,13.2,12436,2246,10190,3,16.8,15825,5602,10223,7.5,21.3,-3389,-4.5,33.6,0,751,752,4228
1989,51,f) 5,5988,6234,59434,60564,188,2.9,720,11.1,10810,1723,9087,2.8,17.8,13070,4951,8119,8.2,21.6,-2260,-3.8,35.6,0,511,512,3358
1989,51,g) 6 to 10,17585,19276,248770,246875,784,4,1881,9.5,41354,8794,32560,3.6,16.8,37563,13434,24129,5.4,15.2,3791,1.6,30.4,0,1317,1323,9109
1989,51,h) 11 to 15,6157,8070,121291,120473,442,5.4,673,8.2,19351,3846,15505,3.2,16.1,17714,5482,12232,4.6,14.7,1637,1.4,29.4,0,377,383,1823
1989,51,l) Left Censored,27972,49476,1452019,1439131,3081,6.2,3446,6.9,194705,66441,128264,4.6,13.5,168929,47376,121553,3.3,11.7,25776,1.8,23.4,0,1332,1391,10846
1989,53,a) 0,8847,8948,52487,26292,8902,199,0,0,52391,52391,0,199.3,199.3,0,0,0,0,0,52391,199.3,0,0,,,
1989,53,b) 1,6591,6732,55308,57311,41,0.5,4049,46,20783,800,19983,1.4,36.3,24789,18652,6137,32.5,43.3,-4006,-7,72.6,0,1714,1715,8274
1989,53,c) 2,5915,6166,64080,69581,267,3.5,3014,39.8,14774,2308,12466,3.3,21.2,25775,19163,6612,27.5,37,-11001,-15.8,42.4,0,1258,1269,8481
1989,53,d) 3,5250,5515,78046,67947,224,3.4,2365,35.8,40540,1171,39369,1.7,59.7,20344,14277,6067,21,29.9,20196,29.8,59.8,0,872,873,4969
1989,53,e) 4,4637,4926,45901,50058,201,3.5,1801,31.4,8686,1283,7403,2.6,17.4,17000,12247,4753,24.5,34,-8314,-16.6,34.8,0,603,603,3569
1989,53,f) 5,4392,4690,45857,49915,220,4,1763,32.3,9439,1818,7621,3.6,18.9,17555,12247,5308,24.5,35.2,-8116,-16.3,37.8,0,552,554,3319
1989,53,g) 6 to 10,14780,16225,230085,218988,661,3.6,5004,27.2,80914,6643,74271,3,36.9,58719,39203,19516,17.9,26.8,22195,10.1,53.6,0,1469,1488,10112
1989,53,h) 11 to 15,5400,6779,89493,92450,370,5,1637,22.1,15231,3962,11269,4.3,16.5,21145,11696,9449,12.7,22.9,-5914,-6.4,33,0,408,409,2082
1989,53,l) Left Censored,19719,33117,895935,897462,2081,5.9,6072,17.3,143514,43819,99695,4.9,16,146569,75085,71484,8.4,16.3,-3055,-0.3,32,0,1239,1262,14261
1989,54,a) 0,2618,2648,17245,8652,2626,198.3,0,0,17186,17186,0,198.6,198.6,0,0,0,0,0,17186,198.6,0,0,,,
1989,54,b) 1,2138,2170,16515,16421,15,0.6,591,23.9,4945,300,4645,1.8,30.1,4757,3010,1747,18.3,29,188,1.1,58,0,463,463,2618
1989,54,c) 2,1920,1988,17736,18704,71,3.3,402,18.6,2868,262,2606,1.4,15.3,4803,2449,2354,13.1,25.7,-1935,-10.4,30.6,0,327,328,1907
1989,54,d) 3,1659,1746,14777,15558,59,3.2,290,15.6,2699,440,2259,2.8,17.3,4260,1804,2456,11.6,27.4,-1561,-10.1,34.6,0,233,233,1576
1989,54,e) 4,1566,1700,24761,24912,67,3.8,229,12.9,2797,796,2001,3.2,11.2,3099,1287,1812,5.2,12.4,-302,-1.2,22.4,0,164,164,939
1989,54,f) 5,1596,1628,11172,11248,41,2.4,161,9.6,1600,177,1423,1.6,14.2,1752,595,1157,5.3,15.6,-152,-1.4,28.4,0,123,123,465
1989,54,g) 6 to 10,4663,5037,49784,49202,192,3.7,472,9.1,8147,2522,5625,5.1,16.6,6982,2546,4436,5.2,14.2,1165,2.4,28.4,0,341,341,1928
1989,54,h) 11 to 15,1812,2240,24752,24444,107,4.7,190,8.3,3940,1303,2637,5.3,16.1,3323,1091,2232,4.5,13.6,617,2.5,27.2,0,120,120,474
1989,54,l) Left Censored,9743,14229,291442,292486,624,4.3,1060,7.3,33336,10326,23010,3.5,11.4,35423,10623,24800,3.6,12.1,-2087,-0.7,22.8,0,549,560,3992
1989,55,a) 0,8238,8321,48291,24307,8275,198.9,0,0,47968,47968,0,197.3,197.3,0,0,0,0,0,47968,197.3,0,0,,,
1989,55,b) 1,6663,6803,51877,50382,67,0.9,1476,19.5,15250,2122,13128,4.2,30.3,12259,7375,4884,14.6,24.3,2991,6,48.6,0,1103,1109,6309
1989,55,c) 2,6453,6857,70797,73118,257,3.5,1151,15.7,11843,1751,10092,2.4,16.2,16484,11267,5217,15.4,22.5,-4641,-6.3,32.4,0,866,866,9610
1989,55,d) 3,5352,5516,54387,54882,154,2.6,787,13.5,10504,1829,8675,3.3,19.1,11494,5989,5505,10.9,20.9,-990,-1.8,38.2,0,625,625,3718
1989,55,e) 4,5057,5404,49019,50328,163,2.9,653,11.6,7429,763,6666,1.5,14.8,10046,3835,6211,7.6,20,-2617,-5.2,29.6,0,478,478,2618
1989,55,f) 5,4824,5125,48218,48836,134,2.5,529,10,7291,1264,6027,2.6,14.9,8526,3726,4800,7.6,17.5,-1235,-2.6,29.8,0,411,411,2483
1989,55,g) 6 to 10,15184,16406,181171,181328,547,3.2,1595,9.4,26516,4340,22176,2.4,14.6,26830,9827,17003,5.4,14.8,-314,-0.2,29.2,0,1131,1134,6785
1989,55,h) 11 to 15,6157,7658,95271,94300,343,4.4,598,7.7,13848,2753,11095,2.9,14.7,11905,4504,7401,4.8,12.6,1943,2.1,25.2,0,374,375,2033
1989,55,l) Left Censored,30866,44169,1272051,1257548,1834,4.1,3030,6.8,156005,32506,123499,2.6,12.4,126999,36273,90726,2.9,10.1,29006,2.3,20.2,0,1551,1578,11129
1989,56,a) 0,949,965,4756,2386,960,199,0,0,4740,4740,0,198.7,198.7,0,0,0,0,0,4740,198.7,0,0,,,
1989,56,b) 1,783,791,5114,5029,5,0.6,206,22.9,1435,125,1310,2.5,28.5,1264,579,685,11.5,25.1,171,3.4,50.2,0,144,144,442
1989,56,c) 2,671,700,5595,5863,26,3.4,167,21.6,874,130,744,2.2,14.9,1410,867,543,14.8,24,-536,-9.1,29.8,0,132,132,739
1989,56,d) 3,678,689,3828,4021,37,5.1,117,16,673,133,540,3.3,16.7,1059,587,472,14.6,26.3,-386,-9.6,33.4,0,90,90,523
1989,56,e) 4,647,661,5185,5043,19,2.7,115,16.2,1153,76,1077,1.5,22.9,869,416,453,8.2,17.2,284,5.7,34.4,0,87,87,322
1989,56,f) 5,601,625,4602,4741,20,3,99,14.9,805,119,686,2.5,17,1084,608,476,12.8,22.9,-279,-5.9,34,0,71,71,408
1989,56,g) 6 to 10,2459,2703,19603,19729,95,3.4,290,10.4,3396,287,3109,1.5,17.2,3648,1219,2429,6.2,18.5,-252,-1.3,34.4,0,193,193,791
1989,56,h) 11 to 15,836,971,9774,9711,59,6,87,8.8,1610,300,1310,3.1,16.6,1483,501,982,5.2,15.3,127,1.3,30.6,0,55,55,330
1989,56,l) Left Censored,3075,4263,65133,65035,208,4.8,349,8.1,8526,2612,5914,4,13.1,8329,2428,5901,3.7,12.8,197,0.3,25.6,0,160,165,1026
1990,01,a) 0,6704,6791,41890,20993,6763,199.2,0,0,41794,41794,0,199.1,199.1,0,0,0,0,0,41794,199.1,0,0,,,
1990,01,b) 1,5262,5382,42580,41902,34,0.6,1340,21.9,12640,486,12154,1.2,30.2,11283,6058,5225,14.5,26.9,1357,3.3,53.8,0,1123,1123,5015
1990,01,c) 2,4452,4568,41507,43289,176,3.6,818,16.6,7723,1048,6675,2.4,17.8,11287,5439,5848,12.6,26.1,-3564,-8.3,35.6,0,701,702,4969
1990,01,d) 3,4229,4467,52290,53052,196,4.1,818,17,7961,1289,6672,2.4,15,9485,4776,4709,9,17.9,-1524,-2.9,30,0,702,710,4173
1990,01,e) 4,3685,3902,40175,40843,164,4,594,14.4,7840,1153,6687,2.8,19.2,9175,3707,5468,9.1,22.5,-1335,-3.3,38.4,0,471,472,2862
1990,01,f) 5,3215,3422,33809,34374,146,4.1,439,12.3,5670,1090,4580,3.2,16.5,6800,3192,3608,9.3,19.8,-1130,-3.3,33,0,361,361,2621
1990,01,g) 6 to 10,11556,12496,161578,158607,430,3.3,1207,9.4,30446,5757,24689,3.6,19.2,24503,10279,14224,6.5,15.4,5943,3.8,30.8,0,889,894,6138
1990,01,h) 11 to 15,5908,7508,108222,107391,266,3.5,536,7,17380,2389,14991,2.2,16.2,15717,3280,12437,3.1,14.6,1663,1.6,29.2,0,374,375,2191
1990,01,l) Left Censored,17159,28650,808239,808323,1294,4.5,2093,7.2,85722,17455,68267,2.2,10.6,85889,22291,63598,2.8,10.6,-167,0,21.2,0,897,931,7638
1990,02,a) 0,1305,1317,6218,3120,1305,198.2,0,0,6196,6196,0,198.6,198.6,0,0,0,0,0,6196,198.6,0,0,,,
1990,02,b) 1,771,779,5602,7662,5,0.6,184,20.9,1608,18,1590,0.2,21,5727,653,5074,8.5,74.7,-4119,-53.7,42,0,121,121,502
1990,02,c) 2,748,782,7444,6974,160,20.8,121,15.8,2287,1152,1135,16.5,32.8,1347,758,589,10.9,19.3,940,13.5,38.6,0,96,96,665
1990,02,d) 3,713,745,8495,8052,151,20.8,102,14,1993,1181,812,14.7,24.8,1107,613,494,7.6,13.7,886,11.1,27.4,0,76,76,394
1990,02,e) 4,692,735,5793,5763,139,19.3,112,15.5,1641,816,825,14.2,28.5,1580,1004,576,17.4,27.4,61,1.1,54.8,0,89,89,937
1990,02,f) 5,676,731,7190,6649,125,17.8,71,10.1,2226,977,1249,14.7,33.5,1144,282,862,4.2,17.2,1082,16.3,34.4,0,50,50,231
1990,02,g) 6 to 10,2229,2459,21014,19204,406,17.3,184,7.8,6561,3388,3173,17.6,34.2,2940,1039,1901,5.4,15.3,3621,18.9,30.6,0,110,110,657
1990,02,h) 11 to 15,978,1237,13996,12881,184,15.5,83,7,3978,2038,1940,15.8,30.9,1747,664,1083,5.2,13.6,2231,17.3,27.2,0,45,45,193
1990,02,l) Left Censored,2047,3304,77875,73091,354,10.9,216,6.7,16455,6421,10034,8.8,22.5,6886,2276,4610,3.1,9.4,9569,13.1,18.8,0,61,62,466
1990,04,a) 0,7783,7852,48681,24395,7826,199.3,0,0,48573,48573,0,199.1,199.1,0,0,0,0,0,48573,199.1,0,0,,,
1990,04,b) 1,6095,6264,52980,52677,60,0.8,1651,23,17012,1379,15633,2.6,32.3,16405,8901,7504,16.9,31.1,607,1.2,62.2,0,1352,1352,6964
1990,04,c) 2,4991,5160,46271,49330,281,4.9,1193,21,10538,2113,8425,4.3,21.4,16656,9035,7621,18.3,33.8,-6118,-12.4,42.8,0,986,992,7885
1990,04,d) 3,4672,4948,55079,57301,240,4.5,1018,19,9635,1426,8209,2.5,16.8,14080,6758,7322,11.8,24.6,-4445,-7.8,33.6,0,825,825,5452
1990,04,e) 4,4155,4395,39983,41760,215,4.6,764,16.3,7588,1178,6410,2.8,18.2,11141,5303,5838,12.7,26.7,-3553,-8.5,36.4,0,606,607,4298
1990,04,f) 5,3693,3914,48572,49697,206,5,621,15,8534,1676,6858,3.4,17.2,10784,4257,6527,8.6,21.7,-2250,-4.5,34.4,0,461,474,3316
1990,04,g) 6 to 10,12482,14163,179282,182308,668,4.5,1673,11.4,32359,6301,26058,3.5,17.7,38410,15743,22667,8.6,21.1,-6051,-3.4,35.4,0,1145,1160,7353
1990,04,h) 11 to 15,5135,6413,93390,94724,327,5,642,9.7,14385,3344,11041,3.5,15.2,17053,5831,11222,6.2,18,-2668,-2.8,30.4,0,394,398,3205
1990,04,l) Left Censored,11349,21988,657468,659608,1443,6.5,1839,8.3,88936,28536,60400,4.3,13.5,93216,23297,69919,3.5,14.1,-4280,-0.6,27,0,596,608,4700
1990,05,a) 0,4222,4251,24051,12076,4227,198.9,0,0,23950,23950,0,198.3,198.3,0,0,0,0,0,23950,198.3,0,0,,,
1990,05,b) 1,3133,3169,25360,25395,27,0.8,724,20.3,7747,1089,6658,4.3,30.5,7816,3432,4384,13.5,30.8,-69,-0.3,61,0,601,601,2955
1990,05,c) 2,2633,2710,23093,23386,97,3.3,509,17.3,5169,443,4726,1.9,22.1,5754,2926,2828,12.5,24.6,-585,-2.5,44.2,0,433,433,2639
1990,05,d) 3,2511,2629,26176,26749,125,4.4,453,16.1,3818,857,2961,3.2,14.3,4964,1943,3021,7.3,18.6,-1146,-4.3,28.6,0,378,378,1608
1990,05,e) 4,2158,2246,17779,18515,84,3.5,340,14.3,3044,377,2667,2,16.4,4516,1622,2894,8.8,24.4,-1472,-8,32.8,0,284,285,1371
1990,05,f) 5,2099,2191,21372,22058,88,3.9,275,12,3034,450,2584,2,13.8,4406,1982,2424,9,20,-1372,-6.2,27.6,0,221,221,1653
1990,05,g) 6 to 10,7885,8491,86500,86448,315,3.6,793,9.1,13913,2877,11036,3.3,16.1,13808,4698,9110,5.4,16,105,0.1,32,0,601,601,3354
1990,05,h) 11 to 15,4169,4880,53907,53921,205,4.1,398,8,7685,1633,6052,3,14.3,7712,2538,5174,4.7,14.3,-27,0,28.6,0,255,255,1213
1990,05,l) Left Censored,11155,16824,467673,463451,685,4,1116,6.5,52111,10785,41326,2.3,11.2,43667,9965,33702,2.2,9.4,8444,1.8,18.8,0,546,547,3195
1990,06,a) 0,64635,65212,423760,212685,64914,199.1,0,0,422150,422150,0,198.5,198.5,0,0,0,0,0,422150,198.5,0,0,,,
1990,06,b) 1,49042,49992,438838,423011,394,0.7,11415,20.3,147653,17442,130211,4.1,34.9,115999,61150,54849,14.5,27.4,31654,7.5,54.8,0,8789,8798,50065
1990,06,c) 2,41751,43055,412790,422685,2236,4.8,8206,17.7,103905,15000,88905,3.5,24.6,123696,62557,61139,14.8,29.3,-19791,-4.7,49.2,0,6497,6509,51449
1990,06,d) 3,38762,40575,499183,508481,2294,5.3,6948,16.1,87199,14602,72597,2.9,17.1,105794,51162,54632,10.1,20.8,-18595,-3.7,34.2,0,5456,5465,41366
1990,06,e) 4,33697,35732,381102,389403,1889,5,5190,13.8,80265,14988,65277,3.8,20.6,96867,46808,50059,12,24.9,-16602,-4.3,41.2,0,4005,4010,32546
1990,06,f) 5,29735,31614,361246,363743,1704,5.2,4267,12.9,71189,14249,56940,3.9,19.6,76182,31576,44606,8.7,20.9,-4993,-1.3,39.2,0,3193,3202,23646
1990,06,g) 6 to 10,108101,118713,1619850,1595324,10418,8.7,11901,9.9,321517,99868,221649,6.3,20.2,272466,101359,171107,6.4,17.1,49051,3.1,34.2,0,8352,8388,69718
1990,06,h) 11 to 15,51053,62339,946930,923868,5685,9.1,5269,8.5,184302,55903,128399,6.1,19.9,138179,40634,97545,4.4,15,46123,4.9,30,0,3138,3184,22617
1990,06,l) Left Censored,109900,195883,6089270,6071856,15205,7.8,14151,7.2,870381,268526,601855,4.4,14.3,835554,224780,610774,3.7,13.8,34827,0.5,27.6,0,5905,5986,51756
1990,08,a) 0,8330,8409,47046,23630,8373,199.1,0,0,46832,46832,0,198.2,198.2,0,0,0,0,0,46832,198.2,0,0,,,
1990,08,b) 1,6462,6560,48602,48377,46,0.6,1553,21,14691,760,13931,1.6,30.4,14241,8814,5427,18.2,29.4,450,1,58.8,0,1237,1237,7466
1990,08,c) 2,5385,5556,43175,44978,294,4.9,1073,17.9,9781,1700,8081,3.8,21.7,13386,7600,5786,16.9,29.8,-3605,-8.1,43.4,0,919,921,6919
1990,08,d) 3,4850,5083,50738,52503,251,4.6,936,17.2,9117,1803,7314,3.4,17.4,12647,6955,5692,13.2,24.1,-3530,-6.7,34.8,0,753,757,5516
1990,08,e) 4,4251,4445,38776,39636,177,3.8,675,14.3,7697,1119,6578,2.8,19.4,9416,4322,5094,10.9,23.8,-1719,-4.4,38.8,0,536,538,3252
1990,08,f) 5,4048,4230,39122,39606,186,4.2,642,14.4,6893,958,5935,2.4,17.4,7860,3892,3968,9.8,19.8,-967,-2.4,34.8,0,500,500,3237
1990,08,g) 6 to 10,14287,15647,184629,186443,646,4,1814,11.2,27899,5103,22796,2.7,15,31527,12957,18570,6.9,16.9,-3628,-1.9,30,0,1250,1263,8503
1990,08,h) 11 to 15,6623,8029,90225,89478,373,4.5,741,9,16498,4841,11657,5.4,18.4,15004,5003,10001,5.6,16.8,1494,1.6,33.6,0,448,455,2691
1990,08,l) Left Censored,15247,25513,697693,695716,1432,5.5,2118,8.2,89810,30187,59623,4.3,12.9,85857,30428,55429,4.4,12.3,3953,0.6,24.6,0,802,808,8397
1990,09,a) 0,6387,6430,34909,17513,6397,199,0,0,34793,34793,0,198.7,198.7,0,0,0,0,0,34793,198.7,0,0,,,
1990,09,b) 1,5913,6007,42941,41553,58,0.9,1408,20.8,13793,2666,11127,6.4,33.2,11017,5451,5566,13.1,26.5,2776,6.7,53,0,1085,1086,4456
1990,09,c) 2,5287,5413,47855,50096,187,3.1,1100,18.5,8792,1471,7321,2.9,17.6,13273,6210,7063,12.4,26.5,-4481,-8.9,35.2,0,891,891,5096
1990,09,d) 3,4855,5015,46364,48333,196,3.6,894,16.6,7876,1376,6500,2.8,16.3,11813,5517,6296,11.4,24.4,-3937,-8.1,32.6,0,712,712,4492
1990,09,e) 4,4105,4260,38047,40461,143,3.1,660,14.5,5047,689,4358,1.7,12.5,9875,3711,6164,9.2,24.4,-4828,-11.9,25,0,527,527,2655
1990,09,f) 5,3714,3896,37487,38695,139,3.4,499,12.2,6109,992,5117,2.6,15.8,8524,3196,5328,8.3,22,-2415,-6.2,31.6,0,381,381,2547
1990,09,g) 6 to 10,12439,13275,133708,139451,382,2.8,1304,9.5,16247,2701,13546,1.9,11.7,27733,8547,19186,6.1,19.9,-11486,-8.2,23.4,0,981,995,6652
1990,09,h) 11 to 15,6051,6967,90808,93928,231,3.2,627,8.7,11134,2070,9064,2.2,11.9,17374,6093,11281,6.5,18.5,-6240,-6.6,23.8,0,402,402,4145
1990,09,l) Left Censored,21558,30614,1014434,1027067,1320,4.3,2146,6.9,99249,28719,70530,2.8,9.7,124516,30926,93590,3,12.1,-25267,-2.4,19.4,0,999,1028,7852
1990,10,a) 0,1521,1535,7370,3698,1523,198.4,0,0,7344,7344,0,198.6,198.6,0,0,0,0,0,7344,198.6,0,0,,,
1990,10,b) 1,1234,1256,9232,8891,7,0.5,264,18.8,2856,100,2756,1.1,32.1,2173,1218,955,13.7,24.4,683,7.7,48.8,0,203,203,977
1990,10,c) 2,991,1004,10052,9593,36,3.4,150,14,3103,1143,1960,11.9,32.3,2185,1015,1170,10.6,22.8,918,9.5,45.6,0,130,130,852
1990,10,d) 3,939,965,10220,10518,39,3.9,127,12.6,1698,342,1356,3.3,16.1,2293,797,1496,7.6,21.8,-595,-5.7,32.2,0,102,102,642
1990,10,e) 4,764,803,7059,7214,36,4.3,109,12.9,1272,216,1056,3,17.6,1582,667,915,9.2,21.9,-310,-4.3,35.2,0,81,81,484
1990,10,f) 5,679,724,7637,7513,27,3.6,92,12.1,1349,240,1109,3.2,18,1101,346,755,4.6,14.7,248,3.3,29.4,0,66,66,230
1990,10,g) 6 to 10,2245,2385,27806,28168,81,3.3,241,9.8,3813,680,3133,2.4,13.5,4536,1375,3161,4.9,16.1,-723,-2.6,27,0,174,174,1055
1990,10,h) 11 to 15,1129,1338,20033,20598,46,3.4,89,6.5,2314,396,1918,1.9,11.2,3444,604,2840,2.9,16.7,-1130,-5.5,22.4,0,57,57,453
1990,10,l) Left Censored,3961,5863,213998,212370,372,6.3,374,6.4,23406,4738,18668,2.2,11,20150,4064,16086,1.9,9.5,3256,1.5,19,0,145,145,1052
1990,11,a) 0,1105,1110,7541,3773,1107,199.5,0,0,7537,7537,0,199.8,199.8,0,0,0,0,0,7537,199.8,0,0,,,
1990,11,b) 1,954,987,9113,8977,19,1.8,178,16.5,2652,363,2289,4,29.5,2379,908,1471,10.1,26.5,273,3,53,0,133,133,475
1990,11,c) 2,879,900,12602,12869,46,4.8,162,16.8,2036,558,1478,4.3,15.8,2569,1008,1561,7.8,20,-533,-4.2,31.6,0,121,121,719
1990,11,d) 3,787,810,8789,8944,47,5.4,162,18.6,1751,281,1470,3.1,19.6,2060,1174,886,13.1,23,-309,-3.4,39.2,0,129,129,1054
1990,11,e) 4,757,775,8051,8432,29,3.5,123,14.9,1236,134,1102,1.6,14.7,1997,979,1018,11.6,23.7,-761,-9,29.4,0,88,89,518
1990,11,f) 5,711,727,12806,12722,22,2.8,147,18.6,2256,638,1618,5,17.7,2087,1090,997,8.6,16.4,169,1.3,32.8,0,113,113,788
1990,11,g) 6 to 10,2747,2934,41392,42066,120,3.9,391,12.7,6301,1409,4892,3.3,15,7648,3340,4308,7.9,18.2,-1347,-3.2,30,0,286,286,1818
1990,11,h) 11 to 15,1340,1582,52322,53106,76,4.6,198,12,4558,947,3611,1.8,8.6,6126,1554,4572,2.9,11.5,-1568,-2.9,17.2,0,139,139,986
1990,11,l) Left Censored,5246,7678,256553,260128,426,5.5,609,7.8,29244,6686,22558,2.6,11.2,36393,7470,28923,2.9,14,-7149,-2.8,22.4,0,229,232,1322
1990,12,a) 0,34760,35038,204906,102697,34918,199.3,0,0,204418,204418,0,199,199,0,0,0,0,0,204418,199,0,0,,,
1990,12,b) 1,26791,27206,196569,196873,188,0.6,6827,22.1,60008,4885,55123,2.5,30.5,60615,32364,28251,16.4,30.8,-607,-0.3,61,0,5571,5571,27040
1990,12,c) 2,22791,23750,196519,203876,1022,3.9,5126,19.7,48200,7309,40891,3.6,23.6,62914,32452,30462,15.9,30.9,-14714,-7.3,47.2,0,4284,4294,27227
1990,12,d) 3,19644,20568,222207,229191,848,3.8,4039,18.1,40574,6077,34497,2.7,17.7,54541,28658,25883,12.5,23.8,-13967,-6.1,35.4,0,3321,3327,24808
1990,12,e) 4,16716,17623,163392,167360,770,4.1,2891,15.4,31089,5581,25508,3.3,18.6,39025,18438,20587,11,23.3,-7936,-4.7,37.2,0,2356,2359,15105
1990,12,f) 5,14657,15545,158154,160350,613,3.7,2247,13.7,28088,4197,23891,2.6,17.5,32479,14227,18252,8.9,20.3,-4391,-2.8,35,0,1791,1792,11224
1990,12,g) 6 to 10,49380,53262,601994,616462,1926,3.5,6245,11.2,92746,17620,75126,2.9,15,121681,44159,77522,7.2,19.7,-28935,-4.7,30,0,4753,4770,33357
1990,12,h) 11 to 15,20733,25587,348649,351540,1162,4.4,2456,9.3,56302,15803,40499,4.5,16,62084,20284,41800,5.8,17.7,-5782,-1.7,32,0,1581,1608,10698
1990,12,l) Left Censored,46439,91063,2461987,2461767,5144,5.6,6740,7.3,325863,98081,227782,4,13.2,325422,94350,231072,3.8,13.2,441,0,26.4,0,2692,2781,22348
1990,13,a) 0,12379,12450,78142,39125,12412,199.4,0,0,78035,78035,0,199.5,199.5,0,0,0,0,0,78035,199.5,0,0,,,
1990,13,b) 1,10046,10273,82690,82548,77,0.7,2567,22,24520,2230,22290,2.7,29.7,24236,13097,11139,15.9,29.4,284,0.3,58.8,0,2031,2033,10671
1990,13,c) 2,8354,8690,78794,82239,378,4,1901,20,17599,2791,14808,3.4,21.4,24489,12997,11492,15.8,29.8,-6890,-8.4,42.8,0,1573,1574,11221
1990,13,d) 3,7536,7964,115349,112560,315,3.7,1485,17.3,27790,1739,26051,1.5,24.7,22212,9566,12646,8.5,19.7,5578,5,39.4,0,1203,1204,7451
1990,13,e) 4,6872,7299,71641,74251,289,3.7,1152,14.8,12427,1794,10633,2.4,16.7,17646,7681,9965,10.3,23.8,-5219,-7.1,33.4,0,894,901,5505
1990,13,f) 5,6315,6644,65651,67020,245,3.5,934,13.3,10898,2070,8828,3.1,16.3,13636,5207,8429,7.8,20.3,-2738,-4,32.6,0,712,713,3770
1990,13,g) 6 to 10,20476,22553,262101,271135,776,3.3,2388,10.2,38446,8207,30239,3,14.2,56514,21667,34847,8,20.8,-18068,-6.6,28.4,0,1713,1738,13331
1990,13,h) 11 to 15,9503,11365,162063,162293,477,4.1,1021,8.7,26873,7193,19680,4.4,16.6,27332,8808,18524,5.4,16.8,-459,-0.2,33.2,0,630,636,4347
1990,13,l) Left Censored,27073,50365,1596487,1596440,2847,5.6,3621,7.1,207575,57144,150431,3.6,13,207481,59084,148397,3.7,13,94,0,26,0,1377,1394,13448
1990,15,a) 0,2236,2257,15203,7619,2242,198.7,0,0,15169,15169,0,199.1,199.1,0,0,0,0,0,15169,199.1,0,0,,,
1990,15,b) 1,1701,1747,19168,17707,26,1.4,292,15.3,5787,1687,4100,9.5,32.7,2864,1189,1675,6.7,16.2,2923,16.5,32.4,0,214,214,961
1990,15,c) 2,1546,1663,15156,15035,78,4.4,231,13.1,3494,488,3006,3.2,23.2,3251,1244,2007,8.3,21.6,243,1.6,43.2,0,180,180,1043
1990,15,d) 3,1290,1389,19437,19357,61,4.1,217,14.7,2959,666,2293,3.4,15.3,2798,1250,1548,6.5,14.5,161,0.8,29,0,166,166,973
1990,15,e) 4,1108,1201,12907,13108,54,4.3,168,13.4,2674,330,2344,2.5,20.4,3076,1468,1608,11.2,23.5,-402,-3.1,40.8,0,128,128,1129
1990,15,f) 5,1108,1179,13713,13853,42,3.4,131,10.7,1831,344,1487,2.5,13.2,2110,755,1355,5.5,15.2,-279,-2,26.4,0,94,94,556
1990,15,g) 6 to 10,4137,4601,51229,50983,198,4.2,418,8.8,8516,1356,7160,2.7,16.7,8024,3267,4757,6.4,15.7,492,1,31.4,0,281,281,2480
1990,15,h) 11 to 15,2026,2572,36896,36823,131,5,209,8,5620,2051,3569,5.6,15.3,5473,1760,3713,4.8,14.9,147,0.4,29.8,0,126,126,943
1990,15,l) Left Censored,5631,9153,242947,240463,391,4.2,533,5.8,28029,6024,22005,2.5,11.7,23060,7535,15525,3.1,9.6,4969,2.1,19.2,0,229,232,3027
1990,16,a) 0,2420,2443,12429,6232,2428,198.8,0,0,12395,12395,0,198.9,198.9,0,0,0,0,0,12395,198.9,0,0,,,
1990,16,b) 1,1615,1644,11249,11155,11,0.6,326,17.9,3352,130,3222,1.2,30,3164,1287,1877,11.5,28.4,188,1.6,56.8,0,249,249,1058
1990,16,c) 2,1320,1339,12366,12507,51,3.6,217,15.1,2828,239,2589,1.9,22.6,3109,1328,1781,10.6,24.9,-281,-2.3,45.2,0,166,166,1052
1990,16,d) 3,1193,1270,11251,11482,60,4.5,208,15.4,2145,356,1789,3.1,18.7,2606,1224,1382,10.7,22.7,-461,-4,37.4,0,172,172,1097
1990,16,e) 4,1158,1194,9564,9598,61,4.9,153,12.3,1772,293,1479,3.1,18.5,1839,752,1087,7.8,19.2,-67,-0.7,37,0,125,125,668
1990,16,f) 5,1064,1115,9303,9097,61,5.3,136,11.8,2035,291,1744,3.2,22.4,1622,704,918,7.7,17.8,413,4.6,35.6,0,104,110,556
1990,16,g) 6 to 10,3666,3962,38230,37881,205,5.1,356,8.8,6684,1172,5512,3.1,17.6,5985,2211,3774,5.8,15.8,699,1.8,31.6,0,257,258,1574
1990,16,h) 11 to 15,2052,2339,28499,28192,110,4.6,161,6.8,4528,732,3796,2.6,16.1,3914,1460,2454,5.2,13.9,614,2.2,27.8,0,111,113,1048
1990,16,l) Left Censored,5063,7799,163422,163104,389,5,434,5.5,19301,3381,15920,2.1,11.8,18664,4579,14085,2.8,11.4,637,0.4,22.8,0,206,206,1511
1990,17,a) 0,19506,19647,126254,63346,19538,198.9,0,0,125817,125817,0,198.6,198.6,0,0,0,0,0,125817,198.6,0,0,,,
1990,17,b) 1,15640,15885,125878,124307,119,0.7,3164,18,39546,5330,34216,4.3,31.8,36404,17627,18777,14.2,29.3,3142,2.5,58.6,0,2476,2476,13444
1990,17,c) 2,13346,13689,127920,131874,537,3.7,2218,15.1,25601,3887,21714,2.9,19.4,33509,16965,16544,12.9,25.4,-7908,-6,38.8,0,1818,1822,14614
1990,17,d) 3,12579,13190,164964,167529,529,3.8,1919,13.8,24148,2951,21197,1.8,14.4,29277,11563,17714,6.9,17.5,-5129,-3.1,28.8,0,1543,1550,9293
1990,17,e) 4,10992,11533,115102,116576,420,3.5,1458,12.1,20363,2664,17699,2.3,17.5,23311,10881,12430,9.3,20,-2948,-2.5,35,0,1144,1146,8377
1990,17,f) 5,10431,11056,122583,124027,360,3.1,1258,10.9,17976,3399,14577,2.7,14.5,20863,7943,12920,6.4,16.8,-2887,-2.3,29,0,975,978,6149
1990,17,g) 6 to 10,36772,39585,504549,506943,1197,2.9,3478,8.5,68605,12962,55643,2.6,13.5,73393,25339,48054,5,14.5,-4788,-1,27,0,2501,2509,16805
1990,17,h) 11 to 15,18304,21801,312070,313131,815,3.7,1692,7.6,43532,9223,34309,2.9,13.9,45654,13601,32053,4.3,14.6,-2122,-0.7,27.8,0,1062,1066,6876
1990,17,l) Left Censored,61465,93962,2990859,2988226,3955,4.2,6452,6.8,327707,80252,247455,2.7,11,322442,82866,239576,2.8,10.8,5265,0.2,21.6,0,2902,2936,22706
1990,18,a) 0,9172,9260,55855,28006,9214,199,0,0,55699,55699,0,198.9,198.9,0,0,0,0,0,55699,198.9,0,0,,,
1990,18,b) 1,7345,7524,63687,60681,72,0.9,1468,17.7,19546,1942,17604,3.2,32.2,13534,6373,7161,10.5,22.3,6012,9.9,44.6,0,1161,1161,5316
1990,18,c) 2,6000,6135,59234,60686,211,3.2,1097,16.5,12502,1536,10966,2.5,20.6,15406,7309,8097,12,25.4,-2904,-4.8,41.2,0,926,926,6229
1990,18,d) 3,5713,6014,67731,68256,219,3.4,913,14.3,10891,2195,8696,3.2,16,11941,5296,6645,7.8,17.5,-1050,-1.5,32,0,757,757,4045
1990,18,e) 4,5176,5481,56146,57530,172,3,724,12.5,10211,2461,7750,4.3,17.7,12979,6123,6856,10.6,22.6,-2768,-4.9,35.4,0,589,589,5020
1990,18,f) 5,4958,5315,53024,54048,183,3.3,583,10.5,8178,1784,6394,3.3,15.1,10225,3842,6383,7.1,18.9,-2047,-3.8,30.2,0,426,426,2880
1990,18,g) 6 to 10,16756,18209,204636,209001,573,3.1,1605,8.6,26877,4823,22054,2.3,12.9,35607,12056,23551,5.8,17,-8730,-4.1,25.8,0,1178,1180,7627
1990,18,h) 11 to 15,8513,10426,145279,145366,406,3.8,813,7.6,20033,4504,15529,3.1,13.8,20207,6348,13859,4.4,13.9,-174,-0.1,27.6,0,520,528,3839
1990,18,l) Left Censored,28651,46332,1426067,1422915,1970,4.2,2815,6,149850,34064,115786,2.4,10.5,143546,34673,108873,2.4,10.1,6304,0.4,20.2,0,1373,1392,9890
1990,19,a) 0,4600,4630,24857,12464,4609,199.1,0,0,24786,24786,0,198.9,198.9,0,0,0,0,0,24786,198.9,0,0,,,
1990,19,b) 1,3663,3752,26761,26232,39,0.9,736,17.8,7579,764,6815,2.9,28.9,6520,3641,2879,13.9,24.9,1059,4,49.8,0,565,565,3236
1990,19,c) 2,3024,3093,23324,24229,101,3,501,15.1,4474,482,3992,2,18.5,6283,2630,3653,10.9,25.9,-1809,-7.4,37,0,390,390,2096
1990,19,d) 3,2927,3130,52691,52954,122,3.7,456,13.8,5144,689,4455,1.3,9.7,5669,2503,3166,4.7,10.7,-525,-1,19.4,0,370,371,1940
1990,19,e) 4,2507,2592,20954,21046,81,3,317,11.7,3774,399,3375,1.9,17.9,3958,1813,2145,8.6,18.8,-184,-0.9,35.8,0,270,270,1496
1990,19,f) 5,2482,2623,24738,25492,73,2.7,285,10.4,3598,464,3134,1.8,14.1,5106,1651,3455,6.5,20,-1508,-5.9,28.2,0,213,213,1081
1990,19,g) 6 to 10,10203,11047,102246,103020,357,3.1,928,8.2,13780,2005,11775,1.9,13.4,15328,5770,9558,5.6,14.9,-1548,-1.5,26.8,0,706,710,4711
1990,19,h) 11 to 15,5564,7006,71957,72617,283,4,483,6.8,10257,2294,7963,3.2,14.1,11577,3349,8228,4.6,15.9,-1320,-1.8,28.2,0,308,310,1700
1990,19,l) Left Censored,18951,27827,659405,653774,941,3.3,1618,5.7,68671,14088,54583,2.2,10.5,57408,13444,43964,2.1,8.8,11263,1.7,17.6,0,883,889,5654
1990,20,a) 0,4535,4578,27406,13735,4547,198.6,0,0,27343,27343,0,199.1,199.1,0,0,0,0,0,27343,199.1,0,0,,,
1990,20,b) 1,3635,3684,27188,26342,37,0.9,834,20.2,8591,799,7792,3,32.6,6898,4088,2810,15.5,26.2,1693,6.4,52.4,0,680,680,3393
1990,20,c) 2,3023,3134,24763,25399,124,3.6,622,18.2,5289,937,4352,3.7,20.8,6561,3459,3102,13.6,25.8,-1272,-5,41.6,0,515,516,2781
1990,20,d) 3,2837,2958,36515,37683,108,3.4,524,16.5,3831,478,3353,1.3,10.2,6166,3158,3008,8.4,16.4,-2335,-6.2,20.4,0,422,423,2704
1990,20,e) 4,2622,2740,23845,24624,102,3.5,420,14.4,4212,1217,2995,4.9,17.1,5769,3189,2580,13,23.4,-1557,-6.3,34.2,0,317,317,2583
1990,20,f) 5,2473,2595,22227,22698,100,3.6,410,14.8,3583,730,2853,3.2,15.8,4525,2384,2141,10.5,19.9,-942,-4.1,31.6,0,334,334,1671
1990,20,g) 6 to 10,9459,10089,95413,96909,352,3.4,1082,10.3,14298,2649,11649,2.7,14.8,17289,6742,10547,7,17.8,-2991,-3,29.6,0,810,811,4272
1990,20,h) 11 to 15,4599,5713,61499,60920,191,3.3,436,7.5,9645,2215,7430,3.6,15.8,8487,2504,5983,4.1,13.9,1158,1.9,27.8,0,287,293,1599
1990,20,l) Left Censored,15468,23055,559809,555827,963,4.1,1677,7.2,63182,13838,49344,2.5,11.4,55217,15835,39382,2.8,9.9,7965,1.5,19.8,0,778,783,4463
1990,21,a) 0,6128,6167,38677,19372,6150,199.4,0,0,38610,38610,0,199.3,199.3,0,0,0,0,0,38610,199.3,0,0,,,
1990,21,b) 1,4831,4921,40772,39972,52,1,966,17.8,12704,1375,11329,3.4,31.8,11103,4697,6406,11.8,27.8,1601,4,55.6,0,781,781,4056
1990,21,c) 2,3935,4043,34356,36189,140,3.2,733,16.8,7246,1136,6110,3.1,20,10911,6309,4602,17.4,30.2,-3665,-10.2,40,0,600,600,5368
1990,21,d) 3,3674,3821,48582,47588,117,2.8,670,16.3,10748,1716,9032,3.6,22.6,8760,3867,4893,8.1,18.4,1988,4.2,36.8,0,561,561,3075
1990,21,e) 4,3293,3475,36453,36130,130,3.6,465,12.7,7127,2267,4860,6.3,19.7,6480,2462,4018,6.8,17.9,647,1.8,35.8,0,390,390,2141
1990,21,f) 5,3050,3204,34985,35982,120,3.6,411,12.2,5131,668,4463,1.9,14.3,7124,2459,4665,6.8,19.8,-1993,-5.5,28.6,0,320,320,2023
1990,21,g) 6 to 10,10708,11442,130267,132033,372,3.2,1067,9,19482,3710,15772,2.8,14.8,23014,8671,14343,6.6,17.4,-3532,-2.6,29.6,0,824,826,5589
1990,21,h) 11 to 15,5128,6119,85500,83911,240,3.8,521,8.3,13320,2857,10463,3.4,15.9,10142,3479,6663,4.1,12.1,3178,3.8,24.2,0,350,350,2240
1990,21,l) Left Censored,17283,27215,731296,727787,1218,4.4,1836,6.7,80972,20348,60624,2.8,11.1,73953,20400,53553,2.8,10.2,7019,0.9,20.4,0,877,889,5658
1990,22,a) 0,6099,6137,41595,20841,6096,198.7,0,0,41509,41509,0,199.2,199.2,0,0,0,0,0,41509,199.2,0,0,,,
1990,22,b) 1,4466,4546,39761,38338,42,0.8,1077,21,12171,1002,11169,2.6,31.7,9325,5142,4183,13.4,24.3,2846,7.4,48.6,0,857,857,4263
1990,22,c) 2,3923,4105,41606,42386,205,4.6,800,18,9763,1948,7815,4.6,23,11322,6500,4822,15.3,26.7,-1559,-3.7,46,0,666,666,5156
1990,22,d) 3,3593,3756,43464,44870,179,4.5,660,16.5,7359,1276,6083,2.8,16.4,10171,5173,4998,11.5,22.7,-2812,-6.3,32.8,0,533,534,4599
1990,22,e) 4,3585,3734,37325,37074,180,4.6,536,13.7,8269,1337,6932,3.6,22.3,7766,3799,3967,10.2,20.9,503,1.4,41.8,0,423,423,2726
1990,22,f) 5,3239,3424,30762,32114,133,3.7,498,13.8,5552,838,4714,2.6,17.3,8256,4655,3601,14.5,25.7,-2704,-8.4,34.6,0,381,383,3797
1990,22,g) 6 to 10,13871,14913,162671,161869,534,3.5,1497,9.7,28753,5078,23675,3.1,17.8,27149,9938,17211,6.1,16.8,1604,1,33.6,0,1103,1113,7020
1990,22,h) 11 to 15,6482,7657,98067,97855,292,3.7,656,8.4,15677,2008,13669,2.1,16,15252,5461,9791,5.6,15.6,425,0.4,31.2,0,460,465,2447
1990,22,l) Left Censored,18751,30797,755057,749284,1350,4.3,2375,7.6,98284,25470,72814,3.4,13.1,86738,27702,59036,3.7,11.6,11546,1.5,23.2,0,1087,1121,8251
1990,23,a) 0,2625,2637,13381,6722,2623,198.9,0,0,13318,13318,0,198.1,198.1,0,0,0,0,0,13318,198.1,0,0,,,
1990,23,b) 1,2435,2452,15380,16454,10,0.4,611,21.8,3489,418,3071,2.5,21.2,5637,2885,2752,17.5,34.3,-2148,-13.1,42.4,0,459,459,2316
1990,23,c) 2,2112,2137,15025,16072,58,2.4,508,21.3,2830,343,2487,2.1,17.6,4924,2407,2517,15,30.6,-2094,-13,35.2,0,393,393,1841
1990,23,d) 3,1964,2060,18294,19266,77,3.4,394,17.6,2560,433,2127,2.2,13.3,4504,1962,2542,10.2,23.4,-1944,-10.1,26.6,0,311,311,1645
1990,23,e) 4,1665,1726,12210,13571,57,3.1,285,15.4,1723,220,1503,1.6,12.7,4444,1402,3042,10.3,32.7,-2721,-20,25.4,0,219,219,1104
1990,23,f) 5,1401,1453,11991,12546,52,3.4,206,13.4,1963,285,1678,2.3,15.6,3073,1288,1785,10.3,24.5,-1110,-8.9,31.2,0,153,153,1108
1990,23,g) 6 to 10,4425,4735,49892,51840,136,2.8,498,10.1,5690,996,4694,1.9,11,9585,2781,6804,5.4,18.5,-3895,-7.5,22,0,351,353,2004
1990,23,h) 11 to 15,2243,2697,32811,33555,81,2.9,239,8.6,4216,824,3392,2.5,12.6,5703,1768,3935,5.3,17,-1487,-4.4,25.2,0,156,156,777
1990,23,l) Left Censored,6612,9733,245676,250111,358,3.6,675,6.8,23147,6963,16184,2.8,9.3,32016,7236,24780,2.9,12.8,-8869,-3.5,18.6,0,364,367,2917
1990,24,a) 0,9089,9143,56337,28227,9109,199.3,0,0,56221,56221,0,199.2,199.2,0,0,0,0,0,56221,199.2,0,0,,,
1990,24,b) 1,7390,7497,56459,55157,55,0.7,1655,19.7,17340,1193,16147,2.2,31.4,14736,8519,6217,15.4,26.7,2604,4.7,53.4,0,1291,1291,6932
1990,24,c) 2,6412,6559,59447,60999,251,3.6,1147,16.3,12829,1854,10975,3,21,15932,8698,7234,14.3,26.1,-3103,-5.1,42,0,919,919,7154
1990,24,d) 3,5712,5966,69770,71678,231,3.6,961,15.1,10162,1357,8805,1.9,14.2,13977,6961,7016,9.7,19.5,-3815,-5.3,28.4,0,745,745,4713
1990,24,e) 4,5177,5368,53742,54994,188,3.3,746,13.2,10163,1720,8443,3.1,18.5,12667,5422,7245,9.9,23,-2504,-4.5,37,0,552,552,4188
1990,24,f) 5,4580,4902,52256,53922,152,3,563,11,8913,1203,7710,2.2,16.5,12244,5645,6599,10.5,22.7,-3331,-6.2,33,0,422,422,4443
1990,24,g) 6 to 10,14624,15861,200896,201834,550,3.4,1455,8.9,32328,5810,26518,2.9,16,34204,10973,23231,5.4,16.9,-1876,-0.9,32,0,1025,1040,7305
1990,24,h) 11 to 15,6874,8360,121655,123488,338,4,643,7.5,15722,2932,12790,2.4,12.7,19388,5675,13713,4.6,15.7,-3666,-3,25.4,0,376,379,2988
1990,24,l) Left Censored,21945,36861,1134838,1134612,1963,5.3,2533,6.8,146792,40721,106071,3.6,12.9,146339,37983,108356,3.3,12.9,453,0,25.8,0,957,973,9281
1990,25,a) 0,10143,10208,64962,32526,10179,199.4,0,0,64872,64872,0,199.4,199.4,0,0,0,0,0,64872,199.4,0,0,,,
1990,25,b) 1,9457,9733,73270,74741,68,0.6,2223,20.3,19455,1787,17668,2.4,26,22396,9858,12538,13.2,30,-2941,-4,52,0,1699,1700,7782
1990,25,c) 2,8646,8827,86492,93587,300,3.1,2006,20.5,13666,1669,11997,1.8,14.6,27855,14161,13694,15.1,29.8,-14189,-15.2,29.2,0,1628,1628,11913
1990,25,d) 3,8159,8508,91878,97750,291,3.1,1757,18.9,11675,2274,9401,2.3,11.9,23418,10527,12891,10.8,24,-11743,-12.1,23.8,0,1395,1395,8726
1990,25,e) 4,7000,7301,73220,79198,220,2.8,1310,16.6,9810,1327,8483,1.7,12.4,21765,9032,12733,11.4,27.5,-11955,-15.1,24.8,0,1058,1058,7895
1990,25,f) 5,6356,6678,76982,80841,235,3.3,950,13.4,9037,1742,7295,2.2,11.2,16754,6152,10602,7.6,20.7,-7717,-9.5,22.4,0,757,757,4602
1990,25,g) 6 to 10,20888,22421,294629,307939,736,3.2,2398,10.3,35586,7957,27629,2.6,11.6,62207,19808,42399,6.4,20.2,-26621,-8.6,23.2,0,1791,1799,14923
1990,25,h) 11 to 15,9857,12189,210400,215851,421,3.4,1089,8.7,23634,4558,19076,2.1,10.9,34535,9077,25458,4.2,16,-10901,-5.1,21.8,0,654,655,5055
1990,25,l) Left Censored,37033,54264,1772225,1818013,2103,3.8,3897,7.1,172323,43848,128475,2.4,9.5,263898,66504,197394,3.7,14.5,-91575,-5,19,0,1870,1921,20074
1990,26,a) 0,14914,15056,88853,44541,14996,199.2,0,0,88625,88625,0,199,199,0,0,0,0,0,88625,199,0,0,,,
1990,26,b) 1,12145,12404,99835,97778,142,1,2423,17.7,31060,5955,25105,6.1,31.8,26946,11823,15123,12.1,27.6,4114,4.2,55.2,0,1845,1845,9443
1990,26,c) 2,10514,10796,97275,101173,385,3.3,1825,15.7,19408,2768,16640,2.7,19.2,27205,13053,14152,12.9,26.9,-7797,-7.7,38.4,0,1487,1487,10743
1990,26,d) 3,10357,10849,117262,119895,407,3.5,1574,13.7,17564,3373,14191,2.8,14.6,22830,9121,13709,7.6,19,-5266,-4.4,29.2,0,1234,1240,7339
1990,26,e) 4,8622,9049,90159,91035,273,2.9,1237,12.9,15505,2381,13124,2.6,17,17257,6909,10348,7.6,19,-1752,-2,34,0,972,975,5416
1990,26,f) 5,7995,8524,85840,88660,281,3.2,942,10.6,12777,1939,10838,2.2,14.4,18417,7149,11268,8.1,20.8,-5640,-6.4,28.8,0,730,730,5758
1990,26,g) 6 to 10,27236,29611,343598,351238,881,2.9,2860,9.3,46150,7642,38508,2.2,13.1,61430,19935,41495,5.7,17.5,-15280,-4.4,26.2,0,2069,2075,12913
1990,26,h) 11 to 15,13885,17128,223493,225606,664,3.8,1318,7.5,31115,6356,24759,2.8,13.8,35340,11537,23803,5.1,15.7,-4225,-1.9,27.6,0,801,807,5286
1990,26,l) Left Censored,43588,70213,2228842,2232901,2874,4,4496,6.3,247050,66389,180661,3,11.1,255168,61093,194075,2.7,11.4,-8118,-0.3,22.2,0,2167,2208,16403
1990,27,a) 0,8071,8156,49203,24656,8122,199.2,0,0,49095,49095,0,199.1,199.1,0,0,0,0,0,49095,199.1,0,0,,,
1990,27,b) 1,6435,6543,56084,51269,72,1,1205,16.8,22338,1355,20983,2.6,43.6,12708,7001,5707,13.7,24.8,9630,18.8,49.6,0,898,898,5290
1990,27,c) 2,5463,5611,45695,47145,203,3.4,874,14.6,10149,1338,8811,2.8,21.5,13049,6752,6297,14.3,27.7,-2900,-6.2,43,0,687,687,5518
1990,27,d) 3,4985,5237,68433,69352,206,3.7,730,13.2,9869,1482,8387,2.1,14.2,11707,5928,5779,8.5,16.9,-1838,-2.7,28.4,0,573,579,4644
1990,27,e) 4,4546,4836,46255,47572,191,3.8,661,13,7268,1292,5976,2.7,15.3,9902,4199,5703,8.8,20.8,-2634,-5.5,30.6,0,500,500,3170
1990,27,f) 5,4283,4581,51326,53301,118,2.5,547,11.4,7594,1177,6417,2.2,14.2,11544,3760,7784,7.1,21.7,-3950,-7.5,28.4,0,417,417,2604
1990,27,g) 6 to 10,14820,16235,201789,203493,505,3,1455,8.7,27818,3938,23880,1.9,13.7,31226,12146,19080,6,15.3,-3408,-1.6,27.4,0,1031,1045,7307
1990,27,h) 11 to 15,7810,9509,125800,125838,348,3.6,701,7.2,17163,2606,14557,2.1,13.6,17238,4499,12739,3.6,13.7,-75,-0.1,27.2,0,420,429,2458
1990,27,l) Left Censored,24695,37142,1179279,1173113,1471,3.9,2514,6.7,134578,29336,105242,2.5,11.5,122245,36232,86013,3.1,10.4,12333,1.1,20.8,0,1087,1093,8286
1990,28,a) 0,4000,4018,22354,11212,3991,198.7,0,0,22284,22284,0,198.8,198.8,0,0,0,0,0,22284,198.8,0,0,,,
1990,28,b) 1,2935,2964,22088,22729,17,0.5,809,23.7,6009,226,5783,1,26.4,7291,4636,2655,20.4,32.1,-1282,-5.7,52.8,0,675,675,4081
1990,28,c) 2,2448,2549,23300,23975,99,3.6,500,18,4734,526,4208,2.2,19.7,6084,3204,2880,13.4,25.4,-1350,-5.7,39.4,0,423,423,2745
1990,28,d) 3,2282,2416,29286,28304,128,5,410,16,6698,1027,5671,3.6,23.7,4733,2460,2273,8.7,16.7,1965,7,33.4,0,339,340,1813
1990,28,e) 4,2011,2075,17755,18254,92,4.1,372,16.7,3400,282,3118,1.5,18.6,4398,2428,1970,13.3,24.1,-998,-5.5,37.2,0,295,295,1612
1990,28,f) 5,2039,2135,19357,19814,79,3.5,285,12.7,3010,611,2399,3.1,15.2,3924,1677,2247,8.5,19.8,-914,-4.6,30.4,0,233,233,1402
1990,28,g) 6 to 10,7528,8033,79439,81269,310,3.7,790,9.5,11716,2606,9110,3.2,14.4,15376,5151,10225,6.3,18.9,-3660,-4.5,28.8,0,592,592,3204
1990,28,h) 11 to 15,3766,4488,49038,49021,166,3.6,406,8.8,7387,1542,5845,3.1,15.1,7353,2329,5024,4.8,15,34,0.1,30,0,271,271,1113
1990,28,l) Left Censored,11557,18245,463215,460031,740,4,1254,6.8,51192,11007,40185,2.4,11.1,44824,12072,32752,2.6,9.7,6368,1.4,19.4,0,579,600,3910
1990,29,a) 0,9792,9846,57726,28939,9790,198.9,0,0,57575,57575,0,199,199,0,0,0,0,0,57575,199,0,0,,,
1990,29,b) 1,7941,8104,56488,56399,59,0.6,1824,20.1,15885,1396,14489,2.5,28.2,15707,8957,6750,15.9,27.8,178,0.4,55.6,0,1442,1442,7482
1990,29,c) 2,6488,6661,54760,56766,249,3.5,1253,17.4,11435,1812,9623,3.2,20.1,15446,7917,7529,13.9,27.2,-4011,-7.1,40.2,0,1000,1000,6159
1990,29,d) 3,6168,6477,70951,72893,280,4.1,1083,15.7,11312,1803,9509,2.5,15.5,15195,7040,8155,9.7,20.8,-3883,-5.3,31,0,855,858,5778
1990,29,e) 4,5295,5554,50597,51805,188,3.2,791,13.5,8793,1777,7016,3.4,17,11209,4911,6298,9.5,21.6,-2416,-4.6,34,0,592,592,3236
1990,29,f) 5,5365,5636,57801,58694,197,3.3,666,11.3,8907,1912,6995,3.3,15.2,10693,3902,6791,6.6,18.2,-1786,-3,30.4,0,512,512,2930
1990,29,g) 6 to 10,17127,18660,201854,205181,622,3.2,1685,8.8,28421,5213,23208,2.5,13.9,35075,13180,21895,6.4,17.1,-6654,-3.2,27.8,0,1202,1213,8963
1990,29,h) 11 to 15,8655,10703,140329,139953,421,3.9,855,7.8,20314,4777,15537,3.4,14.5,19562,5611,13951,4,14,752,0.5,28,0,549,557,2719
1990,29,l) Left Censored,27703,43663,1278690,1280221,1902,4.3,2984,6.7,141757,35197,106560,2.7,11.1,144819,33599,111220,2.6,11.3,-3062,-0.2,22.2,0,1303,1314,8444
1990,30,a) 0,1867,1872,8606,4317,1859,198.6,0,0,8578,8578,0,198.7,198.7,0,0,0,0,0,8578,198.7,0,0,,,
1990,30,b) 1,1459,1502,9122,8968,19,1.1,310,18.7,2380,215,2165,2.4,26.5,2071,1062,1009,11.8,23.1,309,3.4,46.2,0,236,236,882
1990,30,c) 2,1267,1290,8487,8567,49,3.5,227,16.3,1878,184,1694,2.1,21.9,2037,866,1171,10.1,23.8,-159,-1.9,43.8,0,173,173,699
1990,30,d) 3,1187,1230,9681,9798,69,5.3,197,15.1,1816,431,1385,4.4,18.5,2050,1146,904,11.7,20.9,-234,-2.4,37,0,152,152,936
1990,30,e) 4,1116,1145,7489,7859,48,4,145,12.1,1336,164,1172,2.1,17,2075,1173,902,14.9,26.4,-739,-9.4,34,0,108,108,956
1990,30,f) 5,995,1030,8309,8093,48,4.5,121,11.3,1565,244,1321,3,19.3,1132,531,601,6.6,14,433,5.3,28,0,78,78,385
1990,30,g) 6 to 10,3870,4143,32124,32175,176,4.1,389,9.1,5450,1045,4405,3.2,16.9,5551,1814,3737,5.6,17.3,-101,-0.4,33.8,0,266,267,1387
1990,30,h) 11 to 15,2070,2399,21310,21078,96,3.9,210,8.5,3535,473,3062,2.2,16.8,3071,1307,1764,6.2,14.6,464,2.2,29.2,0,119,119,615
1990,30,l) Left Censored,4999,7052,113361,112685,238,3.3,475,6.6,11764,1904,9860,1.7,10.4,10412,3239,7173,2.9,9.2,1352,1.2,18.4,0,250,250,1047
1990,31,a) 0,2919,2943,16650,8348,2924,198.7,0,0,16605,16605,0,198.9,198.9,0,0,0,0,0,16605,198.9,0,0,,,
1990,31,b) 1,2325,2364,15988,15910,21,0.8,467,17.9,4666,172,4494,1.1,29.3,4510,2584,1926,16.2,28.3,156,1,56.6,0,362,362,2211
1990,31,c) 2,2002,2102,17497,17868,77,3.4,327,14.5,3343,663,2680,3.7,18.7,4084,1807,2277,10.1,22.9,-741,-4.2,37.4,0,265,265,1468
1990,31,d) 3,1759,1805,20294,20144,69,3.6,267,14,2948,299,2649,1.5,14.6,2648,1293,1355,6.4,13.1,300,1.5,26.2,0,221,221,1097
1990,31,e) 4,1581,1657,16049,15575,70,4,206,11.9,3060,576,2484,3.7,19.6,2111,1053,1058,6.8,13.6,949,6,27.2,0,165,165,903
1990,31,f) 5,1795,1862,19496,19449,71,3.7,173,9,2903,294,2609,1.5,14.9,2809,1161,1648,6,14.4,94,0.5,28.8,0,135,135,869
1990,31,g) 6 to 10,6188,6696,63908,64483,224,3.2,628,9.1,8412,1478,6934,2.3,13,9562,3472,6090,5.4,14.8,-1150,-1.8,26,0,423,423,2153
1990,31,h) 11 to 15,3386,4017,40772,40562,149,3.6,328,8,6299,1488,4811,3.7,15.5,5879,2177,3702,5.4,14.5,420,1,29,0,215,216,1509
1990,31,l) Left Censored,11002,15673,368156,366053,550,3.5,1013,6.4,36928,8209,28719,2.2,10.1,32722,7941,24781,2.2,8.9,4206,1.2,17.8,0,486,486,2457
1990,32,a) 0,3059,3087,21464,10749,3077,199.4,0,0,21431,21431,0,199.4,199.4,0,0,0,0,0,21431,199.4,0,0,,,
1990,32,b) 1,2344,2372,25771,24345,22,0.8,605,22.4,9342,421,8921,1.7,38.4,6490,3644,2846,15,26.7,2852,11.7,53.4,0,495,495,2704
1990,32,c) 2,1736,1774,24534,23684,68,3.5,371,19.2,7180,499,6681,2.1,30.3,5479,2862,2617,12.1,23.1,1701,7.2,46.2,0,298,298,2134
1990,32,d) 3,1582,1670,20006,21086,88,5,268,15.1,3678,463,3215,2.2,17.4,5838,2040,3798,9.7,27.7,-2160,-10.3,34.8,0,212,212,1440
1990,32,e) 4,1315,1378,21132,20960,63,4.3,204,14,3973,575,3398,2.7,19,3629,1565,2064,7.5,17.3,344,1.7,34.6,0,163,164,1292
1990,32,f) 5,1094,1167,16666,16427,65,5.4,142,11.7,3172,648,2524,3.9,19.3,2693,1101,1592,6.7,16.4,479,2.9,32.8,0,115,115,900
1990,32,g) 6 to 10,4180,4642,73977,74721,230,4.8,509,10.6,12609,2584,10025,3.5,16.9,14096,4721,9375,6.3,18.9,-1487,-2,33.8,0,363,371,3986
1990,32,h) 11 to 15,2068,2441,54973,50618,132,5.4,167,6.8,15018,1583,13435,3.1,29.7,6308,2373,3935,4.7,12.5,8710,17.2,25,0,111,111,2001
1990,32,l) Left Censored,4435,7191,277962,273462,523,7.3,474,6.6,39533,8021,31512,2.9,14.5,30532,7608,22924,2.8,11.2,9001,3.3,22.4,0,159,160,1544
1990,33,a) 0,2561,2575,13629,6826,2562,199,0,0,13606,13606,0,199.3,199.3,0,0,0,0,0,13606,199.3,0,0,,,
1990,33,b) 1,2354,2388,20347,20265,16,0.6,667,24.2,6662,787,5875,3.9,32.9,6498,3116,3382,15.4,32.1,164,0.8,64.2,0,551,551,2712
1990,33,c) 2,2199,2231,16193,18624,84,3.3,596,23.7,2441,361,2080,1.9,13.1,7303,4129,3174,22.2,39.2,-4862,-26.1,26.2,0,508,508,3447
1990,33,d) 3,2089,2145,16577,18184,51,2.1,542,22.5,2218,234,1984,1.3,12.2,5431,2627,2804,14.4,29.9,-3213,-17.7,24.4,0,449,449,2123
1990,33,e) 4,1761,1854,16267,17936,67,3.3,417,20.4,1916,320,1596,1.8,10.7,5253,2626,2627,14.6,29.3,-3337,-18.6,21.4,0,324,324,2267
1990,33,f) 5,1517,1563,14802,15493,41,2.5,243,14.5,2286,307,1979,2,14.8,3667,1402,2265,9,23.7,-1381,-8.9,29.6,0,195,195,1132
1990,33,g) 6 to 10,4390,4675,46893,49964,138,2.8,571,11.6,5006,955,4051,1.9,10,11147,3660,7487,7.3,22.3,-6141,-12.3,20,0,420,420,2565
1990,33,h) 11 to 15,2105,2505,31645,32895,96,3.7,259,10,4056,1433,2623,4.4,12.3,6555,1721,4834,5.2,19.9,-2499,-7.6,24.6,0,172,172,844
1990,33,l) Left Censored,6147,9030,268529,275192,467,5.1,660,7.2,23593,6658,16935,2.4,8.6,36919,8693,28226,3.2,13.4,-13326,-4.8,17.2,0,269,271,2369
1990,34,a) 0,15451,15547,91328,45772,15479,199.1,0,0,91113,91113,0,199.1,199.1,0,0,0,0,0,91113,199.1,0,0,,,
1990,34,b) 1,13233,13332,97072,95180,83,0.6,3123,20.7,28531,2023,26508,2.1,30,24746,12525,12221,13.2,26,3785,4,52,0,2336,2341,9590
1990,34,c) 2,12214,12379,100906,105819,452,3.3,2453,18.2,20495,2262,18233,2.1,19.4,30321,15611,14710,14.8,28.7,-9826,-9.3,38.8,0,1929,1929,11941
1990,34,d) 3,11038,11316,112771,116703,452,3.7,1936,16,17100,3404,13696,2.9,14.7,24963,11120,13843,9.5,21.4,-7863,-6.7,29.4,0,1529,1529,8727
1990,34,e) 4,9591,9884,90522,92940,349,3.3,1501,14.3,15591,1855,13736,2,16.8,20427,8319,12108,9,22,-4836,-5.2,33.6,0,1171,1172,6796
1990,34,f) 5,8527,8822,86266,89293,290,3.1,1193,12.8,14105,1948,12157,2.2,15.8,20158,7304,12854,8.2,22.6,-6053,-6.8,31.6,0,926,927,6048
1990,34,g) 6 to 10,29277,30752,346578,358673,938,2.9,3059,9.6,46028,7125,38903,2,12.8,70217,21525,48692,6,19.6,-24189,-6.8,25.6,0,2273,2273,15764
1990,34,h) 11 to 15,14053,15734,192780,196942,457,2.8,1392,8.6,25345,4874,20471,2.5,12.9,33668,10903,22765,5.5,17.1,-8323,-4.2,25.8,0,942,949,6158
1990,34,l) Left Censored,46574,67857,2078059,2100107,3017,4.4,4646,6.8,243078,72815,170263,3.5,11.6,287175,75902,211273,3.6,13.7,-44097,-2.1,23.2,0,2261,2280,17284
1990,35,a) 0,2898,2906,16462,8271,2888,198.8,0,0,16383,16383,0,198.1,198.1,0,0,0,0,0,16383,198.1,0,0,,,
1990,35,b) 1,2311,2352,17400,16774,15,0.6,565,21.2,5829,257,5572,1.5,34.8,4576,2610,1966,15.6,27.3,1253,7.5,54.6,0,448,448,2245
1990,35,c) 2,1832,1905,14202,14679,97,4.7,365,17.7,3197,543,2654,3.7,21.8,4150,2484,1666,16.9,28.3,-953,-6.5,43.6,0,307,307,2048
1990,35,d) 3,1658,1744,19560,19933,85,4.6,311,16.6,2592,450,2142,2.3,13,3337,1694,1643,8.5,16.7,-745,-3.7,26,0,244,244,1400
1990,35,e) 4,1570,1623,13734,14007,76,4.4,238,13.9,2582,450,2132,3.2,18.4,3128,1327,1801,9.5,22.3,-546,-3.9,36.8,0,180,180,963
1990,35,f) 5,1436,1544,14374,14465,84,5.2,223,13.8,2684,613,2071,4.2,18.6,2866,1395,1471,9.6,19.8,-182,-1.2,37.2,0,164,164,1010
1990,35,g) 6 to 10,5443,5915,57989,57968,256,4.2,629,10.3,10813,2432,8381,4.2,18.7,10770,4564,6206,7.9,18.6,43,0.1,37.2,0,410,411,2677
1990,35,h) 11 to 15,2676,3151,32146,32186,157,4.9,268,8.3,5143,1288,3855,4,16,5223,1719,3504,5.3,16.2,-80,-0.2,32,0,157,166,786
1990,35,l) Left Censored,6451,10086,224417,223281,482,4.7,803,7.8,27666,6627,21039,3,12.4,25394,7329,18065,3.3,11.4,2272,1,22.8,0,334,336,2159
1990,36,a) 0,35107,35241,194712,97584,35099,199.2,0,0,194257,194257,0,199.1,199.1,0,0,0,0,0,194257,199.1,0,0,,,
1990,36,b) 1,29885,30182,211043,208916,150,0.4,6810,20.1,60725,4134,56591,2,29.1,56471,28142,28329,13.5,27,4254,2.1,54,0,5286,5288,22194
1990,36,c) 2,25808,26160,207035,218946,924,3.2,5035,17.7,38252,4736,33516,2.2,17.5,62074,26625,35449,12.2,28.4,-23822,-10.9,35,0,4084,4084,21456
1990,36,d) 3,23643,24276,302513,310797,913,3.5,4138,15.9,33956,5733,28223,1.8,10.9,50524,22847,27677,7.4,16.3,-16568,-5.4,21.8,0,3382,3386,19021
1990,36,e) 4,20693,21270,169802,178281,724,3.2,3237,14.3,28213,3671,24542,2.1,15.8,45171,19649,25522,11,25.3,-16958,-9.5,31.6,0,2648,2648,16864
1990,36,f) 5,18875,19475,182395,187160,686,3.3,2709,13.2,29454,3459,25995,1.8,15.7,38983,16242,22741,8.7,20.8,-9529,-5.1,31.4,0,2108,2113,12969
1990,36,g) 6 to 10,63455,66774,747690,768084,1952,2.8,7183,10.3,97658,15212,82446,2,12.7,138446,45543,92903,5.9,18,-40788,-5.3,25.4,0,5534,5557,33343
1990,36,h) 11 to 15,29429,34319,480299,486905,1210,3.4,2947,8.3,67614,15946,51668,3.3,13.9,80825,20889,59936,4.3,16.6,-13211,-2.7,27.8,0,2056,2065,13271
1990,36,l) Left Censored,105163,148374,4496608,4526468,5343,3.5,10818,7.2,502411,112133,390278,2.5,11.1,562131,152711,409420,3.4,12.4,-59720,-1.3,22.2,0,5959,6053,48241
1990,37,a) 0,12958,13057,71547,35879,12993,199,0,0,71337,71337,0,198.8,198.8,0,0,0,0,0,71337,198.8,0,0,,,
1990,37,b) 1,10007,10212,77111,75508,84,0.7,2413,20.9,23983,2569,21414,3.4,31.8,20776,11189,9587,14.8,27.5,3207,4.3,55,0,1911,1914,9525
1990,37,c) 2,8548,8811,78499,80626,356,3.7,1692,17.7,19769,4698,15071,5.8,24.5,24023,12863,11160,16,29.8,-4254,-5.3,49,0,1384,1385,11301
1990,37,d) 3,7832,8352,89449,88797,360,4.1,1290,14.5,17983,2425,15558,2.7,20.3,16678,7638,9040,8.6,18.8,1305,1.5,37.6,0,1068,1068,6538
1990,37,e) 4,7025,7415,67086,68456,286,3.6,1102,14,11908,1663,10245,2.4,17.4,14647,6968,7679,10.2,21.4,-2739,-4,34.8,0,868,874,5261
1990,37,f) 5,6720,7113,76359,76318,293,4,837,11.3,13660,2648,11012,3.5,17.9,13578,4773,8805,6.3,17.8,82,0.1,35.6,0,635,637,3408
1990,37,g) 6 to 10,22544,24496,280286,282033,803,3.2,2153,8.5,39880,9114,30766,3.2,14.1,43374,14319,29055,5.1,15.4,-3494,-1.3,28.2,0,1500,1515,8652
1990,37,h) 11 to 15,10180,12277,167534,166908,448,3.6,893,7.1,23265,4116,19149,2.5,13.9,22012,7359,14653,4.4,13.2,1253,0.7,26.4,0,581,581,4259
1990,37,l) Left Censored,31234,54371,1759833,1753538,2598,4.7,3394,6.2,211485,54170,157315,3.1,12.1,198894,60254,138640,3.4,11.3,12591,0.8,22.6,0,1424,1444,19608
1990,38,a) 0,1221,1228,5902,2960,1219,198.5,0,0,5885,5885,0,198.8,198.8,0,0,0,0,0,5885,198.8,0,0,,,
1990,38,b) 1,937,943,5903,5943,4,0.4,191,18.2,1247,50,1197,0.8,21,1327,731,596,12.3,22.3,-80,-1.3,42,0,144,144,591
1990,38,c) 2,862,884,6201,6526,31,3.3,138,14.5,1027,63,964,1,15.7,1676,851,825,13,25.7,-649,-10,31.4,0,112,112,605
1990,38,d) 3,818,836,6755,6727,18,2,141,15.6,1131,129,1002,1.9,16.8,1074,540,534,8,16,57,0.8,32,0,124,124,502
1990,38,e) 4,724,759,5541,5588,38,4.8,92,11.6,937,245,692,4.4,16.8,1031,388,643,6.9,18.5,-94,-1.7,33.6,0,72,72,294
1990,38,f) 5,718,755,5037,5147,13,1.6,85,10.7,643,32,611,0.6,12.5,863,342,521,6.6,16.8,-220,-4.3,25,0,66,66,274
1990,38,g) 6 to 10,2843,3096,24360,24318,104,3.3,270,8.5,3621,722,2899,3,14.9,3537,1473,2064,6.1,14.5,84,0.4,29,0,213,214,1137
1990,38,h) 11 to 15,1514,1702,14859,14822,51,2.9,132,7.6,1824,173,1651,1.2,12.3,1749,609,1140,4.1,11.8,75,0.5,23.6,0,97,97,447
1990,38,l) Left Censored,4812,6647,119073,118308,189,2.8,411,6.1,11643,1528,10115,1.3,9.8,10112,2942,7170,2.5,8.5,1531,1.3,17,0,216,216,928
1990,39,a) 0,16108,16224,102590,51783,16106,198.5,0,0,101615,101615,0,196.2,196.2,0,0,0,0,0,101615,196.2,0,0,,,
1990,39,b) 1,13415,13733,121112,118057,272,1.8,2619,17.4,34478,5476,29002,4.6,29.2,28368,15192,13176,12.9,24,6110,5.2,48,0,2017,2017,11993
1990,39,c) 2,11526,11901,110393,115359,402,3.1,1984,15.5,22428,2890,19538,2.5,19.4,32360,16287,16073,14.1,28.1,-9932,-8.7,38.8,0,1642,1642,14030
1990,39,d) 3,10856,11437,124105,127534,467,3.8,1750,14.4,19791,3706,16085,2.9,15.5,26649,13567,13082,10.6,20.9,-6858,-5.4,31,0,1406,1407,11962
1990,39,e) 4,9505,10070,102095,104029,343,3.2,1322,12.5,16504,3302,13202,3.2,15.9,20372,9023,11349,8.7,19.6,-3868,-3.7,31.8,0,1085,1087,7832
1990,39,f) 5,8702,9429,115682,115922,370,3.8,1017,10.4,18262,3956,14306,3.4,15.8,18742,6379,12363,5.5,16.2,-480,-0.4,31.6,0,799,800,5076
1990,39,g) 6 to 10,31133,34208,402050,407879,1056,3,3076,8.7,52775,9698,43077,2.4,12.9,64433,23341,41092,5.7,15.8,-11658,-2.9,25.8,0,2271,2284,17090
1990,39,h) 11 to 15,16331,20267,287005,286917,712,3.4,1444,7,38918,8365,30553,2.9,13.6,38741,12422,26319,4.3,13.5,177,0.1,27,0,927,939,5858
1990,39,l) Left Censored,57017,95095,2862229,2867552,3990,4.1,6276,6.5,303495,77257,226238,2.7,10.6,314142,74281,239861,2.6,11,-10647,-0.4,21.2,0,2818,2873,21845
1990,40,a) 0,5699,5734,30540,15316,5705,199,0,0,30448,30448,0,198.8,198.8,0,0,0,0,0,30448,198.8,0,0,,,
1990,40,b) 1,4308,4351,32783,32412,23,0.5,1054,21.4,10873,1365,9508,4.2,33.5,10131,6551,3580,20.2,31.3,742,2.2,62.6,0,863,863,5817
1990,40,c) 2,3489,3574,29316,32038,143,3.7,698,18,5882,884,4998,2.8,18.4,11326,4724,6602,14.7,35.4,-5444,-17,36.8,0,580,580,3933
1990,40,d) 3,3085,3255,40549,40242,164,4.7,564,16.3,7338,1619,5719,4,18.2,6723,2864,3859,7.1,16.7,615,1.5,33.4,0,456,458,2261
1990,40,e) 4,2969,3089,27523,27982,133,4.1,461,14.1,4811,823,3988,2.9,17.2,5728,2865,2863,10.2,20.5,-917,-3.3,34.4,0,379,379,2329
1990,40,f) 5,2879,3020,25556,25690,120,3.8,452,14.1,4557,817,3740,3.2,17.7,4825,2151,2674,8.4,18.8,-268,-1.1,35.4,0,350,350,1718
1990,40,g) 6 to 10,11741,12660,129923,128739,520,4,1334,10.2,21845,3276,18569,2.5,17,19477,6785,12692,5.3,15.1,2368,1.9,30.2,0,949,949,4421
1990,40,h) 11 to 15,5322,6320,68297,67574,281,4.3,593,9.2,10975,2786,8189,4.1,16.2,9528,3286,6242,4.9,14.1,1447,2.1,28.2,0,393,394,1749
1990,40,l) Left Censored,15005,23910,554741,551545,986,4,1858,7.6,63229,15293,47936,2.8,11.5,56836,18495,38341,3.4,10.3,6393,1.2,20.6,0,851,860,5730
1990,41,a) 0,7420,7452,42000,21060,7423,199.2,0,0,41880,41880,0,198.9,198.9,0,0,0,0,0,41880,198.9,0,0,,,
1990,41,b) 1,4508,4557,33212,32532,48,0.9,1010,19.8,10179,1235,8944,3.8,31.3,8818,4373,4445,13.4,27.1,1361,4.2,54.2,0,779,779,3388
1990,41,c) 2,4491,4564,34190,35356,748,16.4,684,15,10062,4888,5174,13.8,28.5,12394,4303,8091,12.2,35.1,-2332,-6.6,57,0,544,544,3545
1990,41,d) 3,4117,4296,45100,43806,661,15.4,601,14,11063,5114,5949,11.7,25.3,8474,3194,5280,7.3,19.3,2589,6,38.6,0,456,456,2347
1990,41,e) 4,3586,3709,31361,31547,558,15.3,430,11.8,8743,4218,4525,13.4,27.7,9114,2885,6229,9.1,28.9,-371,-1.2,55.4,0,342,351,2500
1990,41,f) 5,3107,3280,31296,30024,456,14.1,345,10.7,8043,3672,4371,12.2,26.8,5499,2132,3367,7.1,18.3,2544,8.5,36.6,0,268,268,1743
1990,41,g) 6 to 10,11562,12523,135958,133008,1766,14.5,1086,8.9,30400,15378,15022,11.6,22.9,24500,7428,17072,5.6,18.4,5900,4.5,36.8,0,770,775,4900
1990,41,h) 11 to 15,5767,6819,81033,79276,912,13.7,539,8.1,18076,8752,9324,11,22.8,14562,5771,8791,7.3,18.4,3514,4.4,36.8,0,332,347,2755
1990,41,l) Left Censored,14645,23181,567893,556221,2412,10.6,1499,6.6,91142,36904,54238,6.6,16.4,67798,20321,47477,3.7,12.2,23344,4.2,24.4,0,639,641,6702
1990,42,a) 0,18875,19008,109405,54832,18934,199.2,0,0,109147,109147,0,199.1,199.1,0,0,0,0,0,109147,199.1,0,0,,,
1990,42,b) 1,16212,16510,126202,124179,145,0.8,3102,17.1,34996,4045,30951,3.3,28.2,30949,16043,14906,12.9,24.9,4047,3.3,49.8,0,2414,2420,13495
1990,42,c) 2,14063,14438,119055,123314,500,3.2,2347,15.2,23501,2964,20537,2.4,19.1,32019,14819,17200,12,26,-8518,-6.9,38.2,0,1914,1917,12416
1990,42,d) 3,13339,13891,143790,147082,505,3.4,1879,12.8,20859,3397,17462,2.3,14.2,27443,12496,14947,8.5,18.7,-6584,-4.5,28.4,0,1519,1519,9917
1990,42,e) 4,11738,12215,118916,120907,392,3.1,1414,11.1,18495,2292,16203,1.9,15.3,22477,8268,14209,6.8,18.6,-3982,-3.3,30.6,0,1115,1115,5970
1990,42,f) 5,10484,11086,132048,134408,365,3.2,1192,10.3,17874,2649,15225,2,13.3,22593,9398,13195,7,16.8,-4719,-3.5,26.6,0,912,912,6616
1990,42,g) 6 to 10,36063,38867,464918,470235,1182,3,3403,8.5,63237,9500,53737,2,13.4,73870,27465,46405,5.8,15.7,-10633,-2.3,26.8,0,2459,2477,17525
1990,42,h) 11 to 15,18239,21911,298987,300095,764,3.4,1553,7,38821,8177,30644,2.7,12.9,41036,12123,28913,4,13.7,-2215,-0.8,25.8,0,1016,1026,6536
1990,42,l) Left Censored,65261,102367,3042947,3041915,4189,4,6545,6.3,325839,68415,257424,2.2,10.7,323776,77769,246007,2.6,10.6,2063,0.1,21.2,0,3248,3269,24699
1990,44,a) 0,2027,2036,10675,5341,2029,199.3,0,0,10668,10668,0,199.7,199.7,0,0,0,0,0,10668,199.7,0,0,,,
1990,44,b) 1,1806,1833,14342,15088,11,0.5,458,22,2997,203,2794,1.3,19.9,4489,1877,2612,12.4,29.8,-1492,-9.9,39.8,0,363,363,1508
1990,44,c) 2,1601,1630,10898,12236,54,3,354,19.8,2099,198,1901,1.6,17.2,4775,2194,2581,17.9,39,-2676,-21.8,34.4,0,278,278,1423
1990,44,d) 3,1458,1502,13046,14044,46,2.8,292,17.9,1578,156,1422,1.1,11.2,3574,1678,1896,11.9,25.4,-1996,-14.2,22.4,0,241,242,1478
1990,44,e) 4,1195,1235,9608,9950,30,2.3,188,14.2,1733,111,1622,1.1,17.4,2416,1073,1343,10.8,24.3,-683,-6.9,34.8,0,155,155,921
1990,44,f) 5,1088,1109,9799,10477,34,2.9,165,14,1150,148,1002,1.4,11,2506,1221,1285,11.7,23.9,-1356,-12.9,22,0,126,126,862
1990,44,g) 6 to 10,3601,3787,41913,43520,112,2.8,370,9.4,6265,1540,4725,3.5,14.4,9478,2754,6724,6.3,21.8,-3213,-7.4,28.8,0,282,282,1587
1990,44,h) 11 to 15,1833,2041,26910,27624,72,3.4,178,8.4,3555,477,3078,1.7,12.9,4982,1827,3155,6.6,18,-1427,-5.1,25.8,0,117,117,641
1990,44,l) Left Censored,7021,9061,255178,260241,306,3.3,599,6.5,21761,5806,15955,2.2,8.4,31887,6851,25036,2.6,12.3,-10126,-3.9,16.8,0,321,321,2444
1990,45,a) 0,6216,6261,38226,19157,6229,199,0,0,38138,38138,0,199.1,199.1,0,0,0,0,0,38138,199.1,0,0,,,
1990,45,b) 1,4777,4898,38932,37932,52,0.9,1089,19.8,12421,1099,11322,2.9,32.7,10420,5269,5151,13.9,27.5,2001,5.2,55,0,880,880,4582
1990,45,c) 2,4278,4424,62641,61996,188,3.9,811,17,11422,1320,10102,2.1,18.4,10132,4969,5163,8,16.3,1290,2.1,32.6,0,677,677,4157
1990,45,d) 3,3915,4150,49528,49601,183,4.1,671,15.2,9046,1367,7679,2.8,18.2,9192,4241,4951,8.6,18.5,-146,-0.3,36.4,0,543,544,3006
1990,45,e) 4,3398,3569,30732,31470,145,3.8,522,13.9,6369,826,5543,2.6,20.2,7844,3313,4531,10.5,24.9,-1475,-4.7,40.4,0,412,412,2831
1990,45,f) 5,3293,3492,33980,34163,123,3.4,444,12.1,6247,1166,5081,3.4,18.3,6613,3129,3484,9.2,19.4,-366,-1.1,36.6,0,335,335,2314
1990,45,g) 6 to 10,10837,11860,137438,138664,429,3.5,1177,9.6,22783,6054,16729,4.4,16.4,25234,10906,14328,7.9,18.2,-2451,-1.8,32.8,0,834,839,5989
1990,45,h) 11 to 15,4926,5910,75732,74705,259,4.3,478,7.9,12337,2354,9983,3.2,16.5,10282,3028,7254,4.1,13.8,2055,2.7,27.6,0,318,328,1929
1990,45,l) Left Censored,15027,25625,779623,776373,1215,4.7,1719,6.6,86652,21821,64831,2.8,11.2,80153,19878,60275,2.6,10.3,6499,0.9,20.6,0,754,757,5247
1990,46,a) 0,1592,1597,8297,4179,1587,198.7,0,0,8237,8237,0,197.1,197.1,0,0,0,0,0,8237,197.1,0,0,,,
1990,46,b) 1,1074,1079,6418,6167,5,0.4,212,17.8,1694,61,1633,1,27.5,1192,629,563,10.2,19.3,502,8.2,38.6,0,163,163,550
1990,46,c) 2,950,989,6650,7137,29,2.7,149,14.1,1065,119,946,1.7,14.9,2038,986,1052,13.8,28.6,-973,-13.7,29.8,0,120,120,821
1990,46,d) 3,848,874,10298,10431,31,3.3,129,13.9,1125,155,970,1.5,10.8,1390,509,881,4.9,13.3,-265,-2.5,21.6,0,100,100,388
1990,46,e) 4,747,768,5994,5669,25,3.1,85,10.6,1510,342,1168,6,26.6,859,370,489,6.5,15.2,651,11.4,30.4,0,64,64,283
1990,46,f) 5,808,836,6237,6098,36,4.1,95,10.9,1143,160,983,2.6,18.7,865,302,563,5,14.2,278,4.5,28.4,0,77,77,261
1990,46,g) 6 to 10,2841,3083,26722,26358,119,3.7,292,9.2,4256,619,3637,2.3,16.1,3528,1337,2191,5.1,13.4,728,2.7,26.8,0,214,214,954
1990,46,h) 11 to 15,1546,1768,17640,17818,55,3,140,7.7,2570,404,2166,2.3,14.4,2926,1508,1418,8.5,16.4,-356,-2,28.8,0,96,96,377
1990,46,l) Left Censored,5127,6803,124047,122924,243,3.5,440,6.4,14904,3827,11077,3.1,12.1,12658,4442,8216,3.6,10.3,2246,1.8,20.6,0,247,248,1826
1990,47,a) 0,8606,8707,57951,29102,8669,199.1,0,0,57698,57698,0,198.3,198.3,0,0,0,0,0,57698,198.3,0,0,,,
1990,47,b) 1,6833,7036,59853,61209,67,0.8,1778,22.2,16104,963,15141,1.6,26.3,18816,10270,8546,16.8,30.7,-2712,-4.4,52.6,0,1481,1481,8210
1990,47,c) 2,5702,5862,53363,53558,290,4.5,1196,18.8,14127,3242,10885,6.1,26.4,14517,7585,6932,14.2,27.1,-390,-0.7,52.8,0,1012,1012,6656
1990,47,d) 3,5274,5608,65408,66620,243,4,1007,16.7,10126,2002,8124,3,15.2,12549,6544,6005,9.8,18.8,-2423,-3.6,30.4,0,798,800,4850
1990,47,e) 4,4741,5021,50134,52021,221,4.2,705,13.4,8261,1474,6787,2.8,15.9,12034,4337,7697,8.3,23.1,-3773,-7.2,31.8,0,560,560,3557
1990,47,f) 5,4194,4417,46475,46992,163,3.5,556,12,7772,1449,6323,3.1,16.5,8805,3853,4952,8.2,18.7,-1033,-2.2,33,0,440,444,3075
1990,47,g) 6 to 10,15192,16520,194074,195967,526,3.1,1633,9.5,28805,5723,23082,2.9,14.7,32591,12622,19969,6.4,16.6,-3786,-1.9,29.4,0,1193,1195,7946
1990,47,h) 11 to 15,7413,9412,138985,139959,401,4.2,752,7.8,20168,5027,15141,3.6,14.4,22115,5620,16495,4,15.8,-1947,-1.4,28.8,0,459,465,3125
1990,47,l) Left Censored,22548,38170,1197047,1200000,1760,4.6,2623,6.8,132772,31006,101766,2.6,11.1,138678,36505,102173,3,11.6,-5906,-0.5,22.2,0,1106,1108,8042
1990,48,a) 0,32363,32756,231868,116156,32607,199.1,0,0,231425,231425,0,199.2,199.2,0,0,0,0,0,231425,199.2,0,0,,,
1990,48,b) 1,24072,24697,221941,216726,274,1,5793,20.8,71588,7131,64457,3.3,33,61158,33686,27472,15.5,28.2,10430,4.8,56.4,0,4728,4728,28907
1990,48,c) 2,19745,20753,194450,200500,945,4.2,4147,18.4,46572,7811,38761,3.9,23.2,58674,32615,26059,16.3,29.3,-12102,-6.1,46.4,0,3406,3420,26698
1990,48,d) 3,17543,18656,218212,220511,862,4.3,3525,17.6,42694,5957,36737,2.7,19.4,47291,25211,22080,11.4,21.4,-4597,-2,38.8,0,2814,2822,20741
1990,48,e) 4,16395,17530,183488,182257,880,4.7,2838,15.3,51764,6247,45517,3.4,28.4,49302,25930,23372,14.2,27.1,2462,1.3,54.2,0,2244,2246,19799
1990,48,f) 5,15052,16258,160253,163145,751,4.4,2479,14.5,32288,7327,24961,4.5,19.8,38072,18079,19993,11.1,23.3,-5784,-3.5,39.6,0,1893,1901,13891
1990,48,g) 6 to 10,58688,64643,694928,702579,2679,4,7328,10.9,122496,26005,96491,3.7,17.4,137797,55294,82503,7.9,19.6,-15301,-2.2,34.8,0,5283,5333,34862
1990,48,h) 11 to 15,25130,31713,400617,399549,1499,4.6,2814,8.7,67776,17060,50716,4.3,17,65639,21731,43908,5.4,16.4,2137,0.6,32.8,0,1788,1815,11967
1990,48,l) Left Censored,61042,119850,3495636,3492730,6186,5.1,9836,8.1,464149,116633,347516,3.3,13.3,458338,155762,302576,4.5,13.1,5811,0.2,26.2,0,3809,3966,29347
1990,49,a) 0,2935,2965,20299,10156,2957,199.5,0,0,20287,20287,0,199.8,199.8,0,0,0,0,0,20287,199.8,0,0,,,
1990,49,b) 1,2329,2371,23845,22362,21,0.8,487,18.4,8375,613,7762,2.7,37.5,5409,2927,2482,13.1,24.2,2966,13.3,48.4,0,378,378,2478
1990,49,c) 2,1931,2017,24523,24189,98,4.5,380,17.5,5676,511,5165,2.1,23.5,5007,2496,2511,10.3,20.7,669,2.8,41.4,0,307,307,2147
1990,49,d) 3,1649,1722,18687,18619,77,4.2,306,16.6,4027,514,3513,2.8,21.6,3891,2072,1819,11.1,20.9,136,0.7,41.8,0,244,244,1766
1990,49,e) 4,1453,1524,20135,20381,75,4.7,215,13.4,3487,476,3011,2.3,17.1,3978,1844,2134,9,19.5,-491,-2.4,34.2,0,191,191,1702
1990,49,f) 5,1367,1479,18979,18346,66,4.3,205,13.2,4618,773,3845,4.2,25.2,3351,1229,2122,6.7,18.3,1267,6.9,36.6,0,160,160,964
1990,49,g) 6 to 10,4993,5571,71328,71727,235,4.1,551,9.6,11196,2013,9183,2.8,15.6,11993,5257,6736,7.3,16.7,-797,-1.1,31.2,0,382,382,3300
1990,49,h) 11 to 15,2602,3020,43078,42567,130,4.2,304,9.7,6582,1241,5341,2.9,15.5,5559,2068,3491,4.9,13.1,1023,2.4,26.2,0,177,184,1413
1990,49,l) Left Censored,6865,11091,324133,322327,547,4.9,777,6.9,42151,10317,31834,3.2,13.1,38539,11434,27105,3.5,12,3612,1.1,24,0,320,325,2302
1990,50,a) 0,1604,1618,7303,3670,1610,199,0,0,7267,,,,198,0,0,0,0,0,7267,198,0,1,,,
1990,50,b) 1,1527,1543,9494,9086,4,0.2,351,20.2,3036,,,,33.4,2220,990,1230,10.9,24.4,816,9,48.8,1,271,271,825
1990,50,c) 2,1262,1270,7739,8200,36,2.6,245,17.7,1544,187,1357,2.3,18.8,2465,1148,1317,14,30.1,-921,-11.3,37.6,0,202,202,1033
1990,50,d) 3,1166,1187,9107,9645,52,4.1,214,16.8,1090,200,890,2.1,11.3,2165,945,1220,9.8,22.4,-1075,-11.1,22.6,0,166,166,743
1990,50,e) 4,1029,1051,7630,8159,28,2.5,163,14.5,987,133,854,1.6,12.1,2044,1011,1033,12.4,25.1,-1057,-13,24.2,0,141,141,917
1990,50,f) 5,854,884,7008,7292,22,2.3,131,13.9,827,120,707,1.6,11.3,1395,564,831,7.7,19.1,-568,-7.8,22.6,0,99,99,408
1990,50,g) 6 to 10,2796,2951,24866,25352,70,2.3,269,8.8,3107,237,2870,0.9,12.3,4079,1232,2847,4.9,16.1,-972,-3.8,24.6,0,213,213,1054
1990,50,h) 11 to 15,1307,1504,18298,18634,46,3,107,7,2244,493,1751,2.6,12,2915,591,2324,3.2,15.6,-671,-3.6,24,0,72,74,378
1990,50,l) Left Censored,3796,5207,124171,126060,167,3.2,309,5.8,11651,2202,9449,1.7,9.2,15428,4520,10908,3.6,12.2,-3777,-3,18.4,0,164,164,1035
1990,51,a) 0,11957,12046,65490,32863,12002,199.3,0,0,65254,65254,0,198.6,198.6,0,0,0,0,0,65254,198.6,0,0,,,
1990,51,b) 1,9454,9661,75255,74394,92,0.8,2291,21.1,22022,1458,20564,2,29.6,20300,10568,9732,14.2,27.3,1722,2.3,54.6,0,1825,1826,9075
1990,51,c) 2,8250,8469,73186,75234,362,4,1560,17.1,15193,2411,12782,3.2,20.2,19288,8900,10388,11.8,25.6,-4095,-5.4,40.4,0,1246,1249,7146
1990,51,d) 3,7336,7671,76515,78476,317,3.9,1286,15.7,13720,2426,11294,3.1,17.5,17641,8743,8898,11.1,22.5,-3921,-5,35,0,1035,1036,7229
1990,51,e) 4,6739,7091,66114,67712,290,3.9,1001,13.4,12763,2808,9955,4.1,18.8,15958,6182,9776,9.1,23.6,-3195,-4.8,37.6,0,765,770,4476
1990,51,f) 5,6058,6620,69962,71485,266,3.9,774,11.2,11895,2354,9541,3.3,16.6,14941,5034,9907,7,20.9,-3046,-4.3,33.2,0,594,594,3790
1990,51,g) 6 to 10,19051,20631,260218,260810,739,3.5,1974,9.3,42332,5890,36442,2.3,16.2,43516,14882,28634,5.7,16.7,-1184,-0.5,32.4,0,1407,1423,9683
1990,51,h) 11 to 15,8851,11242,165525,167817,464,4.1,833,7.3,22338,5594,16744,3.3,13.3,26922,7281,19641,4.3,16,-4584,-2.7,26.6,0,499,500,2681
1990,51,l) Left Censored,26724,49042,1458230,1453939,2863,5.8,3198,6.5,180107,55991,124116,3.9,12.4,171524,44893,126631,3.1,11.8,8583,0.6,23.6,0,1217,1245,9266
1990,53,a) 0,13352,13471,72847,36515,13412,199.1,0,0,72664,72664,0,199,199,0,0,0,0,0,72664,199,0,0,,,
1990,53,b) 1,7165,7305,57991,54896,68,0.8,1507,18.6,19505,1982,17523,3.6,35.5,13315,7735,5580,14.1,24.3,6190,11.2,48.6,0,1148,1148,6454
1990,53,c) 2,7123,7299,60149,56879,1654,23.6,967,13.8,22382,12001,10381,21.1,39.4,15842,5334,10508,9.4,27.9,6540,11.5,55.8,0,736,736,4090
1990,53,d) 3,6489,6793,74309,69765,1464,22.6,787,12.2,21944,11473,10471,16.4,31.5,12856,7693,5163,11,18.4,9088,13.1,36.8,0,627,627,4015
1990,53,e) 4,5839,6153,56612,67202,1314,22.6,644,11.1,18845,9604,9241,14.3,28,40025,3622,36403,5.4,59.6,-21180,-31.6,56,0,494,494,2328
1990,53,f) 5,5172,5503,54913,50352,1106,21.2,513,9.8,16734,9520,7214,18.9,33.2,7611,3467,4144,6.9,15.1,9123,18.1,30.2,0,383,384,2580
1990,53,g) 6 to 10,18730,20377,231951,230892,3977,20.7,1606,8.4,65761,37523,28238,16.3,28.5,63642,34120,29522,14.8,27.6,2119,0.9,55.2,0,1103,1109,30952
1990,53,h) 11 to 15,9053,10793,135928,136728,1922,18.8,747,7.3,32978,17405,15573,12.7,24.1,34577,23506,11071,17.2,25.3,-1599,-1.2,48.2,0,458,459,20469
1990,53,l) Left Censored,21884,35737,964890,930036,4783,13.9,2140,6.2,175397,68190,107207,7.3,18.9,105690,42790,62900,4.6,11.4,69707,7.5,22.8,0,776,792,6079
1990,54,a) 0,2708,2713,15091,7555,2702,199.2,0,0,15072,15072,0,199.5,199.5,0,0,0,0,0,15072,199.5,0,0,,,
1990,54,b) 1,2104,2146,17770,17431,25,1,452,18.9,5026,391,4635,2.2,28.8,4347,1964,2383,11.3,24.9,679,3.9,49.8,0,360,360,1639
1990,54,c) 2,1774,1810,14263,15242,62,3.1,365,18.4,2562,464,2098,3,16.8,4519,2415,2104,15.8,29.6,-1957,-12.8,33.6,0,289,289,1891
1990,54,d) 3,1682,1753,17279,17597,78,4.2,292,15.6,2828,551,2277,3.1,16.1,3464,1569,1895,8.9,19.7,-636,-3.6,32.2,0,233,233,1102
1990,54,e) 4,1467,1565,14219,14487,56,3.4,232,14,2570,714,1856,4.9,17.7,3105,1374,1731,9.5,21.4,-535,-3.7,35.4,0,191,191,1094
1990,54,f) 5,1410,1559,23926,24272,58,3.6,180,11,2309,610,1699,2.5,9.5,3001,1094,1907,4.5,12.4,-692,-2.9,19,0,151,151,944
1990,54,g) 6 to 10,5069,5410,52309,52385,181,3.2,479,8.6,7565,890,6675,1.7,14.4,7716,3044,4672,5.8,14.7,-151,-0.3,28.8,0,360,360,2382
1990,54,h) 11 to 15,2519,3035,32312,32584,141,4.6,237,7.7,4369,968,3401,3,13.4,4913,1660,3253,5.1,15.1,-544,-1.7,26.8,0,171,171,1145
1990,54,l) Left Censored,9242,13786,295214,293410,541,3.9,942,6.7,34180,7949,26231,2.7,11.6,30571,9564,21007,3.3,10.4,3609,1.2,20.8,0,504,509,3763
1990,55,a) 0,8489,8579,50117,25122,8533,198.9,0,0,49990,49990,0,199,199,0,0,0,0,0,49990,199,0,0,,,
1990,55,b) 1,6845,6973,49502,48452,55,0.7,1228,16.1,13265,1068,12197,2.2,27.4,11164,5650,5514,11.7,23,2101,4.4,46,0,970,970,4941
1990,55,c) 2,5829,5956,49235,50464,180,2.8,946,14.8,9205,1196,8009,2.4,18.2,11663,6189,5474,12.3,23.1,-2458,-4.9,36.4,0,748,749,4533
1990,55,d) 3,5780,6173,68716,69501,247,3.8,852,13.1,9890,1376,8514,2,14.2,11460,5979,5481,8.6,16.5,-1570,-2.3,28.4,0,646,653,4418
1990,55,e) 4,4838,5020,53983,54040,155,2.9,610,11.6,9416,1994,7422,3.7,17.4,9530,3965,5565,7.3,17.6,-114,-0.2,34.8,0,499,499,3061
1990,55,f) 5,4611,4972,49215,49232,144,2.8,565,10.9,7496,1393,6103,2.8,15.2,7530,3053,4477,6.2,15.3,-34,-0.1,30.4,0,431,431,2175
1990,55,g) 6 to 10,16045,17355,195803,196782,524,2.9,1477,8.3,26561,4701,21860,2.4,13.5,28519,10695,17824,5.4,14.5,-1958,-1,27,0,1064,1077,7126
1990,55,h) 11 to 15,8624,10417,128453,128386,398,3.7,770,7.2,16742,3306,13436,2.6,13,16608,5900,10708,4.6,12.9,134,0.1,25.8,0,465,466,3513
1990,55,l) Left Censored,29535,43141,1285694,1278998,1548,3.5,2525,5.8,133834,32048,101786,2.5,10.5,120442,29767,90675,2.3,9.4,13392,1.1,18.8,0,1277,1285,8754
1990,56,a) 0,1060,1064,4655,2344,1058,198.9,0,0,4623,,,,197.2,0,0,0,0,0,4623,197.2,0,1,,,
1990,56,b) 1,764,781,5251,4970,7,0.8,165,18.9,1969,,,,39.6,1406,936,470,18.8,28.3,563,11.3,56.6,1,113,113,431
1990,56,c) 2,679,689,4772,4932,35,4.7,122,16.5,1062,118,944,2.4,21.5,1381,916,465,18.6,28,-319,-6.5,43,0,91,91,525
1990,56,d) 3,604,637,5626,5638,33,4.9,91,13.6,913,174,739,3.1,16.2,936,424,512,7.5,16.6,-23,-0.4,32.4,0,73,73,322
1990,56,e) 4,588,598,3708,3744,19,3,100,15.5,674,93,581,2.5,18,746,387,359,10.3,19.9,-72,-1.9,36,0,81,81,302
1990,56,f) 5,596,608,4711,4947,27,4.3,79,12.5,650,96,554,1.9,13.1,1121,374,747,7.6,22.7,-471,-9.6,26.2,0,56,56,216
1990,56,g) 6 to 10,2417,2648,20160,19875,97,3.6,251,9.2,3606,399,3207,2,18.1,3035,1164,1871,5.9,15.3,571,2.8,30.6,0,183,183,915
1990,56,h) 11 to 15,1235,1404,13789,13601,52,3.6,124,8.6,2344,194,2150,1.4,17.2,1968,693,1275,5.1,14.5,376,2.7,29,0,85,85,549
1990,56,l) Left Censored,2925,4105,66698,66369,157,3.8,321,7.7,8127,1900,6227,2.9,12.2,7469,2654,4815,4,11.3,658,0.9,22.6,0,141,142,689
1991,01,a) 0,6511,6616,40036,20106,6561,198.3,0,0,39860,39860,0,198.2,198.2,0,0,0,0,0,39860,198.2,0,0,,,
1991,01,b) 1,5296,5422,40270,40529,63,1,1309,21.5,11945,1318,10627,3.3,29.5,12462,6751,5711,16.7,30.7,-517,-1.2,59,0,951,952,5149
1991,01,c) 2,4464,4601,38775,40564,128,2.6,900,18,8601,1172,7429,2.9,21.2,12179,6108,6071,15.1,30,-3578,-8.8,42.4,0,685,685,4601
1991,01,d) 3,3892,4037,38890,40117,151,3.5,669,15.6,6071,816,5255,2,15.1,8525,3940,4585,9.8,21.3,-2454,-6.2,30.2,0,517,517,3231
1991,01,e) 4,3730,4003,49065,51212,153,3.6,628,14.8,6255,1301,4954,2.5,12.2,10548,5311,5237,10.4,20.6,-4293,-8.4,24.4,0,476,477,2964
1991,01,f) 5,3357,3564,37774,38942,118,3.2,469,12.6,6150,809,5341,2.1,15.8,8486,2752,5734,7.1,21.8,-2336,-6,31.6,0,353,354,2214
1991,01,g) 6 to 10,12031,13106,158654,162935,497,3.7,1320,9.8,20889,5205,15684,3.2,12.8,29450,10271,19179,6.3,18.1,-8561,-5.3,25.6,0,898,907,6876
1991,01,h) 11 to 15,7362,9205,130351,131500,417,4.5,750,8,19766,6262,13504,4.8,15,22064,5689,16375,4.3,16.8,-2298,-1.8,30,0,455,457,3615
1991,01,l) Left Censored,16385,28228,800089,805579,1680,5.9,2199,7.7,94296,32928,61368,4.1,11.7,105275,32455,72820,4,13.1,-10979,-1.4,23.4,0,847,896,8041
1991,02,a) 0,1298,1311,5643,2856,1294,197.4,0,0,5575,5575,0,195.2,195.2,0,0,0,0,0,5575,195.2,0,0,,,
1991,02,b) 1,1048,1069,6093,6201,14,1.2,241,20.2,1963,343,1620,5.5,31.7,2179,1108,1071,17.9,35.1,-216,-3.4,63.4,0,133,133,611
1991,02,c) 2,672,680,4941,5201,32,4.4,117,16.1,1097,126,971,2.4,21.1,1617,696,921,13.4,31.1,-520,-10,42.2,0,80,80,432
1991,02,d) 3,666,704,6961,7157,37,5,106,14.3,1249,295,954,4.1,17.5,1640,610,1030,8.5,22.9,-391,-5.4,35,0,77,77,429
1991,02,e) 4,645,679,8176,8291,26,3.7,85,12,1288,128,1160,1.5,15.5,1518,516,1002,6.2,18.3,-230,-2.8,31,0,60,61,400
1991,02,f) 5,622,668,5537,5649,27,3.9,88,12.6,991,195,796,3.5,17.5,1215,394,821,7,21.5,-224,-4,35,0,66,66,305
1991,02,g) 6 to 10,2390,2630,24139,24087,154,5.7,282,10.5,5136,1386,3750,5.8,21.3,5031,1284,3747,5.3,20.9,105,0.4,41.8,0,169,169,783
1991,02,h) 11 to 15,1289,1611,18560,18107,106,6.5,123,7.6,4099,1254,2845,6.9,22.6,3192,1001,2191,5.5,17.6,907,5,35.2,0,70,71,476
1991,02,l) Left Censored,2001,3396,80034,78710,253,7.5,216,6.4,13074,3709,9365,4.7,16.6,10426,2379,8047,3,13.2,2648,3.4,26.4,0,70,70,793
1991,04,a) 0,8017,8108,48543,24424,8035,198.2,0,0,48239,48239,0,197.5,197.5,0,0,0,0,0,48239,197.5,0,0,,,
1991,04,b) 1,6189,6291,65482,56993,58,0.8,1513,21.4,32898,702,32196,1.2,57.7,15920,7337,8583,12.9,27.9,16978,29.8,55.8,0,1107,1107,5608
1991,04,c) 2,5188,5398,49198,50970,237,4.1,1079,18.5,11398,2167,9231,4.3,22.4,14942,7160,7782,14,29.3,-3544,-6.9,44.8,0,793,809,5699
1991,04,d) 3,4361,4557,42018,44117,205,4.2,804,16.6,8761,1887,6874,4.3,19.9,12959,5949,7010,13.5,29.4,-4198,-9.5,39.8,0,631,631,5085
1991,04,e) 4,4132,4459,50558,52883,235,5,727,15.5,8305,1774,6531,3.4,15.7,12955,5905,7050,11.2,24.5,-4650,-8.8,31.4,0,547,558,5037
1991,04,f) 5,3666,3899,36694,38414,141,3.4,635,15.3,5788,974,4814,2.5,15.1,9227,3670,5557,9.6,24,-3439,-8.9,30.2,0,462,467,2825
1991,04,g) 6 to 10,12881,14542,184284,191040,731,4.8,1845,12.2,27326,7667,19659,4,14.3,40838,15760,25078,8.2,21.4,-13512,-7.1,28.6,0,1242,1249,10628
1991,04,h) 11 to 15,6785,8453,118637,119951,509,5.9,872,10.1,20259,7603,12656,6.3,16.9,22887,7736,15151,6.4,19.1,-2628,-2.2,33.8,0,481,490,3496
1991,04,l) Left Censored,10911,21892,651807,655620,1629,7.4,1774,8.1,90630,37626,53004,5.7,13.8,98258,27258,71000,4.2,15,-7628,-1.2,27.6,0,547,560,7163
1991,05,a) 0,4211,4283,23246,11679,4247,198.3,0,0,23134,23134,0,198.1,198.1,0,0,0,0,0,23134,198.1,0,0,,,
1991,05,b) 1,3429,3501,26080,24969,75,1.9,766,19.8,9695,5012,4683,20.1,38.8,7473,3500,3973,14,29.9,2222,8.9,59.8,0,554,554,2837
1991,05,c) 2,2680,2725,24545,25935,72,2.4,499,17,4514,419,4095,1.6,17.4,7294,3391,3903,13.1,28.1,-2780,-10.7,34.8,0,395,398,2704
1991,05,d) 3,2270,2352,20031,21598,81,3.2,437,17.3,2963,423,2540,2,13.7,6097,2745,3352,12.7,28.2,-3134,-14.5,27.4,0,352,352,2192
1991,05,e) 4,2252,2396,25376,25794,105,4.2,342,13.6,3382,731,2651,2.8,13.1,4217,1712,2505,6.6,16.3,-835,-3.2,26.2,0,257,259,1348
1991,05,f) 5,1914,1995,16372,16916,62,2.9,303,14.3,2387,288,2099,1.7,14.1,3475,1391,2084,8.2,20.5,-1088,-6.4,28.2,0,229,229,1047
1991,05,g) 6 to 10,8040,8631,84983,86670,317,3.6,864,9.7,13136,3577,9559,4.1,15.2,16510,6109,10401,7,19,-3374,-3.8,30.4,0,617,621,3743
1991,05,h) 11 to 15,5273,6138,70208,70169,264,4.2,524,8.4,10119,3005,7114,4.3,14.4,10041,2846,7195,4.1,14.3,78,0.1,28.6,0,318,319,1681
1991,05,l) Left Censored,10656,16660,472066,470298,966,5.8,1187,7.1,56405,17986,38419,3.8,12,52869,13322,39547,2.8,11.2,3536,0.8,22.4,0,541,554,4494
1991,06,a) 0,63008,63823,377515,190181,63230,198.1,0,0,374668,374668,0,197,197,0,0,0,0,0,374668,197,0,0,,,
1991,06,b) 1,51100,52106,409567,413948,593,1,12594,21.5,128977,16442,112535,4,31.2,137738,66675,71063,16.1,33.3,-8761,-2.1,62.4,0,8683,8690,49783
1991,06,c) 2,42036,43284,365899,400059,1814,3.9,8211,17.6,78261,13912,64349,3.5,19.6,146581,65899,80682,16.5,36.6,-68320,-17,39.2,0,6038,6076,53525
1991,06,d) 3,36569,38085,353150,382072,1577,3.9,6511,16.1,65890,11111,54779,2.9,17.2,123733,50557,73176,13.2,32.4,-57843,-15.2,34.4,0,4774,4787,40297
1991,06,e) 4,34347,36354,446201,472072,1645,4.3,5973,15.5,60462,11408,49054,2.4,12.8,112204,48460,63744,10.3,23.8,-51742,-11,25.6,0,4280,4371,37278
1991,06,f) 5,30165,32420,339736,360558,1429,4.2,4759,14,59543,12796,46747,3.5,16.5,101186,37591,63595,10.4,28.1,-41643,-11.6,33,0,3394,3429,28120
1991,06,g) 6 to 10,109246,120837,1565608,1638140,5501,4.4,14045,11.2,242853,56194,186659,3.4,14.8,387917,127135,260782,7.8,23.7,-145064,-8.9,29.6,0,9286,9351,77389
1991,06,h) 11 to 15,65762,79919,1139542,1178393,4286,5.3,7743,9.5,164246,49216,115030,4.2,13.9,241948,69336,172612,5.9,20.5,-77702,-6.6,27.8,0,4550,4666,37930
1991,06,l) Left Censored,103972,192584,5927536,6011985,12255,6.3,16089,8.3,786900,247169,539731,4.1,13.1,955798,252758,703040,4.2,15.9,-168898,-2.8,26.2,0,6170,6328,66014
1991,08,a) 0,8970,9069,47032,23791,9006,198.6,0,0,46483,46483,0,195.4,195.4,0,0,0,0,0,46483,195.4,0,0,,,
1991,08,b) 1,6738,6868,48262,48436,59,0.8,1507,19.7,14153,1048,13105,2.2,29.2,14500,6953,7547,14.4,29.9,-347,-0.7,58.4,0,1092,1092,5451
1991,08,c) 2,5591,5737,45210,46358,210,3.4,1017,16.5,11136,1991,9145,4.3,24,13432,6655,6777,14.4,29,-2296,-5,48,0,790,791,5704
1991,08,d) 3,4732,4922,41227,42327,163,3.1,807,15.4,8689,1151,7538,2.7,20.5,10889,4553,6336,10.8,25.7,-2200,-5.2,41,0,642,642,3946
1991,08,e) 4,4342,4596,49466,50387,210,4.3,716,14.8,8355,1533,6822,3,16.6,10196,4841,5355,9.6,20.2,-1841,-3.6,33.2,0,543,547,3660
1991,08,f) 5,3791,4013,40386,41541,174,4.1,614,14.5,6546,1306,5240,3.1,15.8,8856,4600,4256,11.1,21.3,-2310,-5.5,31.6,0,452,459,3653
1991,08,g) 6 to 10,14726,16189,185137,188564,776,4.7,1778,10.7,30283,8534,21749,4.5,16.1,37137,13495,23642,7.2,19.7,-6854,-3.6,32.2,0,1214,1247,9113
1991,08,h) 11 to 15,8659,10387,119635,121152,543,5.1,897,8.5,18859,4633,14226,3.8,15.6,21892,6915,14977,5.7,18.1,-3033,-2.5,31.2,0,526,546,3688
1991,08,l) Left Censored,14649,25208,695971,693557,1680,6.6,2011,7.9,90283,32241,58042,4.6,13,85455,27753,57702,4,12.3,4828,0.7,24.6,0,719,742,6329
1991,09,a) 0,5605,5669,33516,16931,5610,197.9,0,0,33171,33171,0,195.9,195.9,0,0,0,0,0,33171,195.9,0,0,,,
1991,09,b) 1,5088,5176,33120,34077,56,1,1213,20.9,8515,928,7587,2.7,25,10428,5327,5101,15.6,30.6,-1913,-5.6,50,0,838,841,3887
1991,09,c) 2,4930,5037,34673,38410,157,2.8,1092,19.8,5981,1091,4890,2.8,15.6,13454,7072,6382,18.4,35,-7473,-19.4,31.2,0,833,833,5845
1991,09,d) 3,4490,4613,40501,44122,136,2.7,903,18,5554,932,4622,2.1,12.6,12796,4554,8242,10.3,29,-7242,-16.4,25.2,0,676,677,3321
1991,09,e) 4,4179,4330,46384,46550,145,3.1,835,17.9,9934,851,9083,1.8,21.3,10266,4186,6080,9,22.1,-332,-0.8,42.6,0,615,616,3065
1991,09,f) 5,3573,3737,32313,35182,101,2.5,621,15.5,3516,712,2804,2,10,9253,3626,5627,10.3,26.3,-5737,-16.3,20,0,447,449,2591
1991,09,g) 6 to 10,12809,13684,130333,138987,427,3,1657,11.6,16760,4336,12424,3.1,12.1,34067,10838,23229,7.8,24.5,-17307,-12.4,24.2,0,1142,1145,6971
1991,09,h) 11 to 15,7551,8681,102439,107811,360,4,835,9.4,12572,4319,8253,4,11.7,23316,6859,16457,6.4,21.6,-10744,-9.9,23.4,0,500,507,3751
1991,09,l) Left Censored,20633,29966,989515,1002523,1503,5,2249,7.4,108962,39346,69616,3.9,10.9,134978,33859,101119,3.4,13.5,-26016,-2.6,21.8,0,972,1011,9126
1991,10,a) 0,1466,1475,10594,5319,1460,198,0,0,10551,10551,0,198.4,198.4,0,0,0,0,0,10551,198.4,0,0,,,
1991,10,b) 1,1174,1190,6841,6936,13,1,260,19.6,1793,288,1505,4.2,25.9,1982,912,1070,13.1,28.6,-189,-2.7,51.8,0,172,172,649
1991,10,c) 2,1047,1066,8055,8590,28,2.5,181,15.8,1334,94,1240,1.1,15.5,2404,1033,1371,12,28,-1070,-12.5,31,0,126,126,721
1991,10,d) 3,849,865,8538,9049,29,3.2,130,14.1,1161,152,1009,1.7,12.8,2183,753,1430,8.3,24.1,-1022,-11.3,25.6,0,98,98,627
1991,10,e) 4,817,848,9011,9346,30,3.3,141,15.6,1244,211,1033,2.3,13.3,1914,731,1183,7.8,20.5,-670,-7.2,26.6,0,97,100,525
1991,10,f) 5,705,747,6306,6824,32,4.1,94,12.1,900,261,639,3.8,13.2,1936,693,1243,10.2,28.4,-1036,-15.2,26.4,0,62,62,431
1991,10,g) 6 to 10,2380,2543,28350,29658,114,4.3,282,10.8,3166,769,2397,2.6,10.7,5781,1745,4036,5.9,19.5,-2615,-8.8,21.4,0,192,200,1247
1991,10,h) 11 to 15,1448,1699,29223,28826,85,4.9,140,8.1,5239,1469,3770,5.1,18.2,4444,808,3636,2.8,15.4,795,2.8,30.8,0,80,83,413
1991,10,l) Left Censored,3975,6096,204443,207560,490,8.1,406,6.7,23389,9040,14349,4.4,11.3,29623,9973,19650,4.8,14.3,-6234,-3,22.6,0,144,144,1331
1991,11,a) 0,1081,1084,7128,3606,1073,198,0,0,7044,7044,0,195.3,195.3,0,0,0,0,0,7044,195.3,0,0,,,
1991,11,b) 1,925,932,7910,7703,13,1.3,173,17,2119,509,1610,6.6,27.5,1705,652,1053,8.5,22.1,414,5.4,44.2,0,128,128,471
1991,11,c) 2,839,872,8355,8611,42,4.5,153,16.5,1942,265,1677,3.1,22.6,2454,1131,1323,13.1,28.5,-512,-5.9,45.2,0,104,104,903
1991,11,d) 3,779,799,11723,12256,35,4.1,134,15.8,1279,189,1090,1.5,10.4,2344,873,1471,7.1,19.1,-1065,-8.7,20.8,0,101,101,680
1991,11,e) 4,709,737,6667,7721,37,4.8,116,15,1034,186,848,2.4,13.4,3142,1436,1706,18.6,40.7,-2108,-27.3,26.8,0,76,76,1200
1991,11,f) 5,688,709,7421,7713,36,4.9,97,13.1,1266,621,645,8.1,16.4,1850,733,1117,9.5,24,-584,-7.6,32.8,0,72,72,589
1991,11,g) 6 to 10,2833,3032,43756,45626,129,4.1,327,10.4,5249,1377,3872,3,11.5,8988,2390,6598,5.2,19.7,-3739,-8.2,23,0,207,211,1482
1991,11,h) 11 to 15,1673,1961,59618,58881,125,6.3,181,9.1,8035,1621,6414,2.8,13.6,6561,1319,5242,2.2,11.1,1474,2.5,22.2,0,87,91,624
1991,11,l) Left Censored,5101,7442,236664,246909,478,6.3,738,9.8,23451,7839,15612,3.2,9.5,43940,9954,33986,4,17.8,-20489,-8.3,19,0,192,201,2258
1991,12,a) 0,34857,35253,198996,99845,35010,198.6,0,0,198302,198302,0,198.6,198.6,0,0,0,0,0,198302,198.6,0,0,,,
1991,12,b) 1,27797,28199,198245,200000,261,0.8,6537,20.7,59536,5589,53947,2.8,29.8,63046,28914,34132,14.5,31.5,-3510,-1.7,59.6,0,4603,4616,21370
1991,12,c) 2,22531,23047,166872,180534,849,3.4,4873,19.4,35656,5370,30286,3,19.8,62980,31044,31936,17.2,34.9,-27324,-15.1,39.6,0,3804,3810,24968
1991,12,d) 3,19538,20705,175672,190062,881,4,3984,17.9,31116,5960,25156,3.1,16.4,59896,27383,32513,14.4,31.5,-28780,-15.1,32.8,0,3071,3084,22997
1991,12,e) 4,17074,18064,201477,212636,763,4,3328,17.2,28742,5801,22941,2.7,13.5,51060,21979,29081,10.3,24,-22318,-10.5,27,0,2504,2547,16933
1991,12,f) 5,14754,15755,145491,153967,594,3.6,2501,15,23794,5059,18735,3.3,15.5,40745,15501,25244,10.1,26.5,-16951,-11,31,0,1877,1880,11991
1991,12,g) 6 to 10,51155,55605,603122,631111,2380,4.1,7028,12.1,90756,21480,69276,3.4,14.4,146733,54303,92430,8.6,23.2,-55977,-8.8,28.8,0,5010,5047,37998
1991,12,h) 11 to 15,26497,32354,409554,419485,1644,5,3336,10.1,66672,22085,44587,5.3,15.9,86535,27227,59308,6.5,20.6,-19863,-4.7,31.8,0,2024,2089,16945
1991,12,l) Left Censored,43858,89446,2428297,2452753,6111,6.8,8129,9,335123,124601,210522,5.1,13.7,384035,111003,273032,4.5,15.7,-48912,-2,27.4,0,2682,2849,26784
1991,13,a) 0,12751,12902,77578,39038,12803,198.5,0,0,77081,77081,0,197.5,197.5,0,0,0,0,0,77081,197.5,0,0,,,
1991,13,b) 1,10059,10212,76514,77122,131,1.2,2185,19.3,22700,3547,19153,4.6,29.4,23916,11986,11930,15.5,31,-1216,-1.6,58.8,0,1470,1471,8815
1991,13,c) 2,8566,8846,70247,76511,365,3.8,1728,18.1,14641,3157,11484,4.1,19.1,27169,11367,15802,14.9,35.5,-12528,-16.4,38.2,0,1284,1300,9471
1991,13,d) 3,7235,7638,73396,76632,366,4.5,1402,17.2,12583,2650,9933,3.5,16.4,19055,8290,10765,10.8,24.9,-6472,-8.5,32.8,0,1050,1050,6540
1991,13,e) 4,6638,7119,82468,97974,333,4.4,1210,16.1,10920,2674,8246,2.7,11.1,41932,30755,11177,31.4,42.8,-31012,-31.7,22.2,0,906,919,28660
1991,13,f) 5,6103,6547,66190,69119,268,3.9,1026,14.8,11015,2299,8716,3.3,15.9,16872,7503,9369,10.9,24.4,-5857,-8.5,31.8,0,763,773,5520
1991,13,g) 6 to 10,21764,23720,258867,270683,933,3.8,2771,11.3,37306,8746,28560,3.2,13.8,60937,21732,39205,8,22.5,-23631,-8.7,27.6,0,1899,1923,14098
1991,13,h) 11 to 15,11934,14496,197031,202057,767,5.2,1358,9.2,27473,9547,17926,4.7,13.6,37525,10743,26782,5.3,18.6,-10052,-5,27.2,0,776,788,5160
1991,13,l) Left Censored,25820,49674,1547192,1570711,3265,6.5,4061,8.1,203776,74737,129039,4.8,13,250813,71294,179519,4.5,16,-47037,-3,26,0,1314,1450,14416
1991,15,a) 0,2301,2330,16261,8193,2314,198.6,0,0,16137,16137,0,197,197,0,0,0,0,0,16137,197,0,0,,,
1991,15,b) 1,1845,1893,15622,15316,32,1.5,368,17.8,4475,521,3954,3.4,29.2,3862,1479,2383,9.7,25.2,613,4,50.4,0,283,283,1228
1991,15,c) 2,1510,1582,18390,18727,67,4,223,13.4,4131,585,3546,3.1,22.1,4805,1603,3202,8.6,25.7,-674,-3.6,44.2,0,165,165,1222
1991,15,d) 3,1392,1528,14015,14518,68,4.3,201,12.6,2569,307,2262,2.1,17.7,3575,1300,2275,9,24.6,-1006,-6.9,35.4,0,145,145,976
1991,15,e) 4,1171,1270,18647,19114,55,4.1,179,13.5,2237,743,1494,3.9,11.7,3171,1137,2034,5.9,16.6,-934,-4.9,23.4,0,129,131,683
1991,15,f) 5,1016,1112,11077,11821,45,3.9,132,11.4,2002,361,1641,3.1,16.9,3489,1532,1957,13,29.5,-1487,-12.6,33.8,0,94,96,1088
1991,15,g) 6 to 10,4188,4658,54434,55643,202,4.2,458,9.6,7909,2302,5607,4.1,14.2,10327,3066,7261,5.5,18.6,-2418,-4.4,28.4,0,314,315,1918
1991,15,h) 11 to 15,2629,3407,47228,47656,183,5.3,299,8.6,6629,1784,4845,3.7,13.9,7484,2748,4736,5.8,15.7,-855,-1.8,27.8,0,173,178,1915
1991,15,l) Left Censored,5465,9162,241207,241427,565,6.2,511,5.6,29220,10302,18918,4.3,12.1,29659,6505,23154,2.7,12.3,-439,-0.2,24.2,0,192,200,1939
1991,16,a) 0,2262,2273,11341,5701,2258,198.7,0,0,11281,11281,0,197.9,197.9,0,0,0,0,0,11281,197.9,0,0,,,
1991,16,b) 1,1968,2001,12744,12459,20,0.9,400,18,3810,794,3016,6.4,30.6,3240,1477,1763,11.9,26,570,4.6,52,0,236,236,954
1991,16,c) 2,1422,1460,10667,10940,50,3.2,227,14.6,2468,314,2154,2.9,22.6,3014,1501,1513,13.7,27.6,-546,-5,45.2,0,160,160,928
1991,16,d) 3,1193,1214,12121,12218,44,3.4,166,13,2792,261,2531,2.1,22.9,2985,1303,1682,10.7,24.4,-193,-1.5,45.8,0,124,124,1020
1991,16,e) 4,1100,1171,10513,10789,42,3.4,142,11.7,1652,284,1368,2.6,15.3,2203,799,1404,7.4,20.4,-551,-5.1,30.6,0,103,107,620
1991,16,f) 5,1030,1074,8771,9152,43,3.8,164,14.5,1449,262,1187,2.9,15.8,2211,1028,1183,11.2,24.2,-762,-8.4,31.6,0,118,118,798
1991,16,g) 6 to 10,3832,4141,38619,39819,190,4.5,400,9.4,5883,1350,4533,3.4,14.8,8283,2895,5388,7.3,20.8,-2400,-6,29.6,0,282,282,1775
1991,16,h) 11 to 15,2583,2928,35244,35070,126,4.2,275,9.2,5680,1433,4247,4.1,16.2,5331,1740,3591,5,15.2,349,1,30.4,0,154,159,943
1991,16,l) Left Censored,4881,7792,166943,165320,471,6,487,6.2,22510,6446,16064,3.9,13.6,19264,4609,14655,2.8,11.7,3246,1.9,23.4,0,207,207,1217
1991,17,a) 0,19129,19390,113778,57492,19221,198.3,0,0,112573,112573,0,195.8,195.8,0,0,0,0,0,112573,195.8,0,0,,,
1991,17,b) 1,16057,16358,129009,127925,192,1.1,3252,18.1,38441,5786,32655,4.5,30,36272,16272,20000,12.7,28.4,2169,1.6,56.8,0,2193,2193,12370
1991,17,c) 2,13635,13918,108915,116583,450,3,2332,15.7,20676,3260,17416,2.8,17.7,36012,14360,21652,12.3,30.9,-15336,-13.2,35.4,0,1695,1706,11235
1991,17,d) 3,11886,12187,119464,123238,390,3,1830,14.2,20442,3176,17266,2.6,16.6,27989,12146,15843,9.9,22.7,-7547,-6.1,33.2,0,1371,1371,8604
1991,17,e) 4,11336,11950,157351,161693,421,3.4,1681,13.4,25848,11422,14426,7.1,16,34531,12824,21707,7.9,21.4,-8683,-5.4,32,0,1203,1239,9227
1991,17,f) 5,9952,10534,110153,111981,319,2.9,1351,12.3,18616,4422,14194,3.9,16.6,22271,7916,14355,7.1,19.9,-3655,-3.3,33.2,0,1001,1003,6151
1991,17,g) 6 to 10,38254,41456,514306,527626,1360,3.2,3905,9.1,67540,15309,52231,2.9,12.8,94179,32446,61733,6.1,17.8,-26639,-5,25.6,0,2696,2725,21083
1991,17,h) 11 to 15,23205,27437,378204,383643,1085,3.9,2213,7.9,50577,11864,38713,3.1,13.2,61454,17579,43875,4.6,16,-10877,-2.8,26.4,0,1341,1359,10626
1991,17,l) Left Censored,58432,92187,2941804,2969113,4914,5.3,6800,7.3,317689,104680,213009,3.5,10.7,372307,98005,274302,3.3,12.5,-54618,-1.8,21.4,0,2989,3059,30150
1991,18,a) 0,9098,9261,54919,27608,9184,198.3,0,0,54622,54622,0,197.8,197.8,0,0,0,0,0,54622,197.8,0,0,,,
1991,18,b) 1,7563,7730,59464,58135,100,1.2,1518,17.9,18070,4084,13986,7,31.1,15411,7900,7511,13.6,26.5,2659,4.6,53,0,1060,1060,5753
1991,18,c) 2,6386,6600,58590,61190,216,3.1,1102,15.6,11563,1398,10165,2.3,18.9,16762,8063,8699,13.2,27.4,-5199,-8.5,37.8,0,854,857,6403
1991,18,d) 3,5261,5413,54466,56944,151,2.6,859,14.9,9569,2041,7528,3.6,16.8,14525,7021,7504,12.3,25.5,-4956,-8.7,33.6,0,669,669,5937
1991,18,e) 4,5078,5403,63001,63943,181,3.2,796,14,9857,3092,6765,4.8,15.4,11740,5155,6585,8.1,18.4,-1883,-3,30.8,0,592,602,4101
1991,18,f) 5,4696,5041,52254,54364,167,3.2,623,11.8,7227,1638,5589,3,13.3,11446,3903,7543,7.2,21.1,-4219,-7.8,26.6,0,490,490,3332
1991,18,g) 6 to 10,17641,19190,211166,216683,632,3.2,1774,9,27830,6649,21181,3.1,12.8,38863,13313,25550,6.1,17.9,-11033,-5.1,25.6,0,1280,1295,9476
1991,18,h) 11 to 15,10809,13105,173869,177022,531,4,1035,7.8,21522,4230,17292,2.4,12.2,27828,8687,19141,4.9,15.7,-6306,-3.5,24.4,0,639,646,4631
1991,18,l) Left Censored,27347,45827,1380219,1402288,2423,5.3,2971,6.4,137400,43838,93562,3.1,9.8,181538,41055,140483,2.9,12.9,-44138,-3.1,19.6,0,1350,1397,13373
1991,19,a) 0,4613,4663,25275,12685,4623,198.3,0,0,25180,25180,0,198.5,198.5,0,0,0,0,0,25180,198.5,0,0,,,
1991,19,b) 1,3902,3950,25181,25064,27,0.6,642,15,5966,445,5521,1.8,23.8,5731,2810,2921,11.2,22.9,235,0.9,45.8,0,427,429,2038
1991,19,c) 2,3283,3391,24238,25215,128,3.6,452,12.7,4698,952,3746,3.8,18.6,6652,2935,3717,11.6,26.4,-1954,-7.8,37.2,0,344,346,2433
1991,19,d) 3,2761,2838,22555,22757,102,3.4,342,11.6,4098,769,3329,3.4,18,4502,1971,2531,8.7,19.8,-404,-1.8,36,0,261,266,1615
1991,19,e) 4,2656,2888,51456,51955,119,4,354,11.8,4151,880,3271,1.7,8,5149,2120,3029,4.1,9.9,-998,-1.9,16,0,262,262,1467
1991,19,f) 5,2313,2419,19492,20090,86,3.4,263,10.5,3259,647,2612,3.2,16.2,4455,1788,2667,8.9,22.2,-1196,-6,32.4,0,201,201,1406
1991,19,g) 6 to 10,10139,11068,109422,110574,340,3,974,8.6,13769,2798,10971,2.5,12.5,16073,5697,10376,5.2,14.5,-2304,-2,25,0,693,697,3992
1991,19,h) 11 to 15,7115,8754,86659,88010,383,4.3,662,7.4,11546,2351,9195,2.7,13.1,14248,4447,9801,5.1,16.2,-2702,-3.1,26.2,0,396,404,2196
1991,19,l) Left Censored,18148,27433,664441,661614,1230,4.5,1646,6,75230,17260,57970,2.6,11.4,69575,15844,53731,2.4,10.5,5655,0.9,21,0,837,852,5671
1991,20,a) 0,4633,4696,24798,12453,4661,198.5,0,0,24691,24691,0,198.3,198.3,0,0,0,0,0,24691,198.3,0,0,,,
1991,20,b) 1,3662,3731,26570,26816,45,1.1,811,19.5,7270,1837,5433,6.9,27.1,7762,3983,3779,14.9,28.9,-492,-1.8,54.2,0,580,580,3183
1991,20,c) 2,3120,3186,23885,25353,98,2.9,564,16.5,4685,924,3761,3.6,18.5,7621,3601,4020,14.2,30.1,-2936,-11.6,37,0,419,420,2807
1991,20,d) 3,2653,2767,22873,23701,105,3.6,448,15.2,3817,798,3019,3.4,16.1,5473,2806,2667,11.8,23.1,-1656,-7,32.2,0,324,324,2325
1991,20,e) 4,2506,2630,34068,35245,92,3.3,414,14.9,3480,670,2810,1.9,9.9,5834,2699,3135,7.7,16.6,-2354,-6.7,19.8,0,309,315,2098
1991,20,f) 5,2336,2459,21988,22784,97,3.7,368,14.2,3254,758,2496,3.3,14.3,4846,2236,2610,9.8,21.3,-1592,-7,28.6,0,285,289,1933
1991,20,g) 6 to 10,9551,10240,98018,99083,409,3.8,1210,11.4,16891,5701,11190,5.8,17,19021,7140,11881,7.2,19.2,-2130,-2.2,34,0,883,887,5218
1991,20,h) 11 to 15,5797,7060,79765,81053,322,4.5,632,8.8,11662,2918,8744,3.6,14.4,14238,5140,9098,6.3,17.6,-2576,-3.2,28.8,0,366,372,2167
1991,20,l) Left Censored,14757,22654,548903,552861,1227,5.4,1687,7.4,62298,22639,39659,4.1,11.3,70214,18474,51740,3.3,12.7,-7916,-1.4,22.6,0,704,735,5987
1991,21,a) 0,5800,5847,34594,17410,5811,198.8,0,0,34369,34369,0,197.4,197.4,0,0,0,0,0,34369,197.4,0,0,,,
1991,21,b) 1,4966,5051,37621,37826,62,1.1,1087,19.4,10911,1150,9761,3,28.8,11320,5733,5587,15.2,29.9,-409,-1.1,57.6,0,815,815,4642
1991,21,c) 2,4217,4336,35391,37983,135,2.9,694,15,6417,848,5569,2.2,16.9,11600,5319,6281,14,30.5,-5183,-13.6,33.8,0,544,544,4576
1991,21,d) 3,3489,3613,30872,32459,119,3.1,541,14.2,5023,672,4351,2.1,15.5,8197,3760,4437,11.6,25.3,-3174,-9.8,31,0,419,419,2829
1991,21,e) 4,3248,3400,41858,44706,129,3.6,544,15.1,5618,709,4909,1.6,12.6,11313,6872,4441,15.4,25.3,-5695,-12.7,25.2,0,412,424,6164
1991,21,f) 5,2995,3186,34099,35082,116,3.5,399,12,4690,1098,3592,3.1,13.4,6656,2227,4429,6.3,19,-1966,-5.6,26.8,0,312,312,1799
1991,21,g) 6 to 10,11263,12061,139037,142240,422,3.4,1235,9.9,20579,5405,15174,3.8,14.5,26985,8898,18087,6.3,19,-6406,-4.5,29,0,903,906,6410
1991,21,h) 11 to 15,6412,7693,104244,104996,355,4.5,594,7.6,15616,4794,10822,4.6,14.9,17120,4088,13032,3.9,16.3,-1504,-1.4,29.8,0,361,366,2085
1991,21,l) Left Censored,16404,26961,726754,729182,1615,6,1910,7,84342,29746,54596,4.1,11.6,89198,22740,66458,3.1,12.2,-4856,-0.6,23.2,0,921,937,7158
1991,22,a) 0,6349,6473,45790,23084,6413,198.1,0,0,45412,45412,0,196.7,196.7,0,0,0,0,0,45412,196.7,0,0,,,
1991,22,b) 1,4950,5037,40007,40714,67,1.2,1074,19.2,11472,924,10548,2.3,28.2,12885,6553,6332,16.1,31.6,-1413,-3.4,56.4,0,771,772,5452
1991,22,c) 2,3891,3981,33963,36520,141,3.3,695,16.3,7149,694,6455,1.9,19.6,12262,6576,5686,18,33.6,-5113,-14,39.2,0,525,528,5012
1991,22,d) 3,3456,3693,37788,39443,183,4.7,581,14.9,8522,2091,6431,5.3,21.6,11832,5882,5950,14.9,30,-3310,-8.4,43.2,0,455,455,5113
1991,22,e) 4,3235,3439,41876,42760,181,5,523,14.5,6520,1364,5156,3.2,15.2,8287,3669,4618,8.6,19.4,-1767,-4.2,30.4,0,393,406,2848
1991,22,f) 5,3238,3391,34474,35527,114,3.2,456,12.8,6049,1332,4717,3.7,17,8155,3268,4887,9.2,23,-2106,-6,34,0,363,363,2505
1991,22,g) 6 to 10,13917,15059,166416,166236,589,3.8,1479,9.6,28426,5511,22915,3.3,17.1,28065,9567,18498,5.8,16.9,361,0.2,33.8,0,1024,1036,6633
1991,22,h) 11 to 15,8251,9656,124635,124792,385,3.9,829,8.4,19126,3549,15577,2.8,15.3,19440,5893,13547,4.7,15.6,-314,-0.3,30.6,0,562,570,4147
1991,22,l) Left Censored,17806,30258,749750,753433,1645,5.4,2283,7.5,96510,25669,70841,3.4,12.8,103875,33848,70027,4.5,13.8,-7365,-1,25.6,0,981,993,8055
1991,23,a) 0,2327,2365,10705,5393,2345,198.3,0,0,10625,10625,0,197,197,0,0,0,0,0,10625,197,0,0,,,
1991,23,b) 1,2054,2075,12785,13032,13,0.6,514,21.9,3233,182,3051,1.4,24.8,3726,1952,1774,15,28.6,-493,-3.8,49.6,0,351,352,1432
1991,23,c) 2,2052,2085,13020,14064,66,2.9,402,17.7,2150,315,1835,2.2,15.3,4237,1909,2328,13.6,30.1,-2087,-14.8,30.6,0,274,274,1385
1991,23,d) 3,1818,1851,11857,13408,65,3.3,341,17.1,1418,264,1154,2,10.6,4519,1769,2750,13.2,33.7,-3101,-23.1,21.2,0,251,251,1282
1991,23,e) 4,1694,1797,16281,17267,58,3,318,16.5,1727,283,1444,1.6,10,3698,1234,2464,7.1,21.4,-1971,-11.4,20,0,240,240,950
1991,23,f) 5,1474,1552,11346,11766,55,3.4,219,13.4,2018,422,1596,3.6,17.2,2857,1048,1809,8.9,24.3,-839,-7.1,34.4,0,155,155,658
1991,23,g) 6 to 10,4687,4985,48331,50970,139,2.7,522,10.1,5195,1027,4168,2,10.2,10473,3060,7413,6,20.5,-5278,-10.3,20.4,0,362,367,2319
1991,23,h) 11 to 15,2798,3340,37544,39010,136,4,279,8.2,3523,827,2696,2.1,9,6454,1750,4704,4.5,16.5,-2931,-7.5,18,0,167,167,1070
1991,23,l) Left Censored,6293,9519,234404,240289,484,5,717,7.4,21663,7052,14611,2.9,9,33433,7722,25711,3.2,13.9,-11770,-4.9,18,0,304,305,2418
1991,24,a) 0,8395,8502,46642,23418,8446,198.7,0,0,46448,46448,0,198.3,198.3,0,0,0,0,0,46448,198.3,0,0,,,
1991,24,b) 1,7210,7309,51451,53458,98,1.2,1794,21.8,14536,2804,11732,5.2,27.2,18549,9721,8828,18.2,34.7,-4013,-7.5,54.4,0,1259,1259,6580
1991,24,c) 2,6285,6405,47820,52119,189,2.7,1263,18.2,8196,1300,6896,2.5,15.7,16793,6656,10137,12.8,32.2,-8597,-16.5,31.4,0,922,922,5278
1991,24,d) 3,5573,5744,51302,55611,198,3.2,968,15.8,7314,1322,5992,2.4,13.2,15932,6742,9190,12.1,28.6,-8618,-15.4,26.4,0,744,745,5517
1991,24,e) 4,5066,5323,61407,65417,207,3.7,849,15.1,7303,1617,5686,2.5,11.2,15322,6795,8527,10.4,23.4,-8019,-12.2,22.4,0,616,631,4066
1991,24,f) 5,4653,4912,49005,51475,226,4.4,685,13.3,8310,2614,5696,5.1,16.1,13249,4751,8498,9.2,25.7,-4939,-9.6,32.2,0,495,497,3392
1991,24,g) 6 to 10,15511,16997,202330,210707,591,3.4,1806,10.3,31259,8055,23204,3.8,14.8,48013,15678,32335,7.4,22.8,-16754,-8,29.6,0,1223,1235,9896
1991,24,h) 11 to 15,8583,10416,141890,148772,438,4.1,946,8.9,18886,5212,13674,3.5,12.7,32650,9712,22938,6.5,21.9,-13764,-9.2,25.4,0,568,574,5964
1991,24,l) Left Censored,20966,36307,1084517,1109303,2261,6.2,2893,7.9,127161,47372,79789,4.3,11.5,176735,49889,126846,4.5,15.9,-49574,-4.4,23,0,1000,1050,11031
1991,25,a) 0,8943,9084,51976,26149,9005,198.3,0,0,51655,51655,0,197.5,197.5,0,0,0,0,0,51655,197.5,0,0,,,
1991,25,b) 1,8084,8232,63075,65498,104,1.1,1930,20.9,15830,2313,13517,3.5,24.2,20676,9534,11142,14.6,31.6,-4846,-7.4,48.4,0,1329,1329,6193
1991,25,c) 2,7920,8188,59798,66231,239,2.7,1714,19.2,11754,1332,10422,2,17.7,24620,12795,11825,19.3,37.2,-12866,-19.5,35.4,0,1270,1291,10236
1991,25,d) 3,7298,7502,76443,81550,225,2.8,1523,18.7,9559,1374,8185,1.7,11.7,19772,8050,11722,9.9,24.2,-10213,-12.5,23.4,0,1148,1149,6782
1991,25,e) 4,6928,7290,79701,85481,253,3.2,1440,18.3,8942,2033,6909,2.4,10.5,20502,9714,10788,11.4,24,-11560,-13.5,21,0,1031,1036,7349
1991,25,f) 5,6130,6445,62409,67401,210,3.1,1073,15.6,8129,1366,6763,2,12.1,18112,7561,10551,11.2,26.9,-9983,-14.8,24.2,0,748,750,6028
1991,25,g) 6 to 10,21525,23280,284688,300175,735,3,2929,12,36317,6886,29431,2.3,12.1,67291,23653,43638,7.9,22.4,-30974,-10.3,24.2,0,1990,2001,15572
1991,25,h) 11 to 15,12181,14773,243286,253051,652,4.3,1623,10.6,27413,8837,18576,3.5,10.8,46943,14771,32172,5.8,18.6,-19530,-7.8,21.6,0,903,928,7573
1991,25,l) Left Censored,35171,52741,1651007,1708236,2735,5.1,4391,8.2,163490,53034,110456,3.1,9.6,277950,71852,206098,4.2,16.3,-114460,-6.7,19.2,0,1756,1834,17428
1991,26,a) 0,14327,14530,81183,40963,14422,198.5,0,0,80441,80441,0,196.4,196.4,0,0,0,0,0,80441,196.4,0,0,,,
1991,26,b) 1,12342,12580,90879,88781,130,0.9,2411,17.5,27486,3564,23922,4,31,23290,10363,12927,11.7,26.2,4196,4.8,52.4,0,1687,1690,7863
1991,26,c) 2,10537,10884,84905,92256,347,3,1831,15.7,15282,2208,13074,2.4,16.6,29984,14777,15207,16,32.5,-14702,-15.9,33.2,0,1427,1430,13139
1991,26,d) 3,9245,9555,86140,91230,284,2.8,1493,14.7,13139,2259,10880,2.5,14.4,23319,9687,13632,10.6,25.6,-10180,-11.2,28.8,0,1149,1152,7958
1991,26,e) 4,9175,9658,104396,110624,287,2.8,1484,14.5,12316,1776,10540,1.6,11.1,24771,11875,12896,10.7,22.4,-12455,-11.3,22.2,0,1121,1145,9507
1991,26,f) 5,7788,8271,82256,86416,270,3.1,1076,12.4,11019,2114,8905,2.4,12.8,19339,7339,12000,8.5,22.4,-8320,-9.6,25.6,0,784,784,5478
1991,26,g) 6 to 10,28582,31268,348709,360546,1068,3.3,3012,9.4,47655,12355,35300,3.4,13.2,71328,24310,47018,6.7,19.8,-23673,-6.6,26.4,0,2097,2150,16130
1991,26,h) 11 to 15,17448,21237,264935,273192,866,4,1726,8,34300,9567,24733,3.5,12.6,50814,15495,35319,5.7,18.6,-16514,-6,25.2,0,1043,1060,9244
1991,26,l) Left Censored,41494,68811,2134457,2181450,3348,4.8,4806,6.9,220693,77887,142806,3.6,10.1,314680,70100,244580,3.2,14.4,-93987,-4.3,20.2,0,2005,2076,18280
1991,27,a) 0,8158,8284,46925,23620,8222,198.5,0,0,46610,46610,0,197.3,197.3,0,0,0,0,0,46610,197.3,0,0,,,
1991,27,b) 1,6697,6858,49764,49537,101,1.3,1281,17.1,15017,2835,12182,5.7,30.3,14563,6852,7711,13.8,29.4,454,0.9,58.8,0,853,855,5216
1991,27,c) 2,5686,5843,44091,49624,206,3.3,853,13.8,9400,1927,7473,3.9,18.9,20466,13586,6880,27.4,41.2,-11066,-22.3,37.8,0,636,637,12699
1991,27,d) 3,4895,5072,45230,47050,186,3.5,688,12.9,7153,1093,6060,2.3,15.2,10793,4351,6442,9.2,22.9,-3640,-7.7,30.4,0,543,543,3594
1991,27,e) 4,4462,4735,62217,65615,165,3.3,673,13.5,7472,1481,5991,2.3,11.4,14267,5089,9178,7.8,21.7,-6795,-10.3,22.8,0,473,479,3812
1991,27,f) 5,4106,4415,45978,47393,161,3.5,573,12.4,6766,1037,5729,2.2,14.3,9595,3817,5778,8.1,20.2,-2829,-5.9,28.6,0,394,397,2807
1991,27,g) 6 to 10,15423,16973,215526,219881,640,3.7,1661,9.5,33033,10249,22784,4.7,15,41742,13950,27792,6.3,19,-8709,-4,30,0,1135,1170,9375
1991,27,h) 11 to 15,9848,11953,153990,155193,516,4.2,941,7.7,20921,5754,15167,3.7,13.5,23327,6621,16706,4.3,15,-2406,-1.5,27,0,561,578,3737
1991,27,l) Left Censored,23685,36780,1141947,1157795,2030,5.5,2450,6.6,122221,41770,80451,3.6,10.6,153916,43696,110220,3.8,13.3,-31695,-2.7,21.2,0,1045,1063,11707
1991,28,a) 0,3934,3991,22750,11509,3949,197.9,0,0,22483,22483,0,195.4,195.4,0,0,0,0,0,22483,195.4,0,0,,,
1991,28,b) 1,3211,3250,22057,22078,38,1,721,19.9,6581,1402,5179,6.4,29.8,6622,3540,3082,16,30,-41,-0.2,59.6,0,506,506,2359
1991,28,c) 2,2505,2535,19061,20695,77,2.8,504,18.4,3915,327,3588,1.6,18.9,7182,4273,2909,20.6,34.7,-3267,-15.8,37.8,0,372,372,3589
1991,28,d) 3,2147,2264,21218,22030,97,4,391,16.3,3597,1023,2574,4.6,16.3,5221,2155,3066,9.8,23.7,-1624,-7.4,32.6,0,286,286,1663
1991,28,e) 4,2016,2147,28234,28648,91,4,367,16.1,3617,731,2886,2.6,12.6,4445,2176,2269,7.6,15.5,-828,-2.9,25.2,0,268,269,1772
1991,28,f) 5,1809,1873,15574,16384,76,3.9,283,14.4,2420,391,2029,2.4,14.8,4040,1703,2337,10.4,24.7,-1620,-9.9,29.6,0,208,208,1249
1991,28,g) 6 to 10,7710,8248,79782,81455,295,3.5,861,10.1,12097,3185,8912,3.9,14.9,15442,6134,9308,7.5,19,-3345,-4.1,29.8,0,613,615,4271
1991,28,h) 11 to 15,4803,5681,64894,65006,270,4.7,521,9,9903,2510,7393,3.9,15.2,10126,2524,7602,3.9,15.6,-223,-0.4,30.4,0,311,313,1501
1991,28,l) Left Censored,11044,18012,460542,461966,1003,5.5,1282,7.1,51817,16694,35123,3.6,11.2,54664,13148,41516,2.8,11.8,-2847,-0.6,22.4,0,563,580,4246
1991,29,a) 0,9619,9777,53029,26707,9700,198.4,0,0,52644,52644,0,197.1,197.1,0,0,0,0,0,52644,197.1,0,0,,,
1991,29,b) 1,7820,7952,55961,57440,105,1.2,1859,20.9,15310,2104,13206,3.7,26.7,18267,9151,9116,15.9,31.8,-2957,-5.1,53.4,0,1325,1325,7249
1991,29,c) 2,6753,6947,49287,52826,221,2.9,1312,17.5,10185,1764,8421,3.3,19.3,17262,8069,9193,15.3,32.7,-7077,-13.4,38.6,0,980,989,6379
1991,29,d) 3,5640,5848,56464,55723,219,3.5,1017,16.3,14555,2887,11668,5.2,26.1,13073,6285,6788,11.3,23.5,1482,2.6,47,0,764,764,4817
1991,29,e) 4,5519,5816,65586,68448,217,3.5,882,14.4,8226,1370,6856,2,12,13949,6272,7677,9.2,20.4,-5723,-8.4,24,0,653,658,4754
1991,29,f) 5,4805,5090,47426,49083,201,3.8,666,12.5,7277,1385,5892,2.8,14.8,10591,4072,6519,8.3,21.6,-3314,-6.8,29.6,0,486,488,2898
1991,29,g) 6 to 10,18245,19950,212486,218684,749,3.6,2000,9.7,28392,7192,21200,3.3,13,40787,14454,26333,6.6,18.7,-12395,-5.7,26,0,1379,1394,10072
1991,29,h) 11 to 15,10853,13074,158982,165074,513,3.8,1232,9.2,19011,4852,14159,2.9,11.5,31195,12036,19159,7.3,18.9,-12184,-7.4,23,0,684,714,5488
1991,29,l) Left Censored,26372,42924,1285571,1281358,2279,5.3,3140,7.2,173241,45700,127541,3.6,13.5,164814,45251,119563,3.5,12.9,8427,0.6,25.8,0,1285,1327,13017
1991,30,a) 0,1948,1958,8809,4423,1931,197.2,0,0,8773,8773,0,198.3,198.3,0,0,0,0,0,8773,198.3,0,0,,,
1991,30,b) 1,1535,1543,8246,8403,8,0.5,310,18.2,1810,89,1721,1.1,21.5,2124,994,1130,11.8,25.3,-314,-3.8,43,0,202,202,726
1991,30,c) 2,1288,1343,7983,8498,46,3.2,192,13.5,1302,158,1144,1.9,15.3,2332,1042,1290,12.3,27.4,-1030,-12.1,30.6,0,141,141,844
1991,30,d) 3,1135,1162,7837,8133,51,4.2,172,14.1,1415,215,1200,2.6,17.4,2007,848,1159,10.4,24.7,-592,-7.3,34.8,0,136,136,732
1991,30,e) 4,1065,1113,9260,9436,52,4.5,161,13.8,1271,273,998,2.9,13.5,1623,815,808,8.6,17.2,-352,-3.7,27,0,120,120,603
1991,30,f) 5,997,1037,7507,7494,48,4.4,153,14,1470,340,1130,4.5,19.6,1444,632,812,8.4,19.3,26,0.3,38.6,0,111,111,503
1991,30,g) 6 to 10,3880,4167,32117,32672,198,4.6,430,10,5296,1473,3823,4.5,16.2,6406,2206,4200,6.8,19.6,-1110,-3.4,32.4,0,297,299,1522
1991,30,h) 11 to 15,2662,3073,27690,27865,152,4.9,238,7.6,4180,1102,3078,4,15,4530,1070,3460,3.8,16.3,-350,-1.3,30,0,164,164,718
1991,30,l) Left Censored,4830,6971,112500,113354,339,4.8,455,6.5,11751,3549,8202,3.1,10.4,13459,3577,9882,3.2,11.9,-1708,-1.5,20.8,0,226,235,1544
1991,31,a) 0,2862,2913,13728,6901,2889,198.4,0,0,13654,13654,0,197.9,197.9,0,0,0,0,0,13654,197.9,0,0,,,
1991,31,b) 1,2422,2475,17930,17132,36,1.3,467,17.2,5235,586,4649,3.4,30.6,3638,1616,2022,9.4,21.2,1597,9.4,42.4,0,315,315,1203
1991,31,c) 2,2083,2133,14481,15211,77,3.4,292,13,2815,447,2368,2.9,18.5,4275,1608,2667,10.6,28.1,-1460,-9.6,37,0,217,219,1348
1991,31,d) 3,1794,1905,16291,16725,85,4.3,271,13.6,2719,870,1849,5.2,16.3,3587,1346,2241,8,21.4,-868,-5.1,32.6,0,197,197,1112
1991,31,e) 4,1593,1652,19312,19738,61,3.5,216,12.5,2320,334,1986,1.7,11.8,3172,1788,1384,9.1,16.1,-852,-4.3,23.6,0,173,173,1636
1991,31,f) 5,1445,1524,16536,16088,50,3.2,180,11.3,3420,1158,2262,7.2,21.3,2523,1196,1327,7.4,15.7,897,5.6,31.4,0,139,139,915
1991,31,g) 6 to 10,6503,7074,70134,70972,279,3.9,625,8.6,9759,2307,7452,3.3,13.8,11434,4456,6978,6.3,16.1,-1675,-2.3,27.6,0,463,467,3394
1991,31,h) 11 to 15,4294,5056,52018,52287,245,4.8,383,7.5,7047,1972,5075,3.8,13.5,7584,2698,4886,5.2,14.5,-537,-1,27,0,251,256,1317
1991,31,l) Left Censored,10540,15463,372661,370755,801,5.1,1033,6.6,41223,14108,27115,3.8,11.1,37411,9129,28282,2.5,10.1,3812,1,20.2,0,477,499,3593
1991,32,a) 0,3162,3189,20118,10181,3159,198.1,0,0,19874,19874,0,195.2,195.2,0,0,0,0,0,19874,195.2,0,0,,,
1991,32,b) 1,2406,2445,21395,21294,28,1,619,22.4,6514,709,5805,3.3,30.6,6312,3227,3085,15.2,29.6,202,1,59.2,0,451,453,2414
1991,32,c) 2,1987,2035,24515,25034,87,4,406,18.5,5778,625,5153,2.5,23.1,6816,2826,3990,11.3,27.2,-1038,-4.1,46.2,0,317,317,2405
1991,32,d) 3,1550,1600,19835,22308,71,4.2,252,14.9,3202,1076,2126,4.8,14.4,8147,2017,6130,9,36.5,-4945,-22.1,28.8,0,179,179,1364
1991,32,e) 4,1399,1495,18033,19020,66,4.2,236,14.9,2937,697,2240,3.7,15.4,4910,1971,2939,10.4,25.8,-1973,-10.4,30.8,0,171,179,1608
1991,32,f) 5,1222,1297,20180,21241,66,4.9,159,11.9,3349,881,2468,4.1,15.8,5470,2416,3054,11.4,25.8,-2121,-10,31.6,0,118,119,2125
1991,32,g) 6 to 10,4221,4744,69651,73288,268,5.5,518,10.6,9787,2347,7440,3.2,13.4,17061,4317,12744,5.9,23.3,-7274,-9.9,26.8,0,345,345,2910
1991,32,h) 11 to 15,2673,3171,65625,67514,197,6.2,266,8.3,7977,2026,5951,3,11.8,11754,3320,8434,4.9,17.4,-3777,-5.6,23.6,0,166,169,2085
1991,32,l) Left Censored,4332,7275,286616,282066,588,8.1,529,7.3,41898,11589,30309,4.1,14.9,32798,7324,25474,2.6,11.6,9100,3.3,23.2,0,191,194,2832
1991,33,a) 0,2362,2385,11537,5805,2367,198.5,0,0,11464,11464,0,197.5,197.5,0,0,0,0,0,11464,197.5,0,0,,,
1991,33,b) 1,1990,2015,12922,13189,17,0.7,523,22.8,3923,1024,2899,7.8,29.7,4457,2267,2190,17.2,33.8,-534,-4.1,59.4,0,377,377,1876
1991,33,c) 2,1930,1967,16165,18129,51,2.3,452,20.8,3266,181,3085,1,18,7193,4315,2878,23.8,39.7,-3927,-21.7,36,0,351,351,3930
1991,33,d) 3,1796,1836,13093,14515,52,2.6,432,21.3,1656,318,1338,2.2,11.4,4500,1856,2644,12.8,31,-2844,-19.6,22.8,0,338,338,1498
1991,33,e) 4,1722,1770,14362,15441,51,2.6,416,21.3,1879,532,1347,3.4,12.2,4037,1768,2269,11.5,26.1,-2158,-13.9,24.4,0,302,303,1432
1991,33,f) 5,1485,1577,13535,14748,64,3.7,312,18.2,1583,425,1158,2.9,10.7,4009,1520,2489,10.3,27.2,-2426,-16.5,21.4,0,239,239,1260
1991,33,g) 6 to 10,4727,5043,48848,51902,179,3.4,668,12.6,6517,1788,4729,3.4,12.6,12625,4543,8082,8.8,24.3,-6108,-11.7,25.2,0,455,460,3505
1991,33,h) 11 to 15,2558,3018,37469,38986,119,3.8,319,10.2,3931,1276,2655,3.3,10.1,6965,1761,5204,4.5,17.9,-3034,-7.8,20.2,0,190,197,1003
1991,33,l) Left Censored,5895,8884,243364,251148,560,6.2,715,8,22802,8468,14334,3.4,9.1,38369,10548,27821,4.2,15.3,-15567,-6.2,18.2,0,244,255,2669
1991,34,a) 0,14492,14613,75294,37904,14464,198,0,0,74781,74781,0,197.3,197.3,0,0,0,0,0,74781,197.3,0,0,,,
1991,34,b) 1,12109,12295,88804,93015,121,0.9,3127,22.5,21439,2861,18578,3.1,23,29861,12877,16984,13.8,32.1,-8422,-9.1,46,0,2092,2096,9620
1991,34,c) 2,11222,11373,83308,86988,410,3.3,2270,18.4,19808,2989,16819,3.4,22.8,27167,12193,14974,14,31.2,-7359,-8.4,45.6,0,1672,1672,9241
1991,34,d) 3,10464,10679,87476,93583,409,3.6,2080,18.1,14986,3262,11724,3.5,16,27199,12333,14866,13.2,29.1,-12213,-13.1,32,0,1513,1517,9974
1991,34,e) 4,9567,9817,99638,106021,326,3.1,1786,16.9,11332,2285,9047,2.2,10.7,24097,10078,14019,9.5,22.7,-12765,-12,21.4,0,1268,1292,7865
1991,34,f) 5,8418,8754,81737,86883,282,3,1422,15.3,11267,2670,8597,3.1,13,21558,8090,13468,9.3,24.8,-10291,-11.8,26,0,1021,1023,4846
1991,34,g) 6 to 10,29896,31494,336623,354619,939,2.9,3709,11.3,42587,8032,34555,2.3,12,78578,24576,54002,6.9,22.2,-35991,-10.2,24,0,2546,2556,16664
1991,34,h) 11 to 15,17688,19716,233427,242198,703,3.5,1999,9.8,31800,7506,24294,3.1,13.1,49343,13183,36160,5.4,20.4,-17543,-7.3,26.2,0,1236,1250,7508
1991,34,l) Left Censored,44162,65720,1972844,2022503,3297,4.9,5398,8.1,223504,71577,151927,3.5,11.1,322822,85417,237405,4.2,16,-99318,-4.9,22.2,0,2271,2323,21468
1991,35,a) 0,3070,3122,18123,9138,3095,198.3,0,0,17970,17970,0,196.7,196.7,0,0,0,0,0,17970,196.7,0,0,,,
1991,35,b) 1,2365,2387,16479,16532,28,1.1,502,19,5195,1088,4107,6.6,31.4,5300,2870,2430,17.4,32.1,-105,-0.7,62.8,0,338,338,1727
1991,35,c) 2,1984,2045,14969,15886,65,3,356,16.2,2594,237,2357,1.5,16.3,4428,1844,2584,11.6,27.9,-1834,-11.6,32.6,0,266,267,1505
1991,35,d) 3,1618,1696,16027,15184,70,3.9,282,15.7,5122,2018,3104,13.3,33.7,3435,1549,1886,10.2,22.6,1687,11.1,45.2,0,207,208,1165
1991,35,e) 4,1483,1567,18245,18814,80,4.9,255,15.5,2363,514,1849,2.7,12.6,3500,2011,1489,10.7,18.6,-1137,-6,25.2,0,189,190,1398
1991,35,f) 5,1404,1455,12883,13299,66,4.3,236,15.4,2295,428,1867,3.2,17.3,3127,1502,1625,11.3,23.5,-832,-6.2,34.6,0,171,173,1120
1991,35,g) 6 to 10,5488,5973,55737,57374,325,5.3,680,11.1,9544,3034,6510,5.3,16.6,12817,5407,7410,9.4,22.3,-3273,-5.7,33.2,0,440,443,3459
1991,35,h) 11 to 15,3534,4193,43091,43328,227,5.4,337,7.9,7013,1879,5134,4.3,16.2,7486,2224,5262,5.1,17.3,-473,-1.1,32.4,0,202,203,1137
1991,35,l) Left Censored,6186,9940,229897,228455,644,6.4,815,8.1,32264,12008,20256,5.3,14.1,29379,9651,19728,4.2,12.9,2885,1.2,25.8,0,304,315,3102
1991,36,a) 0,34153,34361,172728,86869,34040,198.1,0,0,171719,171719,0,197.7,197.7,0,0,0,0,0,171719,197.7,0,0,,,
1991,36,b) 1,28065,28353,184164,187064,219,0.7,6742,21.2,53498,8235,45263,4.4,28.6,59297,28734,30563,15.4,31.7,-5799,-3.1,57.2,0,4749,4749,21367
1991,36,c) 2,25559,25944,178816,192524,797,2.8,4981,17.8,32218,4807,27411,2.5,16.7,59633,26843,32790,13.9,31,-27415,-14.3,33.4,0,3702,3706,21313
1991,36,d) 3,22293,22672,186786,197272,712,2.9,4137,17,28949,5327,23622,2.7,14.7,49921,22210,27711,11.3,25.3,-20972,-10.6,29.4,0,3204,3206,18095
1991,36,e) 4,20666,21333,275704,288367,645,2.8,3616,15.9,24228,4307,19921,1.5,8.4,49554,22126,27428,7.7,17.2,-25326,-8.8,16.8,0,2745,2758,16666
1991,36,f) 5,18246,18850,152244,160539,558,2.8,2981,14.9,23744,5703,18041,3.6,14.8,40333,16206,24127,10.1,25.1,-16589,-10.3,29.6,0,2269,2271,12830
1991,36,g) 6 to 10,65756,69473,714448,755975,2159,3,8201,11.3,88627,21037,67590,2.8,11.7,171681,56728,114953,7.5,22.7,-83054,-11,23.4,0,5867,5906,40750
1991,36,h) 11 to 15,36810,42587,581920,601307,1508,3.4,4237,9.7,71751,17156,54595,2.9,11.9,110525,35249,75276,5.9,18.4,-38774,-6.5,23.8,0,2741,2786,19740
1991,36,l) Left Censored,99109,143794,4276906,4390821,6591,4.5,11457,7.8,444982,133280,311702,3,10.1,672813,161254,511559,3.7,15.3,-227831,-5.2,20.2,0,5793,5861,52758
1991,37,a) 0,12191,12372,65395,32935,12288,198.6,0,0,64921,64921,0,197.1,197.1,0,0,0,0,0,64921,197.1,0,0,,,
1991,37,b) 1,10244,10413,67867,69438,102,0.9,2549,21.7,19499,2138,17361,3.1,28.1,22641,11976,10665,17.2,32.6,-3142,-4.5,56.2,0,1854,1854,9112
1991,37,c) 2,8601,8863,65495,71045,329,3.5,1622,17,12097,2127,9970,3,17,23196,11249,11947,15.8,32.6,-11099,-15.6,34,0,1255,1257,8946
1991,37,d) 3,7447,7773,68484,73429,309,3.7,1320,15.9,10396,2215,8181,3,14.2,20286,9471,10815,12.9,27.6,-9890,-13.4,28.4,0,1008,1009,7264
1991,37,e) 4,6897,7444,77229,83171,324,4.1,1236,15.7,10291,2366,7925,2.8,12.4,22175,10680,11495,12.8,26.7,-11884,-14.3,24.8,0,913,929,9135
1991,37,f) 5,6297,6695,60144,63360,270,3.8,983,14,9399,2056,7343,3.2,14.8,15830,5812,10018,9.2,25,-6431,-10.2,29.6,0,708,719,3913
1991,37,g) 6 to 10,24103,26283,289950,302745,988,3.7,2615,9.7,38312,9714,28598,3.2,12.7,63901,22599,41302,7.5,21.1,-25589,-8.4,25.4,0,1759,1799,14299
1991,37,h) 11 to 15,12822,15276,195802,202414,643,4.1,1316,8.4,22919,6534,16385,3.2,11.3,36142,10852,25290,5.4,17.9,-13223,-6.6,22.6,0,767,779,5821
1991,37,l) Left Censored,29819,53657,1678699,1715781,2919,5.4,3801,7,172140,59747,112393,3.5,10,246306,60454,185852,3.5,14.4,-74166,-4.4,20,0,1436,1488,11307
1991,38,a) 0,1220,1225,5709,2864,1214,198.2,0,0,5691,5691,0,198.7,198.7,0,0,0,0,0,5691,198.7,0,0,,,
1991,38,b) 1,1004,1027,5705,5748,21,1.9,191,17,1792,622,1170,10.8,31.2,1878,982,896,17.1,32.7,-86,-1.5,62.4,0,114,114,729
1991,38,c) 2,815,822,5152,5499,18,2,131,14.9,917,47,870,0.9,16.7,1610,910,700,16.5,29.3,-693,-12.6,33.4,0,107,107,857
1991,38,d) 3,782,808,6136,6168,24,2.8,101,12,980,76,904,1.2,15.9,1043,371,672,6,16.9,-63,-1,31.8,0,81,81,337
1991,38,e) 4,734,759,6398,6560,27,3.4,103,12.9,839,174,665,2.7,12.8,1163,655,508,10,17.7,-324,-4.9,25.6,0,81,81,545
1991,38,f) 5,653,692,5276,5425,22,3,92,12.7,758,136,622,2.5,14,1055,436,619,8,19.4,-297,-5.4,28,0,74,74,388
1991,38,g) 6 to 10,2818,3094,25033,24949,103,3.2,291,9.1,3904,556,3348,2.2,15.6,3736,1333,2403,5.3,15,168,0.6,30,0,193,193,873
1991,38,h) 11 to 15,1938,2179,19967,19909,101,4.5,194,8.7,3353,1626,1727,8.2,16.8,3236,789,2447,4,16.3,117,0.5,32.6,0,119,119,441
1991,38,l) Left Censored,4627,6538,120607,119970,308,4.7,442,6.7,13713,4593,9120,3.8,11.4,12438,3389,9049,2.8,10.4,1275,1,20.8,0,208,212,1442
1991,39,a) 0,15890,16139,94785,47658,16034,198.7,0,0,94255,94255,0,197.8,197.8,0,0,0,0,0,94255,197.8,0,0,,,
1991,39,b) 1,13274,13644,111728,107371,262,1.8,2678,17.9,36388,6092,30296,5.7,33.9,27674,13511,14163,12.6,25.8,8714,8.1,51.6,0,1866,1867,10709
1991,39,c) 2,11615,12006,101527,108244,419,3.3,2052,16,20225,3739,16486,3.5,18.7,33659,16327,17332,15.1,31.1,-13434,-12.4,37.4,0,1572,1575,12909
1991,39,d) 3,10124,10552,102731,106743,338,3,1658,14.8,17294,3249,14045,3,16.2,25317,10542,14775,9.9,23.7,-8023,-7.5,32.4,0,1248,1248,8866
1991,39,e) 4,9785,10407,116789,120868,347,3.2,1398,12.8,15697,2785,12912,2.3,13,23855,9456,14399,7.8,19.7,-8158,-6.7,26,0,1035,1047,7119
1991,39,f) 5,8584,9217,94322,96939,328,3.4,1177,12.2,15726,4375,11351,4.5,16.2,20960,8420,12540,8.7,21.6,-5234,-5.4,32.4,0,870,872,5967
1991,39,g) 6 to 10,32144,35537,423091,435732,1123,3.1,3319,9.1,53726,11014,42712,2.5,12.3,79008,27105,51903,6.2,18.1,-25282,-5.8,24.6,0,2363,2385,19802
1991,39,h) 11 to 15,20602,25270,339749,345364,1018,4,1884,7.3,42334,10911,31423,3.2,12.3,53564,14332,39232,4.1,15.5,-11230,-3.2,24.6,0,1131,1146,7894
1991,39,l) Left Censored,54409,93233,2776525,2824025,4327,4.6,6231,6.6,273610,87418,186192,3.1,9.7,368609,97682,270927,3.5,13.1,-94999,-3.4,19.4,0,2553,2627,30320
1991,40,a) 0,5913,5971,32767,16460,5919,198.3,0,0,32615,32615,0,198.1,198.1,0,0,0,0,0,32615,198.1,0,0,,,
1991,40,b) 1,4619,4674,30105,29975,40,0.8,1006,19.4,8666,880,7786,2.9,28.9,8406,4445,3961,14.8,28,260,0.9,56,0,705,705,3330
1991,40,c) 2,3753,3813,31013,31649,125,3.1,638,15.7,7104,1452,5652,4.6,22.4,8376,3747,4629,11.8,26.5,-1272,-4.1,44.8,0,501,501,3102
1991,40,d) 3,3107,3210,26996,28071,135,4,488,14.4,4513,664,3849,2.4,16.1,6662,3079,3583,11,23.7,-2149,-7.6,32.2,0,389,389,2626
1991,40,e) 4,2765,2954,40685,40542,144,4.6,444,14.3,6421,1092,5329,2.7,15.8,6135,2793,3342,6.9,15.1,286,0.7,30.2,0,341,350,2225
1991,40,f) 5,2729,2852,26588,27106,104,3.5,363,12.2,4409,812,3597,3,16.3,5444,2795,2649,10.3,20.1,-1035,-3.8,32.6,0,277,278,2377
1991,40,g) 6 to 10,11916,12963,120567,126593,632,4.8,1284,9.7,21437,7252,14185,5.7,16.9,33488,8877,24611,7,26.5,-12051,-9.6,33.8,0,916,932,6642
1991,40,h) 11 to 15,6919,8151,93989,93447,427,5.2,714,8.6,13695,3681,10014,3.9,14.7,12611,4400,8211,4.7,13.5,1084,1.2,27,0,473,473,2471
1991,40,l) Left Censored,14374,23397,547349,550798,1234,5.2,1806,7.6,59704,18159,41545,3.3,10.8,66601,20547,46054,3.7,12.1,-6897,-1.3,21.6,0,722,731,6060
1991,41,a) 0,6961,7031,35906,18032,6968,198.2,0,0,35749,35749,0,198.3,198.3,0,0,0,0,0,35749,198.3,0,0,,,
1991,41,b) 1,6011,6086,40627,41293,60,0.9,1302,19.2,10764,923,9841,2.2,26.1,12095,5799,6296,14,29.3,-1331,-3.2,52.2,0,896,896,4318
1991,41,c) 2,3850,3918,29265,31152,152,3.6,758,17.9,6283,775,5508,2.5,20.2,10057,5166,4891,16.6,32.3,-3774,-12.1,40.4,0,583,583,3657
1991,41,d) 3,3925,4013,31490,32936,141,3.3,661,15.4,5402,792,4610,2.4,16.4,8293,3699,4594,11.2,25.2,-2891,-8.8,32.8,0,504,504,3087
1991,41,e) 4,3673,3859,43007,43740,152,3.7,578,14.2,6785,1199,5586,2.7,15.5,8250,3444,4806,7.9,18.9,-1465,-3.4,31,0,423,429,2849
1991,41,f) 5,3221,3377,29183,30367,152,4.3,487,13.7,4895,996,3899,3.3,16.1,7263,3111,4152,10.2,23.9,-2368,-7.8,32.2,0,372,372,2459
1991,41,g) 6 to 10,11537,12607,138040,140139,566,4.4,1376,10.6,22315,6690,15625,4.8,15.9,26513,8627,17886,6.2,18.9,-4198,-3,31.8,0,952,964,5953
1991,41,h) 11 to 15,7518,8903,101957,103523,506,5.6,796,8.8,16137,5528,10609,5.3,15.6,19269,5646,13623,5.5,18.6,-3132,-3,31.2,0,475,488,3302
1991,41,l) Left Censored,14049,22946,573454,570337,1520,6.6,1768,7.7,81778,26237,55541,4.6,14.3,75543,24402,51141,4.3,13.2,6235,1.1,26.4,0,673,730,5463
1991,42,a) 0,17875,18124,106615,53615,17993,198.6,0,0,106000,106000,0,197.7,197.7,0,0,0,0,0,106000,197.7,0,0,,,
1991,42,b) 1,15546,15817,109949,109840,178,1,3131,18,29127,3950,25177,3.6,26.5,28908,13767,15141,12.5,26.3,219,0.2,52.6,0,2254,2255,10768
1991,42,c) 2,14290,14622,113861,119665,433,2.8,2227,14.3,21796,2720,19076,2.3,18.2,33403,14857,18546,12.4,27.9,-11607,-9.7,36.4,0,1638,1644,11444
1991,42,d) 3,12544,12953,109360,114677,406,3,1858,13.6,17049,2607,14442,2.3,14.9,27682,12229,15453,10.7,24.1,-10633,-9.2,29.8,0,1405,1419,9817
1991,42,e) 4,11978,12558,133961,138658,375,2.8,1693,12.8,16207,2519,13688,1.8,11.7,25600,10980,14620,7.9,18.5,-9393,-6.8,23.4,0,1238,1258,7964
1991,42,f) 5,10684,11232,108287,113558,382,3.3,1381,11.8,15354,2368,12986,2.1,13.5,25896,10298,15598,9.1,22.8,-10542,-9.3,27,0,1001,1001,7461
1991,42,g) 6 to 10,37670,40865,487338,504473,1347,3.2,3953,9.4,58601,11919,46682,2.4,11.6,92871,31214,61657,6.2,18.4,-34270,-6.8,23.2,0,2779,2812,20101
1991,42,h) 11 to 15,22991,27418,363971,369843,1053,3.8,2103,7.5,46326,13861,32465,3.7,12.5,58070,16549,41521,4.5,15.7,-11744,-3.2,25,0,1248,1268,8940
1991,42,l) Left Censored,62283,100150,2978272,3016237,4599,4.5,6945,6.9,315294,97225,218069,3.2,10.5,391224,112893,278331,3.7,13,-75930,-2.5,21,0,3207,3350,31587
1991,44,a) 0,1787,1793,9349,4713,1771,197.5,0,0,9273,9273,0,196.8,196.8,0,0,0,0,0,9273,196.8,0,0,,,
1991,44,b) 1,1546,1558,10421,10508,12,0.7,457,25.5,3636,1121,2515,10.7,34.6,3809,1792,2017,17.1,36.2,-173,-1.6,69.2,0,315,315,1413
1991,44,c) 2,1497,1526,12438,13375,32,1.9,332,19.8,2275,204,2071,1.5,17,4149,1828,2321,13.7,31,-1874,-14,34,0,220,220,1427
1991,44,d) 3,1353,1394,9441,10241,55,3.6,294,19.4,1788,713,1075,7,17.5,3387,1382,2005,13.5,33.1,-1599,-15.6,35,0,210,210,1023
1991,44,e) 4,1251,1285,11567,12323,40,2.9,250,18,1236,221,1015,1.8,10,2748,1058,1690,8.6,22.3,-1512,-12.3,20,0,173,174,801
1991,44,f) 5,1056,1097,7974,8648,29,2.5,158,13.6,1036,251,785,2.9,12,2384,866,1518,10,27.6,-1348,-15.6,24,0,113,113,642
1991,44,g) 6 to 10,3713,3887,39036,41793,111,2.7,453,11.1,4364,785,3579,1.9,10.4,9878,2943,6935,7,23.6,-5514,-13.2,20.8,0,325,325,1933
1991,44,h) 11 to 15,2261,2515,29623,31374,86,3.3,259,10,3502,925,2577,2.9,11.2,7004,2272,4732,7.2,22.3,-3502,-11.1,22.4,0,162,164,1587
1991,44,l) Left Censored,6645,8681,245193,250699,307,3.5,697,7.9,23429,8038,15391,3.2,9.3,34443,7575,26868,3,13.7,-11014,-4.4,18.6,0,320,340,2985
1991,45,a) 0,6307,6413,36921,18582,6356,198.2,0,0,36679,36679,0,197.4,197.4,0,0,0,0,0,36679,197.4,0,0,,,
1991,45,b) 1,5082,5149,36892,37476,64,1.1,1069,18.8,10917,1281,9636,3.4,29.1,12084,6229,5855,16.6,32.2,-1167,-3.1,58.2,0,734,734,4571
1991,45,c) 2,4152,4322,34820,36723,156,3.4,717,15.6,7024,1338,5686,3.6,19.1,10830,4634,6196,12.6,29.5,-3806,-10.4,38.2,0,541,541,4020
1991,45,d) 3,3769,3988,55062,58782,208,5,636,15.1,5456,1191,4265,2,9.3,12896,3969,8927,6.8,21.9,-7440,-12.6,18.6,0,499,502,3144
1991,45,e) 4,3460,3717,46161,47788,177,4.5,602,15.3,6635,1877,4758,3.9,13.9,9888,3710,6178,7.8,20.7,-3253,-6.8,27.8,0,443,447,2820
1991,45,f) 5,3077,3282,27533,29167,139,4.1,438,12.8,4574,1343,3231,4.6,15.7,7841,3377,4464,11.6,26.9,-3267,-11.2,31.4,0,323,323,2275
1991,45,g) 6 to 10,11556,12658,137728,142853,514,3.9,1295,9.9,17771,4162,13609,2.9,12.4,28020,9633,18387,6.7,19.6,-10249,-7.2,24.8,0,897,903,6027
1991,45,h) 11 to 15,6277,7570,93020,95490,408,5.3,641,8.3,14149,4803,9346,5,14.8,19088,4825,14263,5.1,20,-4939,-5.2,29.6,0,358,359,2166
1991,45,l) Left Censored,14371,25402,761279,770649,1584,6.2,1879,7.4,87745,37052,50693,4.8,11.4,106485,29796,76689,3.9,13.8,-18740,-2.4,22.8,0,694,729,7203
1991,46,a) 0,1512,1529,8442,4245,1511,197.6,0,0,8394,8394,0,197.7,197.7,0,0,0,0,0,8394,197.7,0,0,,,
1991,46,b) 1,1326,1338,8953,8596,11,0.7,239,16.3,2600,198,2402,2.3,30.2,1886,759,1127,8.8,21.9,714,8.3,43.8,0,147,147,476
1991,46,c) 2,947,965,6048,6211,41,4,141,13.8,1234,200,1034,3.2,19.9,1560,608,952,9.8,25.1,-326,-5.2,39.8,0,104,104,498
1991,46,d) 3,860,899,5963,6251,27,2.9,105,11.2,854,92,762,1.5,13.7,1430,555,875,8.9,22.9,-576,-9.2,27.4,0,76,76,476
1991,46,e) 4,781,809,10309,10387,38,4.5,107,12.7,1122,171,951,1.6,10.8,1278,449,829,4.3,12.3,-156,-1.5,21.6,0,77,77,336
1991,46,f) 5,686,715,5911,5778,34,4.6,82,11.1,1310,239,1071,4.1,22.7,1044,303,741,5.2,18.1,266,4.6,36.2,0,63,63,236
1991,46,g) 6 to 10,2962,3238,24873,25374,133,4,283,8.6,3225,578,2647,2.3,12.7,4226,1444,2782,5.7,16.7,-1001,-4,25.4,0,192,192,922
1991,46,h) 11 to 15,1973,2237,22714,22510,99,4.4,163,7.2,3397,597,2800,2.7,15.1,2989,1031,1958,4.6,13.3,408,1.8,26.6,0,97,98,465
1991,46,l) Left Censored,4947,6761,131244,129205,352,5.2,418,6.2,16759,5714,11045,4.4,13,12681,3491,9190,2.7,9.8,4078,3.2,19.6,0,235,235,1859
1991,47,a) 0,8494,8678,59545,29903,8607,198.4,0,0,59285,59285,0,198.3,198.3,0,0,0,0,0,59285,198.3,0,0,,,
1991,47,b) 1,6841,6986,54353,55611,84,1.1,1662,21.2,15761,2176,13585,3.9,28.3,18276,9014,9262,16.2,32.9,-2515,-4.6,56.6,0,1231,1231,6803
1991,47,c) 2,5753,5970,48592,53960,201,3.1,1222,18.8,9858,1321,8537,2.4,18.3,20593,11245,9348,20.8,38.2,-10735,-19.9,36.6,0,977,979,9533
1991,47,d) 3,4997,5211,46792,50039,212,3.8,855,15.5,8884,1694,7190,3.4,17.8,15377,6975,8402,13.9,30.7,-6493,-12.9,35.6,0,650,651,4913
1991,47,e) 4,4704,5093,61882,63479,235,4.4,759,14.2,8495,2438,6057,3.8,13.4,11688,4533,7155,7.1,18.4,-3193,-5,26.8,0,560,561,2993
1991,47,f) 5,4242,4520,43603,46964,146,3.1,644,13.5,6113,1008,5105,2.1,13,12835,5784,7051,12.3,27.3,-6722,-14.3,26,0,460,467,4757
1991,47,g) 6 to 10,15901,17413,193385,201219,633,3.5,1699,9.5,25015,6315,18700,3.1,12.4,40682,14670,26012,7.3,20.2,-15667,-7.8,24.8,0,1173,1178,10201
1991,47,h) 11 to 15,9232,11480,171240,171312,541,4.6,950,8.1,25901,6771,19130,4,15.1,26046,6845,19201,4,15.2,-145,-0.1,30.2,0,554,580,4348
1991,47,l) Left Censored,21605,37829,1169623,1182687,2345,6.2,2810,7.4,137963,51202,86761,4.3,11.7,164092,41706,122386,3.5,13.9,-26129,-2.2,23.4,0,1107,1142,9448
1991,48,a) 0,33970,34446,229388,115360,34200,198.6,0,0,228057,228057,0,197.7,197.7,0,0,0,0,0,228057,197.7,0,0,,,
1991,48,b) 1,26158,26851,237334,231716,435,1.5,5840,19.6,83550,9967,73583,4.3,36.1,72313,35687,36626,15.4,31.2,11237,4.9,62.4,0,4206,4207,27343
1991,48,c) 2,20585,21281,189033,202848,797,3.5,4033,17.6,43926,6343,37583,3.1,21.7,71555,35812,35743,17.7,35.3,-27629,-13.6,43.4,0,3094,3100,29988
1991,48,d) 3,17210,18559,188767,191310,987,5,3151,16.1,45548,9089,36459,4.8,23.8,50634,24460,26174,12.8,26.5,-5086,-2.7,47.6,0,2403,2411,19435
1991,48,e) 4,15562,16743,211446,214990,761,4.3,2755,15.6,38798,5948,32850,2.8,18,45885,25429,20456,11.8,21.3,-7087,-3.3,36,0,1973,2035,19004
1991,48,f) 5,14688,15936,155691,170481,702,4.2,2321,13.9,29488,7085,22403,4.2,17.3,59067,37079,21988,21.7,34.6,-29579,-17.3,34.6,0,1705,1710,32075
1991,48,g) 6 to 10,63466,70320,761414,775535,3124,4.3,7915,10.9,132433,31044,101389,4,17.1,160674,60979,99695,7.9,20.7,-28241,-3.6,34.2,0,5378,5418,38969
1991,48,h) 11 to 15,28431,36149,449511,454661,1901,5.2,3376,9.2,74236,23338,50898,5.1,16.3,84535,30010,54525,6.6,18.6,-10299,-2.3,32.6,0,1944,2013,14715
1991,48,l) Left Censored,57888,117712,3501000,3503186,7299,6.1,9699,8.2,471658,150146,321512,4.3,13.5,476030,143869,332161,4.1,13.6,-4372,-0.1,27,0,3437,3631,33166
1991,49,a) 0,3220,3256,21834,10966,3235,198.7,0,0,21737,21737,0,198.2,198.2,0,0,0,0,0,21737,198.2,0,0,,,
1991,49,b) 1,2384,2440,20467,20052,31,1.1,515,19.1,6383,234,6149,1.2,31.8,5552,2870,2682,14.3,27.7,831,4.1,55.4,0,367,367,2394
1991,49,c) 2,2034,2089,22779,23436,72,3.2,343,15.4,5000,767,4233,3.3,21.3,6313,3001,3312,12.8,26.9,-1313,-5.6,42.6,0,268,268,2610
1991,49,d) 3,1719,1819,20905,22651,69,3.6,268,14,4096,847,3249,3.7,18.1,7587,3487,4100,15.4,33.5,-3491,-15.4,36.2,0,200,200,3053
1991,49,e) 4,1496,1593,18277,18407,98,5.9,234,14.1,3350,695,2655,3.8,18.2,3609,1768,1841,9.6,19.6,-259,-1.4,36.4,0,183,183,1463
1991,49,f) 5,1310,1379,22910,21391,56,3.9,200,13.9,6200,451,5749,2.1,29,3161,1329,1832,6.2,14.8,3039,14.2,29.6,0,157,157,1000
1991,49,g) 6 to 10,5154,5791,76353,77807,293,4.9,590,9.9,12264,2618,9646,3.4,15.8,15171,5940,9231,7.6,19.5,-2907,-3.7,31.6,0,413,422,4059
1991,49,h) 11 to 15,3309,3892,54551,54651,215,5.5,328,8.3,9136,3163,5973,5.8,16.7,9336,2596,6740,4.8,17.1,-200,-0.4,33.4,0,208,210,1689
1991,49,l) Left Censored,6630,10988,336759,330701,691,6.3,829,7.5,49003,13838,35165,4.2,14.8,36887,9313,27574,2.8,11.2,12116,3.6,22.4,0,271,277,2565
1991,50,a) 0,1366,1377,6406,3227,1359,197.4,0,0,6359,6359,0,197.1,197.1,0,0,0,0,0,6359,197.1,0,0,,,
1991,50,b) 1,1324,1342,7075,7125,11,0.7,259,17.5,1910,118,1792,1.7,26.8,2010,757,1253,10.6,28.2,-100,-1.4,53.6,0,172,172,548
1991,50,c) 2,1297,1315,7707,8436,41,2.9,259,18.2,1207,160,1047,1.9,14.3,2664,1426,1238,16.9,31.6,-1457,-17.3,28.6,0,188,188,1069
1991,50,d) 3,1059,1070,6508,7214,32,2.7,227,19.4,981,164,817,2.3,13.6,2393,1192,1201,16.5,33.2,-1412,-19.6,27.2,0,147,147,675
1991,50,e) 4,987,1013,8173,8648,31,2.8,194,17.7,958,342,616,4,11.1,1908,865,1043,10,22.1,-950,-11,22.2,0,151,151,695
1991,50,f) 5,924,945,6829,7218,27,2.7,132,13.2,866,128,738,1.8,12,1644,517,1127,7.2,22.8,-778,-10.8,24,0,90,90,361
1991,50,g) 6 to 10,3026,3220,25616,27132,99,3,290,8.8,2690,554,2136,2,9.9,5722,1625,4097,6,21.1,-3032,-11.2,19.8,0,191,192,1256
1991,50,h) 11 to 15,1623,1834,20051,20964,51,2.7,161,8.5,2162,513,1649,2.4,10.3,3987,1024,2963,4.9,19,-1825,-8.7,20.6,0,100,100,597
1991,50,l) Left Censored,3658,5130,117389,120791,217,4.2,313,6,9617,3000,6617,2.5,8,16421,3754,12667,3.1,13.6,-6804,-5.6,16,0,152,156,1671
1991,51,a) 0,11058,11183,59088,29790,11115,198.8,0,0,58597,58597,0,196.7,196.7,0,0,0,0,0,58597,196.7,0,0,,,
1991,51,b) 1,9417,9574,62205,63600,107,1,2415,22.3,18392,3149,15243,5,28.9,21181,11052,10129,17.4,33.3,-2789,-4.4,57.8,0,1690,1692,8149
1991,51,c) 2,7896,8117,63623,68961,277,3.1,1773,20,10814,1323,9491,1.9,15.7,21489,10726,10763,15.6,31.2,-10675,-15.5,31.4,0,1293,1294,7729
1991,51,d) 3,7067,7360,62541,67992,306,3.9,1401,17.7,9762,2206,7556,3.2,14.4,20664,9486,11178,14,30.4,-10902,-16,28.8,0,1043,1044,7861
1991,51,e) 4,6349,6696,67120,72084,248,3.5,1204,16.8,8178,1544,6634,2.1,11.3,18105,8169,9936,11.3,25.1,-9927,-13.8,22.6,0,882,891,5965
1991,51,f) 5,5993,6394,61369,64440,263,3.9,951,14.1,10059,2156,7903,3.3,15.6,16201,6071,10130,9.4,25.1,-6142,-9.5,31.2,0,674,683,4465
1991,51,g) 6 to 10,20368,22446,264472,277748,960,4.1,2448,10.6,36486,9775,26711,3.5,13.1,63038,18622,44416,6.7,22.7,-26552,-9.6,26.2,0,1563,1583,12502
1991,51,h) 11 to 15,11239,14060,187926,195912,699,4.9,1218,8.5,24080,8021,16059,4.1,12.3,40051,10076,29975,5.1,20.4,-15971,-8.1,24.6,0,665,674,4127
1991,51,l) Left Censored,25468,48358,1394192,1425851,2929,6,3643,7.5,154989,57966,97023,4.1,10.9,218307,59939,158368,4.2,15.3,-63318,-4.4,21.8,0,1222,1286,12249
1991,53,a) 0,11952,12090,61975,31096,11985,198.3,0,0,61759,61759,0,198.6,198.6,0,0,0,0,0,61759,198.6,0,0,,,
1991,53,b) 1,10643,10833,74179,72916,103,0.8,2475,20.4,22587,1791,20796,2.5,31,20061,9967,10094,13.7,27.5,2526,3.5,55,0,1639,1639,7172
1991,53,c) 2,6221,6390,51713,54931,242,3.5,1089,15.9,10781,1333,9448,2.4,19.6,17216,7310,9906,13.3,31.3,-6435,-11.7,39.2,0,784,787,5398
1991,53,d) 3,6426,6645,56675,58445,321,4.6,979,14.1,10916,1642,9274,2.8,18.7,14455,6183,8272,10.6,24.7,-3539,-6,37.4,0,724,724,5176
1991,53,e) 4,5831,6156,67915,70974,258,4,894,13.8,9204,1720,7484,2.4,13,15322,5287,10035,7.4,21.6,-6118,-8.6,26,0,617,632,3814
1991,53,f) 5,5288,5645,50831,53000,254,4.3,761,12.9,8825,1984,6841,3.7,16.7,13163,4831,8332,9.1,24.8,-4338,-8.1,33.4,0,560,563,3560
1991,53,g) 6 to 10,19327,21256,240265,243701,1020,4.7,2190,10,41223,9633,31590,4,16.9,48094,15713,32381,6.4,19.7,-6871,-2.8,33.8,0,1462,1473,10571
1991,53,h) 11 to 15,11710,13848,166563,169232,757,5.4,1171,8.3,25129,6914,18215,4.1,14.8,30466,7902,22564,4.7,18,-5337,-3.2,29.6,0,657,679,4302
1991,53,l) Left Censored,21037,35652,968706,973264,2344,6.6,2565,7.2,130047,34948,95099,3.6,13.4,139163,47260,91903,4.9,14.3,-9116,-0.9,26.8,0,1007,1027,8630
1991,54,a) 0,2609,2665,16401,8226,2644,198.4,0,0,16351,16351,0,198.8,198.8,0,0,0,0,0,16351,198.8,0,0,,,
1991,54,b) 1,2179,2194,15180,15060,24,1,487,19.9,4622,594,4028,3.9,30.7,4382,2099,2283,13.9,29.1,240,1.6,58.2,0,360,360,1563
1991,54,c) 2,1825,1873,16149,17469,61,3,310,15.5,2254,419,1835,2.4,12.9,4894,2204,2690,12.6,28,-2640,-15.1,25.8,0,237,239,1912
1991,54,d) 3,1586,1620,13006,13690,61,3.6,255,14.9,1901,327,1574,2.4,13.9,3269,1455,1814,10.6,23.9,-1368,-10,27.8,0,184,189,1219
1991,54,e) 4,1504,1573,15608,16455,55,3.3,231,13.9,2016,327,1689,2,12.3,3709,1888,1821,11.5,22.5,-1693,-10.2,24.6,0,170,171,1417
1991,54,f) 5,1336,1441,13556,13855,47,3.1,170,11.3,2013,270,1743,1.9,14.5,2611,1024,1587,7.4,18.8,-598,-4.3,29,0,126,126,852
1991,54,g) 6 to 10,5287,5747,64493,66223,205,3.5,523,8.9,6951,1682,5269,2.5,10.5,10411,2986,7425,4.5,15.7,-3460,-5.2,21,0,384,385,2346
1991,54,h) 11 to 15,3200,3854,40793,41144,202,5.2,291,7.5,5536,1523,4013,3.7,13.5,6238,1759,4479,4.3,15.2,-702,-1.7,27,0,169,169,990
1991,54,l) Left Censored,8814,13525,287717,289478,692,5.1,986,7.2,31796,11767,20029,4.1,11,35317,8594,26723,3,12.2,-3521,-1.2,22,0,423,435,3226
1991,55,a) 0,8282,8429,47693,23963,8359,198.3,0,0,47460,47460,0,198.1,198.1,0,0,0,0,0,47460,198.1,0,0,,,
1991,55,b) 1,7090,7278,50331,50526,101,1.3,1281,16.2,13573,1825,11748,3.6,26.9,13962,5367,8595,10.6,27.6,-389,-0.7,53.8,0,865,865,4227
1991,55,c) 2,6072,6204,44807,47028,159,2.4,911,13.8,7983,963,7020,2,17,12425,5331,7094,11.3,26.4,-4442,-9.4,34,0,687,695,4273
1991,55,d) 3,5300,5430,44685,46814,155,2.7,654,11.5,7016,1333,5683,2.8,15,11274,5082,6192,10.9,24.1,-4258,-9.1,30,0,520,520,4348
1991,55,e) 4,5287,5716,66076,67410,217,3.7,682,11.5,8188,1522,6666,2.3,12.1,10856,4299,6557,6.4,16.1,-2668,-4,24.2,0,513,522,3324
1991,55,f) 5,4462,4676,50006,52174,131,2.7,483,10,6938,1420,5518,2.7,13.3,11273,5398,5875,10.3,21.6,-4335,-8.3,26.6,0,380,386,3545
1991,55,g) 6 to 10,16857,18537,203496,207743,683,3.6,1599,8.4,27322,6754,20568,3.3,13.2,35815,13021,22794,6.3,17.2,-8493,-4,26.4,0,1129,1141,7272
1991,55,h) 11 to 15,10804,12906,167761,166775,599,4.6,1029,7.8,24717,4780,19937,2.9,14.8,22744,6196,16548,3.7,13.6,1973,1.2,27.2,0,636,660,3809
1991,55,l) Left Censored,28272,42605,1263993,1271370,2079,4.9,2633,6.1,120605,36579,84026,2.9,9.5,135359,31603,103756,2.5,10.6,-14754,-1.1,19,0,1297,1329,12490
1991,56,a) 0,1117,1122,4891,2458,1111,198,0,0,4867,4867,0,198,198,0,0,0,0,0,4867,198,0,0,,,
1991,56,b) 1,869,876,4857,4707,9,0.9,171,17.6,1391,88,1303,1.9,29.6,1091,557,534,11.8,23.2,300,6.4,46.4,0,111,111,421
1991,56,c) 2,677,704,4888,5070,37,5,109,14.7,1131,237,894,4.7,22.3,1495,498,997,9.8,29.5,-364,-7.2,44.6,0,86,86,442
1991,56,d) 3,608,619,4382,4501,20,3.1,92,14.1,782,155,627,3.4,17.4,1020,437,583,9.7,22.7,-238,-5.3,34.8,0,63,63,303
1991,56,e) 4,555,592,5731,5643,27,4.4,70,11.4,1035,227,808,4,18.3,858,322,536,5.7,15.2,177,3.1,30.4,0,52,52,226
1991,56,f) 5,542,552,3472,3596,23,4,74,12.9,607,94,513,2.6,16.9,855,455,400,12.7,23.8,-248,-6.9,33.8,0,57,57,376
1991,56,g) 6 to 10,2425,2642,21421,21366,118,4.3,275,10.1,3513,663,2850,3.1,16.4,3402,1104,2298,5.2,15.9,111,0.5,31.8,0,200,200,875
1991,56,h) 11 to 15,1606,1847,17142,17503,105,5.6,134,7.2,2684,635,2049,3.6,15.3,3406,788,2618,4.5,19.5,-722,-4.2,30.6,0,80,83,506
1991,56,l) Left Censored,2861,4115,68160,67288,246,6,249,6.1,8607,2293,6314,3.4,12.8,6862,1577,5285,2.3,10.2,1745,2.6,20.4,0,112,112,719
1992,01,a) 0,6730,6873,41423,21625,6855,199.5,0,0,39597,39597,0,183.1,183.1,0,0,0,0,0,39597,183.1,0,0,,,
1992,01,b) 1,5000,5134,37469,37529,59,1,1372,23.4,11748,1119,10629,3,31.3,11867,6822,5045,18.2,31.6,-119,-0.3,62.6,0,1112,1112,5683
1992,01,c) 2,4482,4634,36919,38081,233,4.6,917,18.3,7952,1513,6439,4,20.9,10275,5180,5095,13.6,27,-2323,-6.1,41.8,0,767,767,4456
1992,01,d) 3,3886,4059,35116,36183,188,4.4,651,15.1,7063,1412,5651,3.9,19.5,9197,4177,5020,11.5,25.4,-2134,-5.9,39,0,546,546,3364
1992,01,e) 4,3456,3641,39526,39055,162,4.2,523,13.6,7960,887,7073,2.3,20.4,7018,3244,3774,8.3,18,942,2.4,36,0,407,407,2554
1992,01,f) 5,3331,3591,46963,47103,158,4.2,518,13.7,7813,2458,5355,5.2,16.6,8092,3110,4982,6.6,17.2,-279,-0.6,33.2,0,379,411,2152
1992,01,g) 6 to 10,12561,13667,148287,149571,571,4,1391,9.9,25598,4845,20753,3.2,17.1,28166,10036,18130,6.7,18.8,-2568,-1.7,34.2,0,991,1000,6861
1992,01,h) 11 to 15,8783,11011,171971,175231,508,4.5,882,7.9,22706,4477,18229,2.6,13,29225,6712,22513,3.8,16.7,-6519,-3.7,26,0,536,552,3364
1992,01,l) Left Censored,15742,27728,799808,802079,1332,4.7,1974,7,89767,19737,70030,2.5,11.2,94309,27960,66349,3.5,11.8,-4542,-0.6,22.4,0,762,785,9029
1992,02,a) 0,1189,1225,5048,2527,1222,199.5,0,0,5043,5043,0,199.6,199.6,0,0,0,0,0,5043,199.6,0,0,,,
1992,02,b) 1,992,1013,5665,5476,11,1,269,23.3,2122,345,1777,6.3,38.8,1744,847,897,15.5,31.8,378,7,63.6,0,201,201,680
1992,02,c) 2,891,912,5747,5808,58,5.9,188,19.1,1888,510,1378,8.8,32.5,2010,1089,921,18.8,34.6,-122,-2.1,65,0,141,141,912
1992,02,d) 3,575,586,4652,4764,24,3.8,100,15.9,1082,114,968,2.4,22.7,1305,631,674,13.2,27.4,-223,-4.7,45.4,0,68,68,463
1992,02,e) 4,594,645,6185,6488,32,4.7,84,12.4,1394,133,1261,2,21.5,1999,452,1547,7,30.8,-605,-9.3,43,0,67,67,387
1992,02,f) 5,585,621,7935,8037,39,6,96,14.7,2060,158,1902,2,25.6,2264,769,1495,9.6,28.2,-204,-2.6,51.2,0,57,61,468
1992,02,g) 6 to 10,2523,2805,24347,24890,175,6.1,294,10.2,4927,1254,3673,5,19.8,6013,2379,3634,9.6,24.2,-1086,-4.4,39.6,0,188,191,1565
1992,02,h) 11 to 15,1551,1938,22327,22185,136,7,142,7.3,4325,1218,3107,5.5,19.5,4041,1037,3004,4.7,18.2,284,1.3,36.4,0,69,73,309
1992,02,l) Left Censored,1979,3486,82467,81904,267,7.7,248,7.1,13152,3600,9552,4.4,16.1,12025,2435,9590,3,14.7,1127,1.4,29.4,0,56,59,684
1992,04,a) 0,7877,8024,49971,25012,8005,199.5,0,0,49919,49919,0,199.6,199.6,0,0,0,0,0,49919,199.6,0,0,,,
1992,04,b) 1,6011,6155,48972,48264,86,1.2,1813,25.5,17491,3893,13598,8.1,36.2,16075,9840,6235,20.4,33.3,1416,2.9,66.6,0,1434,1434,8406
1992,04,c) 2,5101,5236,43984,53953,254,4.4,1179,20.5,12322,1522,10800,2.8,22.8,32260,26449,5811,49,59.8,-19938,-37,45.6,0,984,985,5414
1992,04,d) 3,4428,4626,44318,46358,222,4.4,898,18,8977,1957,7020,4.2,19.4,13057,7151,5906,15.4,28.2,-4080,-8.8,38.8,0,693,703,5624
1992,04,e) 4,3798,4029,36199,38288,208,4.9,665,15.5,6918,1060,5858,2.8,18.1,11096,5474,5622,14.3,29,-4178,-10.9,36.2,0,524,527,4457
1992,04,f) 5,3665,3991,52425,51471,174,4.1,611,14.5,10984,1159,9825,2.3,21.3,9076,3771,5305,7.3,17.6,1908,3.7,35.2,0,452,463,3183
1992,04,g) 6 to 10,13417,15148,189572,192512,780,5,1819,11.6,30474,6292,24182,3.3,15.8,36353,11997,24356,6.2,18.9,-5879,-3.1,31.6,0,1189,1223,7814
1992,04,h) 11 to 15,8304,10259,146440,146168,533,5.1,978,9.3,24146,4594,19552,3.1,16.5,23602,6830,16772,4.7,16.1,544,0.4,32.2,0,498,510,3268
1992,04,l) Left Censored,10547,21408,637048,645222,1413,6.5,2070,9.5,85305,29096,56209,4.5,13.2,101653,27211,74442,4.2,15.8,-16348,-2.6,26.4,0,492,601,4903
1992,05,a) 0,4411,4490,25665,13041,4470,199.1,0,0,25249,25249,0,193.6,193.6,0,0,0,0,0,25249,193.6,0,0,,,
1992,05,b) 1,3186,3272,23045,22909,42,1.1,949,25.2,7437,776,6661,3.4,32.5,7165,3909,3256,17.1,31.3,272,1.2,62.6,0,764,764,2998
1992,05,c) 2,2858,2954,21377,23511,133,4.1,606,18.8,5011,913,4098,3.9,21.3,9279,3456,5823,14.7,39.5,-4268,-18.2,42.6,0,506,507,3052
1992,05,d) 3,2305,2358,20616,22154,91,3.6,418,16.5,4549,648,3901,2.9,20.5,7624,5075,2549,22.9,34.4,-3075,-13.9,41,0,327,327,2258
1992,05,e) 4,1972,2047,20827,20313,76,3.5,332,15.2,4846,474,4372,2.3,23.9,3817,1844,1973,9.1,18.8,1029,5.1,37.6,0,266,266,1404
1992,05,f) 5,2045,2205,21795,23428,102,4.4,276,12,3503,593,2910,2.5,15,6768,1972,4796,8.4,28.9,-3265,-13.9,30,0,202,203,1310
1992,05,g) 6 to 10,8057,8667,82491,83589,351,3.9,871,9.7,12748,2255,10493,2.7,15.3,14943,5211,9732,6.2,17.9,-2195,-2.6,30.6,0,632,641,3788
1992,05,h) 11 to 15,6214,7218,88919,88362,295,4,608,8.2,14237,1975,12262,2.2,16.1,13123,4147,8976,4.7,14.9,1114,1.2,29.8,0,383,394,2364
1992,05,l) Left Censored,10224,16392,478678,475970,811,4.9,1161,7,55004,11164,43840,2.3,11.6,49587,12547,37040,2.6,10.4,5417,1.2,20.8,0,485,519,4158
1992,06,a) 0,58011,59170,414263,207717,58981,199.4,0,0,413092,413092,0,198.9,198.9,0,0,0,0,0,413092,198.9,0,0,,,
1992,06,b) 1,46255,47576,356069,365318,635,1.1,14981,26.9,111526,12062,99464,3.3,30.5,130024,72504,57520,19.8,35.6,-18498,-5.1,61,0,11821,11835,58504
1992,06,c) 2,41507,42841,345271,366906,2172,4.6,10137,21.4,83633,12602,71031,3.4,22.8,126902,64961,61941,17.7,34.6,-43269,-11.8,45.6,0,7945,7958,54125
1992,06,d) 3,35683,37114,330226,342237,1751,4.4,7084,17.7,75381,12391,62990,3.6,22,99402,48956,50446,14.3,29,-24021,-7,44,0,5544,5585,39799
1992,06,e) 4,31546,33301,314830,330053,1551,4.4,5796,16.3,61318,9951,51367,3,18.6,91764,42674,49090,12.9,27.8,-30446,-9.2,37.2,0,4339,4361,32729
1992,06,f) 5,30185,32263,427299,435741,1484,4.3,5144,15,78664,17671,60993,4.1,18.1,95548,36758,58790,8.4,21.9,-16884,-3.8,36.2,0,3614,3665,27517
1992,06,g) 6 to 10,109339,121467,1488312,1540503,5626,4.4,14932,11.8,240648,46976,193672,3,15.6,345029,125088,219941,8.1,22.4,-104381,-6.8,31.2,0,9936,10138,85703
1992,06,h) 11 to 15,78912,96254,1320302,1381771,4898,4.9,10110,10.2,204573,57565,147008,4.2,14.8,327510,129753,197757,9.4,23.7,-122937,-8.9,29.6,0,5711,5899,85546
1992,06,l) Left Censored,98559,186869,5603031,5767396,10328,5.4,17042,8.9,702991,219043,483948,3.8,12.2,1031722,279216,752506,4.8,17.9,-328731,-5.7,24.4,0,5819,6292,53744
1992,08,a) 0,9073,9163,49361,24713,9137,199.4,0,0,49297,49297,0,199.5,199.5,0,0,0,0,0,49297,199.5,0,0,,,
1992,08,b) 1,6974,7131,46169,46134,101,1.2,1839,22.8,14525,2703,11822,5.9,31.5,14454,8741,5713,18.9,31.3,71,0.2,62.6,0,1405,1405,7187
1992,08,c) 2,5560,5709,41175,43966,248,4,1276,20.4,10144,1462,8682,3.3,23.1,15726,9689,6037,22,35.8,-5582,-12.7,46.2,0,998,1006,8720
1992,08,d) 3,4828,5006,42942,44355,235,4.4,876,16.4,9058,1677,7381,3.8,20.4,11883,6010,5873,13.5,26.8,-2825,-6.4,40.8,0,669,678,4794
1992,08,e) 4,4237,4427,41007,41093,202,4.3,648,13.9,9011,2303,6708,5.6,21.9,9183,5071,4112,12.3,22.3,-172,-0.4,43.8,0,484,485,3449
1992,08,f) 5,3932,4201,47611,48087,208,4.7,543,12.4,8452,1526,6926,3.2,17.6,9404,4072,5332,8.5,19.6,-952,-2,35.2,0,400,412,3091
1992,08,g) 6 to 10,14879,16389,196079,196232,757,4.5,1797,10.6,36272,9499,26773,4.8,18.5,36577,16909,19668,8.6,18.6,-305,-0.1,37,0,1232,1250,8999
1992,08,h) 11 to 15,10554,12571,150304,149185,658,5.1,1181,9.2,25487,6066,19421,4.1,17.1,23249,7763,15486,5.2,15.6,2238,1.5,31.2,0,648,666,4008
1992,08,l) Left Censored,14116,24630,700803,699133,1433,5.7,2167,8.7,91644,25478,66166,3.6,13.1,88303,26610,61693,3.8,12.6,3341,0.5,25.2,0,666,714,4762
1992,09,a) 0,5390,5486,30916,15541,5468,199.3,0,0,30751,30751,0,197.9,197.9,0,0,0,0,0,30751,197.9,0,0,,,
1992,09,b) 1,4360,4449,31706,32527,53,1.1,1143,22.6,8193,655,7538,2,25.2,9835,5486,4349,16.9,30.2,-1642,-5,50.4,0,881,881,4333
1992,09,c) 2,4234,4327,28823,30489,185,3.9,903,19.1,5820,928,4892,3,19.1,9151,4099,5052,13.4,30,-3331,-10.9,38.2,0,714,714,3295
1992,09,d) 3,4231,4380,30115,31892,194,4.1,802,17,5676,761,4915,2.4,17.8,9230,5074,4156,15.9,28.9,-3554,-11.1,35.6,0,630,633,4357
1992,09,e) 4,3882,4024,39597,39576,178,4.1,679,15.8,7897,1177,6720,3,20,7855,3597,4258,9.1,19.8,42,0.2,39.6,0,534,535,2677
1992,09,f) 5,3670,3817,39471,42644,141,3.5,594,14.6,4964,622,4342,1.5,11.6,11310,4023,7287,9.4,26.5,-6346,-14.9,23.2,0,435,435,2855
1992,09,g) 6 to 10,13000,13796,131093,134482,559,3.9,1639,11.4,21098,5744,15354,4.3,15.7,27876,11520,16356,8.6,20.7,-6778,-5,31.4,0,1102,1115,8104
1992,09,h) 11 to 15,9023,10395,121147,124542,364,3.4,1013,9.4,15031,2984,12047,2.4,12.1,21821,6388,15433,5.1,17.5,-6790,-5.4,24.2,0,611,614,3159
1992,09,l) Left Censored,19573,28968,953218,972468,1270,4.3,2388,8.1,97912,24274,73638,2.5,10.1,136411,32152,104259,3.3,14,-38499,-3.9,20.2,0,932,991,7961
1992,10,a) 0,1385,1408,7081,3545,1406,199.7,0,0,7072,7072,0,199.5,199.5,0,0,0,0,0,7072,199.5,0,0,,,
1992,10,b) 1,1127,1160,7466,7297,57,4.4,269,20.9,2450,853,1597,11.7,33.6,2111,1126,985,15.4,28.9,339,4.7,57.8,0,196,196,869
1992,10,c) 2,973,996,6365,6539,53,4.9,204,18.9,1424,223,1201,3.4,21.8,1771,974,797,14.9,27.1,-347,-5.3,43.6,0,154,154,744
1992,10,d) 3,912,928,7064,7500,36,3.6,149,15.1,1111,151,960,2,14.8,1982,943,1039,12.6,26.4,-871,-11.6,29.6,0,108,108,764
1992,10,e) 4,726,740,6993,7259,30,3.8,123,15.5,1306,338,968,4.7,18,1837,672,1165,9.3,25.3,-531,-7.3,36,0,95,95,491
1992,10,f) 5,738,772,7968,8298,40,5,101,12.5,1294,255,1039,3.1,15.6,1954,753,1201,9.1,23.5,-660,-7.9,31.2,0,76,76,599
1992,10,g) 6 to 10,2513,2702,27122,28017,135,4.9,266,9.6,3583,706,2877,2.5,12.8,5372,2005,3367,7.2,19.2,-1789,-6.4,25.6,0,184,185,1034
1992,10,h) 11 to 15,1746,2059,36153,37541,96,4.6,189,9,6940,1289,5651,3.4,18.5,9716,5746,3970,15.3,25.9,-2776,-7.4,37,0,107,112,725
1992,10,l) Left Censored,3917,6120,195279,200217,449,7.3,569,9.2,19303,5886,13417,2.9,9.6,29178,8518,20660,4.3,14.6,-9875,-5,19.2,0,159,159,980
1992,11,a) 0,1108,1143,27473,13740,1140,199.5,0,0,27467,27467,0,199.9,199.9,0,0,0,0,0,27467,199.9,0,0,,,
1992,11,b) 1,877,886,6275,6558,14,1.4,184,18.8,1621,140,1481,2.1,24.7,2187,947,1240,14.4,33.3,-566,-8.6,49.4,0,138,138,670
1992,11,c) 2,792,824,7625,7642,37,4.2,133,15.1,1688,241,1447,3.2,22.1,1721,891,830,11.7,22.5,-33,-0.4,44.2,0,101,101,677
1992,11,d) 3,748,784,8901,8617,39,4.7,121,14.6,2252,143,2109,1.7,26.1,1684,789,895,9.2,19.5,568,6.6,39,0,93,94,676
1992,11,e) 4,699,738,11359,11208,50,6.5,100,13.1,1675,280,1395,2.5,14.9,1373,534,839,4.8,12.3,302,2.6,24.6,0,76,76,413
1992,11,f) 5,628,656,6168,6344,36,5.2,105,15.1,1253,153,1100,2.4,19.8,1604,714,890,11.3,25.3,-351,-5.5,39.6,0,80,80,634
1992,11,g) 6 to 10,2830,3009,38335,39551,123,3.9,329,10.5,4974,843,4131,2.1,12.6,7405,2439,4966,6.2,18.7,-2431,-6.1,25.2,0,210,213,1740
1992,11,h) 11 to 15,2046,2397,68754,69404,116,4.7,211,8.6,5992,1156,4836,1.7,8.6,7291,1898,5393,2.7,10.5,-1299,-1.9,17.2,0,111,112,840
1992,11,l) Left Censored,4914,7283,229261,233568,428,5.8,603,8.2,26089,5656,20433,2.4,11.2,34702,8412,26290,3.6,14.9,-8613,-3.7,22.4,0,192,201,2468
1992,12,a) 0,36392,36897,199192,100621,36796,199.5,0,0,197143,197143,0,195.9,195.9,0,0,0,0,0,197143,195.9,0,0,,,
1992,12,b) 1,26292,26895,180452,187103,296,1,7809,25.2,54287,6763,47524,3.6,29,67589,41495,26094,22.2,36.1,-13302,-7.1,58,0,6360,6366,34417
1992,12,c) 2,22856,23328,171661,181569,1140,4.4,5461,21.3,40882,6555,34327,3.6,22.5,60697,33479,27218,18.4,33.4,-19815,-10.9,45,0,4431,4441,28217
1992,12,d) 3,19095,19762,154749,159823,950,4.4,3910,18.3,33178,6504,26674,4.1,20.8,43326,21329,21997,13.3,27.1,-10148,-6.3,41.6,0,3170,3203,18166
1992,12,e) 4,16876,17998,155230,163403,765,4,3201,16.6,28729,4531,24198,2.8,17.6,45074,20451,24623,12.5,27.6,-16345,-10,35.2,0,2476,2488,15981
1992,12,f) 5,15113,16117,183611,190473,708,4.1,2463,14.4,32232,5117,27115,2.7,16.9,45955,22442,23513,11.8,24.1,-13723,-7.2,33.8,0,1810,1856,18901
1992,12,g) 6 to 10,52585,57519,620463,628327,2612,4.4,7179,12,111122,28762,82360,4.6,17.7,126850,52636,74214,8.4,20.2,-15728,-2.5,35.4,0,5102,5195,34537
1992,12,h) 11 to 15,32347,39578,498775,508372,2120,5.2,3939,9.7,78886,22882,56004,4.5,15.5,98080,33172,64908,6.5,19.3,-19194,-3.8,31,0,2323,2409,17454
1992,12,l) Left Censored,41739,86688,2397747,2425267,5110,5.8,8476,9.6,331763,107944,223819,4.5,13.7,386804,137328,249476,5.7,15.9,-55041,-2.2,27.4,0,2376,2622,19407
1992,13,a) 0,13482,13680,88207,44148,13639,199.4,0,0,88119,88119,0,199.6,199.6,0,0,0,0,0,88119,199.6,0,0,,,
1992,13,b) 1,9824,10067,81267,79238,139,1.2,2648,23.1,28558,4803,23755,6.1,36,24499,14724,9775,18.6,30.9,4059,5.1,61.8,0,2062,2062,12523
1992,13,c) 2,8313,8499,69120,71602,430,4.6,1910,20.5,16451,3324,13127,4.6,23,21414,13072,8342,18.3,29.9,-4963,-6.9,46,0,1577,1578,11432
1992,13,d) 3,7419,7739,64055,65849,392,4.7,1351,16.3,13184,2318,10866,3.5,20,16772,8602,8170,13.1,25.5,-3588,-5.5,40,0,1063,1075,7149
1992,13,e) 4,6287,6720,63718,67806,359,5,1165,16.3,13296,2530,10766,3.7,19.6,21471,13819,7652,20.4,31.7,-8175,-12.1,39.2,0,856,865,9016
1992,13,f) 5,5946,6372,86557,83925,294,4.4,981,14.6,19517,2110,17407,2.5,23.3,14253,6363,7890,7.6,17,5264,6.3,34,0,675,730,4296
1992,13,g) 6 to 10,22615,24726,269127,271162,1161,4.5,2850,11.1,46329,9041,37288,3.3,17.1,50398,18963,31435,7,18.6,-4069,-1.5,34.2,0,1917,1954,12706
1992,13,h) 11 to 15,14597,17806,243150,247069,1021,5.6,1570,8.7,39489,12328,27161,5,16,47327,18063,29264,7.3,19.2,-7838,-3.2,32,0,837,872,11605
1992,13,l) Left Censored,24711,48398,1538394,1545336,2709,5.5,4209,8.6,202030,54265,147765,3.5,13.1,215913,75862,140051,4.9,14,-13883,-0.9,26.2,0,1253,1339,10398
1992,15,a) 0,2031,2088,13428,6720,2081,199.3,0,0,13417,13417,0,199.7,199.7,0,0,0,0,0,13417,199.7,0,0,,,
1992,15,b) 1,1777,1822,16301,16023,27,1.3,472,22.9,5031,446,4585,2.8,31.4,4474,2550,1924,15.9,27.9,557,3.5,55.8,0,373,373,1870
1992,15,c) 2,1553,1628,14269,14526,66,3.8,300,17.1,3436,293,3143,2,23.7,3949,1818,2131,12.5,27.2,-513,-3.5,47.4,0,242,242,1493
1992,15,d) 3,1267,1339,14555,15882,65,4.5,250,17.3,2245,312,1933,2,14.1,4898,1521,3377,9.6,30.8,-2653,-16.7,28.2,0,205,210,1281
1992,15,e) 4,1227,1378,14824,14828,60,4.1,192,13.2,2983,1359,1624,9.2,20.1,2990,961,2029,6.5,20.2,-7,-0.1,40.2,0,133,133,703
1992,15,f) 5,1051,1153,16997,17794,48,4,148,12.2,2790,405,2385,2.3,15.7,4384,801,3583,4.5,24.6,-1594,-8.9,31.4,0,100,102,530
1992,15,g) 6 to 10,4015,4461,48985,49417,208,4.5,468,10.1,8275,1787,6488,3.6,16.7,9139,3870,5269,7.8,18.5,-864,-1.8,33.4,0,313,317,1962
1992,15,h) 11 to 15,3283,4279,59999,60705,174,4,352,8,7937,1162,6775,1.9,13.1,9348,2139,7209,3.5,15.4,-1411,-2.3,26.2,0,188,197,1172
1992,15,l) Left Censored,5266,9025,247718,246057,419,4.6,616,6.7,30597,6153,24444,2.5,12.4,27274,6848,20426,2.8,11.1,3323,1.3,22.2,0,207,219,1277
1992,16,a) 0,2529,2554,11922,5975,2544,199.2,0,0,11894,11894,0,199.1,199.1,0,0,0,0,0,11894,199.1,0,0,,,
1992,16,b) 1,1770,1796,11345,11168,25,1.2,438,21.5,3556,235,3321,2.1,31.8,3201,1958,1243,17.5,28.7,355,3.1,57.4,0,319,319,1298
1992,16,c) 2,1674,1710,11372,11964,91,4.9,332,18,2682,412,2270,3.4,22.4,3866,1918,1948,16,32.3,-1184,-9.9,44.8,0,241,241,1564
1992,16,d) 3,1223,1271,10011,10171,49,3.6,210,15.4,2355,435,1920,4.3,23.2,2675,1431,1244,14.1,26.3,-320,-3.1,46.4,0,164,164,1115
1992,16,e) 4,1092,1117,11417,11681,54,4.7,140,12.1,2317,666,1651,5.7,19.8,2844,1030,1814,8.8,24.3,-527,-4.5,39.6,0,110,110,875
1992,16,f) 5,994,1071,10589,10655,40,3.6,131,11.7,1920,202,1718,1.9,18,2052,858,1194,8.1,19.3,-132,-1.3,36,0,93,94,654
1992,16,g) 6 to 10,3990,4352,41903,41224,229,5.1,402,9,7745,1308,6437,3.2,18.8,6386,2438,3948,5.9,15.5,1359,3.3,31,0,289,289,1903
1992,16,h) 11 to 15,3113,3515,47261,44862,188,5.3,275,7.7,10905,5629,5276,12.5,24.3,6106,1599,4507,3.6,13.6,4799,10.7,27.2,0,162,174,905
1992,16,l) Left Censored,4714,7655,169704,168684,383,4.9,574,7.4,22153,6140,16013,3.6,13.1,20113,4881,15232,2.9,11.9,2040,1.2,23.8,0,214,221,1235
1992,17,a) 0,18872,19210,137131,68677,19149,199.4,0,0,136909,136909,0,199.4,199.4,0,0,0,0,0,136909,199.4,0,0,,,
1992,17,b) 1,15040,15463,122426,115801,243,1.4,3709,21.3,44939,6347,38592,5.5,38.8,31688,16475,15213,14.2,27.4,13251,11.4,54.8,0,2798,2798,12713
1992,17,c) 2,13828,14208,121429,124155,589,3.9,2444,16,27540,3102,24438,2.5,22.2,32991,16411,16580,13.2,26.6,-5451,-4.4,44.4,0,1901,1905,13040
1992,17,d) 3,11910,12332,98876,102535,528,4,1926,14.7,19186,2951,16235,2.9,18.7,26503,11842,14661,11.5,25.8,-7317,-7.1,37.4,0,1510,1513,9389
1992,17,e) 4,10622,11010,112416,113068,483,4.2,1459,12.6,27518,10930,16588,9.7,24.3,28822,10417,18405,9.2,25.5,-1304,-1.2,48.6,0,1121,1128,8589
1992,17,f) 5,10325,10973,145811,151374,400,3.5,1301,11.3,19813,1883,17930,1.2,13.1,30939,13300,17639,8.8,20.4,-11126,-7.3,26.2,0,904,918,9649
1992,17,g) 6 to 10,39011,42264,514271,517721,1552,3.6,4137,9.5,76257,13469,62788,2.6,14.7,83156,28398,54758,5.5,16.1,-6899,-1.4,29.4,0,2747,2809,18103
1992,17,h) 11 to 15,27889,33022,469240,477577,1317,3.9,2666,7.9,65235,13153,52082,2.8,13.7,81909,21314,60595,4.5,17.2,-16674,-3.5,27.4,0,1501,1537,12402
1992,17,l) Left Censored,55772,89935,2885018,2909716,4381,4.8,6952,7.6,338162,84804,253358,2.9,11.6,387557,107755,279802,3.7,13.3,-49395,-1.7,23.2,0,2683,2815,25250
1992,18,a) 0,8983,9164,52595,26328,9139,199.5,0,0,52535,52535,0,199.5,199.5,0,0,0,0,0,52535,199.5,0,0,,,
1992,18,b) 1,7231,7491,54015,53976,140,1.7,1679,20.1,16116,3046,13070,5.6,29.9,16038,8379,7659,15.5,29.7,78,0.2,59.4,0,1309,1310,6775
1992,18,c) 2,6371,6610,51320,54745,283,4,1264,17.6,11214,2627,8587,4.8,20.5,18063,10374,7689,18.9,33,-6849,-12.5,41,0,1006,1009,8504
1992,18,d) 3,5596,5903,56734,57933,264,4.2,903,14.5,11155,1930,9225,3.3,19.3,13552,6387,7165,11,23.4,-2397,-4.1,38.6,0,730,730,5130
1992,18,e) 4,4670,4889,54618,54033,217,4.2,693,13.5,11652,1463,10189,2.7,21.6,10482,4774,5708,8.8,19.4,1170,2.2,38.8,0,549,552,4023
1992,18,f) 5,4609,4953,58462,59474,200,3.9,593,11.5,8827,1632,7195,2.7,14.8,10851,3810,7041,6.4,18.2,-2024,-3.4,29.6,0,440,444,2956
1992,18,g) 6 to 10,18345,19990,217080,219913,690,3.3,1850,9,31739,5393,26346,2.5,14.4,37404,14776,22628,6.7,17,-5665,-2.6,28.8,0,1328,1344,10053
1992,18,h) 11 to 15,12784,15575,216364,217659,668,4.2,1180,7.4,28934,6819,22115,3.1,13.3,31523,8856,22667,4.1,14.5,-2589,-1.2,26.6,0,716,736,4512
1992,18,l) Left Censored,26251,45071,1393856,1386790,2069,4.5,3086,6.8,173079,53757,119322,3.9,12.5,158947,41205,117742,3,11.5,14132,1,23,0,1214,1294,10119
1992,19,a) 0,4762,4830,29847,14943,4810,199.2,0,0,29809,29809,0,199.5,199.5,0,0,0,0,0,29809,199.5,0,0,,,
1992,19,b) 1,3679,3762,27118,25759,50,1.2,833,19.8,9346,1807,7539,7,36.3,6628,3619,3009,14,25.7,2718,10.6,51.4,0,627,627,2882
1992,19,c) 2,3337,3414,22551,23775,133,3.6,595,16.2,4518,726,3792,3.1,19,6966,4143,2823,17.4,29.3,-2448,-10.3,38,0,472,472,3584
1992,19,d) 3,2869,3008,22807,23438,113,3.5,432,13.6,4287,1018,3269,4.3,18.3,5549,2384,3165,10.2,23.7,-1262,-5.4,36.6,0,335,337,1827
1992,19,e) 4,2462,2530,22193,22037,82,3.1,327,12.3,4473,718,3755,3.3,20.3,4160,1828,2332,8.3,18.9,313,1.4,37.8,0,249,251,1386
1992,19,f) 5,2428,2673,37656,38362,99,3.6,295,10.6,4166,817,3349,2.1,10.9,5577,1443,4134,3.8,14.5,-1411,-3.6,21.8,0,224,226,1138
1992,19,g) 6 to 10,10015,10927,106820,108380,384,3.4,957,8.5,14843,2802,12041,2.6,13.7,17963,6171,11792,5.7,16.6,-3120,-2.9,27.4,0,690,701,4447
1992,19,h) 11 to 15,8418,10335,109317,110380,399,3.8,810,7.7,13212,2257,10955,2,12,15337,5418,9919,4.9,13.9,-2125,-1.9,24,0,486,499,3595
1992,19,l) Left Censored,17423,26892,649021,656738,1075,3.9,1719,6.3,70949,16641,54308,2.5,10.8,86382,22123,64259,3.4,13.2,-15433,-2.4,21.6,0,740,764,5166
1992,20,a) 0,4711,4798,26161,13106,4779,199.2,0,0,26110,26110,0,199.2,199.2,0,0,0,0,0,26110,199.2,0,0,,,
1992,20,b) 1,3575,3667,23830,24154,53,1.3,961,23,7058,1130,5928,4.7,29.2,7706,4409,3297,18.3,31.9,-648,-2.7,58.4,0,764,765,3679
1992,20,c) 2,3103,3188,22619,24183,139,4,607,17.6,4963,893,4070,3.7,20.5,8091,4184,3907,17.3,33.5,-3128,-13,41,0,490,490,3433
1992,20,d) 3,2749,2854,22635,23119,135,4.5,423,14,4488,743,3745,3.2,19.4,5455,2626,2829,11.4,23.6,-967,-4.2,38.8,0,354,355,2246
1992,20,e) 4,2350,2483,21920,22166,104,4,348,13.3,3823,693,3130,3.1,17.2,4314,2112,2202,9.5,19.5,-491,-2.3,34.4,0,268,268,1732
1992,20,f) 5,2294,2419,32551,32566,113,4.5,308,12.2,4741,951,3790,2.9,14.6,4770,2454,2316,7.5,14.6,-29,0,29.2,0,222,222,1960
1992,20,g) 6 to 10,9537,10213,90257,93173,396,3.8,974,9.3,14000,3386,10614,3.6,15,19831,7963,11868,8.5,21.3,-5831,-6.3,30,0,688,703,6356
1992,20,h) 11 to 15,7113,8620,104584,104761,403,4.6,712,8.1,16662,4403,12259,4.2,15.9,17016,5970,11046,5.7,16.2,-354,-0.3,31.8,0,381,397,2292
1992,20,l) Left Censored,14135,22167,543843,547070,1059,4.7,1634,7.3,59003,15624,43379,2.9,10.8,65456,16428,49028,3,12,-6453,-1.2,21.6,0,668,698,5030
1992,21,a) 0,6018,6123,33421,16730,6104,199.4,0,0,33383,33383,0,199.5,199.5,0,0,0,0,0,33383,199.5,0,0,,,
1992,21,b) 1,4443,4517,33401,33454,50,1,1242,24,9942,1444,8498,4.3,29.7,10047,6159,3888,18.4,30,-105,-0.3,59.4,0,1028,1031,5451
1992,21,c) 2,4175,4293,34325,35610,179,3.8,836,18,7535,1357,6178,3.8,21.2,10104,5120,4984,14.4,28.4,-2569,-7.2,42.4,0,693,693,4368
1992,21,d) 3,3646,3814,31671,33157,151,3.7,626,15.4,5603,880,4723,2.7,16.9,8574,4043,4531,12.2,25.9,-2971,-9,33.8,0,519,519,3244
1992,21,e) 4,3116,3274,29646,30194,137,4,442,12.9,5170,1181,3989,3.9,17.1,6265,2385,3880,7.9,20.7,-1095,-3.6,34.2,0,354,354,1986
1992,21,f) 5,2898,3052,42873,42997,106,3.3,427,13.3,7167,673,6494,1.6,16.7,7414,2711,4703,6.3,17.2,-247,-0.5,33.4,0,339,339,2268
1992,21,g) 6 to 10,11602,12514,136149,137697,413,3.2,1234,9.5,20569,3716,16853,2.7,14.9,23665,9725,13940,7.1,17.2,-3096,-2.3,29.8,0,891,899,7015
1992,21,h) 11 to 15,7644,9151,138745,139052,352,3.7,817,8.7,18352,3442,14910,2.5,13.2,18966,4747,14219,3.4,13.6,-614,-0.4,26.4,0,497,509,2771
1992,21,l) Left Censored,15615,26326,719440,724214,1223,4.6,1922,7.2,73861,16981,56880,2.3,10.2,83409,23802,59607,3.3,11.5,-9548,-1.3,20.4,0,796,833,6705
1992,22,a) 0,6491,6585,39517,19827,6566,199.4,0,0,39380,39380,0,198.6,198.6,0,0,0,0,0,39380,198.6,0,0,,,
1992,22,b) 1,5000,5158,45081,44805,68,1.2,1206,20.8,14483,957,13526,2.1,32.3,13931,7074,6857,15.8,31.1,552,1.2,62.2,0,972,972,5981
1992,22,c) 2,4201,4310,35875,37463,188,4,807,17.3,8005,1027,6978,2.7,21.4,11181,5355,5826,14.3,29.8,-3176,-8.4,42.8,0,666,668,4687
1992,22,d) 3,3403,3500,31433,32170,139,3.7,544,14.6,7107,1170,5937,3.6,22.1,8581,3785,4796,11.8,26.7,-1474,-4.6,44.2,0,449,450,3243
1992,22,e) 4,3055,3311,34691,36098,142,4.1,469,13.4,6128,1183,4945,3.3,17,8941,4739,4202,13.1,24.8,-2813,-7.8,34,0,355,357,3591
1992,22,f) 5,2929,3152,43139,42136,134,4.1,412,12.5,10539,964,9575,2.3,25,8532,3192,5340,7.6,20.2,2007,4.8,40.4,0,314,321,2438
1992,22,g) 6 to 10,13687,14867,159940,160111,605,3.9,1443,9.4,28798,5953,22845,3.7,18,29139,9752,19387,6.1,18.2,-341,-0.2,36,0,1045,1058,7690
1992,22,h) 11 to 15,10147,11943,166137,165170,524,4.3,993,8.1,29173,7145,22028,4.3,17.7,27239,7037,20202,4.3,16.5,1934,1.2,33,0,638,658,4796
1992,22,l) Left Censored,16997,29403,740693,747072,1504,5,2454,8.2,95040,23492,71548,3.1,12.7,107798,33485,74313,4.5,14.4,-12758,-1.7,25.4,0,863,952,7834
1992,23,a) 0,2276,2343,10685,5376,2331,199,0,0,10619,10619,0,197.5,197.5,0,0,0,0,0,10619,197.5,0,0,,,
1992,23,b) 1,1798,1850,10711,10616,24,1.1,477,22.7,3434,526,2908,5,32.3,3244,1710,1534,16.1,30.6,190,1.7,61.2,0,363,363,1373
1992,23,c) 2,1733,1760,11370,11967,63,3.3,334,17.5,2269,302,1967,2.5,19,3462,1574,1888,13.2,28.9,-1193,-9.9,38,0,250,250,1344
1992,23,d) 3,1781,1815,11441,12012,87,4.5,318,16.3,1907,298,1609,2.5,15.9,3049,1501,1548,12.5,25.4,-1142,-9.5,31.8,0,237,238,1215
1992,23,e) 4,1593,1622,10822,11262,62,3.6,262,15.1,1626,279,1347,2.5,14.4,2506,921,1585,8.2,22.3,-880,-7.9,28.8,0,177,177,632
1992,23,f) 5,1525,1624,15026,15386,67,3.9,209,12.2,2090,191,1899,1.2,13.6,2810,1197,1613,7.8,18.3,-720,-4.7,27.2,0,148,148,906
1992,23,g) 6 to 10,5018,5337,47727,49005,188,3.4,579,10.4,6399,981,5418,2,13.1,8955,3210,5745,6.6,18.3,-2556,-5.2,26.2,0,391,403,2142
1992,23,h) 11 to 15,3321,3982,44639,45339,183,4.5,301,7.4,5523,1220,4303,2.7,12.2,6922,1699,5223,3.7,15.3,-1399,-3.1,24.4,0,184,190,1037
1992,23,l) Left Censored,5954,9159,225264,230447,377,4,764,8.2,22488,6796,15692,2.9,9.8,32853,10925,21928,4.7,14.3,-10365,-4.5,19.6,0,306,326,2322
1992,24,a) 0,8215,8371,47480,23990,8351,199.5,0,0,46981,46981,0,195.8,195.8,0,0,0,0,0,46981,195.8,0,0,,,
1992,24,b) 1,6515,6659,47475,46537,88,1.2,1733,22.9,15063,2080,12983,4.5,32.4,13186,7633,5553,16.4,28.3,1877,4.1,56.6,0,1284,1284,6193
1992,24,c) 2,6111,6271,46908,48596,302,4.5,1208,17.8,10883,2450,8433,5,22.4,14259,7169,7090,14.8,29.3,-3376,-6.9,44.8,0,909,911,5401
1992,24,d) 3,5514,5665,44031,45564,274,4.6,923,15.3,8487,1416,7071,3.1,18.6,11552,5563,5989,12.2,25.4,-3065,-6.8,37.2,0,715,719,4609
1992,24,e) 4,4926,5117,46742,48460,218,4,768,14.2,7517,1718,5799,3.5,15.5,10952,4513,6439,9.3,22.6,-3435,-7.1,31,0,562,569,3607
1992,24,f) 5,4503,4791,56469,58305,205,4.1,675,13.4,8623,1464,7159,2.5,14.8,12294,4731,7563,8.1,21.1,-3671,-6.3,29.6,0,491,503,3775
1992,24,g) 6 to 10,16546,18093,197437,206706,761,4.1,1865,10,28281,5384,22897,2.6,13.7,46818,15598,31220,7.5,22.6,-18537,-8.9,27.4,0,1174,1187,9965
1992,24,h) 11 to 15,10377,12654,176811,179149,584,4.5,1095,8.5,25479,6322,19157,3.5,14.2,30155,9045,21110,5,16.8,-4676,-2.6,28.4,0,580,603,4381
1992,24,l) Left Censored,20111,35557,1048049,1066055,1952,5.4,2875,8,133886,40387,93499,3.8,12.6,169899,43123,126776,4,15.9,-36013,-3.3,25.2,0,896,981,8661
1992,25,a) 0,9000,9245,55070,27743,9221,199.5,0,0,54655,54655,0,197,197,0,0,0,0,0,54655,197,0,0,,,
1992,25,b) 1,7061,7249,53134,53132,79,1,1700,20.8,15490,1919,13571,3.6,29.2,15486,7498,7988,14.1,29.1,4,0.1,58.2,0,1295,1295,5758
1992,25,c) 2,6767,6967,56853,58975,323,4.3,1417,18.7,12888,2351,10537,4,21.9,17132,8879,8253,15.1,29,-4244,-7.1,43.8,0,1104,1107,7085
1992,25,d) 3,6816,7091,56652,57433,317,4.2,1257,16.5,11294,2102,9192,3.7,19.7,12856,6030,6826,10.5,22.4,-1562,-2.7,39.4,0,994,996,4862
1992,25,e) 4,6382,6684,72435,73664,297,4.2,1047,14.7,13081,2177,10904,3,17.8,15538,8761,6777,11.9,21.1,-2457,-3.3,35.6,0,803,805,6836
1992,25,f) 5,6105,6481,75380,77768,286,4.2,1007,14.6,10680,1510,9170,1.9,13.7,15456,7017,8439,9,19.9,-4776,-6.2,27.4,0,722,724,5330
1992,25,g) 6 to 10,22213,23789,271483,278316,996,4,2702,10.9,39836,7851,31985,2.8,14.3,53502,18487,35015,6.6,19.2,-13666,-4.9,28.6,0,1819,1837,13006
1992,25,h) 11 to 15,14705,17900,289620,291024,837,4.6,1673,9.1,41282,8832,32450,3,14.2,44089,15271,28818,5.2,15.1,-2807,-0.9,28.4,0,885,915,7131
1992,25,l) Left Censored,33464,51207,1613965,1639666,2376,4.6,4166,8,184542,53536,131006,3.3,11.3,235943,63586,172357,3.9,14.4,-51401,-3.1,22.6,0,1652,1750,16331
1992,26,a) 0,14277,14487,77822,38976,14449,199.5,0,0,77692,77692,0,199.3,199.3,0,0,0,0,0,77692,199.3,0,0,,,
1992,26,b) 1,11627,11919,84061,81273,143,1.1,2343,17.8,25893,3947,21946,4.9,31.9,20316,10155,10161,12.5,25,5577,6.9,50,0,1716,1716,8121
1992,26,c) 2,10841,11174,86221,87826,413,3.5,1590,13.4,18722,2471,16251,2.8,21.3,21931,10403,11528,11.8,25,-3209,-3.7,42.6,0,1163,1164,8547
1992,26,d) 3,9367,9692,77783,79211,328,3.2,1350,13.2,15192,1886,13306,2.4,19.2,18048,8156,9892,10.3,22.8,-2856,-3.6,38.4,0,986,988,6366
1992,26,e) 4,8255,8632,79374,82185,349,3.8,1187,13.1,13886,2476,11410,3,16.9,19507,10051,9456,12.2,23.7,-5621,-6.8,33.8,0,857,859,6303
1992,26,f) 5,8288,8822,100700,101855,312,3.4,1097,11.9,15730,1642,14088,1.6,15.4,18040,7851,10189,7.7,17.7,-2310,-2.3,30.8,0,794,801,6178
1992,26,g) 6 to 10,29333,32100,355772,358952,1151,3.5,3227,9.7,58667,10118,48549,2.8,16.3,65026,24797,40229,6.9,18.1,-6359,-1.8,32.6,0,2196,2234,18228
1992,26,h) 11 to 15,20831,25311,333643,333061,990,3.8,2037,7.9,51197,12153,39044,3.6,15.4,50032,15164,34868,4.6,15,1165,0.4,30,0,1187,1235,7522
1992,26,l) Left Censored,39637,67437,2132742,2138979,3068,4.5,4844,7.1,243437,54769,188668,2.6,11.4,255911,64135,191776,3,12,-12474,-0.6,22.8,0,1792,1854,15043
1992,27,a) 0,8071,8203,43669,21850,8186,199.6,0,0,43639,43639,0,199.7,199.7,0,0,0,0,0,43639,199.7,0,0,,,
1992,27,b) 1,6482,6688,46593,46082,111,1.5,1508,20.2,13467,1936,11531,4.2,29.2,12444,6853,5591,14.9,27,1023,2.2,54,0,1118,1118,5709
1992,27,c) 2,5718,5918,43417,45706,236,3.7,1022,16.1,8674,1167,7507,2.6,19,13251,7428,5823,16.3,29,-4577,-10,38,0,821,822,6334
1992,27,d) 3,4958,5122,40698,41579,172,3.2,770,14.1,7727,1050,6677,2.5,18.6,9489,4634,4855,11.1,22.8,-1762,-4.2,37.2,0,588,588,3556
1992,27,e) 4,4338,4531,38811,39341,147,3.1,641,13.4,7411,831,6580,2.1,18.8,8470,3873,4597,9.8,21.5,-1059,-2.7,37.6,0,490,500,3139
1992,27,f) 5,4055,4365,62990,62132,192,4.2,519,11.4,11452,1747,9705,2.8,18.4,9736,4275,5461,6.9,15.7,1716,2.7,31.4,0,386,391,3362
1992,27,g) 6 to 10,15898,17554,215589,214571,724,4,1686,9.3,34437,8133,26304,3.8,16,32400,11108,21292,5.2,15.1,2037,0.9,30.2,0,1148,1174,7802
1992,27,h) 11 to 15,11726,14225,200327,200645,610,4.2,1164,8,28875,5295,23580,2.6,14.4,29510,10315,19195,5.1,14.7,-635,-0.3,28.8,0,662,694,4699
1992,27,l) Left Censored,22714,36081,1152327,1151725,1755,4.8,2666,7.3,136400,34876,101524,3,11.8,135195,39085,96110,3.4,11.7,1205,0.1,23.4,0,997,1043,9470
1992,28,a) 0,3924,3992,19623,9837,3978,199.3,0,0,19573,19573,0,199,199,0,0,0,0,0,19573,199,0,0,,,
1992,28,b) 1,2988,3069,22056,22355,37,1,844,23.9,7037,1087,5950,4.9,31.5,7634,4599,3035,20.6,34.1,-597,-2.6,63,0,673,673,3808
1992,28,c) 2,2713,2783,20137,20719,139,4.6,547,18.1,4933,1078,3855,5.2,23.8,6096,2710,3386,13.1,29.4,-1163,-5.6,47.6,0,435,435,2264
1992,28,d) 3,2132,2173,17092,17834,104,4.4,426,18.1,3407,756,2651,4.2,19.1,4891,2600,2291,14.6,27.4,-1484,-8.3,38.2,0,346,346,1934
1992,28,e) 4,1901,2040,20515,20754,108,5,308,14.3,3516,761,2755,3.7,16.9,3994,2009,1985,9.7,19.2,-478,-2.3,33.8,0,238,238,1752
1992,28,f) 5,1830,1951,24490,24824,81,4,253,12.4,5736,338,5398,1.4,23.1,6403,1573,4830,6.3,25.8,-667,-2.7,46.2,0,181,184,1244
1992,28,g) 6 to 10,7736,8211,77469,77999,313,3.7,848,10,11219,1671,9548,2.1,14.4,12279,4316,7963,5.5,15.7,-1060,-1.3,28.8,0,597,613,3081
1992,28,h) 11 to 15,5709,6710,78978,80233,290,4.2,589,8.6,10914,1814,9100,2.3,13.6,13423,4780,8643,6,16.7,-2509,-3.1,27.2,0,360,371,2674
1992,28,l) Left Censored,10556,17550,459159,459885,766,4.3,1283,7.2,50888,10605,40283,2.3,11.1,52340,12942,39398,2.8,11.4,-1452,-0.3,22.2,0,490,500,3251
1992,29,a) 0,9733,9890,55342,27699,9866,199.5,0,0,55286,55286,0,199.6,199.6,0,0,0,0,0,55286,199.6,0,0,,,
1992,29,b) 1,7347,7563,51463,51538,110,1.3,2035,23.6,16171,2400,13771,4.7,31.4,16321,9609,6712,18.6,31.7,-150,-0.3,62.8,0,1634,1634,8293
1992,29,c) 2,6495,6664,50938,52959,283,3.9,1418,19.5,12062,1907,10155,3.6,22.8,16103,9046,7057,17.1,30.4,-4041,-7.6,45.6,0,1102,1102,7125
1992,29,d) 3,5898,6145,47051,47297,275,4.2,962,14.7,10253,1855,8398,3.9,21.7,10745,4741,6004,10,22.7,-492,-1,43.4,0,758,762,3918
1992,29,e) 4,5023,5241,48340,51812,217,3.9,753,13.6,8364,1244,7120,2.4,16.1,15307,4267,11040,8.2,29.5,-6943,-13.4,32.2,0,581,581,3283
1992,29,f) 5,4982,5284,66459,65372,217,3.9,723,13,13544,3468,10076,5.3,20.7,11369,5121,6248,7.8,17.4,2175,3.3,34.8,0,529,538,3657
1992,29,g) 6 to 10,18685,20287,213519,216338,820,3.9,2101,10,32487,5999,26488,2.8,15,38125,14333,23792,6.6,17.6,-5638,-2.6,30,0,1415,1453,9176
1992,29,h) 11 to 15,12985,15816,203076,204058,652,4,1301,8,28497,6652,21845,3.3,14,30461,9641,20820,4.7,14.9,-1964,-0.9,28,0,767,793,5218
1992,29,l) Left Censored,25290,41848,1257209,1270277,1833,4.3,3147,7.4,134110,29325,104785,2.3,10.6,160247,41108,119139,3.2,12.6,-26137,-2,21.2,0,1146,1203,8377
1992,30,a) 0,2145,2159,9447,4729,2151,199.3,0,0,9436,9436,0,199.5,199.5,0,0,0,0,0,9436,199.5,0,0,,,
1992,30,b) 1,1518,1534,9082,8894,15,0.9,389,22.3,2494,138,2356,1.6,28,2117,1219,898,13.7,23.8,377,4.2,47.6,0,294,294,1022
1992,30,c) 2,1313,1323,7874,7866,59,4.1,244,17.1,1756,202,1554,2.6,22.3,1739,971,768,12.3,22.1,17,0.2,44.2,0,181,181,739
1992,30,d) 3,1134,1191,7902,7886,45,3.6,183,14.5,1589,147,1442,1.9,20.1,1556,705,851,8.9,19.7,33,0.4,39.4,0,130,130,496
1992,30,e) 4,1013,1042,7303,7514,42,3.8,149,13.5,1398,144,1254,1.9,18.6,1820,952,868,12.7,24.2,-422,-5.6,37.2,0,116,116,813
1992,30,f) 5,961,1010,9273,9280,48,4.5,151,14.2,1629,196,1433,2.1,17.6,1643,846,797,9.1,17.7,-14,-0.1,35.2,0,106,107,616
1992,30,g) 6 to 10,3950,4267,33429,33352,198,4.5,424,9.7,5640,1080,4560,3.2,16.9,5485,2138,3347,6.4,16.4,155,0.5,32.8,0,296,299,1604
1992,30,h) 11 to 15,3133,3602,34133,33983,161,4.4,294,8,5301,780,4521,2.3,15.6,5000,1463,3537,4.3,14.7,301,0.9,29.4,0,197,201,962
1992,30,l) Left Censored,4653,6975,117377,115139,378,5.4,471,6.7,16348,3212,13136,2.8,14.2,11871,3849,8022,3.3,10.3,4477,3.9,20.6,0,215,222,1665
1992,31,a) 0,2995,3035,16452,8275,3019,198.9,0,0,16355,16355,0,197.6,197.6,0,0,0,0,0,16355,197.6,0,0,,,
1992,31,b) 1,2324,2387,13493,13474,33,1.2,500,18.9,3511,316,3195,2.3,26.1,3472,1883,1589,14,25.8,39,0.3,51.6,0,388,388,1546
1992,31,c) 2,2095,2165,16477,16989,115,5,369,16,3414,669,2745,3.9,20.1,4438,2140,2298,12.6,26.1,-1024,-6,40.2,0,295,295,1787
1992,31,d) 3,1836,1910,18923,19924,62,3.1,266,13.1,2311,269,2042,1.4,11.6,4313,1271,3042,6.4,21.6,-2002,-10,23.2,0,211,211,1040
1992,31,e) 4,1605,1728,14640,15288,71,3.9,215,11.9,2092,403,1689,2.6,13.7,3388,1964,1424,12.8,22.2,-1296,-8.5,27.4,0,163,163,1676
1992,31,f) 5,1464,1558,20908,20084,69,4.3,168,10.4,3817,220,3597,1.1,19,2168,865,1303,4.3,10.8,1649,8.2,21.6,0,125,128,666
1992,31,g) 6 to 10,6470,7044,72867,73536,268,3.7,650,9,10005,1754,8251,2.4,13.6,11343,3521,7822,4.8,15.4,-1338,-1.8,27.2,0,461,470,2541
1992,31,h) 11 to 15,5106,5968,63210,63932,239,3.9,461,7.6,7830,1462,6368,2.3,12.2,9274,2654,6620,4.2,14.5,-1444,-2.3,24.4,0,268,281,1574
1992,31,l) Left Censored,10089,15022,363113,363113,614,4,1078,7.1,40384,8644,31740,2.4,11.1,40383,11171,29212,3.1,11.1,1,0,22.2,0,457,477,3213
1992,32,a) 0,3059,3100,20381,10283,3096,199.7,0,0,20197,20197,0,196.4,196.4,0,0,0,0,0,20197,196.4,0,0,,,
1992,32,b) 1,2291,2339,18650,18913,38,1.4,787,28.6,6267,454,5813,2.4,33.1,6793,3592,3201,19,35.9,-526,-2.8,66.2,0,637,637,3090
1992,32,c) 2,1984,2037,18864,19837,119,5.3,469,21,4447,716,3731,3.6,22.4,6392,3302,3090,16.6,32.2,-1945,-9.8,44.8,0,378,379,2385
1992,32,d) 3,1709,1769,19633,21576,77,4.1,317,16.7,3216,475,2741,2.2,14.9,7101,2895,4206,13.4,32.9,-3885,-18,29.8,0,256,258,2492
1992,32,e) 4,1340,1399,17096,18543,76,5.1,257,17.2,2550,383,2167,2.1,13.8,5443,2037,3406,11,29.4,-2893,-15.6,27.6,0,192,197,1654
1992,32,f) 5,1245,1354,16704,17362,65,4.6,197,13.8,2512,493,2019,2.8,14.5,3827,1342,2485,7.7,22,-1315,-7.5,29,0,144,147,1054
1992,32,g) 6 to 10,4313,4887,75188,77407,309,6.1,558,11.1,11112,3777,7335,4.9,14.4,15550,4726,10824,6.1,20.1,-4438,-5.7,28.8,0,364,369,2721
1992,32,h) 11 to 15,3205,3897,73049,74294,226,5.7,371,9.3,8271,2081,6190,2.8,11.1,10760,3134,7626,4.2,14.5,-2489,-3.4,22.2,0,207,210,1469
1992,32,l) Left Censored,4282,7305,286831,288054,576,7.8,644,8.8,33815,10764,23051,3.7,11.7,36260,9433,26827,3.3,12.6,-2445,-0.9,23.4,0,166,171,1281
1992,33,a) 0,2246,2318,11578,5809,2308,199.1,0,0,11539,11539,0,198.6,198.6,0,0,0,0,0,11539,198.6,0,0,,,
1992,33,b) 1,1760,1792,10759,11032,11,0.5,536,25.7,3011,133,2878,1.2,27.3,3556,2194,1362,19.9,32.2,-545,-4.9,54.6,0,430,430,1796
1992,33,c) 2,1632,1663,10289,11387,71,3.9,382,20.8,2084,210,1874,1.8,18.3,4280,2757,1523,24.2,37.6,-2196,-19.3,36.6,0,307,308,2087
1992,33,d) 3,1652,1704,16929,16321,81,4.4,300,16.4,3914,264,3650,1.6,24,2698,1269,1429,7.8,16.5,1216,7.5,33,0,240,242,1082
1992,33,e) 4,1569,1624,11892,12297,82,4.7,262,15.2,2295,546,1749,4.4,18.7,3105,1604,1501,13,25.3,-810,-6.6,37.4,0,206,206,1445
1992,33,f) 5,1532,1572,13502,14009,81,4.9,246,14.7,1848,254,1594,1.8,13.2,2862,882,1980,6.3,20.4,-1014,-7.2,26.4,0,184,187,694
1992,33,g) 6 to 10,5037,5388,51498,52319,235,4.2,638,11.4,7606,1116,6490,2.1,14.5,9248,3432,5816,6.6,17.7,-1642,-3.2,29,0,450,455,2629
1992,33,h) 11 to 15,3064,3610,43140,43710,170,4.6,322,8.7,6076,1822,4254,4.2,13.9,7216,1960,5256,4.5,16.5,-1140,-2.6,27.8,0,191,200,1048
1992,33,l) Left Censored,5727,8929,243623,245063,593,6.6,652,7.3,29510,9783,19727,4,12,32390,8467,23923,3.5,13.2,-2880,-1.2,24,0,245,267,3164
1992,34,a) 0,14128,14310,76831,39053,14270,199.4,0,0,75557,75557,0,193.5,193.5,0,0,0,0,0,75557,193.5,0,0,,,
1992,34,b) 1,11377,11561,80718,77540,104,0.8,2791,21.3,30746,2081,28665,2.7,39.7,24390,11348,13042,14.6,31.5,6356,8.2,63,0,2070,2071,8822
1992,34,c) 2,10308,10511,72001,75531,470,4.1,1992,17.5,15964,1863,14101,2.5,21.1,23024,12859,10165,17,30.5,-7060,-9.4,42.2,0,1528,1528,8041
1992,34,d) 3,9766,9981,80181,81092,449,4.2,1669,15.7,16831,2409,14422,3,20.8,18653,8606,10047,10.6,23,-1822,-2.2,41.6,0,1276,1279,6339
1992,34,e) 4,9184,9424,84832,85810,414,4.1,1528,15.2,17083,2024,15059,2.4,19.9,19038,8817,10221,10.3,22.2,-1955,-2.3,39.8,0,1124,1140,6314
1992,34,f) 5,8548,8828,91192,94757,377,4,1278,13.7,13130,1498,11632,1.6,13.9,20260,6464,13796,6.8,21.4,-7130,-7.5,27.8,0,943,947,4901
1992,34,g) 6 to 10,30701,32331,347937,352489,1274,3.8,3657,10.9,52008,8632,43376,2.4,14.8,61111,21146,39965,6,17.3,-9103,-2.5,29.6,0,2522,2535,13895
1992,34,h) 11 to 15,21182,23717,299516,298722,896,3.7,2164,8.9,50179,9117,41062,3.1,16.8,48591,14425,34166,4.8,16.3,1588,0.5,32.6,0,1316,1334,7766
1992,34,l) Left Censored,41920,63273,1907518,1939057,2838,4.4,5337,8.3,231277,56510,174767,2.9,11.9,294357,80273,214084,4.1,15.2,-63080,-3.3,23.8,0,2069,2150,17067
1992,35,a) 0,2983,3041,16560,8428,3026,199,0,0,16264,16264,0,193,193,0,0,0,0,0,16264,193,0,0,,,
1992,35,b) 1,2370,2483,17239,18018,81,2.9,610,21.8,4840,960,3880,5.3,26.9,6398,2945,3453,16.3,35.5,-1558,-8.6,53.8,0,446,446,1983
1992,35,c) 2,1997,2031,15079,15432,98,4.5,397,18,4288,1098,3190,7.1,27.8,4993,2731,2262,17.7,32.4,-705,-4.6,55.6,0,299,299,2352
1992,35,d) 3,1716,1791,12374,12905,107,5.6,314,16.5,2520,487,2033,3.8,19.5,3581,1763,1818,13.7,27.7,-1061,-8.2,39,0,248,248,1360
1992,35,e) 4,1402,1486,13884,14164,67,4.2,254,16,2912,433,2479,3.1,20.6,3471,1725,1746,12.2,24.5,-559,-3.9,41.2,0,183,183,1063
1992,35,f) 5,1346,1430,18819,18352,65,4.3,179,12,3663,523,3140,2.8,20,2728,1120,1608,6.1,14.9,935,5.1,29.8,0,125,126,839
1992,35,g) 6 to 10,5514,6055,57851,58300,332,5.3,682,10.9,10716,2431,8285,4.2,18.4,11614,4628,6986,7.9,19.9,-898,-1.5,36.8,0,466,474,3113
1992,35,h) 11 to 15,4207,5017,53715,53708,253,4.9,420,8.2,9157,2467,6690,4.6,17,9142,2710,6432,5,17,15,0,34,0,250,252,1544
1992,35,l) Left Censored,5979,9737,230544,230016,585,5.9,835,8.5,35638,9825,25813,4.3,15.5,34582,10027,24555,4.4,15,1056,0.5,30,0,264,297,1738
1992,36,a) 0,32549,32936,184251,92247,32854,199.5,0,0,184009,184009,0,199.5,199.5,0,0,0,0,0,184009,199.5,0,0,,,
1992,36,b) 1,26061,26401,177690,174366,199,0.7,7404,24.4,57609,8678,48931,5,33,50961,30171,20790,17.3,29.2,6648,3.8,58.4,0,5740,5742,23558
1992,36,c) 2,23416,23789,157555,167849,1014,3.9,5031,19.3,32910,4906,28004,2.9,19.6,53498,27883,25615,16.6,31.9,-20588,-12.3,39.2,0,4016,4018,22976
1992,36,d) 3,21799,22257,159280,165047,902,3.8,4193,17.4,31751,5367,26384,3.3,19.2,43284,20003,23281,12.1,26.2,-11533,-7,38.4,0,3386,3388,16928
1992,36,e) 4,19466,19963,178627,181937,774,3.6,3221,15.1,34760,8287,26473,4.6,19.1,41380,17552,23828,9.6,22.7,-6620,-3.6,38.2,0,2569,2569,14185
1992,36,f) 5,18257,18934,259856,266466,666,3.3,2848,14.2,34515,6947,27568,2.6,13,47735,14755,32980,5.5,17.9,-13220,-4.9,26,0,2194,2218,11753
1992,36,g) 6 to 10,66880,70653,706027,711232,2470,3.3,8497,11.5,125336,15797,109539,2.2,17.6,135746,47985,87761,6.7,19.1,-10410,-1.5,35.2,0,6212,6280,35402
1992,36,h) 11 to 15,43758,50665,707777,720911,1898,3.6,4777,9.1,100150,20180,79970,2.8,13.9,126417,37968,88449,5.3,17.5,-26267,-3.6,27.8,0,3097,3172,24354
1992,36,l) Left Censored,93460,137933,4139522,4198569,5337,3.8,11431,8.1,475097,127154,347943,3,11.3,593191,172342,420849,4.1,14.1,-118094,-2.8,22.6,0,5334,5648,48322
1992,37,a) 0,11801,11995,66222,33161,11959,199.4,0,0,66122,66122,0,199.4,199.4,0,0,0,0,0,66122,199.4,0,0,,,
1992,37,b) 1,9437,9702,66216,64809,160,1.5,2509,22.8,22558,3177,19381,4.9,34.8,19743,12124,7619,18.7,30.5,2815,4.3,61,0,2001,2002,9772
1992,37,c) 2,8580,8809,61891,63980,403,4.2,1770,18.5,13118,2029,11089,3.2,20.5,17296,8805,8491,13.8,27,-4178,-6.5,41,0,1450,1451,7375
1992,37,d) 3,7400,7677,62317,64099,303,3.7,1326,16.1,11676,1785,9891,2.8,18.2,15240,8134,7106,12.7,23.8,-3564,-5.6,36.4,0,1042,1042,6776
1992,37,e) 4,6620,6995,68890,69214,297,4,990,13.4,12363,1852,10511,2.7,17.9,13011,5819,7192,8.4,18.8,-648,-0.9,35.8,0,778,780,4877
1992,37,f) 5,6209,6778,75927,74569,291,4.1,898,12.6,14543,1625,12918,2.2,19.5,11827,4984,6843,6.7,15.9,2716,3.6,31.8,0,652,664,3732
1992,37,g) 6 to 10,25192,27419,271897,274442,1132,4,2616,9.3,46018,10781,35237,3.9,16.8,51107,19888,31219,7.2,18.6,-5089,-1.8,33.6,0,1762,1793,13429
1992,37,h) 11 to 15,15358,18625,273302,270517,800,4.2,1457,7.7,39957,8602,31355,3.2,14.8,34387,10101,24286,3.7,12.7,5570,2.1,25.4,0,848,880,5447
1992,37,l) Left Censored,28621,52669,1680582,1681759,2609,4.9,3796,7.1,199043,53515,145528,3.2,11.8,201397,62139,139258,3.7,12,-2354,-0.2,23.6,0,1285,1354,9131
1992,38,a) 0,1199,1206,5343,2724,1197,198.5,0,0,5238,5238,0,192.3,192.3,0,0,0,0,0,5238,192.3,0,0,,,
1992,38,b) 1,969,982,5629,5672,14,1.3,221,20,1394,323,1071,5.7,24.6,1479,784,695,13.8,26.1,-85,-1.5,49.2,0,171,171,610
1992,38,c) 2,882,911,5194,5413,39,4,141,14.6,1104,166,938,3.1,20.4,1541,894,647,16.5,28.5,-437,-8.1,40.8,0,106,106,802
1992,38,d) 3,711,723,4759,4883,31,4,112,14.6,847,188,659,3.9,17.3,1094,581,513,11.9,22.4,-247,-5.1,34.6,0,89,89,475
1992,38,e) 4,689,711,6079,6088,25,3.3,110,14.5,1025,87,938,1.4,16.8,1042,431,611,7.1,17.1,-17,-0.3,33.6,0,82,82,318
1992,38,f) 5,680,710,6222,6368,33,4.5,82,11.1,916,63,853,1,14.4,1208,404,804,6.3,19,-292,-4.6,28.8,0,61,61,338
1992,38,g) 6 to 10,2761,3055,25022,25148,110,3.5,285,9,3141,370,2771,1.5,12.5,3393,1095,2298,4.4,13.5,-252,-1,25,0,184,190,668
1992,38,h) 11 to 15,2299,2604,25650,25476,104,3.9,214,8,3606,482,3124,1.9,14.2,3257,768,2489,3,12.8,349,1.4,25.6,0,144,145,538
1992,38,l) Left Censored,4394,6391,120860,120334,308,4.8,459,7.1,14325,4215,10110,3.5,11.9,13272,4034,9238,3.4,11,1053,0.9,22,0,212,218,1400
1992,39,a) 0,15408,15671,88872,44629,15625,199.4,0,0,88487,88487,0,198.3,198.3,0,0,0,0,0,88487,198.3,0,0,,,
1992,39,b) 1,12540,12887,93926,92324,191,1.3,3049,21.1,29394,4375,25019,4.7,31.8,26189,14308,11881,15.5,28.4,3205,3.4,56.8,0,2382,2382,11669
1992,39,c) 2,11303,11693,91364,96465,464,3.7,2091,16.6,18883,2531,16352,2.6,19.6,29085,14144,14941,14.7,30.2,-10202,-10.6,39.2,0,1676,1679,11709
1992,39,d) 3,10173,10739,103646,101756,488,4.3,1595,14.1,25822,6483,19339,6.4,25.4,22041,8834,13207,8.7,21.7,3781,3.7,43.4,0,1275,1275,7300
1992,39,e) 4,9031,9533,95725,97674,373,3.7,1276,12.7,16638,2545,14093,2.6,17,20536,7916,12620,8.1,21,-3898,-4,34,0,980,980,5811
1992,39,f) 5,8851,9540,111850,114340,359,3.6,1176,11.8,17824,4043,13781,3.5,15.6,22803,8489,14314,7.4,19.9,-4979,-4.3,31.2,0,868,875,6041
1992,39,g) 6 to 10,32837,36355,421413,430046,1294,3.4,3498,9.3,57429,10492,46937,2.4,13.4,74695,25283,49412,5.9,17.4,-17266,-4,26.8,0,2348,2412,15267
1992,39,h) 11 to 15,24667,30364,435135,434483,1190,3.8,2371,7.6,63241,12082,51159,2.8,14.6,61936,17260,44676,4,14.3,1305,0.3,28.6,0,1348,1391,9794
1992,39,l) Left Censored,51997,91010,2720539,2747401,3935,4.3,6506,7,276216,64116,212100,2.3,10.1,329939,85306,244633,3.1,12,-53723,-1.9,20.2,0,2356,2496,18858
1992,40,a) 0,5986,6062,31767,15902,6047,199.5,0,0,31730,31730,0,199.5,199.5,0,0,0,0,0,31730,199.5,0,0,,,
1992,40,b) 1,4466,4573,30937,31551,63,1.2,1313,25,10110,1167,8943,3.7,32,11337,7607,3730,24.1,35.9,-1227,-3.9,64,0,1066,1066,6566
1992,40,c) 2,3863,3930,25955,27483,176,4.1,808,18.9,5502,696,4806,2.5,20,8558,4353,4205,15.8,31.1,-3056,-11.1,40,0,671,671,3865
1992,40,d) 3,3176,3252,28662,29918,129,3.7,637,18.1,5686,760,4926,2.5,19,8198,4627,3571,15.5,27.4,-2512,-8.4,38,0,521,522,4049
1992,40,e) 4,2737,2860,24940,25925,120,4,432,14.3,3854,761,3093,2.9,14.9,5823,2563,3260,9.9,22.5,-1969,-7.6,29.8,0,347,348,2049
1992,40,f) 5,2502,2720,38523,39640,121,4.3,358,12.6,7007,588,6419,1.5,17.7,9240,4969,4271,12.5,23.3,-2233,-5.6,35.4,0,275,278,1860
1992,40,g) 6 to 10,11884,12926,120448,120955,583,4.4,1281,9.6,19223,4033,15190,3.3,15.9,20236,6732,13504,5.6,16.7,-1013,-0.8,31.8,0,908,931,4954
1992,40,h) 11 to 15,8383,9956,118111,119440,422,4.1,816,8,15380,3129,12251,2.6,12.9,18037,5416,12621,4.5,15.1,-2657,-2.2,25.8,0,524,533,2576
1992,40,l) Left Censored,13665,22822,534063,540074,1170,5,1790,7.7,61989,17206,44783,3.2,11.5,74010,22812,51198,4.2,13.7,-12021,-2.2,23,0,740,793,5908
1992,41,a) 0,6986,7093,37579,18802,7078,199.6,0,0,37555,37555,0,199.7,199.7,0,0,0,0,0,37555,199.7,0,0,,,
1992,41,b) 1,5301,5422,33078,34033,68,1.1,1502,24.2,9804,964,8840,2.8,28.8,11714,7665,4049,22.5,34.4,-1910,-5.6,57.6,0,1135,1135,6074
1992,41,c) 2,5068,5184,33491,36126,256,4.6,994,17.7,7185,1458,5727,4,19.9,12454,6961,5493,19.3,34.5,-5269,-14.6,39.8,0,768,769,5546
1992,41,d) 3,3396,3499,27350,28140,171,4.6,535,14.4,5505,1021,4484,3.6,19.6,7085,3655,3430,13,25.2,-1580,-5.6,39.2,0,413,413,3151
1992,41,e) 4,3459,3554,29664,29931,141,3.7,538,14.3,6023,1110,4913,3.7,20.1,6557,2813,3744,9.4,21.9,-534,-1.8,40.2,0,397,401,2216
1992,41,f) 5,3293,3493,40424,41147,162,4.4,506,13.8,6577,909,5668,2.2,16,8022,2961,5061,7.2,19.5,-1445,-3.5,32,0,358,365,2208
1992,41,g) 6 to 10,11859,12971,137292,139260,596,4.5,1333,10,21711,5103,16608,3.7,15.6,25646,9147,16499,6.6,18.4,-3935,-2.8,31.2,0,911,922,5523
1992,41,h) 11 to 15,9118,10767,124446,125865,513,4.7,888,8.1,19021,3817,15204,3,15.1,21858,7095,14763,5.6,17.4,-2837,-2.3,30.2,0,513,528,3705
1992,41,l) Left Censored,13548,22556,561834,569258,1208,5.3,1750,7.7,65692,16875,48817,3,11.5,80539,19081,61458,3.4,14.1,-14847,-2.6,23,0,642,669,4520
1992,42,a) 0,16750,17059,104313,52203,17025,199.6,0,0,104221,104221,0,199.6,199.6,0,0,0,0,0,104221,199.6,0,0,,,
1992,42,b) 1,14088,14419,102591,104838,174,1.1,3423,21.1,27681,3643,24038,3.5,26.4,32175,16565,15610,15.8,30.7,-4494,-4.3,52.8,0,2662,2664,13440
1992,42,c) 2,13214,13551,98307,102354,473,3.2,2436,16.6,20010,3402,16608,3.3,19.5,28103,13388,14715,13.1,27.5,-8093,-8,39,0,1950,1963,11292
1992,42,d) 3,12427,12846,108102,109343,440,3.2,1990,14.5,23148,2908,20240,2.7,21.2,25630,11591,14039,10.6,23.4,-2482,-2.2,42.4,0,1583,1585,9764
1992,42,e) 4,11112,11599,100452,104209,388,3.2,1599,13,16179,2157,14022,2.1,15.5,23693,10015,13678,9.6,22.7,-7514,-7.2,31,0,1277,1281,8123
1992,42,f) 5,10929,11495,129521,131047,408,3.4,1350,11.2,19507,2753,16754,2.1,14.9,22558,8953,13605,6.8,17.2,-3051,-2.3,29.8,0,1000,1022,6243
1992,42,g) 6 to 10,39366,42535,485975,495879,1475,3.3,4314,9.8,68002,12070,55932,2.4,13.7,87809,33898,53911,6.8,17.7,-19807,-4,27.4,0,2956,3005,21820
1992,42,h) 11 to 15,27205,32603,449102,452468,1233,3.7,2641,7.9,59548,12049,47499,2.7,13.2,66279,19200,47079,4.2,14.6,-6731,-1.4,26.4,0,1619,1648,10986
1992,42,l) Left Censored,59396,97709,2898032,2938228,4055,4.1,7008,7.1,299014,85467,213547,2.9,10.2,379407,101806,277601,3.5,12.9,-80393,-2.7,20.4,0,2840,2973,21689
1992,44,a) 0,1728,1745,9295,4653,1738,199.2,0,0,9285,9285,0,199.5,199.5,0,0,0,0,0,9285,199.5,0,0,,,
1992,44,b) 1,1330,1342,8738,9082,8,0.5,400,25.5,2392,125,2267,1.4,26.3,3080,1973,1107,21.7,33.9,-688,-7.6,52.6,0,312,312,1465
1992,44,c) 2,1277,1299,7894,9051,74,5.2,294,20.6,1888,508,1380,5.6,20.9,4201,2236,1965,24.7,46.4,-2313,-25.5,41.8,0,239,239,1775
1992,44,d) 3,1315,1346,10990,11471,67,4.7,215,15,1977,575,1402,5,17.2,2939,1201,1738,10.5,25.6,-962,-8.4,34.4,0,168,168,1037
1992,44,e) 4,1197,1234,9428,9471,53,4,200,15.2,2252,216,2036,2.3,23.8,2338,1308,1030,13.8,24.7,-86,-0.9,47.6,0,146,146,1019
1992,44,f) 5,1122,1157,10779,11264,65,5.3,187,15.3,1585,226,1359,2,14.1,2555,1022,1533,9.1,22.7,-970,-8.6,28.2,0,128,129,669
1992,44,g) 6 to 10,3805,3973,36572,38276,155,3.7,453,10.9,5267,725,4542,1.9,13.8,8674,3103,5571,8.1,22.7,-3407,-8.9,27.6,0,315,318,1670
1992,44,h) 11 to 15,2659,2959,34148,35179,107,3.5,289,9.4,4193,1157,3036,3.3,11.9,6254,1801,4453,5.1,17.8,-2061,-5.9,23.8,0,168,172,1132
1992,44,l) Left Censored,6276,8306,235204,239714,323,3.8,689,8.1,23064,5177,17887,2.2,9.6,32085,9578,22507,4,13.4,-9021,-3.8,19.2,0,301,328,3645
1992,45,a) 0,6240,6322,37078,18573,6303,199.4,0,0,37011,37011,0,199.3,199.3,0,0,0,0,0,37011,199.3,0,0,,,
1992,45,b) 1,4872,5030,34312,35007,81,1.4,1281,22.5,8957,787,8170,2.2,25.6,10346,5741,4605,16.4,29.6,-1389,-4,51.2,0,1010,1011,4849
1992,45,c) 2,4195,4294,32081,33471,196,4.2,942,20,7022,1332,5690,4,21,9802,5328,4474,15.9,29.3,-2780,-8.3,42,0,771,771,4567
1992,45,d) 3,3546,3755,32112,32147,173,4.3,658,16.3,7074,1518,5556,4.7,22,7144,3190,3954,9.9,22.2,-70,-0.2,44,0,516,516,2674
1992,45,e) 4,3290,3523,35840,34157,120,3.2,495,13.2,10171,748,9423,2.2,29.8,6804,3061,3743,9,19.9,3367,9.9,39.8,0,404,404,2439
1992,45,f) 5,3108,3380,48619,47295,140,4,446,12.6,10719,771,9948,1.6,22.7,8070,3117,4953,6.6,17.1,2649,5.6,34.2,0,342,350,2485
1992,45,g) 6 to 10,12022,13148,129517,133074,513,3.8,1384,10.2,17748,4358,13390,3.3,13.3,24862,8807,16055,6.6,18.7,-7114,-5.4,26.6,0,969,984,5757
1992,45,h) 11 to 15,7554,9149,118554,120477,435,4.7,788,8.4,16617,4979,11638,4.1,13.8,20462,5399,15063,4.5,17,-3845,-3.2,27.6,0,439,454,2743
1992,45,l) Left Censored,13809,24884,783249,787432,1278,5.1,1895,7.5,83696,23979,59717,3,10.6,92062,24212,67850,3.1,11.7,-8366,-1.1,21.2,0,613,643,7043
1992,46,a) 0,1485,1513,7095,3553,1504,198.8,0,0,7084,7084,0,199.4,199.4,0,0,0,0,0,7084,199.4,0,0,,,
1992,46,b) 1,1195,1213,7849,8093,19,1.4,296,21.7,2494,178,2316,2.2,30.8,2982,1360,1622,16.8,36.8,-488,-6,61.6,0,211,211,1089
1992,46,c) 2,1121,1139,7696,8257,47,3.8,214,17.3,1468,216,1252,2.6,17.8,2590,1454,1136,17.6,31.4,-1122,-13.6,35.6,0,162,162,1297
1992,46,d) 3,827,856,5815,6001,31,3.4,125,13.8,1072,189,883,3.1,17.9,1444,797,647,13.3,24.1,-372,-6.2,35.8,0,98,98,645
1992,46,e) 4,771,806,5825,5858,26,3.1,107,12.6,1026,172,854,2.9,17.5,1092,524,568,8.9,18.6,-66,-1.1,35,0,75,76,378
1992,46,f) 5,720,741,11239,10782,36,4.7,89,11.5,2165,107,2058,1,20.1,1251,488,763,4.5,11.6,914,8.5,23.2,0,66,67,363
1992,46,g) 6 to 10,3006,3291,28072,27557,138,4.1,282,8.4,5047,684,4363,2.5,18.3,4016,1458,2558,5.3,14.6,1031,3.7,29.2,0,175,177,1069
1992,46,h) 11 to 15,2304,2616,29585,29580,95,3.5,245,9.1,3731,467,3264,1.6,12.6,3720,1503,2217,5.1,12.6,11,0,25.2,0,156,159,678
1992,46,l) Left Censored,4742,6668,131089,129690,343,5.1,466,6.9,16283,4890,11393,3.8,12.6,13485,3945,9540,3,10.4,2798,2.2,20.8,0,245,249,1439
1992,47,a) 0,8567,8721,52108,26082,8697,199.4,0,0,52052,52052,0,199.6,199.6,0,0,0,0,0,52052,199.6,0,0,,,
1992,47,b) 1,6438,6687,61718,59636,121,1.6,1885,24.6,22897,3598,19299,6,38.4,18733,10453,8280,17.5,31.4,4164,7,62.8,0,1532,1536,9229
1992,47,c) 2,5702,5859,46287,49325,244,3.8,1213,19,10567,1761,8806,3.6,21.4,16643,8990,7653,18.2,33.7,-6076,-12.3,42.8,0,989,990,8067
1992,47,d) 3,4930,5171,44561,45944,224,4,913,16.4,9108,1458,7650,3.2,19.8,11874,5723,6151,12.5,25.8,-2766,-6,39.6,0,746,747,4878
1992,47,e) 4,4434,4687,48465,47570,218,4.4,694,14,11692,1454,10238,3.1,24.6,9902,4502,5400,9.5,20.8,1790,3.8,41.6,0,530,532,3617
1992,47,f) 5,4209,4609,64930,63462,226,4.7,638,13.2,13109,2633,10476,4.1,20.7,10172,3751,6421,5.9,16,2937,4.7,32,0,467,470,2869
1992,47,g) 6 to 10,16642,18130,194121,195715,787,4.2,1778,9.5,29754,5570,24184,2.8,15.2,32941,13039,19902,6.7,16.8,-3187,-1.6,30.4,0,1254,1275,8317
1992,47,h) 11 to 15,10957,13599,218148,215685,629,4.5,1328,9.5,40054,7139,32915,3.3,18.6,35128,15014,20114,7,16.3,4926,2.3,32.6,0,677,710,4583
1992,47,l) Left Censored,20745,37100,1163343,1166037,1930,5.1,2801,7.5,132029,32828,99201,2.8,11.3,137417,38500,98917,3.3,11.8,-5388,-0.5,22.6,0,947,996,7783
1992,48,a) 0,34284,35037,242467,121495,34934,199.4,0,0,241945,241945,0,199.1,199.1,0,0,0,0,0,241945,199.1,0,0,,,
1992,48,b) 1,26101,26999,227496,223943,554,1.8,7152,23.3,80025,14547,65478,6.5,35.7,72919,42410,30509,18.9,32.6,7106,3.1,65.2,0,5738,5741,35669
1992,48,c) 2,21692,22561,189306,206273,1079,4.4,4765,19.4,43885,7932,35953,3.8,21.3,77818,44785,33033,21.7,37.7,-33933,-16.4,42.6,0,3874,3894,38554
1992,48,d) 3,17521,18474,168148,176552,946,4.8,3394,17.1,36415,6102,30313,3.5,20.6,53223,28162,25061,16,30.1,-16808,-9.5,41.2,0,2705,2752,22954
1992,48,e) 4,15124,16423,160689,171144,824,4.7,2629,15.1,31741,5969,25772,3.5,18.5,52650,26928,25722,15.7,30.8,-20909,-12.3,37,0,1932,1946,18563
1992,48,f) 5,13840,15091,216944,213328,744,4.7,2243,14.1,57631,19543,38088,9.2,27,50400,15569,34831,7.3,23.6,7231,3.4,47.2,0,1626,1650,10389
1992,48,g) 6 to 10,58907,65722,708758,719748,3369,5,7418,10.9,131124,25958,105166,3.6,18.2,153104,57347,95757,8,21.3,-21980,-3.1,36.4,0,4957,5102,36814
1992,48,h) 11 to 15,40539,50393,626415,634907,2578,5,4547,8.8,98235,25739,72496,4.1,15.5,115219,35898,79321,5.7,18.1,-16984,-2.6,31,0,2650,2781,17891
1992,48,l) Left Censored,55239,115264,3468762,3491989,6663,5.7,10106,8.6,448650,135165,313485,3.9,12.8,495105,148133,346972,4.2,14.2,-46455,-1.4,25.6,0,3111,3374,25846
1992,49,a) 0,3491,3548,21073,10553,3539,199.5,0,0,21041,21041,0,199.4,199.4,0,0,0,0,0,21041,199.4,0,0,,,
1992,49,b) 1,2482,2547,21170,21170,40,1.4,675,23.3,7159,695,6464,3.3,33.8,7158,4515,2643,21.3,33.8,1,0,67.6,0,535,535,3802
1992,49,c) 2,2012,2092,19513,19728,104,4.6,399,17.7,4926,962,3964,4.9,25,5356,2614,2742,13.3,27.1,-430,-2.1,50,0,324,324,2151
1992,49,d) 3,1764,1820,22334,22063,90,4.6,316,16.3,5919,621,5298,2.8,26.8,5377,3414,1963,15.5,24.4,542,2.4,48.8,0,256,256,2730
1992,49,e) 4,1509,1624,20144,20747,77,4.5,264,15.3,3807,392,3415,1.9,18.3,5012,2611,2401,12.6,24.2,-1205,-5.9,36.6,0,206,208,2117
1992,49,f) 5,1355,1456,16993,17214,69,4.5,193,12.7,3142,612,2530,3.6,18.3,3583,1528,2055,8.9,20.8,-441,-2.5,36.6,0,148,153,940
1992,49,g) 6 to 10,5137,5677,77202,79246,257,4.4,591,10.1,13486,1833,11653,2.3,17,17573,9915,7658,12.5,22.2,-4087,-5.2,34,0,397,402,8318
1992,49,h) 11 to 15,4063,4828,73995,72503,245,5,397,8.1,13282,2744,10538,3.8,18.3,10297,2930,7367,4,14.2,2985,4.1,28.4,0,236,242,1630
1992,49,l) Left Censored,6397,10779,340470,340433,584,5.3,962,8.8,45687,14628,31059,4.3,13.4,45613,13703,31910,4,13.4,74,0,26.8,0,313,330,1897
1992,50,a) 0,1313,1325,6405,3204,1324,199.8,0,0,6402,6402,0,199.8,199.8,0,0,0,0,0,6402,199.8,0,0,,,
1992,50,b) 1,1108,1130,6284,6218,13,1,223,17.8,1756,204,1552,3.3,28.2,1623,734,889,11.8,26.1,133,2.1,52.2,0,180,180,598
1992,50,c) 2,1129,1156,5705,6109,50,4,200,16.1,1105,147,958,2.4,18.1,1912,928,984,15.2,31.3,-807,-13.2,36.2,0,153,153,716
1992,50,d) 3,1106,1127,7484,7535,43,3.5,209,17.2,1537,248,1289,3.3,20.4,1639,737,902,9.8,21.8,-102,-1.4,40.8,0,162,165,617
1992,50,e) 4,949,962,5718,6059,45,4.4,138,13.6,1010,181,829,3,16.7,1691,868,823,14.3,27.9,-681,-11.2,33.4,0,103,103,684
1992,50,f) 5,877,908,6235,7204,33,3.4,132,13.7,791,152,639,2.1,11,2728,468,2260,6.5,37.9,-1937,-26.9,22,0,97,97,349
1992,50,g) 6 to 10,3230,3388,26975,27335,107,3,359,10.2,3773,663,3110,2.4,13.8,4492,1847,2645,6.8,16.4,-719,-2.6,27.6,0,253,254,1474
1992,50,h) 11 to 15,1957,2223,25238,25099,92,4,187,8.2,3346,403,2943,1.6,13.3,3068,706,2362,2.8,12.2,278,1.1,24.4,0,110,111,445
1992,50,l) Left Censored,3534,5019,116951,117267,208,4.1,333,6.5,11652,2859,8793,2.4,9.9,12283,2877,9406,2.5,10.5,-631,-0.6,19.8,0,137,138,1201
1992,51,a) 0,10947,11223,62701,31376,11196,199.5,0,0,62650,62650,0,199.7,199.7,0,0,0,0,0,62650,199.7,0,0,,,
1992,51,b) 1,8458,8645,56735,57479,101,1,2372,24,17863,1188,16675,2.1,31.1,19351,11398,7953,19.8,33.7,-1488,-2.6,62.2,0,1853,1853,9295
1992,51,c) 2,7892,8111,54447,57255,398,4.5,1683,19.1,12218,2060,10158,3.6,21.3,17834,9836,7998,17.2,31.1,-5616,-9.8,42.6,0,1377,1379,8748
1992,51,d) 3,6847,7112,54585,58669,344,4.5,1219,16.1,10594,1726,8868,2.9,18.1,18761,10940,7821,18.6,32,-8167,-13.9,36.2,0,963,967,9795
1992,51,e) 4,6242,6609,61310,61758,308,4.4,998,14.3,11795,2139,9656,3.5,19.1,12691,5677,7014,9.2,20.5,-896,-1.4,38.2,0,748,749,4365
1992,51,f) 5,5732,6080,68752,67364,299,4.7,852,13.4,16521,2661,13860,4,24.5,13744,6211,7533,9.2,20.4,2777,4.1,40.8,0,595,606,3580
1992,51,g) 6 to 10,21647,23869,258429,263701,1063,4.3,2407,9.8,40670,9926,30744,3.8,15.4,51214,18273,32941,6.9,19.4,-10544,-4,30.8,0,1587,1619,12695
1992,51,h) 11 to 15,13534,16784,245491,245055,748,4.3,1476,8.6,39491,7815,31676,3.2,16.1,38619,10638,27981,4.3,15.8,872,0.3,31.6,0,776,815,5220
1992,51,l) Left Censored,24585,47461,1376261,1388436,2654,5.5,3833,8,163189,51749,111440,3.7,11.8,187539,52908,134631,3.8,13.5,-24350,-1.7,23.6,0,1079,1218,9322
1992,53,a) 0,12613,12825,64302,32678,12771,199.2,0,0,63249,63249,0,193.6,193.6,0,0,0,0,0,63249,193.6,0,0,,,
1992,53,b) 1,9151,9357,60648,60003,105,1,2519,23.5,19458,1671,17787,2.8,32.4,18168,10035,8133,16.7,30.3,1290,2.1,60.6,0,1902,1902,7821
1992,53,c) 2,8984,9262,66812,69255,488,4.9,1825,18.2,15304,2304,13000,3.3,22.1,20190,10229,9961,14.8,29.2,-4886,-7.1,44.2,0,1392,1392,8172
1992,53,d) 3,5495,5712,51523,52135,285,4.7,854,14.1,10935,1295,9640,2.5,21,12158,5137,7021,9.9,23.3,-1223,-2.3,42,0,663,665,4280
1992,53,e) 4,5705,5938,53271,53864,297,4.7,864,13.8,11420,3485,7935,6.5,21.2,12605,5541,7064,10.3,23.4,-1185,-2.2,42.4,0,665,673,4539
1992,53,f) 5,5264,5604,70305,68865,278,4.7,785,13.4,14523,1169,13354,1.7,21.1,11643,4923,6720,7.1,16.9,2880,4.2,33.8,0,571,574,3438
1992,53,g) 6 to 10,19998,21962,247320,246941,1066,4.7,2267,10,44791,8312,36479,3.4,18.1,44033,14642,29391,5.9,17.8,758,0.3,35.6,0,1495,1517,9893
1992,53,h) 11 to 15,14098,16843,208029,209108,905,5.3,1419,8.3,32356,7239,25117,3.5,15.5,34514,10365,24149,5,16.5,-2158,-1,31,0,823,841,5242
1992,53,l) Left Censored,20295,35219,966701,969332,2061,5.8,2767,7.8,140671,30708,109963,3.2,14.5,145933,48611,97322,5,15.1,-5262,-0.6,29,0,956,999,7838
1992,54,a) 0,2540,2563,12837,6435,2549,198.9,0,0,12805,12805,0,199,199,0,0,0,0,0,12805,199,0,0,,,
1992,54,b) 1,2039,2100,13885,15148,20,0.8,511,21.5,3473,200,3273,1.3,22.9,5998,2751,3247,18.2,39.6,-2525,-16.7,45.8,0,393,393,2257
1992,54,c) 2,1844,1865,13020,13703,69,3.4,346,17.1,2478,399,2079,2.9,18.1,3843,2176,1667,15.9,28,-1365,-9.9,36.2,0,290,290,1847
1992,54,d) 3,1581,1625,14150,15038,50,2.9,277,15.9,2273,164,2109,1.1,15.1,4048,2614,1434,17.4,26.9,-1775,-11.8,30.2,0,215,215,1414
1992,54,e) 4,1411,1451,11317,11540,50,3.3,182,11.9,1839,226,1613,2,15.9,2285,891,1394,7.7,19.8,-446,-3.9,31.8,0,149,149,799
1992,54,f) 5,1369,1430,15462,15442,54,3.6,174,11.6,2804,252,2552,1.6,18.2,2764,1137,1627,7.4,17.9,40,0.3,35.8,0,129,131,948
1992,54,g) 6 to 10,5444,6009,66858,67673,229,3.7,529,8.6,7781,1444,6337,2.1,11.5,9411,2973,6438,4.4,13.9,-1630,-2.4,23,0,354,354,1885
1992,54,h) 11 to 15,3807,4543,52625,52590,183,3.9,358,7.7,7132,1622,5510,3.1,13.6,7061,2414,4647,4.6,13.4,71,0.2,26.8,0,208,210,1120
1992,54,l) Left Censored,8469,13174,280426,284050,629,4.7,1014,7.6,32309,8211,24098,2.9,11.4,39557,11955,27602,4.2,13.9,-7248,-2.5,22.8,0,369,386,2120
1992,55,a) 0,8112,8183,45057,22544,8165,199.6,0,0,45027,45027,0,199.7,199.7,0,0,0,0,0,45027,199.7,0,0,,,
1992,55,b) 1,6654,6845,46876,46212,105,1.4,1482,19.5,13588,2050,11538,4.4,29.4,12259,6494,5765,14.1,26.5,1329,2.9,53,0,1090,1090,5219
1992,55,c) 2,6096,6340,48014,48596,255,3.8,1023,15.1,10441,2495,7946,5.1,21.5,11605,5632,5973,11.6,23.9,-1164,-2.4,43,0,780,780,4605
1992,55,d) 3,5339,5495,41647,42818,174,3,786,13.5,7152,1116,6036,2.6,16.7,9494,4559,4935,10.6,22.2,-2342,-5.5,33.4,0,599,605,3569
1992,55,e) 4,4750,4897,43106,43811,149,2.9,607,11.8,6649,820,5829,1.9,15.2,8059,3651,4408,8.3,18.4,-1410,-3.2,30.4,0,465,465,2604
1992,55,f) 5,4865,5331,65640,65885,217,3.9,558,10.1,9240,1854,7386,2.8,14,9730,3470,6260,5.3,14.8,-490,-0.8,28,0,390,401,2557
1992,55,g) 6 to 10,17304,18946,213601,213833,652,3.3,1736,8.9,31695,5462,26233,2.6,14.8,32159,11400,20759,5.3,15,-464,-0.2,29.6,0,1205,1217,7200
1992,55,h) 11 to 15,12846,15366,202307,203258,581,3.7,1213,7.7,25999,4520,21479,2.2,12.8,27900,8195,19705,4,13.7,-1901,-0.9,25.6,0,692,708,4498
1992,55,l) Left Censored,27159,41788,1265983,1269458,1647,3.9,2748,6.5,123473,23059,100414,1.8,9.7,130423,36011,94412,2.8,10.3,-6950,-0.6,19.4,0,1190,1219,8737
1992,56,a) 0,1155,1157,4834,2485,1151,199,0,0,4698,4698,0,189.1,189.1,0,0,0,0,0,4698,189.1,0,0,,,
1992,56,b) 1,888,895,5316,5066,6,0.6,198,19.6,1861,174,1687,3.4,36.7,1361,643,718,12.7,26.9,500,9.8,53.8,0,141,141,454
1992,56,c) 2,756,764,4137,4468,30,3.7,118,14.4,776,146,630,3.3,17.4,1437,615,822,13.8,32.2,-661,-14.8,34.8,0,89,89,495
1992,56,d) 3,604,634,4455,4684,26,3.9,86,12.9,849,72,777,1.5,18.1,1307,762,545,16.3,27.9,-458,-9.8,36.2,0,58,58,656
1992,56,e) 4,561,579,4117,4223,33,5.5,70,11.7,724,140,584,3.3,17.1,935,407,528,9.6,22.1,-211,-5,34.2,0,56,56,377
1992,56,f) 5,505,546,5235,5374,30,5.3,68,12,899,213,686,4,16.7,1176,355,821,6.6,21.9,-277,-5.2,33.4,0,45,45,247
1992,56,g) 6 to 10,2378,2580,20956,21157,111,4.2,238,9,3331,476,2855,2.2,15.7,3732,1187,2545,5.6,17.6,-401,-1.9,31.4,0,166,167,950
1992,56,h) 11 to 15,1920,2195,20579,20788,84,3.7,196,8.7,3232,503,2729,2.4,15.5,3650,947,2703,4.6,17.6,-418,-2.1,31,0,113,117,605
1992,56,l) Left Censored,2781,4023,67591,67751,229,5.6,334,8.2,8523,2182,6341,3.2,12.6,8843,2520,6323,3.7,13.1,-320,-0.5,25.2,0,90,92,588
1993,01,a) 0,7148,7174,39166,19650,7114,198.3,0,0,39033,39033,0,198.6,198.6,0,0,0,0,0,39033,198.6,0,0,,,
1993,01,b) 1,5147,5292,43781,42153,28,0.5,1452,23.9,13122,1155,11967,2.7,31.1,9865,5646,4219,13.4,23.4,3257,7.7,46.8,0,1193,1193,4807
1993,01,c) 2,4250,4419,36719,37234,155,3.2,824,17.3,8494,1150,7344,3.1,22.8,9523,4842,4681,13,25.6,-1029,-2.8,45.6,0,689,689,4276
1993,01,d) 3,3970,4121,33861,35235,134,3.1,632,14.5,5891,499,5392,1.4,16.7,8638,3595,5043,10.2,24.5,-2747,-7.8,33.4,0,526,526,3027
1993,01,e) 4,3495,3669,34670,34662,112,2.9,482,12.5,6629,789,5840,2.3,19.1,6613,2491,4122,7.2,19.1,16,0,38.2,0,391,391,2085
1993,01,f) 5,3153,3318,36887,37649,110,3.2,401,11.6,5332,672,4660,1.8,14.2,6856,2567,4289,6.8,18.2,-1524,-4,28.4,0,316,316,1960
1993,01,g) 6 to 10,13313,14500,174380,173899,444,3,1295,8.7,26050,2766,23284,1.6,15,25088,8383,16705,4.8,14.4,962,0.6,28.8,0,951,953,5917
1993,01,h) 11 to 15,8105,9531,147047,146920,316,3.2,749,7.7,19253,2901,16352,2,13.1,18999,5223,13776,3.6,12.9,254,0.2,25.8,0,510,514,2988
1993,01,i) 16 to 20,1863,2864,50090,49598,104,3.6,169,5.8,6318,770,5548,1.6,12.7,5333,1586,3747,3.2,10.8,985,1.9,21.6,0,88,88,549
1993,01,l) Left Censored,15012,26851,806523,806559,973,3.6,1841,6.7,88281,15564,72717,1.9,10.9,88353,26861,61492,3.3,11,-72,-0.1,21.8,0,684,695,5433
1993,02,a) 0,1292,1297,5859,2979,1279,197.2,0,0,5761,5761,0,193.4,193.4,0,0,0,0,0,5761,193.4,0,0,,,
1993,02,b) 1,881,914,5622,5327,3,0.3,292,27.3,2209,,,,41.5,1618,1000,618,18.8,30.4,591,11.1,60.8,1,188,188,679
1993,02,c) 2,841,864,5692,5668,26,2.8,166,17.7,1402,74,1328,1.3,24.7,1353,654,699,11.5,23.9,49,0.8,47.8,0,120,120,505
1993,02,d) 3,799,819,5329,5343,43,5,130,15,1338,127,1211,2.4,25,1365,650,715,12.2,25.5,-27,-0.5,50,0,104,104,443
1993,02,e) 4,523,530,4997,4823,30,5.4,85,15.2,1329,196,1133,4.1,27.6,981,431,550,8.9,20.3,348,7.3,40.6,0,57,57,294
1993,02,f) 5,538,588,5879,6011,19,3.1,66,10.7,936,54,882,0.9,15.6,1199,366,833,6.1,19.9,-263,-4.3,31.2,0,52,52,322
1993,02,g) 6 to 10,2550,2825,27676,27961,91,3.1,268,9.2,4480,576,3904,2.1,16,5050,1671,3379,6,18.1,-570,-2.1,32,0,175,175,1358
1993,02,h) 11 to 15,1520,1731,17885,18212,65,3.6,162,9.1,2646,333,2313,1.8,14.5,3300,1119,2181,6.1,18.1,-654,-3.6,29,0,79,86,583
1993,02,i) 16 to 20,328,492,7604,7602,20,4,39,7.8,1121,,,,14.7,1117,291,826,3.8,14.7,4,0,29.4,1,7,7,24
1993,02,l) Left Censored,1909,3418,80556,81695,156,4.5,242,7,10356,2106,8250,2.6,12.7,12634,2936,9698,3.6,15.5,-2278,-2.8,25.4,0,58,59,378
1993,04,a) 0,8158,8201,46233,23274,8151,198.8,0,0,45918,45918,0,197.3,197.3,0,0,0,0,0,45918,197.3,0,0,,,
1993,04,b) 1,5954,6109,50951,50718,33,0.5,1780,25.2,15989,991,14998,2,31.5,15522,8974,6548,17.7,30.6,467,0.9,61.2,0,1470,1470,7119
1993,04,c) 2,5126,5271,45190,46882,213,3.7,1032,18.1,10624,1003,9621,2.1,22.7,14007,6050,7957,12.9,29.9,-3383,-7.2,45.4,0,869,869,5182
1993,04,d) 3,4441,4581,40093,41975,161,3.3,786,16,8428,1171,7257,2.8,20.1,12192,5256,6936,12.5,29,-3764,-8.9,40.2,0,660,660,4377
1993,04,e) 4,3981,4173,44279,44063,181,4.1,632,14.4,9962,2094,7868,4.8,22.6,9530,4692,4838,10.6,21.6,432,1,43.2,0,496,509,3932
1993,04,f) 5,3483,3708,35711,35620,136,3.5,455,11.8,6671,804,5867,2.3,18.7,6489,2919,3570,8.2,18.2,182,0.5,36.4,0,354,354,1959
1993,04,g) 6 to 10,13876,15562,200374,201847,608,3.8,1658,10.3,31961,6283,25678,3.1,15.8,34909,13795,21114,6.8,17.3,-2948,-1.5,31.6,0,1114,1130,7543
1993,04,h) 11 to 15,8540,9899,140525,140727,378,3.7,877,8.6,19648,3089,16559,2.2,14,20051,6092,13959,4.3,14.2,-403,-0.2,28,0,528,530,3110
1993,04,i) 16 to 20,1437,2278,46501,46224,122,5.3,150,6.6,7053,1483,5570,3.2,15.3,6498,2130,4368,4.6,14.1,555,1.2,28.2,0,69,70,898
1993,04,l) Left Censored,10118,20750,647147,642113,1225,5.8,1913,9.1,93500,28434,65066,4.4,14.6,83432,28361,55071,4.4,13,10068,1.6,26,0,432,441,3302
1993,05,a) 0,4721,4743,23413,11765,4713,198.7,0,0,23297,23297,0,198,198,0,0,0,0,0,23297,198,0,0,,,
1993,05,b) 1,3375,3467,27866,26776,24,0.6,957,24,9517,1227,8290,4.6,35.5,7336,4228,3108,15.8,27.4,2181,8.1,54.8,0,789,789,3624
1993,05,c) 2,2743,2851,21098,22063,104,3.4,516,16.9,4948,888,4060,4,22.4,6878,3990,2888,18.1,31.2,-1930,-8.8,44.8,0,428,428,2951
1993,05,d) 3,2558,2666,20668,20903,100,3.6,374,13.3,3848,691,3157,3.3,18.4,4318,1657,2661,7.9,20.7,-470,-2.3,36.8,0,306,306,1388
1993,05,e) 4,2048,2104,19705,19915,79,3.5,319,14.3,3444,448,2996,2.2,17.3,3864,1809,2055,9.1,19.4,-420,-2.1,34.6,0,267,267,1508
1993,05,f) 5,1818,1893,19048,19876,61,3.1,221,11.2,2584,314,2270,1.6,13,4239,1574,2665,7.9,21.3,-1655,-8.3,26,0,187,187,1274
1993,05,g) 6 to 10,8345,8949,90065,89544,311,3.4,829,9,14519,2017,12502,2.3,16.2,13476,5220,8256,5.8,15,1043,1.2,30,0,632,638,3611
1993,05,h) 11 to 15,5821,6524,78367,77855,217,3.2,534,8,12374,2305,10069,3,15.9,11350,3366,7984,4.3,14.6,1024,1.3,29.2,0,374,388,2065
1993,05,i) 16 to 20,1231,1702,27563,27494,48,2.8,101,5.9,4223,549,3674,2,15.4,4085,792,3293,2.9,14.9,138,0.5,29.8,0,67,68,274
1993,05,l) Left Censored,9848,15851,483750,480536,540,3.4,1031,6.4,51540,10112,41428,2.1,10.7,45112,13144,31968,2.7,9.4,6428,1.3,18.8,0,398,421,2295
1993,06,a) 0,54522,54747,337784,170253,54203,198,0,0,335062,335062,0,196.8,196.8,0,0,0,0,0,335062,196.8,0,0,,,
1993,06,b) 1,42472,43735,444342,426916,188,0.4,14071,27.3,153907,23627,130280,5.5,36.1,119054,62473,56581,14.6,27.9,34853,8.2,55.8,0,11323,11335,52825
1993,06,c) 2,38179,39518,307953,328364,1530,3.5,8947,20.6,71533,9557,61976,2.9,21.8,112355,57784,54571,17.6,34.2,-40822,-12.4,43.6,0,7090,7109,43239
1993,06,d) 3,35437,36737,317630,327819,1532,3.9,7050,17.7,71344,10445,60899,3.2,21.8,91721,42698,49023,13,28,-20377,-6.2,43.6,0,5593,5599,34616
1993,06,e) 4,31092,32515,309574,318842,1223,3.5,5514,15.8,60587,8344,52243,2.6,19,79123,33071,46052,10.4,24.8,-18536,-5.8,38,0,4310,4320,26868
1993,06,f) 5,27919,29611,293283,303088,1175,3.7,4619,14.7,53678,9755,43923,3.2,17.7,73287,28890,44397,9.5,24.2,-19609,-6.5,35.4,0,3444,3458,21264
1993,06,g) 6 to 10,111103,122998,1565953,1606504,4561,3.6,14499,11.3,237671,39791,197880,2.5,14.8,318775,104184,214591,6.5,19.8,-81104,-5,29.6,0,10108,10224,68034
1993,06,h) 11 to 15,76064,88176,1157696,1181862,2896,3.2,8466,9.3,163348,27504,135844,2.3,13.8,211679,66260,145419,5.6,17.9,-48331,-4.1,27.6,0,5348,5490,39348
1993,06,i) 16 to 20,14176,21664,378501,382191,776,3.5,1858,8.4,49763,9361,40402,2.4,13,57143,15395,41748,4,15,-7380,-2,26,0,907,950,5044
1993,06,l) Left Censored,92678,176205,5413596,5500135,7650,4.2,17388,9.6,716508,196076,520432,3.6,13,889585,307051,582534,5.6,16.2,-173077,-3.2,26,0,5267,5686,46364
1993,08,a) 0,10090,10108,50851,25512,10042,198.7,0,0,50679,50679,0,198.6,198.6,0,0,0,0,0,50679,198.6,0,0,,,
1993,08,b) 1,7024,7130,53396,51484,31,0.4,1938,23.8,18058,693,17365,1.3,35.1,14233,8403,5830,16.3,27.6,3825,7.5,55.2,0,1512,1513,6578
1993,08,c) 2,5989,6149,43416,44499,227,3.4,1152,17.4,10135,1222,8913,2.7,22.8,12301,7221,5080,16.2,27.6,-2166,-4.8,45.6,0,915,915,5933
1993,08,d) 3,4987,5130,40869,40953,199,3.7,751,13.9,8933,1049,7884,2.6,21.8,9100,4531,4569,11.1,22.2,-167,-0.4,43.6,0,581,581,3645
1993,08,e) 4,4418,4591,40751,41199,158,3.3,569,11.9,8056,824,7232,2,19.6,8952,3829,5123,9.3,21.7,-896,-2.1,39.2,0,458,458,3231
1993,08,f) 5,3900,4086,43588,42218,146,3.4,486,11.4,9473,1058,8415,2.5,22.4,6733,2840,3893,6.7,15.9,2740,6.5,31.8,0,372,372,2214
1993,08,g) 6 to 10,15483,16950,210134,209443,641,3.7,1588,9.1,32417,4503,27914,2.1,15.5,31034,12175,18859,5.8,14.8,1383,0.7,29.6,0,1075,1079,6497
1993,08,h) 11 to 15,10574,11830,140562,138831,454,3.8,907,7.5,23645,3639,20006,2.6,17,20183,7052,13131,5.1,14.5,3462,2.5,29,0,564,584,3851
1993,08,i) 16 to 20,1876,2803,43934,42697,123,4.3,198,7,7976,2413,5563,5.7,18.7,5501,2131,3370,5,12.9,2475,5.8,25.8,0,77,77,389
1993,08,l) Left Censored,13601,23924,709220,708013,1166,4.8,1917,7.9,87979,21133,66846,3,12.4,85566,24955,60611,3.5,12.1,2413,0.3,24.2,0,544,553,3391
1993,09,a) 0,5568,5588,28751,14418,5543,198.4,0,0,28666,28666,0,198.8,198.8,0,0,0,0,0,28666,198.8,0,0,,,
1993,09,b) 1,4296,4403,33240,31729,26,0.5,1023,20.7,10520,1195,9325,3.8,33.2,7497,3981,3516,12.5,23.6,3023,9.6,47.2,0,791,791,2923
1993,09,c) 2,3728,3822,36043,33776,133,3.2,715,17.3,15504,727,14777,2.2,45.9,10970,7707,3263,22.8,32.5,4534,13.4,65,0,569,571,7187
1993,09,d) 3,3754,3842,28452,28778,133,3.3,592,14.5,5417,812,4605,2.8,18.8,6068,2702,3366,9.4,21.1,-651,-2.3,37.6,0,471,472,2240
1993,09,e) 4,3818,3970,29535,29768,140,3.4,537,12.9,5183,656,4527,2.2,17.4,5649,2113,3536,7.1,19,-466,-1.6,34.8,0,420,420,1704
1993,09,f) 5,3510,3663,38582,39008,126,3.3,488,12.7,6480,1153,5327,3,16.6,7331,2562,4769,6.6,18.8,-851,-2.2,33.2,0,359,360,1949
1993,09,g) 6 to 10,13639,14368,144212,145948,453,3,1432,9.6,21378,3312,18066,2.3,14.6,24850,8397,16453,5.8,17,-3472,-2.4,29.2,0,1046,1055,5660
1993,09,h) 11 to 15,8686,9617,104448,106224,257,2.6,746,7.6,12706,2095,10611,2,12,16257,4180,12077,3.9,15.3,-3551,-3.3,24,0,501,507,2471
1993,09,i) 16 to 20,1785,2421,40260,39057,75,3,217,8.7,7059,1048,6011,2.7,18.1,4652,1166,3486,3,11.9,2407,6.2,23.8,0,105,106,418
1993,09,l) Left Censored,18752,27883,917251,934077,918,3.2,1948,6.9,93308,19842,73466,2.1,10,126959,27346,99613,2.9,13.6,-33651,-3.6,20,0,763,775,4561
1993,10,a) 0,1449,1452,6633,3333,1444,198.9,0,0,6600,6600,0,198,198,0,0,0,0,0,6600,198,0,0,,,
1993,10,b) 1,1107,1133,7310,7182,5,0.4,263,20.7,2017,,,,28.1,1761,1050,711,14.6,24.5,256,3.6,49,1,219,219,955
1993,10,c) 2,953,975,6356,6834,38,3.6,211,19.8,1336,222,1114,3.2,19.5,2292,1370,922,20,33.5,-956,-14,39,0,172,172,1278
1993,10,d) 3,878,905,5845,5953,45,4.7,127,13.4,1241,186,1055,3.1,20.8,1457,783,674,13.2,24.5,-216,-3.7,41.6,0,101,101,690
1993,10,e) 4,835,848,6652,6842,34,3.8,113,12.7,925,124,801,1.8,13.5,1305,488,817,7.1,19.1,-380,-5.6,27,0,86,86,349
1993,10,f) 5,655,673,6630,6584,24,3.4,88,12.5,1229,465,764,7.1,18.7,1137,613,524,9.3,17.3,92,1.4,34.6,0,63,63,526
1993,10,g) 6 to 10,2696,2898,29559,30143,81,2.7,265,8.9,3875,345,3530,1.1,12.9,5043,1750,3293,5.8,16.7,-1168,-3.8,25.8,0,191,191,1140
1993,10,h) 11 to 15,1585,1757,22938,23250,36,2,154,8.5,3340,517,2823,2.2,14.4,3963,978,2985,4.2,17,-623,-2.6,28.8,0,105,107,682
1993,10,i) 16 to 20,395,541,16517,16579,16,2.9,35,6.4,3110,,,,18.8,3234,371,2863,2.2,19.5,-124,-0.7,37.6,1,16,16,105
1993,10,l) Left Censored,3788,5918,194681,195411,301,5,489,8.1,23418,5774,17644,3,12,24879,8052,16827,4.1,12.7,-1461,-0.7,24,0,94,94,835
1993,11,a) 0,1041,1044,7884,3952,1033,197.9,0,0,7865,7865,0,199,199,0,0,0,0,0,7865,199,0,0,,,
1993,11,b) 1,879,913,28377,28464,8,0.8,220,21.3,2203,224,1979,0.8,7.7,2376,717,1659,2.5,8.3,-173,-0.6,15.4,0,161,161,485
1993,11,c) 2,771,780,6662,6437,27,3.2,126,15.2,1818,396,1422,6.2,28.2,1368,693,675,10.8,21.3,450,6.9,42.6,0,100,100,547
1993,11,d) 3,710,743,6940,7285,23,2.9,108,13.8,1549,80,1469,1.1,21.3,2239,1372,867,18.8,30.7,-690,-9.4,42.6,0,85,85,521
1993,11,e) 4,675,706,8479,8653,21,2.8,97,13,1653,72,1581,0.8,19.1,2001,779,1222,9,23.1,-348,-4,38.2,0,79,79,723
1993,11,f) 5,626,661,11553,11659,18,2.6,89,12.7,1152,82,1070,0.7,9.9,1363,705,658,6,11.7,-211,-1.8,19.8,0,53,53,378
1993,11,g) 6 to 10,2809,2960,35630,36201,91,3,261,8.6,5003,758,4245,2.1,13.8,6144,1672,4472,4.6,17,-1141,-3.2,27.6,0,168,168,902
1993,11,h) 11 to 15,1919,2114,34337,35353,50,2.3,177,8.1,3975,406,3569,1.1,11.2,6006,2028,3978,5.7,17,-2031,-5.8,22.4,0,93,94,828
1993,11,i) 16 to 20,463,654,35855,36301,26,3.9,52,7.8,1873,605,1268,1.7,5.2,2765,299,2466,0.8,7.6,-892,-2.4,10.4,0,19,21,97
1993,11,l) Left Censored,4699,6922,253281,242342,318,4.5,682,9.6,51040,5609,45431,2.3,21.1,29163,9796,19367,4,12,21877,9.1,24,0,170,171,1627
1993,12,a) 0,37748,37875,209533,105474,37577,198.4,0,0,208118,208118,0,197.3,197.3,0,0,0,0,0,208118,197.3,0,0,,,
1993,12,b) 1,27384,27919,199127,198717,85,0.3,8409,26,62647,4998,57649,2.5,31.5,61827,39759,22068,20,31.1,820,0.4,62.2,0,7053,7053,34142
1993,12,c) 2,22132,22755,164174,171199,801,3.2,4784,19.3,38468,4377,34091,2.6,22.5,52517,28436,24081,16.6,30.7,-14049,-8.2,45,0,3976,3984,23121
1993,12,d) 3,19981,20458,168765,169863,841,3.8,3611,16.5,42354,4866,37488,2.9,24.9,44550,19491,25059,11.5,26.2,-2196,-1.3,49.8,0,3045,3049,16885
1993,12,e) 4,16954,17700,147968,150997,709,3.8,2778,14.8,29301,4879,24422,3.2,19.4,35358,16606,18752,11,23.4,-6057,-4,38.8,0,2294,2298,13505
1993,12,f) 5,15266,16322,152926,153860,669,3.9,2329,13.6,33007,4316,28691,2.8,21.5,34874,17947,16927,11.7,22.7,-1867,-1.2,43,0,1786,1815,14908
1993,12,g) 6 to 10,54903,59813,677769,685608,2226,3.6,6594,10.6,115527,19285,96242,2.8,16.9,131206,47144,84062,6.9,19.1,-15679,-2.2,33.8,0,4931,4968,33530
1993,12,h) 11 to 15,32649,37332,457927,461142,1241,3.2,3299,8.6,67212,10341,56871,2.2,14.6,73641,26382,47259,5.7,16,-6429,-1.4,29.2,0,2255,2283,15196
1993,12,i) 16 to 20,5769,9115,143991,145796,363,3.9,742,8,22167,4209,17958,2.9,15.2,25777,9754,16023,6.7,17.7,-3610,-2.5,30.4,0,322,383,3169
1993,12,l) Left Censored,39495,83184,2410812,2403703,4093,4.8,7480,8.8,340435,104166,236269,4.3,14.2,326217,107780,218437,4.5,13.6,14218,0.6,27.2,0,2139,2295,20766
1993,13,a) 0,14164,14204,83282,41827,14106,198.6,0,0,82911,82911,0,198.2,198.2,0,0,0,0,0,82911,198.2,0,0,,,
1993,13,b) 1,10352,10573,87881,89819,90,0.7,2952,24.3,29539,4752,24787,5.3,32.9,33414,14585,18829,16.2,37.2,-3875,-4.3,65.8,0,2480,2480,13162
1993,13,c) 2,8462,8718,72175,75722,327,3.5,1598,17,15324,1982,13342,2.6,20.2,22418,10757,11661,14.2,29.6,-7094,-9.4,40.4,0,1323,1323,8446
1993,13,d) 3,7358,7547,65537,66853,295,3.7,1181,14.7,13400,1315,12085,2,20,16031,7796,8235,11.7,24,-2631,-4,40,0,967,969,6447
1993,13,e) 4,6685,7022,64118,63865,284,3.9,985,13.4,14097,2339,11758,3.7,22.1,13590,6632,6958,10.4,21.3,507,0.8,42.6,0,800,800,5024
1993,13,f) 5,5723,6115,59825,61447,227,3.5,805,12.6,10651,1160,9491,1.9,17.3,13895,6786,7109,11,22.6,-3244,-5.3,34.6,0,630,634,5466
1993,13,g) 6 to 10,23655,25669,305298,305880,921,3.5,2585,9.8,47074,9696,37378,3.2,15.4,48238,19111,29127,6.2,15.8,-1164,-0.4,30.8,0,1815,1827,12468
1993,13,h) 11 to 15,14105,16536,227686,225620,536,3.2,1207,7.1,36052,6657,29395,3,16,31920,9432,22488,4.2,14.1,4132,1.9,28.2,0,788,799,6027
1993,13,i) 16 to 20,2988,4243,72501,71540,179,4.2,279,6.5,11193,2975,8218,4.2,15.6,9271,2219,7052,3.1,13,1922,2.6,26,0,113,113,487
1993,13,l) Left Censored,23657,47001,1541385,1538548,2297,4.8,3690,7.7,190152,49337,140815,3.2,12.4,184479,57510,126969,3.7,12,5673,0.4,24,0,1046,1065,8734
1993,15,a) 0,1996,2021,11745,5911,2006,198.5,0,0,11668,11668,0,197.4,197.4,0,0,0,0,0,11668,197.4,0,0,,,
1993,15,b) 1,1508,1571,13742,13740,10,0.5,478,26.1,3586,249,3337,1.8,26.1,3581,2057,1524,15,26.1,5,0,52.2,0,393,393,1686
1993,15,c) 2,1493,1539,15321,15622,57,3.4,327,19.5,2922,787,2135,5,18.7,3523,1474,2049,9.4,22.6,-601,-3.9,37.4,0,266,266,1156
1993,15,d) 3,1311,1396,12515,13374,45,3,265,17.5,2356,244,2112,1.8,17.6,4074,1676,2398,12.5,30.5,-1718,-12.9,35.2,0,211,212,1282
1993,15,e) 4,1123,1191,13071,13743,34,2.7,162,12.8,2498,196,2302,1.4,18.2,3841,1398,2443,10.2,27.9,-1343,-9.7,36.4,0,137,137,1260
1993,15,f) 5,1108,1244,12944,13826,44,3.4,173,13.2,2245,419,1826,3,16.2,4009,793,3216,5.7,29,-1764,-12.8,32.4,0,126,128,609
1993,15,g) 6 to 10,4073,4564,53735,55456,163,3.5,405,8.6,5830,967,4863,1.7,10.5,9271,2393,6878,4.3,16.7,-3441,-6.2,21,0,308,308,1859
1993,15,h) 11 to 15,3214,3802,45408,47587,110,2.8,314,8,4400,497,3903,1,9.2,8758,1702,7056,3.6,18.4,-4358,-9.2,18.4,0,171,172,781
1993,15,i) 16 to 20,601,1011,17832,18142,32,3.1,74,7.2,1867,216,1651,1.2,10.3,2487,619,1868,3.4,13.7,-620,-3.4,20.6,0,23,23,103
1993,15,l) Left Censored,5046,8739,234943,241299,334,3.8,611,6.9,21702,6208,15494,2.6,9,34413,9982,24431,4.1,14.3,-12711,-5.3,18,0,205,209,1546
1993,16,a) 0,2629,2636,12443,6256,2604,197.6,0,0,12374,12374,0,197.8,197.8,0,0,0,0,0,12374,197.8,0,0,,,
1993,16,b) 1,1962,1987,12142,12040,9,0.4,519,22.8,3593,189,3404,1.6,29.8,3389,1908,1481,15.8,28.1,204,1.7,56.2,0,367,367,1411
1993,16,c) 2,1500,1525,10242,10665,58,3.5,310,18.7,2446,497,1949,4.7,22.9,3291,1791,1500,16.8,30.9,-845,-8,45.8,0,238,238,1329
1993,16,d) 3,1511,1545,11010,11085,73,4.5,213,13.1,2481,498,1983,4.5,22.4,2630,1238,1392,11.2,23.7,-149,-1.3,44.8,0,148,148,871
1993,16,e) 4,1129,1179,9291,9656,54,4.4,149,12.2,1897,263,1634,2.7,19.6,2627,1129,1498,11.7,27.2,-730,-7.6,39.2,0,112,112,777
1993,16,f) 5,1016,1043,11713,11482,32,3,97,9,2547,340,2207,3,22.2,2085,631,1454,5.5,18.2,462,4,36.4,0,75,75,516
1993,16,g) 6 to 10,4138,4467,45078,45254,145,3.1,400,8.7,6967,858,6109,1.9,15.4,7319,2816,4503,6.2,16.2,-352,-0.8,30.8,0,280,280,1646
1993,16,h) 11 to 15,2934,3208,38373,40372,116,3.5,257,7.8,5788,1131,4657,2.8,14.3,9785,2039,7746,5.1,24.2,-3997,-9.9,28.6,0,174,174,1493
1993,16,i) 16 to 20,583,789,13725,13164,33,4.1,72,8.9,2547,288,2259,2.2,19.3,1425,477,948,3.6,10.8,1122,8.5,21.6,0,38,40,187
1993,16,l) Left Censored,4516,7458,170713,169766,325,4.3,521,6.9,18703,4620,14083,2.7,11,16809,4370,12439,2.6,9.9,1894,1.1,19.8,0,214,214,1143
1993,17,a) 0,19370,19433,108920,54698,19293,198.6,0,0,108444,108444,0,198.3,198.3,0,0,0,0,0,108444,198.3,0,0,,,
1993,17,b) 1,14932,15315,126049,131483,82,0.5,3622,21,42254,6513,35741,5,32.1,53122,15534,37588,11.8,40.4,-10868,-8.3,64.2,0,2824,2824,12397
1993,17,c) 2,13141,13625,109122,112413,483,3.3,2185,15,25284,4112,21172,3.7,22.5,31866,17812,14054,15.8,28.3,-6582,-5.8,45,0,1747,1747,11838
1993,17,d) 3,12353,12717,120831,119458,419,3.1,1781,13.3,26715,2498,24217,2.1,22.4,23968,9884,14084,8.3,20.1,2747,2.3,40.2,0,1396,1396,7757
1993,17,e) 4,10831,11240,97129,97496,372,3.2,1413,12,17000,2475,14525,2.5,17.4,17733,7216,10517,7.4,18.2,-733,-0.8,34.8,0,1075,1076,5487
1993,17,f) 5,9725,10122,112637,111612,309,2.9,1160,11,22625,9708,12917,8.7,20.3,20574,7164,13410,6.4,18.4,2051,1.9,36.8,0,882,884,5611
1993,17,g) 6 to 10,40277,43631,561513,565099,1208,2.7,3847,8.6,71910,10296,61614,1.8,12.7,79081,25037,54044,4.4,14,-7171,-1.3,25.4,0,2787,2797,17327
1993,17,h) 11 to 15,26873,29959,406424,409455,869,2.8,2201,7.2,51572,7976,43596,1.9,12.6,57633,17315,40318,4.2,14.1,-6061,-1.5,25.2,0,1435,1443,9467
1993,17,i) 16 to 20,5763,8287,147632,146911,271,3.2,541,6.4,19936,2765,17171,1.9,13.6,18494,4684,13810,3.2,12.6,1442,1,25.2,0,257,263,1635
1993,17,l) Left Censored,53294,86884,2833117,2862384,3206,3.6,6235,7.1,311059,79495,231564,2.8,10.9,369595,100687,268908,3.5,12.9,-58536,-2,21.8,0,2389,2470,18361
1993,18,a) 0,9336,9356,47603,23992,9265,198.1,0,0,47223,47223,0,196.8,196.8,0,0,0,0,0,47223,196.8,0,0,,,
1993,18,b) 1,7171,7371,55532,53906,42,0.5,1693,20.5,15975,1042,14933,1.9,29.6,12723,7192,5531,13.3,23.6,3252,6,47.2,0,1392,1393,6202
1993,18,c) 2,6327,6611,52757,53056,228,3.2,1064,15.1,12008,2369,9639,4.5,22.6,12605,6670,5935,12.6,23.8,-597,-1.2,45.2,0,856,857,5632
1993,18,d) 3,5762,5979,49890,50512,217,3.5,835,13.3,9618,1075,8543,2.1,19,10861,5783,5078,11.4,21.5,-1243,-2.5,38,0,656,668,4354
1993,18,e) 4,5060,5401,55611,56086,187,3.3,677,12,10239,1653,8586,2.9,18.3,11189,4013,7176,7.2,19.9,-950,-1.6,36.6,0,540,540,3247
1993,18,f) 5,4312,4542,52684,53456,149,3.2,501,10.6,6943,1085,5858,2,13,8486,3455,5031,6.5,15.9,-1543,-2.9,26,0,416,416,2792
1993,18,g) 6 to 10,19115,20809,239192,240451,583,2.7,1801,8.4,33182,4620,28562,1.9,13.8,35699,12089,23610,5,14.8,-2517,-1,27.6,0,1380,1384,8330
1993,18,h) 11 to 15,12032,13581,172677,172103,343,2.5,953,6.9,23611,2673,20938,1.6,13.7,22463,6208,16255,3.6,13.1,1148,0.6,26.2,0,672,680,3778
1993,18,i) 16 to 20,2639,4073,78882,78076,130,3.1,276,6.7,10119,1538,8581,2,13,8506,2759,5747,3.5,10.9,1613,2.1,21.8,0,125,136,888
1993,18,l) Left Censored,25164,43795,1402072,1398940,1465,3.3,2706,6.1,155199,30922,124277,2.2,11.1,148935,38819,110116,2.8,10.6,6264,0.5,21.2,0,1058,1080,8390
1993,19,a) 0,4597,4603,23032,11548,4574,198.7,0,0,22968,22968,0,198.9,198.9,0,0,0,0,0,22968,198.9,0,0,,,
1993,19,b) 1,3738,3819,29747,29747,24,0.6,938,21.7,7097,389,6708,1.3,23.9,7097,3485,3612,11.7,23.9,0,0,47.8,0,745,745,2971
1993,19,c) 2,3242,3336,24197,25530,108,3,507,14.3,4730,537,4193,2.1,18.5,7396,3322,4074,13,29,-2666,-10.5,37,0,402,402,2958
1993,19,d) 3,3001,3081,21991,22073,108,3.3,406,12.5,4290,572,3718,2.6,19.4,4453,1961,2492,8.9,20.2,-163,-0.8,38.8,0,326,326,1548
1993,19,e) 4,2619,2761,22416,22637,64,2.2,309,10.7,3853,564,3289,2.5,17,4294,1847,2447,8.2,19,-441,-2,34,0,230,230,1525
1993,19,f) 5,2253,2318,22342,22222,63,2.6,271,11.2,3297,512,2785,2.3,14.8,3056,1280,1776,5.8,13.8,241,1,27.6,0,218,218,980
1993,19,g) 6 to 10,10194,11225,129724,129840,295,2.6,900,7.8,16367,2052,14315,1.6,12.6,16598,4830,11768,3.7,12.8,-231,-0.2,25.2,0,651,657,3495
1993,19,h) 11 to 15,7812,8998,91152,92052,247,2.7,619,6.7,9747,1397,8350,1.5,10.6,11546,2569,8977,2.8,12.5,-1799,-1.9,21.2,0,442,443,1777
1993,19,i) 16 to 20,1795,2660,33945,33520,88,3.3,150,5.6,4216,1001,3215,3,12.6,3366,667,2699,2,10,850,2.6,20,0,84,85,328
1993,19,l) Left Censored,16722,26029,647319,646960,725,2.7,1543,5.8,61722,11458,50264,1.8,9.5,61005,15850,45155,2.4,9.4,717,0.1,18.8,0,671,682,3720
1993,20,a) 0,4811,4825,25761,12934,4785,198.3,0,0,25655,25655,0,198.4,198.4,0,0,0,0,0,25655,198.4,0,0,,,
1993,20,b) 1,3676,3764,24819,25362,21,0.5,968,22.6,6565,751,5814,3,25.9,7650,4430,3220,17.5,30.2,-1085,-4.3,51.8,0,758,758,3786
1993,20,c) 2,3002,3107,20594,21792,122,3.6,649,19.2,4500,619,3881,2.8,20.6,6895,3873,3022,17.8,31.6,-2395,-11,41.2,0,521,521,3366
1993,20,d) 3,2706,2803,21544,22062,84,2.8,450,15,4030,421,3609,1.9,18.3,5065,2782,2283,12.6,23,-1035,-4.7,36.6,0,355,356,2413
1993,20,e) 4,2497,2599,22226,22392,66,2.4,322,11.8,3927,395,3532,1.8,17.5,4259,1788,2471,8,19,-332,-1.5,35,0,249,249,1472
1993,20,f) 5,2159,2286,19571,20766,82,3.4,277,11.6,2567,368,2199,1.8,12.4,4957,1624,3333,7.8,23.9,-2390,-11.5,24.8,0,212,213,1197
1993,20,g) 6 to 10,9685,10364,105034,106028,319,3,917,8.6,13321,2268,11053,2.1,12.6,15309,5672,9637,5.3,14.4,-1988,-1.8,25.2,0,668,675,3843
1993,20,h) 11 to 15,6786,7595,81696,82176,221,2.8,530,6.8,10903,1174,9729,1.4,13.3,11863,3749,8114,4.6,14.4,-960,-1.1,26.6,0,354,358,2212
1993,20,i) 16 to 20,1494,2292,38783,38202,75,3.2,132,5.7,5604,1003,4601,2.6,14.7,4442,1231,3211,3.2,11.6,1162,3.1,23.2,0,65,65,316
1993,20,l) Left Censored,13538,21475,538637,541395,712,3.3,1390,6.4,52765,9406,43359,1.7,9.7,58280,14380,43900,2.7,10.8,-5515,-1.1,19.4,0,543,562,3393
1993,21,a) 0,6111,6132,35010,17577,6090,198.6,0,0,34867,34867,0,198.4,198.4,0,0,0,0,0,34867,198.4,0,0,,,
1993,21,b) 1,4625,4741,33457,33280,23,0.4,1298,23.9,9666,1145,8521,3.4,29,9312,5503,3809,16.5,28,354,1,56,0,1123,1124,4951
1993,21,c) 2,3829,3931,31676,32739,115,2.7,686,16.2,6523,527,5996,1.6,19.9,8648,4163,4485,12.7,26.4,-2125,-6.5,39.8,0,574,574,3573
1993,21,d) 3,3668,3795,31370,32722,123,3,588,14.6,5643,878,4765,2.7,17.2,8347,4276,4071,13.1,25.5,-2704,-8.3,34.4,0,488,489,3549
1993,21,e) 4,3281,3445,30801,31092,101,2.8,449,12.4,5737,802,4935,2.6,18.5,6319,2665,3654,8.6,20.3,-582,-1.8,37,0,358,358,2194
1993,21,f) 5,2853,3018,29310,29645,92,2.9,349,11.1,4477,566,3911,1.9,15.1,5146,2071,3075,7,17.4,-669,-2.3,30.2,0,287,287,1775
1993,21,g) 6 to 10,11919,12846,154737,155201,353,2.7,1224,9.2,21070,2755,18315,1.8,13.6,21998,7746,14252,5,14.2,-928,-0.6,27.2,0,909,914,4967
1993,21,h) 11 to 15,7312,8170,126327,124534,225,2.7,580,6.9,17005,3402,13603,2.7,13.7,13419,4214,9205,3.4,10.8,3586,2.9,21.6,0,398,404,2674
1993,21,i) 16 to 20,1622,2357,36664,36645,95,4,160,6.7,4450,854,3596,2.3,12.1,4411,1122,3289,3.1,12,39,0.1,24,0,73,73,287
1993,21,l) Left Censored,14989,25599,729695,725490,1139,4.4,1867,7.2,86082,20333,65749,2.8,11.9,77671,24426,53245,3.4,10.7,8411,1.2,21.4,0,658,669,4107
1993,22,a) 0,6797,6828,46366,23270,6776,198.5,0,0,46192,46192,0,198.5,198.5,0,0,0,0,0,46192,198.5,0,0,,,
1993,22,b) 1,5080,5203,40686,40031,35,0.6,1301,22.1,13012,1308,11704,3.3,32.5,11701,6255,5446,15.6,29.2,1311,3.3,58.4,0,1091,1091,5596
1993,22,c) 2,4341,4499,40387,42346,142,2.9,770,16,8353,871,7482,2.1,19.7,12271,4333,7938,10.2,29,-3918,-9.3,39.4,0,616,616,3771
1993,22,d) 3,3733,3837,33212,34458,119,2.9,579,14.2,6483,447,6036,1.3,18.8,8975,4567,4408,13.3,26,-2492,-7.2,37.6,0,469,469,3929
1993,22,e) 4,3095,3195,28372,29547,100,3,401,12,5033,431,4602,1.5,17,7382,2902,4480,9.8,25,-2349,-8,34,0,344,347,2451
1993,22,f) 5,2822,3051,34625,34437,100,3.2,361,11.4,6244,774,5470,2.2,18.1,5867,2354,3513,6.8,17,377,1.1,34,0,262,262,1809
1993,22,g) 6 to 10,13268,14385,164402,169310,415,2.8,1345,9.1,24441,4293,20148,2.5,14.4,34257,13396,20861,7.9,20.2,-9816,-5.8,28.8,0,1016,1020,10010
1993,22,h) 11 to 15,10143,11488,150983,152295,316,2.7,817,7,21788,2913,18875,1.9,14.3,24412,6338,18074,4.2,16,-2624,-1.7,28.6,0,553,554,4053
1993,22,i) 16 to 20,1853,2626,42268,42174,97,3.6,189,7.1,6318,757,5561,1.8,15,6130,2240,3890,5.3,14.5,188,0.5,29,0,100,112,1164
1993,22,l) Left Censored,16236,28353,727167,733943,983,3.4,1981,6.9,83111,15599,67512,2.1,11.3,96665,25097,71568,3.4,13.2,-13554,-1.9,22.6,0,791,795,5276
1993,23,a) 0,2400,2411,11570,5822,2391,198.3,0,0,11496,11496,0,197.5,197.5,0,0,0,0,0,11496,197.5,0,0,,,
1993,23,b) 1,1756,1816,12285,11562,18,0.9,470,22.7,4314,153,4161,1.3,37.3,2867,1858,1009,16.1,24.8,1447,12.5,49.6,0,371,371,1492
1993,23,c) 2,1537,1591,13310,13585,44,2.6,287,16.7,2260,234,2026,1.7,16.6,2809,1553,1256,11.4,20.7,-549,-4.1,33.2,0,220,220,1317
1993,23,d) 3,1539,1566,10695,10865,63,3.8,245,14.7,2156,190,1966,1.7,19.8,2496,1056,1440,9.7,23,-340,-3.2,39.6,0,204,204,836
1993,23,e) 4,1593,1629,10754,10869,68,4,234,13.6,1838,206,1632,1.9,16.9,2067,1069,998,9.8,19,-229,-2.1,33.8,0,177,177,946
1993,23,f) 5,1461,1495,11025,10941,67,4.3,183,11.7,1872,210,1662,1.9,17.1,1704,715,989,6.5,15.6,168,1.5,31.2,0,143,143,629
1993,23,g) 6 to 10,5448,5781,53329,53193,177,3,562,9.4,7833,840,6993,1.6,14.7,7561,2870,4691,5.4,14.2,272,0.5,28.4,0,400,400,1977
1993,23,h) 11 to 15,3145,3512,41894,41761,96,2.7,263,7.3,5615,786,4829,1.9,13.4,5348,1617,3731,3.9,12.8,267,0.6,25.6,0,169,169,899
1993,23,i) 16 to 20,667,1033,13378,13204,41,3.9,58,5.6,1777,265,1512,2,13.5,1428,446,982,3.4,10.8,349,2.7,21.6,0,24,28,165
1993,23,l) Left Censored,5727,8869,225143,223462,293,3.2,604,6.7,26467,8738,17729,3.9,11.8,23104,6752,16352,3,10.3,3363,1.5,20.6,0,219,238,1293
1993,24,a) 0,8650,8709,47872,24057,8640,198.4,0,0,47630,47630,0,198,198,0,0,0,0,0,47630,198,0,0,,,
1993,24,b) 1,6411,6577,48595,48082,34,0.5,1684,22.5,13391,1021,12370,2.1,27.9,12365,6715,5650,14,25.7,1026,2.2,51.4,0,1314,1314,5643
1993,24,c) 2,5670,5811,43805,45796,233,3.7,1037,16.6,9405,1219,8186,2.7,20.5,13387,7109,6278,15.5,29.2,-3982,-8.7,41,0,820,826,5056
1993,24,d) 3,5377,5509,43580,44922,201,3.4,906,15.4,8401,1024,7377,2.3,18.7,11084,5240,5844,11.7,24.7,-2683,-6,37.4,0,704,704,4386
1993,24,e) 4,5044,5208,44068,44068,199,3.7,657,12.1,9054,1408,7646,3.2,20.5,9053,3369,5684,7.6,20.5,1,0,41,0,501,501,2658
1993,24,f) 5,4482,4658,44231,44936,151,3.1,598,12.3,7158,863,6295,1.9,15.9,8568,3423,5145,7.6,19.1,-1410,-3.2,31.8,0,447,447,2415
1993,24,g) 6 to 10,17351,18829,219150,220407,618,3.2,1878,9.6,34819,7979,26840,3.6,15.8,37333,14220,23113,6.5,16.9,-2514,-1.1,31.6,0,1295,1297,10645
1993,24,h) 11 to 15,10002,11399,149265,152590,343,2.9,883,7.6,18620,2681,15939,1.8,12.2,25269,8818,16451,5.8,16.6,-6649,-4.4,24.4,0,544,566,6151
1993,24,i) 16 to 20,2173,3387,57004,55240,131,3.8,214,6.2,10414,3452,6962,6.2,18.9,6885,1548,5337,2.8,12.5,3529,6.4,25,0,99,101,777
1993,24,l) Left Censored,19180,33810,1010833,1028790,1393,4,3087,8.9,112588,29844,82744,2.9,10.9,148501,40773,107728,4,14.4,-35913,-3.5,21.8,0,801,830,8049
1993,25,a) 0,9472,9494,52302,26244,9424,198.5,0,0,52116,52116,0,198.6,198.6,0,0,0,0,0,52116,198.6,0,0,,,
1993,25,b) 1,7271,7545,63636,59127,62,0.7,1609,19.2,20761,2583,18178,4.4,35.1,11743,5994,5749,10.1,19.9,9018,15.2,39.8,0,1265,1265,5057
1993,25,c) 2,6149,6352,51634,52205,226,3.3,1078,15.9,12902,2016,10886,3.9,24.7,14043,7081,6962,13.6,26.9,-1141,-2.2,49.4,0,829,850,5920
1993,25,d) 3,6014,6225,51908,53345,230,3.5,924,14,10153,967,9186,1.8,19,13027,5474,7553,10.3,24.4,-2874,-5.4,38,0,737,745,4465
1993,25,e) 4,6186,6462,54446,55471,224,3.3,854,12.6,9755,1070,8685,1.9,17.6,11804,5566,6238,10,21.3,-2049,-3.7,35.2,0,679,680,4543
1993,25,f) 5,5826,6124,73055,72439,210,3.3,746,11.7,11402,2076,9326,2.9,15.7,10170,3356,6814,4.6,14,1232,1.7,28,0,587,588,2712
1993,25,g) 6 to 10,23260,24835,292866,292190,888,3.5,2482,9.7,43682,5226,38456,1.8,14.9,42330,15558,26772,5.3,14.5,1352,0.4,29,0,1797,1807,10441
1993,25,h) 11 to 15,14328,16421,241393,240141,516,3.1,1359,8.1,36113,6462,29651,2.7,15,33609,10488,23121,4.4,14,2504,1,28,0,883,902,5417
1993,25,i) 16 to 20,2955,4403,112979,111763,160,3.6,288,6.5,16927,5421,11506,4.9,15.1,14496,5457,9039,4.9,13,2431,2.1,26,0,113,120,525
1993,25,l) Left Censored,31886,49177,1595543,1603572,1793,3.6,3718,7.4,189036,48484,140552,3,11.8,205094,57539,147555,3.6,12.8,-16058,-1,23.6,0,1529,1576,12293
1993,26,a) 0,14298,14363,82219,41222,14253,198.5,0,0,81995,81995,0,198.9,198.9,0,0,0,0,0,81995,198.9,0,0,,,
1993,26,b) 1,11348,11578,85620,82606,58,0.4,2696,20.7,26837,4121,22716,5,32.5,20808,10821,9987,13.1,25.2,6029,7.3,50.4,0,2094,2094,8692
1993,26,c) 2,10194,10502,80908,82395,332,3,1678,15,18577,2515,16062,3.1,22.5,21550,10985,10565,13.3,26.2,-2973,-3.7,45,0,1352,1353,9389
1993,26,d) 3,9705,9981,85703,84823,336,3.2,1450,13.7,19827,1639,18188,1.9,23.4,18066,7848,10218,9.3,21.3,1761,2.1,42.6,0,1101,1101,6086
1993,26,e) 4,8451,8778,75440,76149,268,2.9,1143,12.4,14048,1524,12524,2,18.4,15466,6367,9099,8.4,20.3,-1418,-1.9,36.8,0,898,898,4691
1993,26,f) 5,7555,7937,77490,78141,234,2.8,914,11,11857,1516,10341,1.9,15.2,13159,5095,8064,6.5,16.8,-1302,-1.6,30.4,0,710,712,3898
1993,26,g) 6 to 10,31247,34009,385742,390694,1020,2.9,3113,8.9,53845,8999,44846,2.3,13.8,63749,21691,42058,5.6,16.3,-9904,-2.5,27.6,0,2224,2245,13917
1993,26,h) 11 to 15,19755,22605,282683,284616,618,2.7,1613,7,37984,6860,31124,2.4,13.3,41850,11525,30325,4,14.7,-3866,-1.4,26.6,0,1080,1085,6642
1993,26,i) 16 to 20,4139,6215,108205,107476,184,2.9,401,6.4,15225,2698,12527,2.5,14.2,13767,3732,10035,3.5,12.8,1458,1.4,25.6,0,199,213,1617
1993,26,l) Left Censored,38018,65453,2136781,2135013,2246,3.4,4222,6.4,228360,43750,184610,2,10.7,224824,56981,167843,2.7,10.5,3536,0.2,21,0,1629,1670,12812
1993,27,a) 0,8367,8413,48890,24514,8364,198.8,0,0,48752,48752,0,198.9,198.9,0,0,0,0,0,48752,198.9,0,0,,,
1993,27,b) 1,6511,6667,48046,45809,48,0.6,1418,19.1,15247,3110,12137,6.8,33.3,10773,5908,4865,12.9,23.5,4474,9.8,47,0,1098,1098,4902
1993,27,c) 2,5732,5951,47423,46843,196,3.1,868,13.7,10712,978,9734,2.1,22.9,9552,4060,5492,8.7,20.4,1160,2.5,40.8,0,691,692,3441
1993,27,d) 3,5130,5318,43634,43642,157,2.8,718,12.8,8525,962,7563,2.2,19.5,8541,3739,4802,8.6,19.6,-16,-0.1,39,0,549,549,3047
1993,27,e) 4,4576,4743,40472,40505,164,3.3,522,10.6,7175,998,6177,2.5,17.7,7241,3341,3900,8.2,17.9,-66,-0.2,35.4,0,414,414,2697
1993,27,f) 5,4046,4232,38236,38246,130,3,416,9.5,7121,622,6499,1.6,18.6,7141,2963,4178,7.7,18.7,-20,-0.1,37.2,0,320,320,2385
1993,27,g) 6 to 10,16654,18316,241005,242753,521,2.8,1491,7.9,31502,4370,27132,1.8,13,34998,12848,22150,5.3,14.4,-3496,-1.4,26,0,1053,1063,8524
1993,27,h) 11 to 15,11048,12688,169782,169741,390,3,813,6.3,24162,5468,18694,3.2,14.2,24080,7162,16918,4.2,14.2,82,0,28.4,0,540,548,3822
1993,27,i) 16 to 20,2511,3638,64153,63221,129,3.5,219,6,8165,1903,6262,3,12.9,6301,1987,4314,3.1,10,1864,2.9,20,0,102,106,968
1993,27,l) Left Censored,21828,35087,1164507,1160100,1297,3.6,2283,6.4,130574,31726,98848,2.7,11.3,121760,33771,87989,2.9,10.5,8814,0.8,21,0,868,913,6614
1993,28,a) 0,4355,4379,27700,13912,4327,197.6,0,0,27577,27577,0,198.2,198.2,0,0,0,0,0,27577,198.2,0,0,,,
1993,28,b) 1,2967,3047,21354,20658,16,0.5,905,25.7,7049,2224,4825,10.8,34.1,5657,3467,2190,16.8,27.4,1392,6.7,54.8,0,771,771,2971
1993,28,c) 2,2566,2658,20371,21057,89,3.1,484,16.9,4386,401,3985,1.9,20.8,5758,3332,2426,15.8,27.3,-1372,-6.5,41.6,0,406,406,3033
1993,28,d) 3,2392,2444,18931,19487,95,3.7,395,15.2,3523,347,3176,1.8,18.1,4634,2080,2554,10.7,23.8,-1111,-5.7,36.2,0,320,320,1483
1993,28,e) 4,1903,1953,17823,17488,80,3.9,285,13.8,4760,558,4202,3.2,27.2,4089,2175,1914,12.4,23.4,671,3.8,46.8,0,246,246,1610
1993,28,f) 5,1723,1861,18752,19584,67,3.4,243,12.5,3292,213,3079,1.1,16.8,4956,2704,2252,13.8,25.3,-1664,-8.5,33.6,0,189,189,1364
1993,28,g) 6 to 10,7893,8373,88409,88115,281,3.3,775,9,12563,1530,11033,1.7,14.3,11974,4217,7757,4.8,13.6,589,0.7,27.2,0,613,614,2890
1993,28,h) 11 to 15,5396,6092,73944,73207,228,3.7,438,7.1,10446,2009,8437,2.7,14.3,8971,2521,6450,3.4,12.3,1475,2,24.6,0,313,314,1413
1993,28,i) 16 to 20,1188,1624,20180,19800,62,3.8,118,7.2,2666,559,2107,2.8,13.5,1905,632,1273,3.2,9.6,761,3.9,19.2,0,63,64,252
1993,28,l) Left Censored,10079,17070,461147,460924,628,3.6,1119,6.5,50762,10395,40367,2.3,11,50315,16923,33392,3.7,10.9,447,0.1,21.8,0,490,495,5631
1993,29,a) 0,10222,10300,54452,27543,10221,198.5,0,0,53819,53819,0,195.4,195.4,0,0,0,0,0,53819,195.4,0,0,,,
1993,29,b) 1,7482,7646,54813,54696,43,0.5,2117,24.2,17291,1937,15354,3.5,31.6,17057,10280,6777,18.8,31.2,234,0.4,62.4,0,1741,1741,9211
1993,29,c) 2,6315,6571,47421,49150,217,3.1,1181,16.7,10234,1439,8795,2.9,20.8,13691,6732,6959,13.7,27.9,-3457,-7.1,41.6,0,979,981,5951
1993,29,d) 3,5714,5874,50843,51569,225,3.6,965,15.4,9837,1384,8453,2.7,19.1,11289,5312,5977,10.3,21.9,-1452,-2.8,38.2,0,802,802,4576
1993,29,e) 4,5305,5545,44687,45817,167,2.9,754,12.9,8035,747,7288,1.6,17.5,10295,4889,5406,10.7,22.5,-2260,-5,35,0,598,607,3978
1993,29,f) 5,4575,4803,45682,46471,164,3.3,596,11.9,7495,1756,5739,3.8,16.1,9072,3787,5285,8.1,19.5,-1577,-3.4,32.2,0,457,457,2447
1993,29,g) 6 to 10,19600,21161,232911,237891,582,2.7,1958,9,29954,4382,25572,1.8,12.6,39913,11973,27940,5,16.8,-9959,-4.2,25.2,0,1432,1435,8139
1993,29,h) 11 to 15,12235,13943,169689,172218,372,2.6,1048,7.3,20803,2677,18126,1.6,12.1,25860,8993,16867,5.2,15,-5057,-2.9,24.2,0,687,700,5654
1993,29,i) 16 to 20,2671,4065,68293,67302,125,3,270,6.5,9787,1317,8470,2,14.5,7805,2293,5512,3.4,11.6,1982,2.9,23.2,0,136,137,1015
1993,29,l) Left Censored,24202,40440,1237636,1246989,1414,3.4,2816,6.8,126848,26365,100483,2.1,10.2,145554,42666,102888,3.4,11.7,-18706,-1.5,20.4,0,1060,1100,8614
1993,30,a) 0,2178,2186,9076,4550,2168,198.4,0,0,9052,9052,0,198.9,198.9,0,0,0,0,0,9052,198.9,0,0,,,
1993,30,b) 1,1669,1687,9534,9512,7,0.4,428,22.3,2579,124,2455,1.3,27.1,2535,1411,1124,14.8,26.7,44,0.4,53.4,0,329,329,1124
1993,30,c) 2,1323,1345,8349,8717,48,3.3,227,15.8,1561,143,1418,1.6,17.9,2296,1101,1195,12.6,26.3,-735,-8.4,35.8,0,169,169,875
1993,30,d) 3,1167,1177,7758,7693,42,3.4,168,13.5,1553,249,1304,3.2,20.2,1422,606,816,7.9,18.5,131,1.7,37,0,137,137,531
1993,30,e) 4,987,1041,7488,7677,31,2.8,168,15.1,1180,143,1037,1.9,15.4,1558,863,695,11.2,20.3,-378,-4.9,30.8,0,139,139,757
1993,30,f) 5,927,959,7241,7399,32,3.2,121,12.1,1120,163,957,2.2,15.1,1436,493,943,6.7,19.4,-316,-4.3,30.2,0,91,91,333
1993,30,g) 6 to 10,4028,4349,38223,37878,157,3.5,424,9.4,7419,2672,4747,7.1,19.6,6729,2318,4411,6.1,17.8,690,1.8,35.6,0,301,301,1672
1993,30,h) 11 to 15,2954,3254,29739,29723,94,2.8,260,7.8,4219,371,3848,1.2,14.2,4187,1263,2924,4.2,14.1,32,0.1,28.2,0,180,182,939
1993,30,i) 16 to 20,612,792,9102,9161,23,2.9,52,6.4,1216,134,1082,1.5,13.3,1333,572,761,6.2,14.6,-117,-1.3,26.6,0,25,25,322
1993,30,l) Left Censored,4437,6716,115815,116069,216,3.2,473,6.9,13094,2826,10268,2.4,11.3,13601,3220,10381,2.8,11.7,-507,-0.4,22.6,0,218,227,1463
1993,31,a) 0,2944,2949,16295,8178,2922,198.2,0,0,16234,16234,0,198.5,198.5,0,0,0,0,0,16234,198.5,0,0,,,
1993,31,b) 1,2379,2423,16536,16385,13,0.5,558,20.5,4359,189,4170,1.2,26.6,4059,2068,1991,12.6,24.8,300,1.8,49.6,0,450,450,1801
1993,31,c) 2,2006,2073,12994,13214,62,2.8,349,15.7,2642,304,2338,2.3,20,3082,1591,1491,12,23.3,-440,-3.3,40,0,283,283,1287
1993,31,d) 3,1881,1954,15886,16173,65,3.2,263,12.8,3009,326,2683,2,18.6,3582,1431,2151,8.8,22.1,-573,-3.5,37.2,0,192,192,961
1993,31,e) 4,1663,1736,17567,17793,47,2.6,212,11.6,2435,253,2182,1.4,13.7,2886,1174,1712,6.6,16.2,-451,-2.5,27.4,0,177,177,937
1993,31,f) 5,1480,1613,14537,14593,60,3.6,174,10.4,2096,239,1857,1.6,14.4,2207,941,1266,6.4,15.1,-111,-0.7,28.8,0,138,138,674
1993,31,g) 6 to 10,6528,7100,83079,82652,194,2.7,583,8,11682,1459,10223,1.8,14.1,10828,3638,7190,4.4,13.1,854,1,26.2,0,427,430,2749
1993,31,h) 11 to 15,4715,5229,56283,56321,150,2.8,392,7.3,6672,1021,5651,1.8,11.8,6747,1902,4845,3.4,12,-75,-0.2,23.6,0,291,292,1318
1993,31,i) 16 to 20,1072,1530,18321,18043,65,4.2,120,7.7,2560,580,1980,3.2,14.2,2004,650,1354,3.6,11.1,556,3.1,22.2,0,74,75,304
1993,31,l) Left Censored,9706,14583,362182,363304,493,3.3,919,6.2,35149,5939,29210,1.6,9.7,37393,8167,29226,2.2,10.3,-2244,-0.6,19.4,0,369,375,1978
1993,32,a) 0,3242,3253,21773,10920,3234,198.8,0,0,21706,21706,0,198.8,198.8,0,0,0,0,0,21706,198.8,0,0,,,
1993,32,b) 1,2237,2279,19975,19831,12,0.4,747,27.8,6615,312,6303,1.6,33.4,6327,3343,2984,16.9,31.9,288,1.5,63.8,0,622,623,2924
1993,32,c) 2,1883,1931,18429,18465,76,3.6,463,21.7,5931,412,5519,2.2,32.1,6003,3427,2576,18.6,32.5,-72,-0.4,64.2,0,363,363,3010
1993,32,d) 3,1696,1750,18125,18407,75,4,337,17.8,3549,442,3107,2.4,19.3,4112,1975,2137,10.7,22.3,-563,-3,38.6,0,269,269,1468
1993,32,e) 4,1480,1537,17514,18554,43,2.6,261,15.8,3461,259,3202,1.4,18.7,5541,3209,2332,17.3,29.9,-2080,-11.2,37.4,0,203,203,2997
1993,32,f) 5,1215,1277,16377,16707,59,4.4,166,12.4,2642,645,1997,3.9,15.8,3301,1139,2162,6.8,19.8,-659,-4,31.6,0,130,131,871
1993,32,g) 6 to 10,4544,5089,74005,75062,210,4,517,9.9,11741,2050,9691,2.7,15.6,13855,5520,8335,7.4,18.5,-2114,-2.9,31.2,0,363,364,3875
1993,32,h) 11 to 15,3149,3636,68746,68185,129,3.5,279,7.5,7440,1084,6356,1.6,10.9,6318,1747,4571,2.6,9.3,1122,1.6,18.6,0,183,183,1129
1993,32,i) 16 to 20,581,894,21929,21286,41,4.6,53,5.9,3294,1636,1658,7.7,15.5,2007,360,1647,1.7,9.4,1287,6.1,18.8,0,26,27,177
1993,32,l) Left Censored,4165,7142,292240,289817,518,7.1,709,9.8,35587,12237,23350,4.2,12.3,30740,8897,21843,3.1,10.6,4847,1.7,21.2,0,131,160,993
1993,33,a) 0,2339,2343,11020,5542,2318,197.9,0,0,10957,10957,0,197.7,197.7,0,0,0,0,0,10957,197.7,0,0,,,
1993,33,b) 1,1728,1788,11973,11710,11,0.5,475,23.2,3560,93,3467,0.8,30.4,3033,1762,1271,15,25.9,527,4.5,51.8,0,367,367,1455
1993,33,c) 2,1517,1555,11089,10921,57,3.4,285,17,2749,258,2491,2.4,25.2,2412,1402,1010,12.8,22.1,337,3.1,44.2,0,235,237,1228
1993,33,d) 3,1445,1478,10111,10219,46,2.9,227,14.4,2068,297,1771,2.9,20.2,2283,1172,1111,11.5,22.3,-215,-2.1,40.4,0,186,186,1006
1993,33,e) 4,1480,1534,16536,16900,55,3.4,228,14.1,1809,176,1633,1,10.7,2537,820,1717,4.9,15,-728,-4.3,21.4,0,178,178,697
1993,33,f) 5,1430,1487,11779,11845,55,3.5,199,12.8,2040,180,1860,1.5,17.2,2171,961,1210,8.1,18.3,-131,-1.1,34.4,0,166,166,848
1993,33,g) 6 to 10,5479,5778,56725,57327,192,3.2,624,10.4,8952,1385,7567,2.4,15.6,10156,3815,6341,6.7,17.7,-1204,-2.1,31.2,0,427,430,1941
1993,33,h) 11 to 15,2885,3163,35326,35460,92,2.8,271,8.3,4656,630,4026,1.8,13.1,4924,1529,3395,4.3,13.9,-268,-0.8,26.2,0,175,176,830
1993,33,i) 16 to 20,633,966,15774,15737,56,5.7,79,8.1,2136,700,1436,4.4,13.6,2061,783,1278,5,13.1,75,0.5,26.2,0,38,39,126
1993,33,l) Left Censored,5472,8669,239736,240824,369,4.2,619,7,25405,6851,18554,2.8,10.5,27580,7640,19940,3.2,11.5,-2175,-1,21,0,206,207,1224
1993,34,a) 0,15041,15059,74911,37776,14935,198.4,0,0,74271,74271,0,196.6,196.6,0,0,0,0,0,74271,196.6,0,0,,,
1993,34,b) 1,11105,11274,79106,76600,43,0.3,2802,21.9,25430,3632,21798,4.7,33.2,20418,10463,9955,13.7,26.7,5012,6.5,53.4,0,2133,2135,8430
1993,34,c) 2,9854,10045,66986,73381,326,3,1755,16.3,14970,1453,13517,2,20.4,27759,9104,18655,12.4,37.8,-12789,-17.4,40.8,0,1417,1417,7468
1993,34,d) 3,9240,9423,68417,70180,374,3.8,1412,14.2,14523,1407,13116,2,20.7,18048,6543,11505,9.3,25.7,-3525,-5,41.4,0,1087,1087,4907
1993,34,e) 4,8838,9057,76860,78363,338,3.6,1225,12.9,14036,1212,12824,1.5,17.9,17041,6937,10104,8.9,21.7,-3005,-3.8,35.8,0,954,954,5440
1993,34,f) 5,8504,8752,83344,83929,353,3.9,1029,11.3,13752,1803,11949,2.1,16.4,14921,5034,9887,6,17.8,-1169,-1.4,32.8,0,785,787,3799
1993,34,g) 6 to 10,32327,34020,375128,378912,1173,3.3,3259,9.3,54492,7454,47038,2,14.4,62059,20274,41785,5.4,16.4,-7567,-2,28.8,0,2378,2381,14611
1993,34,h) 11 to 15,20454,22191,262265,267035,619,2.7,1713,7.5,36609,6167,30442,2.3,13.7,46148,13874,32274,5.2,17.3,-9539,-3.6,27.4,0,1153,1159,6424
1993,34,i) 16 to 20,4243,5353,92457,93364,170,3.1,396,7.3,13470,1640,11830,1.8,14.4,15283,3444,11839,3.7,16.4,-1813,-2,28.8,0,208,212,1002
1993,34,l) Left Censored,39955,60895,1880156,1892171,2215,3.6,4446,7.2,232245,55513,176732,2.9,12.3,256275,73803,182472,3.9,13.5,-24030,-1.2,24.6,0,1883,1912,12449
1993,35,a) 0,3105,3109,16985,8538,3079,198.1,0,0,16894,16894,0,197.9,197.9,0,0,0,0,0,16894,197.9,0,0,,,
1993,35,b) 1,2307,2371,17033,16722,18,0.7,626,23.1,5087,821,4266,4.9,30.4,4465,2376,2089,14.2,26.7,622,3.7,53.4,0,507,507,1904
1993,35,c) 2,2078,2190,15912,16516,84,3.6,363,15.6,3392,500,2892,3,20.5,4600,2014,2586,12.2,27.9,-1208,-7.4,41,0,289,289,1636
1993,35,d) 3,1776,1802,13772,14400,69,3.6,292,15.3,2927,378,2549,2.6,20.3,4183,1655,2528,11.5,29,-1256,-8.7,40.6,0,227,227,1237
1993,35,e) 4,1577,1641,12545,12471,68,4,224,13,2612,437,2175,3.5,20.9,2463,1167,1296,9.4,19.7,149,1.2,39.4,0,172,172,847
1993,35,f) 5,1292,1382,13111,13498,59,4.1,169,11.8,2148,405,1743,3,15.9,2922,776,2146,5.7,21.6,-774,-5.7,31.8,0,135,135,666
1993,35,g) 6 to 10,5685,6228,69223,68852,258,4,599,9.4,10551,1680,8871,2.4,15.3,9809,3394,6415,4.9,14.2,742,1.1,28.4,0,428,428,2642
1993,35,h) 11 to 15,4063,4560,47657,47701,181,3.9,350,7.5,7076,1172,5904,2.5,14.8,7164,2361,4803,4.9,15,-88,-0.2,29.6,0,240,240,1296
1993,35,i) 16 to 20,818,1193,14197,14336,49,4.1,67,5.6,1907,266,1641,1.9,13.3,2185,410,1775,2.9,15.2,-278,-1.9,26.6,0,38,38,274
1993,35,l) Left Censored,5762,9435,230325,230092,399,4.2,708,7.4,30494,6473,24021,2.8,13.3,30027,9191,20836,4,13,467,0.3,26,0,224,227,1335
1993,36,a) 0,33315,33417,170664,85727,33168,198.5,0,0,169874,169874,0,198.2,198.2,0,0,0,0,0,169874,198.2,0,0,,,
1993,36,b) 1,25072,25465,188035,186223,78,0.3,6960,23.8,67901,14356,53545,7.7,36.5,64277,27395,36882,14.7,34.5,3624,2,69,0,5570,5571,22848
1993,36,c) 2,22237,22602,158967,165876,776,3.2,4387,17.9,34628,4087,30541,2.5,20.9,48446,23378,25068,14.1,29.2,-13818,-8.3,41.8,0,3614,3615,20394
1993,36,d) 3,20449,20806,147516,151405,737,3.3,3535,15.9,29614,2851,26763,1.9,19.6,37391,17521,19870,11.6,24.7,-7777,-5.1,39.2,0,2863,2865,14512
1993,36,e) 4,19323,19787,147935,153413,635,3,3019,14.4,25480,3139,22341,2,16.6,36435,16119,20316,10.5,23.7,-10955,-7.1,33.2,0,2406,2406,13158
1993,36,f) 5,17532,18027,162337,170117,547,2.9,2457,12.9,23783,4649,19134,2.7,14,39342,16460,22882,9.7,23.1,-15559,-9.1,28,0,1972,1977,13942
1993,36,g) 6 to 10,69185,72781,782276,807183,2189,2.9,7889,10.4,98001,12661,85340,1.6,12.1,147815,42290,105525,5.2,18.3,-49814,-6.2,24.2,0,5924,5951,30752
1993,36,h) 11 to 15,42286,46620,586516,592962,1239,2.6,3874,8.1,75515,9882,65633,1.7,12.7,88407,22782,65625,3.8,14.9,-12892,-2.2,25.4,0,2826,2855,15115
1993,36,i) 16 to 20,8457,11919,236132,234653,390,3.2,883,7.3,39706,14387,25319,6.1,16.9,36748,10699,26049,4.6,15.7,2958,1.2,31.4,0,470,482,2712
1993,36,l) Left Censored,88312,132088,4009276,4072610,4776,3.5,10525,7.8,442829,103783,339046,2.5,10.9,569499,144353,425146,3.5,14,-126670,-3.1,21.8,0,4782,4900,31825
1993,37,a) 0,12234,12280,64611,32475,12168,198.2,0,0,64272,64272,0,197.9,197.9,0,0,0,0,0,64272,197.9,0,0,,,
1993,37,b) 1,9153,9391,73484,69914,51,0.5,2455,22.9,24279,2868,21411,4.1,34.7,17138,9971,7167,14.3,24.5,7141,10.2,49,0,2006,2006,8517
1993,37,c) 2,8101,8391,62086,64216,274,3,1485,16.4,14613,2127,12486,3.3,22.8,18873,8509,10364,13.3,29.4,-4260,-6.6,45.6,0,1239,1241,7491
1993,37,d) 3,7558,7780,63011,62017,270,3.3,1205,14.5,14349,1455,12894,2.3,23.1,12361,6162,6199,9.9,19.9,1988,3.2,39.8,0,940,941,4901
1993,37,e) 4,6718,7000,61620,61820,254,3.5,907,12.4,11566,1721,9845,2.8,18.7,11966,5040,6926,8.2,19.4,-400,-0.7,37.4,0,734,735,4201
1993,37,f) 5,6020,6312,67323,67583,205,3.1,785,11.9,10704,1112,9592,1.6,15.8,11223,4725,6498,7,16.6,-519,-0.8,31.6,0,594,594,3369
1993,37,g) 6 to 10,26311,28743,300660,301776,880,3,2511,8.5,42855,5869,36986,1.9,14.2,45087,14990,30097,5,14.9,-2232,-0.7,28.4,0,1836,1847,10467
1993,37,h) 11 to 15,14882,17118,235618,238383,518,3,1163,6.7,30680,5876,24804,2.5,12.9,36210,10331,25879,4.3,15.2,-5530,-2.3,25.8,0,793,807,6954
1993,37,i) 16 to 20,3043,4491,79243,78347,158,3.5,331,7.2,10403,1559,8844,2,13.3,8610,2956,5654,3.8,11,1793,2.3,22,0,141,149,755
1993,37,l) Left Censored,27400,51319,1693646,1688662,1952,3.8,3256,6.3,183766,39200,144566,2.3,10.9,173798,47975,125823,2.8,10.3,9968,0.6,20.6,0,1194,1229,9744
1993,38,a) 0,1265,1266,6108,3068,1253,197.9,0,0,6081,6081,0,198.2,198.2,0,0,0,0,0,6081,198.2,0,0,,,
1993,38,b) 1,936,944,5437,5371,4,0.4,235,21.8,1488,58,1430,1.1,27.7,1355,680,675,12.7,25.2,133,2.5,50.4,0,176,176,529
1993,38,c) 2,836,854,5281,5460,25,2.7,153,16.7,934,125,809,2.3,17.1,1292,652,640,11.9,23.7,-358,-6.6,34.2,0,126,126,546
1993,38,d) 3,787,816,5203,5195,31,3.6,116,13.5,1075,213,862,4.1,20.7,1058,425,633,8.2,20.4,17,0.3,40.8,0,92,92,276
1993,38,e) 4,652,665,4506,4639,19,2.7,80,11.5,698,95,603,2,15,963,616,347,13.3,20.8,-265,-5.8,30,0,64,64,550
1993,38,f) 5,610,632,5780,5919,17,2.5,91,13.6,699,54,645,0.9,11.8,976,396,580,6.7,16.5,-277,-4.7,23.6,0,71,71,340
1993,38,g) 6 to 10,2821,3082,26592,26520,101,3.2,249,7.9,3639,433,3206,1.6,13.7,3494,1258,2236,4.7,13.2,145,0.5,26.4,0,175,176,954
1993,38,h) 11 to 15,2191,2399,23491,23285,65,2.7,155,6.3,3206,441,2765,1.9,13.8,2794,761,2033,3.3,12,412,1.8,24,0,110,110,413
1993,38,i) 16 to 20,469,628,7546,7407,20,3.2,29,4.6,1000,106,894,1.4,13.5,722,131,591,1.8,9.7,278,3.8,19.4,0,18,18,43
1993,38,l) Left Censored,4244,6233,121829,121389,188,3,339,5.4,11471,2211,9260,1.8,9.4,10591,2781,7810,2.3,8.7,880,0.7,17.4,0,145,146,888
1993,39,a) 0,15886,15957,91793,46141,15811,198.2,0,0,91304,91304,0,197.9,197.9,0,0,0,0,0,91304,197.9,0,0,,,
1993,39,b) 1,12234,12544,89263,88754,60,0.4,2930,20.8,25204,1754,23450,2,28.4,24185,14111,10074,15.9,27.2,1019,1.2,54.4,0,2360,2360,12105
1993,39,c) 2,10874,11237,85443,88867,329,2.7,1867,15.5,17747,1964,15783,2.2,20,24594,12768,11826,14.4,27.7,-6847,-7.7,40,0,1525,1527,10737
1993,39,d) 3,10112,10498,87698,89017,322,2.9,1454,13.1,16200,1711,14489,1.9,18.2,18838,8022,10816,9,21.2,-2638,-3,36.4,0,1171,1171,6638
1993,39,e) 4,9230,9811,97982,98785,331,3.2,1237,12,18526,3450,15076,3.5,18.8,20131,8721,11410,8.8,20.4,-1605,-1.6,37.6,0,978,982,6178
1993,39,f) 5,8276,8786,96964,96239,284,3.1,1011,11,17483,2454,15029,2.5,18.2,16033,6345,9688,6.6,16.7,1450,1.5,33.4,0,794,794,5083
1993,39,g) 6 to 10,34415,37898,466103,465514,1117,2.9,3271,8.4,67319,10324,56995,2.2,14.5,66140,20963,45177,4.5,14.2,1179,0.3,28.4,0,2336,2381,13753
1993,39,h) 11 to 15,23397,26876,371114,366177,660,2.4,1834,6.7,55209,10957,44252,3,15.1,45335,12224,33111,3.3,12.4,9874,2.7,24.8,0,1197,1207,7426
1993,39,i) 16 to 20,5079,7834,143155,143349,242,3,541,6.8,18480,4591,13889,3.2,12.9,18868,5597,13271,3.9,13.2,-388,-0.3,25.8,0,210,228,1292
1993,39,l) Left Censored,49825,87503,2718248,2721908,2972,3.3,6423,7.2,302194,63638,238556,2.3,11.1,309515,92687,216828,3.4,11.4,-7321,-0.3,22.2,0,2097,2148,14306
1993,40,a) 0,6145,6156,30684,15433,6100,198.2,0,0,30503,30503,0,197.6,197.6,0,0,0,0,0,30503,197.6,0,0,,,
1993,40,b) 1,4549,4632,30423,31151,15,0.3,1350,25.2,8883,1098,7785,3.5,28.5,10339,5730,4609,18.4,33.2,-1456,-4.7,57,0,1107,1107,4946
1993,40,c) 2,3782,3891,27303,29193,132,3.1,784,18.5,5538,636,4902,2.2,19,9317,5706,3611,19.5,31.9,-3779,-12.9,38,0,625,625,3965
1993,40,d) 3,3447,3524,26042,25885,134,3.6,518,13.9,5985,1030,4955,4,23.1,5670,2511,3159,9.7,21.9,315,1.2,43.8,0,418,418,2206
1993,40,e) 4,2872,2948,26741,27455,100,3.2,390,12.6,4330,781,3549,2.8,15.8,5757,2051,3706,7.5,21,-1427,-5.2,31.6,0,321,321,1734
1993,40,f) 5,2467,2592,23658,24163,78,2.9,350,12.8,4985,608,4377,2.5,20.6,5994,3616,2378,15,24.8,-1009,-4.2,41.2,0,281,282,1972
1993,40,g) 6 to 10,11556,12511,132201,132585,379,2.9,1131,8.8,18041,2999,15042,2.3,13.6,18809,6195,12614,4.7,14.2,-768,-0.6,27.2,0,827,831,4349
1993,40,h) 11 to 15,8477,9516,107847,108359,321,3.3,716,7.4,14610,3022,11588,2.8,13.5,15633,4314,11319,4,14.4,-1023,-0.9,27,0,464,478,2478
1993,40,i) 16 to 20,1537,2322,34146,33687,81,3.5,139,5.9,4409,638,3771,1.9,13.1,3490,828,2662,2.5,10.4,919,2.7,20.8,0,69,69,288
1993,40,l) Left Censored,13110,22016,537651,536884,771,3.4,1565,7,62342,15363,46979,2.9,11.6,60808,17423,43385,3.2,11.3,1534,0.3,22.6,0,549,553,2906
1993,41,a) 0,7115,7150,33769,16964,7083,198.1,0,0,33611,33611,0,198.1,198.1,0,0,0,0,0,33611,198.1,0,0,,,
1993,41,b) 1,5279,5408,36907,37177,34,0.5,1571,25.1,10340,1039,9301,2.8,27.8,10880,5961,4919,16,29.3,-540,-1.5,55.6,0,1201,1201,4779
1993,41,c) 2,4596,4715,30918,31856,201,4,860,17,6754,1101,5653,3.5,21.2,8630,3965,4665,12.4,27.1,-1876,-5.9,42.4,0,658,658,3083
1993,41,d) 3,4493,4614,32196,32476,161,3.3,696,14.2,6785,860,5925,2.6,20.9,7344,3224,4120,9.9,22.6,-559,-1.7,41.8,0,538,538,2655
1993,41,e) 4,3102,3212,27303,27397,114,3.4,401,11.9,5222,760,4462,2.8,19.1,5409,2114,3295,7.7,19.7,-187,-0.6,38.2,0,308,308,1379
1993,41,f) 5,3199,3297,29358,29785,147,4.3,413,12.1,5080,704,4376,2.4,17.1,5934,2425,3509,8.1,19.9,-854,-2.8,34.2,0,335,336,1996
1993,41,g) 6 to 10,12401,13462,147126,148299,499,3.6,1322,9.5,22055,3865,18190,2.6,14.9,24400,8069,16331,5.4,16.5,-2345,-1.6,29.8,0,941,948,4815
1993,41,h) 11 to 15,8834,9902,109575,109805,310,3.1,681,6.7,15440,2350,13090,2.1,14.1,15900,5042,10858,4.6,14.5,-460,-0.4,28.2,0,459,465,3038
1993,41,i) 16 to 20,1733,2486,42302,41467,83,3.3,162,6.4,6168,792,5376,1.9,14.9,4497,891,3606,2.1,10.8,1671,4.1,21.6,0,68,75,358
1993,41,l) Left Censored,12944,21649,566294,565001,828,3.7,1724,7.8,70814,15605,55209,2.8,12.5,68228,20409,47819,3.6,12.1,2586,0.4,24.2,0,556,563,3469
1993,42,a) 0,16262,16331,93792,47070,16213,198.6,0,0,93444,93444,0,198.5,198.5,0,0,0,0,0,93444,198.5,0,0,,,
1993,42,b) 1,13345,13686,107148,106637,82,0.5,3165,20.6,28732,2098,26634,2,26.9,27710,14070,13640,13.2,26,1022,0.9,52,0,2535,2535,11428
1993,42,c) 2,12278,12642,95002,97959,368,2.7,2031,15,19422,1848,17574,1.9,19.8,25336,12204,13132,12.5,25.9,-5914,-6.1,39.6,0,1678,1679,10285
1993,42,d) 3,11747,12064,92828,94986,380,3,1746,13.7,16657,1989,14668,2.1,17.5,20973,9063,11910,9.5,22.1,-4316,-4.6,35,0,1448,1452,7119
1993,42,e) 4,11242,11682,99771,103670,336,2.7,1449,11.8,15147,2055,13092,2,14.6,22944,8202,14742,7.9,22.1,-7797,-7.5,29.2,0,1172,1178,6848
1993,42,f) 5,10132,10625,95596,97750,266,2.4,1203,10.8,14441,1694,12747,1.7,14.8,18749,7038,11711,7.2,19.2,-4308,-4.4,29.6,0,969,971,5975
1993,42,g) 6 to 10,41590,44709,513663,520583,1254,2.7,3919,8.5,64183,9020,55163,1.7,12.3,78022,25635,52387,4.9,15,-13839,-2.7,24.6,0,2945,2968,19467
1993,42,h) 11 to 15,25789,29123,368196,373754,700,2.3,2080,7,44520,6213,38307,1.7,11.9,55635,15897,39738,4.3,14.9,-11115,-3,23.8,0,1390,1406,9885
1993,42,i) 16 to 20,5722,8262,160777,161652,209,2.5,594,7,16767,2438,14329,1.5,10.4,18516,4551,13965,2.8,11.5,-1749,-1.1,20.8,0,274,281,1388
1993,42,l) Left Censored,56516,93997,2874292,2885102,3074,3.2,6640,6.9,308949,78604,230345,2.7,10.7,330568,89848,240720,3.1,11.5,-21619,-0.8,21.4,0,2645,2704,19453
1993,44,a) 0,1818,1818,8437,4237,1805,198.6,0,0,8401,8401,0,198.3,198.3,0,0,0,0,0,8401,198.3,0,0,,,
1993,44,b) 1,1367,1379,15116,12197,3,0.2,345,22.1,8244,,,,67.6,2405,1430,975,11.7,19.7,5839,47.9,39.4,1,260,260,1096
1993,44,c) 2,1168,1179,8866,8794,49,3.9,211,16.7,1971,161,1810,1.8,22.4,1826,1017,809,11.6,20.8,145,1.6,41.6,0,171,171,719
1993,44,d) 3,1154,1177,7744,7762,45,3.6,173,14,1520,265,1255,3.4,19.6,1556,778,778,10,20,-36,-0.4,39.2,0,138,138,648
1993,44,e) 4,1197,1226,11102,11180,50,3.9,170,13.2,1994,366,1628,3.3,17.8,2150,1232,918,11,19.2,-156,-1.4,35.6,0,130,130,1117
1993,44,f) 5,1093,1132,9457,9364,49,4.1,148,12.5,1777,176,1601,1.9,19,1590,678,912,7.2,17,187,2,34,0,104,104,531
1993,44,g) 6 to 10,4125,4282,39426,39757,148,3.4,401,9.1,5449,759,4690,1.9,13.7,6111,2064,4047,5.2,15.4,-662,-1.7,27.4,0,287,287,1557
1993,44,h) 11 to 15,2479,2672,30763,30224,96,3.5,225,8.2,4864,621,4243,2.1,16.1,3785,1436,2349,4.8,12.5,1079,3.6,25,0,130,130,643
1993,44,i) 16 to 20,587,725,12790,12609,20,2.7,44,6,1830,,,,14.5,1468,267,1201,2.1,11.6,362,2.9,23.2,1,19,19,62
1993,44,l) Left Censored,6071,8099,228815,231680,310,3.8,517,6.3,21525,6436,15089,2.8,9.3,27254,8130,19124,3.5,11.8,-5729,-2.5,18.6,0,225,230,1544
1993,45,a) 0,6374,6406,33760,16976,6341,198,0,0,33569,33569,0,197.7,197.7,0,0,0,0,0,33569,197.7,0,0,,,
1993,45,b) 1,4741,4838,38496,38167,16,0.3,1369,24.5,11054,618,10436,1.6,29,10395,6099,4296,16,27.2,659,1.8,54.4,0,1140,1140,5136
1993,45,c) 2,4156,4325,32350,33100,151,3.2,820,17.5,6146,641,5505,1.9,18.6,7645,3750,3895,11.3,23.1,-1499,-4.5,37.2,0,689,689,3111
1993,45,d) 3,3720,3817,29180,30448,140,3.5,611,15.1,5227,513,4714,1.7,17.2,7763,4040,3723,13.3,25.5,-2536,-8.3,34.4,0,479,481,3237
1993,45,e) 4,3231,3452,30601,31072,155,4.3,444,12.3,5769,751,5018,2.4,18.6,6710,2704,4006,8.7,21.6,-941,-3,37.2,0,357,357,2246
1993,45,f) 5,2959,3150,32989,34138,91,2.7,423,12.7,4082,668,3414,2,12,6379,2613,3766,7.7,18.7,-2297,-6.7,24,0,335,337,1718
1993,45,g) 6 to 10,12598,13812,152716,154900,428,3,1235,8.7,21610,3497,18113,2.3,14,25978,7581,18397,4.9,16.8,-4368,-2.8,28,0,883,891,4777
1993,45,h) 11 to 15,7336,8545,111300,111150,261,3,595,6.8,14949,2065,12884,1.9,13.4,14648,4601,10047,4.1,13.2,301,0.2,26.4,0,394,396,2161
1993,45,i) 16 to 20,1514,2119,29215,29062,111,5.2,175,8.1,4840,1274,3566,4.4,16.7,4533,1595,2938,5.5,15.6,307,1.1,31.2,0,80,82,357
1993,45,l) Left Censored,13261,24318,785879,785711,1073,4.4,1619,6.6,79538,20075,59463,2.6,10.1,79202,22671,56531,2.9,10.1,336,0,20.2,0,534,543,2857
1993,46,a) 0,1527,1531,7639,3835,1522,198.8,0,0,7609,7609,0,198.4,198.4,0,0,0,0,0,7609,198.4,0,0,,,
1993,46,b) 1,1173,1201,8242,7628,8,0.6,285,21,3044,1164,1880,15.3,39.9,1816,976,840,12.8,23.8,1228,16.1,47.6,0,216,216,745
1993,46,c) 2,1042,1062,8075,7949,34,3,180,15.8,1801,152,1649,1.9,22.7,1548,847,701,10.7,19.5,253,3.2,39,0,145,145,767
1993,46,d) 3,1008,1029,7471,7688,37,3.4,140,12.9,1249,129,1120,1.7,16.2,1683,837,846,10.9,21.9,-434,-5.7,32.4,0,103,103,738
1993,46,e) 4,757,785,6084,5936,23,2.8,93,11.3,1200,270,930,4.5,20.2,904,446,458,7.5,15.2,296,5,30.4,0,74,74,397
1993,46,f) 5,711,744,5759,5768,27,3.5,83,10.7,821,153,668,2.7,14.2,838,422,416,7.3,14.5,-17,-0.3,28.4,0,61,61,259
1993,46,g) 6 to 10,3131,3374,34128,34475,106,3.1,285,8.2,4281,615,3666,1.8,12.4,4974,1501,3473,4.4,14.4,-693,-2,24.8,0,204,204,1000
1993,46,h) 11 to 15,2157,2360,28777,28180,79,3.3,161,6.7,4136,392,3744,1.4,14.7,2942,731,2211,2.6,10.4,1194,4.3,20.8,0,116,117,491
1993,46,i) 16 to 20,485,655,6501,6622,25,3.8,35,5.3,716,101,615,1.5,10.8,958,200,758,3,14.5,-242,-3.7,21.6,0,21,21,143
1993,46,l) Left Censored,4531,6423,131730,131190,183,2.8,409,6.3,14468,3642,10826,2.8,11,13387,4773,8614,3.6,10.2,1081,0.8,20.4,0,178,187,1046
1993,47,a) 0,9103,9159,53713,26942,9094,198.6,0,0,53542,53542,0,198.7,198.7,0,0,0,0,0,53542,198.7,0,0,,,
1993,47,b) 1,6543,6720,55338,53681,47,0.6,1875,24.3,19016,2847,16169,5.3,35.4,15701,8443,7258,15.7,29.2,3315,6.2,58.4,0,1581,1581,7169
1993,47,c) 2,5502,5734,53030,57172,209,3.4,1116,18,10971,1130,9841,2,19.2,19255,10131,9124,17.7,33.7,-8284,-14.5,38.4,0,893,905,8434
1993,47,d) 3,4994,5156,43850,44934,198,3.6,870,15.8,9851,1640,8211,3.6,21.9,12018,5369,6649,11.9,26.7,-2167,-4.8,43.8,0,713,713,4595
1993,47,e) 4,4446,4699,42640,43257,151,3.1,601,12.2,7806,1241,6565,2.9,18,9040,3753,5287,8.7,20.9,-1234,-2.9,36,0,470,471,3234
1993,47,f) 5,4045,4283,46500,47191,132,2.9,498,11.1,8028,678,7350,1.4,17,9410,3382,6028,7.2,19.9,-1382,-2.9,34,0,396,400,2812
1993,47,g) 6 to 10,17438,18970,229154,228544,583,3,1624,8.3,33501,5655,27846,2.5,14.7,32281,11382,20899,5,14.1,1220,0.6,28.2,0,1157,1173,7184
1993,47,h) 11 to 15,10395,11964,160577,161884,378,3.1,835,6.8,20591,3327,17264,2.1,12.7,23205,6165,17040,3.8,14.3,-2614,-1.6,25.4,0,560,573,3226
1993,47,i) 16 to 20,2359,3939,87998,88576,318,8.2,233,6,17889,8935,8954,10.1,20.2,19045,2086,16959,2.4,21.5,-1156,-1.3,40.4,0,107,113,813
1993,47,l) Left Censored,19930,35967,1173290,1167146,1350,3.7,2495,6.8,134338,24061,110277,2.1,11.5,122050,34465,87585,3,10.5,12288,1,21,0,831,861,5372
1993,48,a) 0,34965,35182,216818,108935,34902,198.4,0,0,215766,215766,0,198.1,198.1,0,0,0,0,0,215766,198.1,0,0,,,
1993,48,b) 1,26122,26863,242801,241729,129,0.4,7533,24.3,73575,6829,66746,2.8,30.4,71431,41624,29807,17.2,29.6,2144,0.8,59.2,0,6217,6224,34580
1993,48,c) 2,22037,23005,210773,217552,835,3.3,4565,18.3,61284,5290,55994,2.4,28.2,74841,41924,32917,19.3,34.4,-13557,-6.2,56.4,0,3746,3754,37598
1993,48,d) 3,19024,19876,183276,185594,707,3.3,3228,15.2,40100,6046,34054,3.3,21.6,44736,21254,23482,11.5,24.1,-4636,-2.5,43.2,0,2594,2624,17266
1993,48,e) 4,15711,16693,160455,164349,629,3.6,2392,13.6,32387,7115,25272,4.3,19.7,40175,18224,21951,11.1,24.4,-7788,-4.7,39.4,0,1885,1893,14969
1993,48,f) 5,13568,14755,154951,157365,487,3.1,2104,13.5,29874,4911,24963,3.1,19,34701,15926,18775,10.1,22.1,-4827,-3.1,38,0,1548,1553,10830
1993,48,g) 6 to 10,58489,65275,768977,778533,2416,3.6,6509,9.7,129968,24777,105191,3.2,16.7,149081,48877,100204,6.3,19.1,-19113,-2.4,33.4,0,4677,4767,32498
1993,48,h) 11 to 15,41106,47828,597997,596173,1599,3.3,3935,8,94104,17066,77038,2.9,15.8,90456,28560,61896,4.8,15.2,3648,0.6,30.4,0,2574,2623,16365
1993,48,i) 16 to 20,7020,11253,180314,177979,380,3.3,799,7,28762,6727,22035,3.8,16.2,24091,8512,15579,4.8,13.5,4671,2.7,27,0,356,364,2302
1993,48,l) Left Censored,52600,111193,3470697,3467327,5651,5,9568,8.5,495757,119235,376522,3.4,14.3,489017,149466,339551,4.3,14.1,6740,0.2,28.2,0,2623,2671,15933
1993,49,a) 0,3734,3755,23452,11752,3736,199,0,0,23400,23400,0,199.1,199.1,0,0,0,0,0,23400,199.1,0,0,,,
1993,49,b) 1,2716,2763,23759,22218,13,0.4,730,23.1,8706,1154,7552,5.2,39.2,5623,3396,2227,15.3,25.3,3083,13.9,50.6,0,578,578,2899
1993,49,c) 2,2160,2234,20580,20732,82,3.4,374,15.6,5490,614,4876,3,26.5,5793,3106,2687,15,27.9,-303,-1.4,53,0,309,311,2631
1993,49,d) 3,1762,1845,19318,19340,60,3.1,290,14.8,4395,453,3942,2.3,22.7,4438,2318,2120,12,22.9,-43,-0.2,45.4,0,220,220,1859
1993,49,e) 4,1580,1636,23185,22633,45,2.6,215,12.4,4903,646,4257,2.9,21.7,3799,1444,2355,6.4,16.8,1104,4.9,33.6,0,163,163,1114
1993,49,f) 5,1367,1487,20461,20239,65,4.2,191,12.3,4342,647,3695,3.2,21.5,3898,1997,1901,9.9,19.3,444,2.2,38.6,0,149,150,1740
1993,49,g) 6 to 10,5270,5810,82556,81448,226,3.8,561,9.4,13907,1700,12207,2.1,17.1,11690,4086,7604,5,14.4,2217,2.7,28.8,0,410,411,3077
1993,49,h) 11 to 15,3926,4436,68589,68056,173,3.8,390,8.6,10225,1100,9125,1.6,15,9159,4062,5097,6,13.5,1066,1.5,27,0,241,245,2325
1993,49,i) 16 to 20,791,1080,19266,19032,39,3.6,74,6.7,2654,331,2323,1.7,13.9,2185,871,1314,4.6,11.5,469,2.4,23,0,36,36,255
1993,49,l) Left Censored,6148,10512,346805,344882,511,4.8,796,7.5,38812,8683,30129,2.5,11.3,34966,12499,22467,3.6,10.1,3846,1.2,20.2,0,281,287,2244
1993,50,a) 0,1483,1486,6097,3060,1474,198.4,0,0,6074,6074,0,198.5,198.5,0,0,0,0,0,6074,198.5,0,0,,,
1993,50,b) 1,1036,1048,6493,6447,5,0.4,262,22.1,1639,48,1591,0.7,25.4,1546,982,564,15.2,24,93,1.4,48,0,203,203,847
1993,50,c) 2,945,966,5253,5500,15,1.4,170,16.2,890,58,832,1.1,16.2,1383,747,636,13.6,25.1,-493,-8.9,32.4,0,131,131,676
1993,50,d) 3,1014,1039,5644,5665,34,3.1,157,14.3,1203,181,1022,3.2,21.2,1244,600,644,10.6,22,-41,-0.8,42.4,0,131,131,485
1993,50,e) 4,1025,1048,7384,7443,35,3.2,122,11.2,1207,156,1051,2.1,16.2,1324,502,822,6.7,17.8,-117,-1.6,32.4,0,94,94,421
1993,50,f) 5,866,879,5359,5529,33,3.6,110,12,923,65,858,1.2,16.7,1263,443,820,8,22.8,-340,-6.1,33.4,0,83,83,354
1993,50,g) 6 to 10,3427,3576,29352,29188,106,2.9,328,8.9,4354,417,3937,1.4,14.9,4025,1411,2614,4.8,13.8,329,1.1,27.6,0,237,238,954
1993,50,h) 11 to 15,1875,2056,19884,19885,58,2.7,164,7.8,2705,342,2363,1.7,13.6,2706,894,1812,4.5,13.6,-1,0,27.2,0,122,122,675
1993,50,i) 16 to 20,401,538,9850,9662,21,3.8,40,7.3,1269,217,1052,2.2,13.1,892,195,697,2,9.2,377,3.9,18.4,0,20,20,87
1993,50,l) Left Censored,3394,4857,118447,118355,152,3.1,309,6.3,11057,2610,8447,2.2,9.3,10872,3734,7138,3.2,9.2,185,0.1,18.4,0,125,126,913
1993,51,a) 0,11343,11374,61258,30741,11291,198.5,0,0,61034,61034,0,198.5,198.5,0,0,0,0,0,61034,198.5,0,0,,,
1993,51,b) 1,8533,8811,64273,63339,51,0.5,2264,22.6,18695,941,17754,1.5,29.5,16827,9880,6947,15.6,26.6,1868,2.9,53.2,0,1827,1827,8475
1993,51,c) 2,7377,7579,55810,56894,256,3.2,1287,15.9,12375,1405,10970,2.5,21.8,14542,6953,7589,12.2,25.6,-2167,-3.8,43.6,0,1030,1031,5369
1993,51,d) 3,7010,7236,53901,54019,282,3.7,1123,14.7,11263,1390,9873,2.6,20.9,11498,5668,5830,10.5,21.3,-235,-0.4,41.8,0,884,884,4689
1993,51,e) 4,6145,6425,53529,53779,203,3,856,12.6,9643,1117,8526,2.1,17.9,10143,4373,5770,8.1,18.9,-500,-1,35.8,0,677,677,3767
1993,51,f) 5,5735,6052,59500,60011,224,3.6,725,11.5,9595,1779,7816,3,16,10617,4424,6193,7.4,17.7,-1022,-1.7,32,0,541,541,3205
1993,51,g) 6 to 10,22750,24903,279989,279983,838,3.3,2295,8.9,43403,6791,36612,2.4,15.5,43390,16041,27349,5.7,15.5,13,0,31,0,1608,1615,10120
1993,51,h) 11 to 15,13113,15168,211986,215365,453,2.9,1181,7.6,28381,5774,22607,2.7,13.2,35138,9336,25802,4.3,16.3,-6757,-3.1,26.4,0,767,780,5077
1993,51,i) 16 to 20,2734,4362,74077,73411,152,3.4,273,6.2,10314,2400,7914,3.3,14,8982,2087,6895,2.8,12.2,1332,1.8,24.4,0,109,113,538
1993,51,l) Left Censored,23553,46042,1469785,1422712,1957,4.2,3301,7.1,262495,44771,217724,3.1,18.5,168348,45539,122809,3.2,11.8,94147,6.7,23.6,0,972,1004,6912
1993,53,a) 0,12602,12646,60009,30352,12533,198.2,0,0,59314,59314,0,195.4,195.4,0,0,0,0,0,59314,195.4,0,0,,,
1993,53,b) 1,9489,9738,63686,64237,53,0.5,2852,25.3,18275,1280,16995,2,28.4,19376,11180,8196,17.4,30.2,-1101,-1.8,56.8,0,2193,2193,8995
1993,53,c) 2,7856,8065,58066,58461,322,3.7,1488,17.1,14400,2311,12089,4,24.6,15189,7437,7752,12.7,26,-789,-1.4,49.2,0,1151,1157,6264
1993,53,d) 3,7968,8240,63203,64413,351,4,1285,14.7,13527,1987,11540,3.1,21,15947,6678,9269,10.4,24.8,-2420,-3.8,42,0,977,978,5327
1993,53,e) 4,4919,5125,47401,49429,167,3.1,728,13.4,8366,705,7661,1.4,16.9,12422,4647,7775,9.4,25.1,-4056,-8.2,33.8,0,574,576,3257
1993,53,f) 5,5138,5364,50208,51312,189,3.3,737,13,8105,825,7280,1.6,15.8,10313,4698,5615,9.2,20.1,-2208,-4.3,31.6,0,560,561,3594
1993,53,g) 6 to 10,20889,22820,264859,267675,837,3.6,2164,9.2,37997,6364,31633,2.4,14.2,43629,13718,29911,5.1,16.3,-5632,-2.1,28.4,0,1489,1491,9208
1993,53,h) 11 to 15,13635,15487,192050,192026,532,3.4,1155,7.3,27841,5320,22521,2.8,14.5,27793,7586,20207,4,14.5,48,0,29,0,740,761,4527
1993,53,i) 16 to 20,2732,3949,62703,62042,180,4.5,271,6.8,8843,1675,7168,2.7,14.3,7521,2164,5357,3.5,12.1,1322,2.2,24.2,0,133,136,720
1993,53,l) Left Censored,19485,34164,968713,978519,1525,4.4,2578,7.4,108214,26583,81631,2.7,11.1,127827,38557,89270,3.9,13.1,-19613,-2,22.2,0,813,847,6993
1993,54,a) 0,2541,2546,11878,5972,2519,197.9,0,0,11812,11812,0,197.8,197.8,0,0,0,0,0,11812,197.8,0,0,,,
1993,54,b) 1,1984,2012,12032,12349,8,0.3,499,21.8,3079,133,2946,1.1,24.9,3712,1969,1743,15.9,30.1,-633,-5.2,49.8,0,412,412,1719
1993,54,c) 2,1755,1878,17742,17825,64,3.2,314,15.6,3514,507,3007,2.8,19.7,3680,1685,1995,9.5,20.6,-166,-0.9,39.4,0,261,261,1322
1993,54,d) 3,1629,1648,11626,12231,39,2.2,238,13.6,1977,161,1816,1.3,16.2,3186,1618,1568,13.2,26,-1209,-9.8,32.4,0,209,209,1483
1993,54,e) 4,1433,1478,13709,13929,49,3.2,194,12.5,2230,456,1774,3.3,16,2670,1238,1432,8.9,19.2,-440,-3.2,32,0,154,154,1005
1993,54,f) 5,1288,1326,10607,10901,40,2.9,158,11.4,1544,152,1392,1.4,14.2,2131,897,1234,8.2,19.5,-587,-5.3,28.4,0,127,127,734
1993,54,g) 6 to 10,5649,6090,68152,68558,178,2.8,498,8,8167,1351,6816,2,11.9,8979,2637,6342,3.8,13.1,-812,-1.2,23.8,0,347,357,1702
1993,54,h) 11 to 15,3622,4104,45846,46103,135,3.2,283,6.8,5717,912,4805,2,12.4,6231,1281,4950,2.8,13.5,-514,-1.1,24.8,0,194,197,956
1993,54,i) 16 to 20,846,1210,18231,17885,35,2.8,77,6.3,2371,353,2018,2,13.3,1678,506,1172,2.8,9.4,693,3.9,18.8,0,33,33,141
1993,54,l) Left Censored,8064,12720,277051,277759,420,3.2,883,6.8,30604,5307,25297,1.9,11,32020,9515,22505,3.4,11.5,-1416,-0.5,22,0,357,360,2223
1993,55,a) 0,8653,8695,45331,22778,8631,198.5,0,0,45107,45107,0,198,198,0,0,0,0,0,45107,198,0,0,,,
1993,55,b) 1,6513,6594,46948,45871,38,0.5,1488,20.1,12524,850,11674,1.9,27.3,10370,6120,4250,13.3,22.6,2154,4.7,45.2,0,1161,1161,4616
1993,55,c) 2,5858,6070,45947,46667,190,2.9,918,14.2,9072,1072,8000,2.3,19.4,10511,4896,5615,10.5,22.5,-1439,-3.1,38.8,0,756,756,4034
1993,55,d) 3,5490,5750,46161,46901,223,3.7,739,12.3,8318,1494,6824,3.2,17.7,9797,3787,6010,8.1,20.9,-1479,-3.2,35.4,0,563,563,2776
1993,55,e) 4,4892,5052,43878,42651,181,3.4,607,11.5,10059,1055,9004,2.5,23.6,7604,3497,4107,8.2,17.8,2455,5.8,35.6,0,491,492,2900
1993,55,f) 5,4373,4514,41352,42070,115,2.4,495,10.5,5680,638,5042,1.5,13.5,7115,2400,4715,5.7,16.9,-1435,-3.4,27,0,386,389,1857
1993,55,g) 6 to 10,18547,20255,244343,244828,584,2.8,1655,8,31917,4057,27860,1.7,13,32886,11492,21394,4.7,13.4,-969,-0.4,26,0,1202,1213,7869
1993,55,h) 11 to 15,12079,13585,174673,174082,378,2.7,942,6.8,22188,3450,18738,2,12.7,21005,6118,14887,3.5,12.1,1183,0.6,24.2,0,666,674,4327
1993,55,i) 16 to 20,2649,4023,66204,66439,140,3.4,258,6.3,9095,2103,6992,3.2,13.7,9564,2069,7495,3.1,14.4,-469,-0.7,27.4,0,122,123,539
1993,55,l) Left Censored,26037,40652,1273023,1267731,1338,3.2,2440,5.9,133543,28930,104613,2.3,10.5,122960,37593,85367,3,9.7,10583,0.8,19.4,0,1086,1140,10389
1993,56,a) 0,1270,1275,6231,3126,1268,198.9,0,0,6211,6211,0,198.7,198.7,0,0,0,0,0,6211,198.7,0,0,,,
1993,56,b) 1,892,894,4838,4796,1,0.1,238,23.2,1363,,,,28.4,1279,702,577,14.6,26.7,84,1.7,53.4,1,183,183,572
1993,56,c) 2,766,773,4437,4830,30,3.6,144,17.3,981,152,829,3.1,20.3,1767,687,1080,14.2,36.6,-786,-16.3,40.6,0,109,109,583
1993,56,d) 3,677,685,3866,3996,20,2.8,96,13.3,685,73,612,1.8,17.1,944,321,623,8,23.6,-259,-6.5,34.2,0,72,72,245
1993,56,e) 4,554,583,4179,4311,25,4.1,74,12.2,667,66,601,1.5,15.5,931,280,651,6.5,21.6,-264,-6.1,31,0,51,51,179
1993,56,f) 5,517,535,3818,3964,18,3.2,65,11.7,542,61,481,1.5,13.7,834,323,511,8.1,21,-292,-7.3,27.4,0,52,52,281
1993,56,g) 6 to 10,2271,2447,20944,21910,84,3.3,264,10.4,2552,239,2313,1.1,11.6,4484,1963,2521,9,20.5,-1932,-8.9,23.2,0,183,185,1368
1993,56,h) 11 to 15,1949,2116,18266,18360,82,3.8,148,6.9,2609,317,2292,1.7,14.2,2797,816,1981,4.4,15.2,-188,-1,28.4,0,102,106,650
1993,56,i) 16 to 20,349,489,6663,6528,17,3.4,28,5.7,1084,,,,16.6,814,101,713,1.5,12.5,270,4.1,25,1,12,12,42
1993,56,l) Left Censored,2657,4059,67782,67664,323,8,286,7.1,8808,3405,5403,5,13,8572,2470,6102,3.7,12.7,236,0.3,25.4,0,115,118,778
1994,01,a) 0,7742,7801,47638,23879,7745,198.6,0,0,47519,47519,0,199,199,0,0,0,0,0,47519,199,0,0,,,
1994,01,b) 1,5466,5509,37692,38252,26,0.4,1541,24.3,11276,473,10803,1.2,29.5,12395,6933,5462,18.1,32.4,-1119,-2.9,59,0,1301,1301,6065
1994,01,c) 2,4371,4460,37423,40178,134,2.8,874,18,6770,968,5802,2.4,16.9,12280,5710,6570,14.2,30.6,-5510,-13.7,33.8,0,717,717,5078
1994,01,d) 3,3741,3919,32029,33945,137,3.3,606,14.6,5941,658,5283,1.9,17.5,9773,4480,5293,13.2,28.8,-3832,-11.3,35,0,478,478,3341
1994,01,e) 4,3556,3687,30620,31794,124,3.2,523,13.4,5526,502,5024,1.6,17.4,7874,3388,4486,10.7,24.8,-2348,-7.4,34.8,0,403,404,2190
1994,01,f) 5,3139,3319,33305,33414,128,3.7,439,12.6,6252,855,5397,2.6,18.7,6470,2647,3823,7.9,19.4,-218,-0.7,37.4,0,346,346,2094
1994,01,g) 6 to 10,13662,14963,185302,187799,480,3.1,1398,9.1,23634,4505,19129,2.4,12.6,28627,8668,19959,4.6,15.2,-4993,-2.6,25.2,0,1032,1035,5794
1994,01,h) 11 to 15,7822,8832,130912,130957,274,3,696,7.7,17318,3234,14084,2.5,13.2,17408,5289,12119,4,13.3,-90,-0.1,26.4,0,437,444,3184
1994,01,i) 16 to 20,3359,4917,76351,75805,163,3.3,299,6,10005,2745,7260,3.6,13.2,8912,2810,6102,3.7,11.8,1093,1.4,23.6,0,153,153,1572
1994,01,l) Left Censored,14405,26412,819872,819467,1206,4.5,1708,6.4,87668,23001,64667,2.8,10.7,86857,24093,62764,2.9,10.6,811,0.1,21.2,0,628,643,6781
1994,02,a) 0,1308,1309,6552,3296,1290,197.1,0,0,6513,6513,0,197.6,197.6,0,0,0,0,0,6513,197.6,0,0,,,
1994,02,b) 1,988,998,5791,5783,9,0.8,276,24,1887,56,1831,1,32.6,1871,952,919,16.5,32.4,16,0.2,64.8,0,191,191,676
1994,02,c) 2,753,791,4617,5147,45,5.3,159,18.6,1254,224,1030,4.4,24.4,2313,901,1412,17.5,44.9,-1059,-20.5,48.8,0,116,116,596
1994,02,d) 3,749,769,5489,5569,39,4.8,129,15.8,1257,96,1161,1.7,22.6,1416,438,978,7.9,25.4,-159,-2.8,45.2,0,91,91,315
1994,02,e) 4,697,715,4703,5005,22,2.9,117,15.3,886,127,759,2.5,17.7,1490,465,1025,9.3,29.8,-604,-12.1,35.4,0,81,81,319
1994,02,f) 5,489,496,3793,4440,21,4.1,58,11.3,559,53,506,1.2,12.6,1853,342,1511,7.7,41.7,-1294,-29.1,25.2,0,44,44,206
1994,02,g) 6 to 10,2489,2760,28850,29110,112,3.9,286,10,4601,793,3808,2.7,15.8,5121,1643,3478,5.6,17.6,-520,-1.8,31.6,0,184,186,1004
1994,02,h) 11 to 15,1584,1790,17499,17587,78,4.3,140,7.7,2686,370,2316,2.1,15.3,2862,740,2122,4.2,16.3,-176,-1,30.6,0,74,76,458
1994,02,i) 16 to 20,601,817,11366,11513,38,4.6,46,5.6,1470,158,1312,1.4,12.8,1763,354,1409,3.1,15.3,-293,-2.5,25.6,0,11,11,50
1994,02,l) Left Censored,1853,3367,82827,81753,176,5.2,225,6.6,12979,4454,8525,5.4,15.9,10830,3417,7413,4.2,13.2,2149,2.7,26.4,0,50,52,285
1994,04,a) 0,9110,9204,56356,28235,9157,199,0,0,56243,56243,0,199.2,199.2,0,0,0,0,0,56243,199.2,0,0,,,
1994,04,b) 1,6168,6231,46378,46384,33,0.5,1827,25.3,14426,489,13937,1.1,31.1,14437,8502,5935,18.3,31.1,-11,0,62.2,0,1507,1507,7582
1994,04,c) 2,5043,5195,47933,49182,181,3.2,1053,18.7,11406,1584,9822,3.2,23.2,13903,6848,7055,13.9,28.3,-2497,-5.1,46.4,0,869,869,5897
1994,04,d) 3,4429,4573,40604,42806,153,3.1,811,16.5,8727,884,7843,2.1,20.4,13131,4757,8374,11.1,30.7,-4404,-10.3,40.8,0,660,660,3713
1994,04,e) 4,3940,4073,39857,40070,145,3.4,651,15,8697,1420,7277,3.5,21.7,9122,4653,4469,11.6,22.8,-425,-1.1,43.4,0,502,502,3914
1994,04,f) 5,3558,3776,42064,42440,169,4.3,568,14.3,8233,1188,7045,2.8,19.4,8984,4115,4869,9.7,21.2,-751,-1.8,38.8,0,441,444,2992
1994,04,g) 6 to 10,14284,15767,199180,198192,688,4.2,1689,10.4,33977,5653,28324,2.9,17.1,32001,11975,20026,6,16.1,1976,1,32.2,0,1185,1192,8348
1994,04,h) 11 to 15,8763,10411,163777,160472,463,4.4,783,7.4,25507,4983,20524,3.1,15.9,18897,5776,13121,3.6,11.8,6610,4.1,23.6,0,498,502,3544
1994,04,i) 16 to 20,2660,3708,69241,67015,178,4.7,282,7.5,11832,2572,9260,3.8,17.7,7380,2048,5332,3.1,11,4452,6.7,22,0,149,149,936
1994,04,l) Left Censored,9736,20817,679929,665423,1471,7.1,1461,7,113153,38503,74650,5.8,17,84141,29218,54923,4.4,12.6,29012,4.4,25.2,0,386,391,2432
1994,05,a) 0,4949,4978,29235,14652,4945,198.7,0,0,29167,29167,0,199.1,199.1,0,0,0,0,0,29167,199.1,0,0,,,
1994,05,b) 1,3618,3644,21726,22465,9,0.2,1015,24.2,5902,141,5761,0.6,26.3,7380,4378,3002,19.5,32.9,-1478,-6.6,52.6,0,843,843,3732
1994,05,c) 2,2878,2974,24289,26037,87,2.7,548,17,5627,449,5178,1.7,21.6,9123,5587,3536,21.5,35,-3496,-13.4,43.2,0,432,432,4992
1994,05,d) 3,2424,2533,19319,20046,76,2.8,376,14,3384,363,3021,1.8,16.9,4837,1891,2946,9.4,24.1,-1453,-7.2,33.8,0,311,311,1610
1994,05,e) 4,2291,2401,17885,19199,68,2.7,323,12.7,3114,501,2613,2.6,16.2,5741,3411,2330,17.8,29.9,-2627,-13.7,32.4,0,263,269,3089
1994,05,f) 5,1858,1915,21221,20300,66,3.3,241,12,5514,845,4669,4.2,27.2,3672,1623,2049,8,18.1,1842,9.1,36.2,0,201,201,876
1994,05,g) 6 to 10,8239,8798,91394,91866,284,3.1,933,10.2,13584,2157,11427,2.3,14.8,14527,6375,8152,6.9,15.8,-943,-1,29.6,0,705,705,4649
1994,05,h) 11 to 15,5594,6298,78022,78348,208,3.2,484,7.5,11039,2552,8487,3.3,14.1,11690,2935,8755,3.7,14.9,-651,-0.8,28.2,0,330,331,1721
1994,05,i) 16 to 20,2279,2840,41384,41834,105,3.6,206,7.1,4726,958,3768,2.3,11.3,5625,1563,4062,3.7,13.4,-899,-2.1,22.6,0,124,131,927
1994,05,l) Left Censored,9448,15744,486704,485845,784,5,938,5.9,51739,14975,36764,3.1,10.6,50020,16896,33124,3.5,10.3,1719,0.3,20.6,0,414,418,3690
1994,06,a) 0,56361,56846,367968,184788,56362,198.3,0,0,366361,366361,0,198.3,198.3,0,0,0,0,0,366361,198.3,0,0,,,
1994,06,b) 1,40721,41168,324827,331918,202,0.4,12479,26,95021,5681,89340,1.7,28.6,109202,64562,44640,19.5,32.9,-14181,-4.3,57.2,0,10025,10030,54062
1994,06,c) 2,35135,36455,380195,409018,1455,3.6,8151,20.3,74655,10151,64504,2.5,18.3,132300,65713,66587,16.1,32.3,-57645,-14,36.6,0,6480,6482,56312
1994,06,d) 3,32763,34048,289149,297683,1396,3.8,6523,17.8,66423,8512,57911,2.9,22.3,83490,39539,43951,13.3,28,-17067,-5.7,44.6,0,5083,5090,31252
1994,06,e) 4,31104,32430,288518,302571,1405,4.1,5530,16,57388,9331,48057,3.1,19,85494,41672,43822,13.8,28.3,-28106,-9.3,38,0,4169,4190,33501
1994,06,f) 5,27650,29098,280442,293178,1170,3.8,4407,14.3,48793,6907,41886,2.4,16.6,74265,29833,44432,10.2,25.3,-25472,-8.7,33.2,0,3361,3373,22735
1994,06,g) 6 to 10,111935,122693,1503478,1536303,4792,3.7,15067,11.8,228404,39354,189050,2.6,14.9,294053,112489,181564,7.3,19.1,-65649,-4.2,29.8,0,10460,10532,79034
1994,06,h) 11 to 15,73778,85745,1195134,1211812,3168,3.6,8366,9.5,163170,32307,130863,2.7,13.5,196525,65624,130901,5.4,16.2,-33355,-2.7,27,0,5078,5127,37980
1994,06,i) 16 to 20,25624,35270,582848,582696,1324,3.7,3229,8.9,82578,16554,66024,2.8,14.2,82274,26722,55552,4.6,14.1,304,0.1,28.2,0,1617,1664,10102
1994,06,l) Left Censored,87507,170137,5251344,5335420,9207,5.3,15394,8.9,620875,206393,414482,3.9,11.6,789027,239577,549450,4.5,14.8,-168152,-3.2,23.2,0,4880,5089,36424
1994,08,a) 0,11100,11176,58707,29483,11107,198.8,0,0,58448,58448,0,198.2,198.2,0,0,0,0,0,58448,198.2,0,0,,,
1994,08,b) 1,7761,7794,51905,51210,32,0.4,2189,24.5,15843,520,15323,1,30.9,14453,8852,5601,17.3,28.2,1390,2.7,56.4,0,1738,1738,7581
1994,08,c) 2,6022,6129,47239,49975,207,3.1,1150,17.3,10751,1009,9742,2,21.5,16222,6912,9310,13.8,32.5,-5471,-11,43,0,888,888,5781
1994,08,d) 3,5297,5467,41461,42496,206,3.5,855,14.7,8468,1428,7040,3.4,19.9,10537,4421,6116,10.4,24.8,-2069,-4.9,39.8,0,675,675,3498
1994,08,e) 4,4515,4666,39236,39795,172,3.5,610,12.5,7884,1177,6707,3,19.8,9002,3795,5207,9.5,22.6,-1118,-2.8,39.6,0,474,475,2921
1994,08,f) 5,4012,4221,40355,40542,166,3.8,515,11.7,7670,1595,6075,3.9,18.9,8044,3621,4423,8.9,19.8,-374,-0.9,37.8,0,392,392,2631
1994,08,g) 6 to 10,15901,17069,196622,198615,670,3.8,1709,9.7,31057,4382,26675,2.2,15.6,35042,14768,20274,7.4,17.6,-3985,-2,31.2,0,1220,1225,8161
1994,08,h) 11 to 15,10508,12090,169089,167943,469,3.8,908,7.4,24646,5233,19413,3.1,14.7,22353,7075,15278,4.2,13.3,2293,1.4,26.6,0,584,588,3881
1994,08,i) 16 to 20,3567,4753,70843,70387,187,3.9,352,7.3,10772,1737,9035,2.5,15.3,9860,3044,6816,4.3,14,912,1.3,28,0,190,191,1427
1994,08,l) Left Censored,13141,23909,718212,713986,1546,6.5,1601,6.7,91344,28565,62779,4,12.8,82892,27588,55304,3.9,11.6,8452,1.2,23.2,0,489,507,3412
1994,09,a) 0,5672,5688,31018,15540,5651,198.7,0,0,30956,30956,0,199.2,199.2,0,0,0,0,0,30956,199.2,0,0,,,
1994,09,b) 1,4411,4447,31579,29825,27,0.5,1052,21,11678,851,10827,2.9,39.2,8169,4642,3527,15.6,27.4,3509,11.8,54.8,0,833,833,4064
1994,09,c) 2,3690,3814,29061,30705,128,3.1,689,16.8,5681,526,5155,1.7,18.5,8969,4511,4458,14.7,29.2,-3288,-10.7,37,0,533,533,3623
1994,09,d) 3,3293,3391,26427,31354,107,3,511,14.2,5567,430,5137,1.4,17.8,15420,12444,2976,39.7,49.2,-9853,-31.4,35.6,0,403,403,11976
1994,09,e) 4,3389,3492,27101,27589,145,4,477,13,4850,929,3921,3.4,17.6,5826,2275,3551,8.2,21.1,-976,-3.5,35.2,0,367,367,1642
1994,09,f) 5,3441,3578,28955,29117,133,3.5,515,13.6,4998,688,4310,2.4,17.2,5321,2519,2802,8.7,18.3,-323,-1.1,34.4,0,376,376,1608
1994,09,g) 6 to 10,14153,14926,157812,159818,506,3.3,1514,9.8,22124,2969,19155,1.9,13.8,26136,9037,17099,5.7,16.4,-4012,-2.6,27.6,0,1082,1092,6137
1994,09,h) 11 to 15,8619,9456,105114,105296,258,2.7,754,7.8,15148,2889,12259,2.7,14.4,15512,4180,11332,4,14.7,-364,-0.3,28.8,0,513,517,2420
1994,09,i) 16 to 20,3193,4058,57485,58574,150,3.6,252,6.1,7543,1756,5787,3,12.9,9721,2173,7548,3.7,16.6,-2178,-3.7,25.8,0,145,145,1031
1994,09,l) Left Censored,17918,27069,884389,899728,1017,3.7,1796,6.5,83249,19664,63585,2.2,9.3,113926,27416,86510,3,12.7,-30677,-3.4,18.6,0,744,753,5474
1994,10,a) 0,1560,1568,8223,4140,1552,198,0,0,8166,8166,0,197.2,197.2,0,0,0,0,0,8166,197.2,0,0,,,
1994,10,b) 1,1191,1194,31436,18998,6,0.5,229,17.3,26531,47,26484,0.2,139.7,1655,675,980,3.6,8.7,24876,131,17.4,0,181,181,530
1994,10,c) 2,932,958,6333,6807,22,2.1,187,17.9,1286,127,1159,1.9,18.9,2233,1203,1030,17.7,32.8,-947,-13.9,37.8,0,127,127,954
1994,10,d) 3,822,847,5974,6165,25,2.7,151,16.6,1060,109,951,1.8,17.2,1441,651,790,10.6,23.4,-381,-6.2,34.4,0,117,117,483
1994,10,e) 4,788,815,5758,5805,25,2.9,111,12.9,1159,302,857,5.2,20,1252,427,825,7.4,21.6,-93,-1.6,40,0,85,85,351
1994,10,f) 5,759,780,6317,6515,26,3.2,91,11.2,960,115,845,1.8,14.7,1356,459,897,7,20.8,-396,-6.1,29.4,0,69,69,372
1994,10,g) 6 to 10,2792,2965,30262,31057,103,3.4,294,9.6,3659,503,3156,1.6,11.8,5248,2267,2981,7.3,16.9,-1589,-5.1,23.6,0,206,206,1479
1994,10,h) 11 to 15,1572,1752,23922,24237,47,2.6,137,7.6,3145,276,2869,1.1,13,3775,1078,2697,4.4,15.6,-630,-2.6,26,0,88,88,549
1994,10,i) 16 to 20,653,826,20337,20012,25,3,60,7.1,2693,152,2541,0.8,13.5,2043,769,1274,3.8,10.2,650,3.3,20.4,0,26,26,191
1994,10,l) Left Censored,3645,5880,190611,192500,369,6.3,410,7,22666,7577,15089,3.9,11.8,26444,4399,22045,2.3,13.7,-3778,-1.9,23.6,0,123,123,527
1994,11,a) 0,1129,1136,10129,5070,1132,199.3,0,0,10118,,,,199.6,0,0,0,0,0,10118,199.6,0,1,,,
1994,11,b) 1,838,841,7171,7269,7,0.7,196,20.8,1703,,,,23.4,1898,1050,848,14.4,26.1,-195,-2.7,46.8,1,155,155,744
1994,11,c) 2,766,802,27268,27768,34,4,137,16,1294,319,975,1.1,4.7,2293,799,1494,2.9,8.3,-999,-3.6,9.4,0,96,96,424
1994,11,d) 3,683,692,6423,6534,19,2.6,104,14.2,1083,121,962,1.9,16.6,1304,450,854,6.9,20,-221,-3.4,33.2,0,83,83,400
1994,11,e) 4,648,685,6883,6899,30,4.2,82,11.5,1222,283,939,4.1,17.7,1253,474,779,6.9,18.2,-31,-0.5,35.4,0,63,63,276
1994,11,f) 5,628,655,6299,7387,22,3.2,74,10.9,1008,128,880,1.7,13.6,3184,267,2917,3.6,43.1,-2176,-29.5,27.2,0,51,51,187
1994,11,g) 6 to 10,2757,2920,40764,40612,98,3.3,256,8.5,5478,675,4803,1.7,13.5,5174,1562,3612,3.8,12.7,304,0.8,25.4,0,168,168,1036
1994,11,h) 11 to 15,1964,2178,33187,33706,77,3.5,162,7.3,4168,564,3604,1.7,12.4,5205,1213,3992,3.6,15.4,-1037,-3,24.8,0,99,99,678
1994,11,i) 16 to 20,766,987,45282,44066,57,5.7,100,9.9,4726,746,3980,1.7,10.7,2293,854,1439,1.9,5.2,2433,5.5,10.4,0,34,54,457
1994,11,l) Left Censored,4535,6777,226382,241465,314,4.6,457,6.7,23021,6579,16442,2.7,9.5,53187,8071,45116,3.3,22,-30166,-12.5,19,0,155,156,919
1994,12,a) 0,37920,38167,210215,105563,37890,198.5,0,0,209305,209305,0,198.3,198.3,0,0,0,0,0,209305,198.3,0,0,,,
1994,12,b) 1,28231,28456,203344,208016,115,0.3,8866,26.7,56672,3681,52991,1.8,27.2,66015,41226,24789,19.8,31.7,-9343,-4.5,54.4,0,7395,7395,35836
1994,12,c) 2,22597,23079,190382,193294,774,3,5338,21,52212,7864,44348,4.1,27,58036,30998,27038,16,30,-5824,-3,54,0,4344,4352,25722
1994,12,d) 3,19064,19654,154956,159275,674,3.2,3635,17.2,33763,3751,30012,2.4,21.2,42401,22228,20173,14,26.6,-8638,-5.4,42.4,0,2942,2944,18022
1994,12,e) 4,17530,18037,151659,159945,552,2.9,2873,14.9,28050,2652,25398,1.7,17.5,44621,17181,27440,10.7,27.9,-16571,-10.4,35,0,2331,2331,14311
1994,12,f) 5,15138,15943,140454,143684,602,3.6,2319,13.8,27894,5122,22772,3.6,19.4,34354,13890,20464,9.7,23.9,-6460,-4.5,38.8,0,1838,1841,10596
1994,12,g) 6 to 10,57101,62196,716664,719987,2188,3.4,7111,11,129303,26457,102846,3.7,18,135950,53169,82781,7.4,18.9,-6647,-0.9,36,0,5204,5287,38636
1994,12,h) 11 to 15,32640,37070,475146,476191,1198,3.1,3513,9.2,68718,12585,56133,2.6,14.4,70808,25310,45498,5.3,14.9,-2090,-0.5,28.8,0,2340,2362,15328
1994,12,i) 16 to 20,10660,15060,225927,223679,676,4.4,1203,7.8,32940,8893,24047,4,14.7,28444,7376,21068,3.3,12.7,4496,2,25.4,0,655,669,3389
1994,12,l) Left Censored,37524,82410,2449330,2430288,4753,5.7,5797,7,315337,90124,225213,3.7,13,277253,77803,199450,3.2,11.4,38084,1.6,22.8,0,1934,1957,14592
1994,13,a) 0,15082,15193,92123,46187,15106,198.9,0,0,91873,91873,0,198.9,198.9,0,0,0,0,0,91873,198.9,0,0,,,
1994,13,b) 1,10841,10918,87869,86680,61,0.5,3074,24.5,26468,2240,24228,2.6,30.5,24090,14511,9579,16.7,27.8,2378,2.7,55.6,0,2474,2474,12088
1994,13,c) 2,8601,8829,75030,79883,259,2.7,1902,19.6,16287,1227,15060,1.5,20.4,25992,13651,12341,17.1,32.5,-9705,-12.1,40.8,0,1550,1551,11363
1994,13,d) 3,7327,7592,67677,69340,273,3.4,1355,16.6,14085,1789,12296,2.6,20.3,17410,8682,8728,12.5,25.1,-3325,-4.8,40.6,0,1060,1063,6798
1994,13,e) 4,6593,6768,64290,64800,243,3.4,1011,14.1,12929,1348,11581,2.1,20,13948,6558,7390,10.1,21.5,-1019,-1.5,40,0,775,775,4813
1994,13,f) 5,6013,6426,66282,65749,245,3.6,821,12.2,13879,2648,11231,4,21.1,12812,4677,8135,7.1,19.5,1067,1.6,39,0,633,634,3445
1994,13,g) 6 to 10,24186,26345,321080,318025,1000,3.7,2719,10,53392,11983,41409,3.8,16.8,47282,18838,28444,5.9,14.9,6110,1.9,29.8,0,1971,1973,12235
1994,13,h) 11 to 15,13990,16316,229105,228587,573,3.4,1329,8,33522,6948,26574,3,14.7,32485,11826,20659,5.2,14.2,1037,0.5,28.4,0,849,878,6847
1994,13,i) 16 to 20,5290,7120,119422,117123,359,5,555,7.7,18629,4283,14346,3.7,15.9,14031,4744,9287,4.1,12,4598,3.9,24,0,320,322,2365
1994,13,l) Left Censored,22588,46314,1563809,1552037,2569,5.5,3318,7.1,199194,61104,138090,3.9,12.8,175650,57554,118096,3.7,11.3,23544,1.5,22.6,0,1006,1024,6665
1994,15,a) 0,1975,1984,16593,8311,1970,198.6,0,0,16565,16565,0,199.3,199.3,0,0,0,0,0,16565,199.3,0,0,,,
1994,15,b) 1,1516,1544,10601,11146,10,0.6,444,24.9,3085,161,2924,1.4,27.7,4175,2599,1576,23.3,37.5,-1090,-9.8,55.4,0,363,363,2130
1994,15,c) 2,1287,1342,12462,13085,46,3.2,258,17.7,2232,167,2065,1.3,17.1,3478,1373,2105,10.5,26.6,-1246,-9.5,34.2,0,204,204,1142
1994,15,d) 3,1287,1333,13925,14585,54,3.8,244,17,1975,185,1790,1.3,13.5,3295,1595,1700,10.9,22.6,-1320,-9.1,27,0,194,194,1343
1994,15,e) 4,1147,1243,9685,10768,61,4.6,205,15.5,1687,450,1237,4.2,15.7,3852,2096,1756,19.5,35.8,-2165,-20.1,31.4,0,152,154,1801
1994,15,f) 5,1025,1095,9754,11372,39,3.4,130,11.4,1308,207,1101,1.8,11.5,4544,2324,2220,20.4,40,-3236,-28.5,23,0,107,107,2212
1994,15,g) 6 to 10,4150,4696,55854,57265,148,3,493,10.1,6869,1094,5775,1.9,12,9690,3483,6207,6.1,16.9,-2821,-4.9,24,0,332,332,2278
1994,15,h) 11 to 15,3192,3764,45565,46469,93,2.4,265,6.9,5268,659,4609,1.4,11.3,7075,1706,5369,3.7,15.2,-1807,-3.9,22.6,0,151,167,1050
1994,15,i) 16 to 20,1082,1545,22869,23224,42,2.7,114,7.2,2278,202,2076,0.9,9.8,2988,889,2099,3.8,12.9,-710,-3.1,19.6,0,56,56,216
1994,15,l) Left Censored,4840,8545,224920,230291,335,3.9,521,6,19634,6940,12694,3,8.5,30376,9297,21079,4,13.2,-10742,-4.7,17,0,188,204,1538
1994,16,a) 0,3053,3071,15043,7548,3047,198.4,0,0,14990,14990,0,198.6,198.6,0,0,0,0,0,14990,198.6,0,0,,,
1994,16,b) 1,2021,2034,12566,12319,10,0.4,552,23.6,3657,174,3483,1.4,29.7,3163,1827,1336,14.8,25.7,494,4,51.4,0,406,406,1399
1994,16,c) 2,1700,1725,11332,11672,71,3.8,305,16.4,2517,368,2149,3.2,21.6,3196,1586,1610,13.6,27.4,-679,-5.8,43.2,0,238,238,1262
1994,16,d) 3,1356,1382,9473,9772,62,4.3,198,13.6,1887,231,1656,2.4,19.3,2485,939,1546,9.6,25.4,-598,-6.1,38.6,0,147,147,634
1994,16,e) 4,1384,1415,10575,10737,63,4.3,189,12.8,2157,189,1968,1.8,20.1,2481,1036,1445,9.6,23.1,-324,-3,40.2,0,139,139,691
1994,16,f) 5,1032,1090,9320,9321,35,3.1,122,10.7,1680,187,1493,2,18,1682,597,1085,6.4,18,-2,0,36,0,98,98,529
1994,16,g) 6 to 10,4274,4545,48592,48668,174,3.7,400,8.6,8717,1355,7362,2.8,17.9,8869,3785,5084,7.8,18.2,-152,-0.3,35.8,0,288,292,2946
1994,16,h) 11 to 15,2819,3158,40357,40154,153,4.8,252,7.8,6573,2186,4387,5.4,16.4,6166,2097,4069,5.2,15.4,407,1,30.8,0,166,166,1067
1994,16,i) 16 to 20,1105,1351,19583,19682,48,3.5,118,8.5,2217,332,1885,1.7,11.3,2415,751,1664,3.8,12.3,-198,-1,22.6,0,63,63,418
1994,16,l) Left Censored,4422,7446,179607,175279,398,5.3,407,5.5,24467,5665,18802,3.2,14,15810,4379,11431,2.5,9,8657,5,18,0,164,171,867
1994,17,a) 0,19951,20083,129579,65016,19944,198.6,0,0,129126,129126,0,198.6,198.6,0,0,0,0,0,129126,198.6,0,0,,,
1994,17,b) 1,15421,15525,109882,109499,79,0.5,3599,20.6,30657,1764,28893,1.6,28,29891,15223,14668,13.9,27.3,766,0.7,54.6,0,2823,2823,12839
1994,17,c) 2,12910,13307,117113,120992,416,2.9,2275,15.9,24513,2842,21671,2.3,20.3,32270,13724,18546,11.3,26.7,-7757,-6.4,40.6,0,1774,1774,10895
1994,17,d) 3,11705,12204,101315,105123,367,2.8,1723,13.3,19019,3478,15541,3.3,18.1,26634,12192,14442,11.6,25.3,-7615,-7.2,36.2,0,1338,1339,10364
1994,17,e) 4,11168,11559,124072,122063,337,2.8,1455,12,24305,2401,21904,2,19.9,20287,8313,11974,6.8,16.6,4018,3.3,33.2,0,1071,1072,6301
1994,17,f) 5,9934,10370,96061,96903,306,2.8,1169,10.8,15921,2030,13891,2.1,16.4,17604,6949,10655,7.2,18.2,-1683,-1.8,32.8,0,908,908,5301
1994,17,g) 6 to 10,41243,44279,559051,563871,1280,2.8,4017,8.8,74697,9768,64929,1.7,13.2,84337,27546,56791,4.9,15,-9640,-1.8,26.4,0,2881,2891,18265
1994,17,h) 11 to 15,26474,29673,429061,429297,925,3.1,2127,7,53023,9782,43241,2.3,12.4,53494,15697,37797,3.7,12.5,-471,-0.1,24.8,0,1400,1402,9883
1994,17,i) 16 to 20,10179,13392,220266,220184,496,3.6,878,6.5,27756,7297,20459,3.3,12.6,27592,8039,19553,3.7,12.5,164,0.1,25,0,467,471,4090
1994,17,l) Left Censored,50864,84995,2848274,2843264,3585,4.2,5596,6.5,313806,76492,237314,2.7,11,303786,89827,213959,3.2,10.7,10020,0.3,21.4,0,2287,2324,18271
1994,18,a) 0,9848,9914,54658,27416,9840,198.5,0,0,54484,54484,0,198.7,198.7,0,0,0,0,0,54484,198.7,0,0,,,
1994,18,b) 1,7389,7429,47784,47588,46,0.5,1791,21.3,13514,977,12537,2.1,28.4,13121,7677,5444,16.1,27.6,393,0.8,55.2,0,1458,1458,6249
1994,18,c) 2,6172,6380,55398,56184,138,2,1119,16.2,12421,1038,11383,1.8,22.1,13993,6867,7126,12.2,24.9,-1572,-2.8,44.2,0,896,896,4872
1994,18,d) 3,5587,5861,49038,50440,163,2.6,873,14,8213,959,7254,1.9,16.3,11016,5102,5914,10.1,21.8,-2803,-5.5,32.6,0,685,685,3764
1994,18,e) 4,5243,5469,49998,49831,189,3.3,671,11.7,10418,2134,8284,4.3,20.9,10084,5496,4588,11,20.2,334,0.7,40.4,0,512,527,3448
1994,18,f) 5,4599,4939,53551,54123,142,2.8,585,11.3,7983,1065,6918,2,14.7,9127,3311,5816,6.1,16.9,-1144,-2.2,29.4,0,459,459,2476
1994,18,g) 6 to 10,19295,21074,254582,254864,572,2.6,1779,8.2,34633,5327,29306,2.1,13.6,35197,12142,23055,4.8,13.8,-564,-0.2,27.2,0,1321,1328,8132
1994,18,h) 11 to 15,11914,13407,179109,178133,379,2.8,943,6.9,23771,4142,19629,2.3,13.3,21818,7216,14602,4.1,12.2,1953,1.1,24.4,0,637,637,4141
1994,18,i) 16 to 20,4727,6550,113056,112360,282,4.3,425,6.4,14968,2861,12107,2.5,13.3,13575,3779,9796,3.4,12.1,1393,1.2,24.2,0,231,233,1863
1994,18,l) Left Censored,24156,43002,1402918,1402643,1744,4,2519,5.8,154623,38679,115944,2.8,11,154073,46098,107975,3.3,11,550,0,22,0,952,974,6775
1994,19,a) 0,5005,5037,25397,12741,5004,198.7,0,0,25312,25312,0,198.7,198.7,0,0,0,0,0,25312,198.7,0,0,,,
1994,19,b) 1,3653,3663,21445,22035,12,0.3,847,20.5,5184,205,4979,0.9,23.5,6363,3655,2708,16.6,28.9,-1179,-5.4,47,0,649,649,2848
1994,19,c) 2,3220,3327,26511,27597,116,3.3,582,16.3,4689,955,3734,3.5,17,6860,2876,3984,10.4,24.9,-2171,-7.9,34,0,479,481,2389
1994,19,d) 3,2898,3000,25440,24729,90,2.8,407,12.8,7259,608,6651,2.5,29.4,5836,2693,3143,10.9,23.6,1423,5.8,47.2,0,310,312,2041
1994,19,e) 4,2680,2759,20125,21005,79,2.7,386,13.2,3083,362,2721,1.7,14.7,4842,2027,2815,9.7,23.1,-1759,-8.4,29.4,0,291,291,1542
1994,19,f) 5,2391,2531,21374,21928,87,3.3,312,11.8,3089,447,2642,2,14.1,4196,1708,2488,7.8,19.1,-1107,-5,28.2,0,234,234,948
1994,19,g) 6 to 10,10271,11056,130547,131036,281,2.5,934,8.2,17193,3890,13303,3,13.1,18171,6057,12114,4.6,13.9,-978,-0.8,26.2,0,694,699,3723
1994,19,h) 11 to 15,7286,8497,95905,95952,260,3,639,7.3,12112,1923,10189,2,12.6,12206,3985,8221,4.2,12.7,-94,-0.1,25.2,0,448,448,2757
1994,19,i) 16 to 20,3198,4419,53526,53628,137,3.1,248,5.5,6747,1212,5535,2.3,12.6,6950,1669,5281,3.1,13,-203,-0.4,25.2,0,146,146,787
1994,19,l) Left Censored,16027,25432,648531,645621,884,3.4,1440,5.6,65482,14054,51428,2.2,10.1,59663,19847,39816,3.1,9.2,5819,0.9,18.4,0,634,639,3328
1994,20,a) 0,5097,5134,27988,14062,5085,198.1,0,0,27852,27852,0,198.1,198.1,0,0,0,0,0,27852,198.1,0,0,,,
1994,20,b) 1,3750,3780,25005,25438,24,0.6,991,23,6427,262,6165,1,25.3,7293,4642,2651,18.2,28.7,-866,-3.4,50.6,0,805,805,3983
1994,20,c) 2,3128,3215,23106,23848,118,3.4,629,18,5557,1051,4506,4.4,23.3,7041,3959,3082,16.6,29.5,-1484,-6.2,46.6,0,505,505,2942
1994,20,d) 3,2702,2821,20559,20827,110,3.7,390,13.2,3913,457,3456,2.2,18.8,4449,2015,2434,9.7,21.4,-536,-2.6,37.6,0,311,311,1610
1994,20,e) 4,2432,2535,21066,21158,95,3.6,354,13.3,4605,668,3937,3.2,21.8,4789,2391,2398,11.3,22.6,-184,-0.8,43.6,0,253,253,1362
1994,20,f) 5,2234,2344,20317,21152,83,3.4,329,13.3,3122,541,2581,2.6,14.8,4791,2072,2719,9.8,22.7,-1669,-7.9,29.6,0,253,255,1721
1994,20,g) 6 to 10,9667,10298,110457,110440,340,3.2,996,9.4,14600,2289,12311,2.1,13.2,14565,5400,9165,4.9,13.2,35,0,26.4,0,703,707,3796
1994,20,h) 11 to 15,6743,7554,82655,82449,204,2.6,533,6.9,10409,1342,9067,1.6,12.6,9997,2504,7493,3,12.1,412,0.5,24.2,0,379,379,1546
1994,20,i) 16 to 20,2564,3556,53139,52478,141,3.9,230,6.4,6891,1592,5299,3,13.1,5569,1821,3748,3.5,10.6,1322,2.5,21.2,0,117,117,568
1994,20,l) Left Censored,13029,21041,543575,541180,932,4.4,1350,6.4,60749,15428,45321,2.9,11.2,55960,15571,40389,2.9,10.3,4789,0.9,20.6,0,555,595,4108
1994,21,a) 0,6166,6203,37365,18739,6164,198.7,0,0,37253,37253,0,198.8,198.8,0,0,0,0,0,37253,198.8,0,0,,,
1994,21,b) 1,4871,4912,35442,35111,31,0.6,1159,21,10272,1200,9072,3.4,29.3,9610,5350,4260,15.2,27.4,662,1.9,54.8,0,1004,1004,4788
1994,21,c) 2,3916,4063,31289,32349,102,2.3,768,17.4,6638,425,6213,1.3,20.5,8757,4352,4405,13.5,27.1,-2119,-6.6,41,0,628,628,3737
1994,21,d) 3,3340,3429,29609,30221,103,2.8,563,15.3,6899,513,6386,1.7,22.8,8123,3911,4212,12.9,26.9,-1224,-4.1,45.6,0,447,447,2686
1994,21,e) 4,3279,3395,28727,29883,84,2.3,470,13.1,4841,519,4322,1.7,16.2,7153,3408,3745,11.4,23.9,-2312,-7.7,32.4,0,374,376,2635
1994,21,f) 5,2956,3123,29578,30227,91,2.8,395,12.1,5044,986,4058,3.3,16.7,6341,2480,3861,8.2,21,-1297,-4.3,33.4,0,319,319,2073
1994,21,g) 6 to 10,12225,13182,161534,163171,395,2.9,1208,8.9,21761,4830,16931,3,13.3,25034,8097,16937,5,15.3,-3273,-2,26.6,0,918,923,6083
1994,21,h) 11 to 15,7198,8033,119928,121498,233,2.8,578,7,13203,2264,10939,1.9,10.9,16343,4376,11967,3.6,13.5,-3140,-2.6,21.8,0,395,396,2544
1994,21,i) 16 to 20,2912,3887,59358,58836,214,5.5,256,6.5,7539,2102,5437,3.6,12.8,6494,1376,5118,2.3,11,1045,1.8,22,0,139,140,640
1994,21,l) Left Censored,14361,25147,739405,734986,1194,4.7,1656,6.5,83377,21096,62281,2.9,11.3,74538,20651,53887,2.8,10.1,8839,1.2,20.2,0,627,632,5302
1994,22,a) 0,7287,7353,50300,25275,7293,198.4,0,0,50050,50050,0,198,198,0,0,0,0,0,50050,198,0,0,,,
1994,22,b) 1,5253,5299,46956,46460,22,0.4,1403,23.1,13464,368,13096,0.8,29,12472,6757,5715,14.5,26.8,992,2.2,53.6,0,1148,1148,5754
1994,22,c) 2,4367,4489,37937,38994,122,2.5,792,16.3,8763,996,7767,2.6,22.5,10877,4642,6235,11.9,27.9,-2114,-5.4,45,0,642,642,3888
1994,22,d) 3,3761,3930,36354,38237,136,3.2,657,15.6,6745,815,5930,2.1,17.6,10511,4369,6142,11.4,27.5,-3766,-9.9,35.2,0,538,538,3736
1994,22,e) 4,3363,3480,32300,32750,128,3.5,471,12.9,5713,769,4944,2.3,17.4,6612,2499,4113,7.6,20.2,-899,-2.8,34.8,0,365,367,2047
1994,22,f) 5,2814,2933,28641,28524,69,2.3,342,11.2,5718,339,5379,1.2,20,5483,1820,3663,6.4,19.2,235,0.8,38.4,0,279,280,1511
1994,22,g) 6 to 10,12904,14066,166793,169034,466,3.2,1329,9.2,23594,4866,18728,2.9,14,28075,9585,18490,5.7,16.6,-4481,-2.6,28,0,950,950,6901
1994,22,h) 11 to 15,10135,11568,147324,149445,399,3.4,959,8.1,19663,3965,15698,2.7,13.2,23904,6741,17163,4.5,16,-4241,-2.8,26.4,0,655,661,3858
1994,22,i) 16 to 20,3346,4275,65302,66215,161,3.7,294,6.8,9170,1841,7329,2.8,13.8,10995,2311,8684,3.5,16.6,-1825,-2.8,27.6,0,162,174,1012
1994,22,l) Left Censored,15558,27790,731708,729736,1239,4.4,1823,6.5,83441,19645,63796,2.7,11.4,79497,22375,57122,3.1,10.9,3944,0.5,21.8,0,687,696,5765
1994,23,a) 0,2523,2532,11729,5889,2510,198.3,0,0,11681,11681,0,198.4,198.4,0,0,0,0,0,11681,198.4,0,0,,,
1994,23,b) 1,1836,1850,11214,11233,6,0.3,497,23.3,3034,49,2985,0.4,27,3071,1845,1226,16.4,27.3,-37,-0.3,54,0,388,388,1564
1994,23,c) 2,1505,1581,10168,11187,58,3.4,285,16.8,2424,232,2192,2.1,21.7,4462,2923,1539,26.1,39.9,-2038,-18.2,43.4,0,230,230,2727
1994,23,d) 3,1360,1415,8884,9221,46,3.1,204,13.6,1588,408,1180,4.4,17.2,2261,951,1310,10.3,24.5,-673,-7.3,34.4,0,168,168,833
1994,23,e) 4,1386,1415,9948,10311,46,3.1,192,12.9,1827,142,1685,1.4,17.7,2553,977,1576,9.5,24.8,-726,-7.1,35.4,0,157,157,850
1994,23,f) 5,1489,1527,9998,10391,57,3.6,151,9.6,1413,145,1268,1.4,13.6,2198,740,1458,7.1,21.2,-785,-7.6,27.2,0,131,131,485
1994,23,g) 6 to 10,5741,6056,55477,56218,211,3.4,655,10.4,7641,1021,6620,1.8,13.6,9122,3583,5539,6.4,16.2,-1481,-2.6,27.2,0,462,462,2179
1994,23,h) 11 to 15,3076,3434,40479,40828,110,3.1,269,7.6,4667,894,3773,2.2,11.4,5364,1333,4031,3.3,13.1,-697,-1.7,22.8,0,182,182,926
1994,23,i) 16 to 20,1221,1679,21877,21487,71,4.2,98,5.8,3190,960,2230,4.5,14.8,2410,506,1904,2.4,11.2,780,3.6,22.4,0,59,59,198
1994,23,l) Left Censored,5474,8653,228589,228540,353,4,540,6.2,25283,6113,19170,2.7,11.1,25184,6586,18598,2.9,11,99,0.1,22,0,229,233,1631
1994,24,a) 0,8787,8863,51194,25683,8817,199,0,0,51023,51023,0,198.7,198.7,0,0,0,0,0,51023,198.7,0,0,,,
1994,24,b) 1,6769,6846,49615,48438,35,0.4,1757,22.6,15800,441,15359,0.9,32.6,13446,7467,5979,15.4,27.8,2354,4.8,55.6,0,1364,1364,6105
1994,24,c) 2,5453,5643,42846,44979,205,3.4,1084,17.8,8594,1216,7378,2.7,19.1,12859,5841,7018,13,28.6,-4265,-9.5,38.2,0,843,843,4456
1994,24,d) 3,4978,5134,42278,42951,182,3.3,824,15.1,9297,1255,8042,2.9,21.6,10643,5283,5360,12.3,24.8,-1346,-3.2,43.2,0,629,629,3865
1994,24,e) 4,4871,5000,40871,42105,187,3.6,676,12.9,7148,792,6356,1.9,17,9616,4361,5255,10.4,22.8,-2468,-5.8,34,0,491,493,3499
1994,24,f) 5,4555,4723,41438,42561,147,3,604,12.2,6753,1046,5707,2.5,15.9,8999,3974,5025,9.3,21.1,-2246,-5.2,31.8,0,459,459,2905
1994,24,g) 6 to 10,18070,19479,229049,229470,683,3.4,1924,9.6,34707,5879,28828,2.6,15.1,35549,12372,23177,5.4,15.5,-842,-0.4,30.2,0,1314,1333,8072
1994,24,h) 11 to 15,10123,11468,150733,151998,327,2.8,919,7.8,18748,3229,15519,2.1,12.3,21278,6015,15263,4,14,-2530,-1.7,24.6,0,516,535,3150
1994,24,i) 16 to 20,3731,5208,85107,85586,199,3.7,390,7.3,10574,1952,8622,2.3,12.4,11532,2763,8769,3.2,13.5,-958,-1.1,24.8,0,172,186,1080
1994,24,l) Left Censored,18350,33086,996745,1004098,1509,4.5,2273,6.8,121348,33808,87540,3.4,12.1,136055,40702,95353,4.1,13.5,-14707,-1.4,24.2,0,727,744,7085
1994,25,a) 0,10467,10500,58561,29371,10436,198.8,0,0,58380,58380,0,198.8,198.8,0,0,0,0,0,58380,198.8,0,0,,,
1994,25,b) 1,7614,7656,55591,53742,42,0.5,1706,19.9,17830,1676,16154,3.1,33.2,14131,7315,6816,13.6,26.3,3699,6.9,52.6,0,1342,1342,5894
1994,25,c) 2,6279,6592,58304,60915,209,3,1104,15.6,11446,1559,9887,2.6,18.8,16667,7975,8692,13.1,27.4,-5221,-8.6,37.6,0,886,886,7037
1994,25,d) 3,5525,5701,49094,49777,190,3.2,791,13.2,9517,1055,8462,2.1,19.1,10883,4972,5911,10,21.9,-1366,-2.8,38.2,0,604,604,3888
1994,25,e) 4,5466,5691,51473,51411,215,3.6,725,12.2,9776,1213,8563,2.4,19,9652,4209,5443,8.2,18.8,124,0.2,37.6,0,577,579,3426
1994,25,f) 5,5626,5834,51623,52748,205,3.3,819,13.3,8769,1103,7666,2.1,16.6,11019,4869,6150,9.2,20.9,-2250,-4.3,33.2,0,586,586,3008
1994,25,g) 6 to 10,24039,25591,316195,318400,899,3.4,2514,9.5,43101,5279,37822,1.7,13.5,47511,16527,30984,5.2,14.9,-4410,-1.4,27,0,1772,1775,11578
1994,25,h) 11 to 15,14343,16266,234172,237505,523,3.1,1300,7.8,31502,6298,25204,2.7,13.3,38167,9445,28722,4,16.1,-6665,-2.8,26.6,0,814,820,4404
1994,25,i) 16 to 20,5208,7278,156120,157071,290,3.9,493,6.7,17026,3504,13522,2.2,10.8,18927,6840,12087,4.4,12,-1901,-1.2,21.6,0,250,253,4819
1994,25,l) Left Censored,30476,47916,1581168,1588664,1988,4.1,3231,6.7,183659,44524,139135,2.8,11.6,198650,55505,143145,3.5,12.5,-14991,-0.9,23.2,0,1372,1394,12985
1994,26,a) 0,14979,15059,88480,44434,14949,198.5,0,0,88093,88093,0,198.3,198.3,0,0,0,0,0,88093,198.3,0,0,,,
1994,26,b) 1,11605,11716,86591,84691,60,0.5,2444,18.7,25620,2761,22859,3.3,30.3,21819,11545,10274,13.6,25.8,3801,4.5,51.6,0,1853,1853,8531
1994,26,c) 2,9892,10147,79664,82980,312,2.9,1676,15.4,17370,1691,15679,2,20.9,24001,10402,13599,12.5,28.9,-6631,-8,41.8,0,1341,1341,8439
1994,26,d) 3,9117,9442,78250,79990,283,2.8,1327,13.3,14951,1206,13745,1.5,18.7,18431,8475,9956,10.6,23,-3480,-4.3,37.4,0,1037,1037,6583
1994,26,e) 4,8816,9124,83990,84560,290,3,1116,11.7,16073,1696,14377,2,19,17212,6623,10589,7.8,20.4,-1139,-1.4,38,0,906,908,5082
1994,26,f) 5,7675,8060,72666,73769,264,3.1,964,11.5,12834,1872,10962,2.5,17.4,15040,5787,9253,7.8,20.4,-2206,-3,34.8,0,792,794,4691
1994,26,g) 6 to 10,31973,34707,402078,401410,1058,3,3145,8.8,61969,11733,50236,2.9,15.4,60633,23989,36644,6,15.1,1336,0.3,30.2,0,2307,2337,16793
1994,26,h) 11 to 15,19546,22225,288431,288797,643,2.8,1566,6.9,38280,6437,31843,2.2,13.3,39011,13133,25878,4.5,13.5,-731,-0.2,26.6,0,1033,1036,7656
1994,26,i) 16 to 20,7552,10292,164970,163575,379,3.6,653,6.3,24503,4610,19893,2.8,15,21712,5337,16375,3.3,13.3,2791,1.7,26.6,0,354,356,2370
1994,26,l) Left Censored,36358,64150,2144063,2141574,2524,3.9,3911,6,233131,59936,173195,2.8,10.9,228153,78182,149971,3.7,10.7,4978,0.2,21.4,0,1576,1659,13774
1994,27,a) 0,8857,8907,51255,25700,8852,198.8,0,0,51111,51111,0,198.9,198.9,0,0,0,0,0,51111,198.9,0,0,,,
1994,27,b) 1,6727,6795,49875,49514,32,0.4,1500,19.7,13782,1245,12537,2.5,27.8,13059,7705,5354,15.6,26.4,723,1.4,52.8,0,1152,1152,5810
1994,27,c) 2,5665,5835,42343,45074,167,2.7,954,15.3,8439,959,7480,2.1,18.7,13901,7327,6574,16.3,30.8,-5462,-12.1,37.4,0,753,753,6014
1994,27,d) 3,5133,5362,46889,46941,154,2.7,707,12.5,8946,1319,7627,2.8,19.1,9050,4138,4912,8.8,19.3,-104,-0.2,38.2,0,538,538,3245
1994,27,e) 4,4711,4906,44008,43713,157,3.1,548,10.7,8602,1285,7317,2.9,19.7,8012,3117,4895,7.1,18.3,590,1.4,36.6,0,434,436,2451
1994,27,f) 5,4265,4438,39905,40090,123,2.7,428,9.3,6468,896,5572,2.2,16.1,6837,2286,4551,5.7,17.1,-369,-1,32.2,0,335,335,1837
1994,27,g) 6 to 10,17188,18648,234670,236105,494,2.6,1568,8.2,31477,4452,27025,1.9,13.3,34348,12170,22178,5.2,14.5,-2871,-1.2,26.6,0,1119,1119,8391
1994,27,h) 11 to 15,10746,12352,175721,174692,389,3.1,894,7.1,24364,4838,19526,2.8,13.9,22306,6818,15488,3.9,12.8,2058,1.1,25.6,0,552,558,3445
1994,27,i) 16 to 20,4434,6025,97701,97330,252,4.1,412,6.7,12455,3488,8967,3.6,12.8,11712,3714,7998,3.8,12,743,0.8,24,0,204,204,1285
1994,27,l) Left Censored,20990,34667,1173983,1170635,1506,4.3,1952,5.6,119775,24840,94935,2.1,10.2,113079,32422,80657,2.8,9.7,6696,0.5,19.4,0,785,806,7623
1994,28,a) 0,4514,4540,34891,17561,4499,198.2,0,0,34661,34661,0,197.4,197.4,0,0,0,0,0,34661,197.4,0,0,,,
1994,28,b) 1,3259,3292,28733,27214,17,0.4,1011,26.4,9899,715,9184,2.6,36.4,6860,4222,2638,15.5,25.2,3039,11.2,50.4,0,847,847,3637
1994,28,c) 2,2433,2518,18679,19616,73,2.6,555,19.9,3357,441,2916,2.2,17.1,5231,2647,2584,13.5,26.7,-1874,-9.6,34.2,0,461,461,2310
1994,28,d) 3,2239,2333,19219,19552,75,3,392,15.7,3586,330,3256,1.7,18.3,4252,1739,2513,8.9,21.7,-666,-3.4,36.6,0,327,327,1304
1994,28,e) 4,2112,2168,16952,17828,72,3.1,343,14.9,2790,314,2476,1.8,15.6,4542,1754,2788,9.8,25.5,-1752,-9.9,31.2,0,283,283,1452
1994,28,f) 5,1738,1787,18460,18030,66,3.5,223,11.9,4316,916,3400,5.1,23.9,3455,1398,2057,7.8,19.2,861,4.7,38.4,0,180,184,1154
1994,28,g) 6 to 10,7784,8316,92464,94122,271,3.1,905,10.5,13499,2367,11132,2.5,14.3,16815,6561,10254,7,17.9,-3316,-3.6,28.6,0,692,699,4178
1994,28,h) 11 to 15,5233,5864,72219,71926,155,2.6,476,7.9,9943,1524,8419,2.1,13.8,9357,3145,6212,4.4,13,586,0.8,26,0,343,343,1837
1994,28,i) 16 to 20,2084,2707,37840,36116,107,3.9,181,6.6,7470,1059,6411,2.9,20.7,4021,1222,2799,3.4,11.1,3449,9.6,22.2,0,106,106,765
1994,28,l) Left Censored,9649,16653,476624,469431,686,4.1,1096,6.5,59223,19664,39559,4.2,12.6,44836,14204,30632,3,9.6,14387,3,19.2,0,459,464,2863
1994,29,a) 0,10956,11061,59466,29816,10984,198.6,0,0,59301,59301,0,198.9,198.9,0,0,0,0,0,59301,198.9,0,0,,,
1994,29,b) 1,7803,7918,53749,54126,51,0.6,2223,24.4,15578,778,14800,1.4,28.8,16331,9544,6787,17.6,30.2,-753,-1.4,57.6,0,1820,1820,7958
1994,29,c) 2,6293,6468,51495,53637,225,3.2,1326,18.8,11255,1454,9801,2.7,21,15538,7211,8327,13.4,29,-4283,-8,42,0,1077,1079,6152
1994,29,d) 3,5535,5811,47108,47454,203,3.3,920,14.9,9630,1576,8054,3.3,20.3,10323,4643,5680,9.8,21.8,-693,-1.5,40.6,0,745,745,3836
1994,29,e) 4,5088,5256,46166,48363,175,3.1,769,13.8,7545,649,6896,1.3,15.6,11938,6055,5883,12.5,24.7,-4393,-9.1,31.2,0,609,611,4442
1994,29,f) 5,4797,5056,42013,43355,192,3.6,673,12.7,7727,1246,6481,2.9,17.8,10411,4828,5583,11.1,24,-2684,-6.2,35.6,0,519,522,3835
1994,29,g) 6 to 10,19898,21392,241117,242486,632,2.9,2097,9.5,34089,3947,30142,1.6,14.1,36826,14004,22822,5.8,15.2,-2737,-1.1,28.2,0,1553,1556,9358
1994,29,h) 11 to 15,12040,13733,173705,173850,412,2.9,1068,7.6,23343,4393,18950,2.5,13.4,23633,7762,15871,4.5,13.6,-290,-0.2,26.8,0,723,727,4572
1994,29,i) 16 to 20,4729,6460,100075,98962,249,3.8,422,6.4,14179,3966,10213,4,14.3,11953,2864,9089,2.9,12.1,2226,2.2,24.2,0,243,245,1366
1994,29,l) Left Censored,23181,39672,1249407,1243225,1860,4.6,2629,6.6,136524,32354,104170,2.6,11,124160,35251,88909,2.8,10,12364,1,20,0,1013,1028,7609
1994,30,a) 0,2390,2397,10553,5303,2386,199.1,0,0,10500,10500,0,198,198,0,0,0,0,0,10500,198,0,0,,,
1994,30,b) 1,1686,1698,8822,8886,6,0.3,453,23.3,2344,52,2292,0.6,26.4,2471,1417,1054,15.9,27.8,-127,-1.4,52.8,0,348,348,1133
1994,30,c) 2,1431,1451,8394,8916,47,3,268,17.1,1551,229,1322,2.6,17.4,2594,1187,1407,13.3,29.1,-1043,-11.7,34.8,0,215,215,1043
1994,30,d) 3,1196,1220,8100,8244,47,3.7,161,12.6,1425,164,1261,2,17.3,1713,794,919,9.6,20.8,-288,-3.5,34.6,0,127,127,526
1994,30,e) 4,1073,1084,7575,7875,33,2.9,132,11.7,1135,153,982,1.9,14.4,1735,568,1167,7.2,22,-600,-7.6,28.8,0,90,90,407
1994,30,f) 5,901,952,6598,6854,27,2.7,111,11.1,876,63,813,0.9,12.8,1387,531,856,7.7,20.2,-511,-7.4,25.6,0,81,81,337
1994,30,g) 6 to 10,3996,4257,37574,38790,152,3.4,454,10.3,5222,704,4518,1.8,13.5,7654,2363,5291,6.1,19.7,-2432,-6.2,27,0,336,336,1746
1994,30,h) 11 to 15,2894,3243,31122,31429,106,3.2,266,8,3837,483,3354,1.5,12.2,4451,1241,3210,3.9,14.2,-614,-2,24.4,0,180,180,945
1994,30,i) 16 to 20,1095,1330,12821,13199,49,3.6,80,5.9,1475,197,1278,1.5,11.2,2230,569,1661,4.3,16.9,-755,-5.7,22.4,0,52,52,394
1994,30,l) Left Censored,4246,6574,114236,114888,243,3.7,379,5.7,11451,2584,8867,2.2,10,12755,4039,8716,3.5,11.1,-1304,-1.1,20,0,189,189,964
1994,31,a) 0,3134,3168,16475,8263,3142,198.4,0,0,16425,16425,0,198.8,198.8,0,0,0,0,0,16425,198.8,0,0,,,
1994,31,b) 1,2347,2361,15421,15731,15,0.6,549,20.7,3792,151,3641,1,24.1,4411,2511,1900,16,28,-619,-3.9,48.2,0,420,420,2156
1994,31,c) 2,2029,2071,13778,15110,45,2,379,16.9,2336,273,2063,1.8,15.5,5000,2196,2804,14.5,33.1,-2664,-17.6,31,0,305,306,1896
1994,31,d) 3,1736,1802,12575,12746,46,2.4,293,15.1,2522,148,2374,1.2,19.8,2863,1391,1472,10.9,22.5,-341,-2.7,39.6,0,218,220,1129
1994,31,e) 4,1705,1784,14809,15275,62,3.3,227,12.1,2592,374,2218,2.4,17,3523,1377,2146,9,23.1,-931,-6.1,34,0,182,182,1059
1994,31,f) 5,1521,1600,18029,17598,41,2.5,164,9.8,2958,644,2314,3.7,16.8,2095,843,1252,4.8,11.9,863,4.9,23.8,0,135,135,692
1994,31,g) 6 to 10,6618,7117,82084,82903,189,2.6,573,7.8,10201,1844,8357,2.2,12.3,11838,4572,7266,5.5,14.3,-1637,-2,24.6,0,428,429,2726
1994,31,h) 11 to 15,4548,5122,56449,57250,164,3.1,357,6.8,7115,1775,5340,3.1,12.4,8716,2559,6157,4.5,15.2,-1601,-2.8,24.8,0,234,234,1282
1994,31,i) 16 to 20,1931,2553,33112,32661,97,3.8,146,5.7,4255,979,3276,3,13,3352,758,2594,2.3,10.3,903,2.7,20.6,0,94,94,400
1994,31,l) Left Censored,9308,14293,367581,363952,621,4.3,902,6.2,39894,10628,29266,2.9,11,32636,11799,20837,3.2,9,7258,2,18,0,408,414,2237
1994,32,a) 0,3688,3706,28062,14174,3675,198.3,0,0,27777,27777,0,196,196,0,0,0,0,0,27777,196,0,0,,,
1994,32,b) 1,2420,2437,21927,21784,15,0.5,764,26.9,7558,444,7114,2,34.7,7271,4377,2894,20.1,33.4,287,1.3,66.8,0,638,639,3723
1994,32,c) 2,1854,1910,18430,19280,76,3.6,425,20.2,4278,436,3842,2.3,22.2,5977,3023,2954,15.7,31,-1699,-8.8,44.4,0,335,335,2579
1994,32,d) 3,1653,1708,17310,17768,74,4.1,286,15.7,4302,402,3900,2.3,24.2,5218,2916,2302,16.4,29.4,-916,-5.2,48.4,0,225,225,2509
1994,32,e) 4,1515,1577,16937,17446,71,4.3,250,15,3122,337,2785,1.9,17.9,4140,2229,1911,12.8,23.7,-1018,-5.8,35.8,0,194,194,1814
1994,32,f) 5,1355,1418,17213,17384,71,4.8,187,12.7,3199,374,2825,2.2,18.4,3540,1191,2349,6.9,20.4,-341,-2,36.8,0,148,149,990
1994,32,g) 6 to 10,4741,5264,77475,77910,247,4.5,576,10.6,14238,1929,12309,2.5,18.3,15107,7460,7647,9.6,19.4,-869,-1.1,36.6,0,386,387,5949
1994,32,h) 11 to 15,3176,3704,78886,75654,179,4.8,286,7.6,14891,2378,12513,3.1,19.7,8427,3333,5094,4.4,11.1,6464,8.6,22.2,0,178,178,2349
1994,32,i) 16 to 20,1067,1430,29134,29377,68,4.7,96,6.6,3784,617,3167,2.1,12.9,4269,659,3610,2.2,14.5,-485,-1.6,25.8,0,47,47,179
1994,32,l) Left Censored,4081,7163,314417,303481,525,7.3,502,7,48983,12305,36678,4.1,16.1,27110,9013,18097,3,8.9,21873,7.2,17.8,0,148,151,1953
1994,33,a) 0,2565,2575,13098,6565,2558,198.7,0,0,13067,13067,0,199,199,0,0,0,0,0,13067,199,0,0,,,
1994,33,b) 1,1804,1819,11000,10762,11,0.5,483,23.2,3421,91,3330,0.8,31.8,2945,1716,1229,15.9,27.4,476,4.4,54.8,0,392,392,1453
1994,33,c) 2,1503,1567,11174,11558,53,3.2,256,15.3,2467,232,2235,2,21.3,3234,1275,1959,11,28,-767,-6.7,42.6,0,201,201,1014
1994,33,d) 3,1327,1359,9891,10345,34,2.3,215,14.8,1866,135,1731,1.3,18,2773,1729,1044,16.7,26.8,-907,-8.8,36,0,168,168,707
1994,33,e) 4,1295,1332,10009,10047,46,3.3,189,13.4,1808,147,1661,1.5,18,1884,826,1058,8.2,18.8,-76,-0.8,36,0,150,150,641
1994,33,f) 5,1339,1391,17390,16954,50,3.4,190,13,2623,257,2366,1.5,15.5,1750,793,957,4.7,10.3,873,5.2,20.6,0,153,153,552
1994,33,g) 6 to 10,5801,6126,61522,61286,276,4.4,628,9.9,10412,2437,7975,4,17,9939,3830,6109,6.2,16.2,473,0.8,32.4,0,444,444,2646
1994,33,h) 11 to 15,2948,3223,36314,36023,129,3.9,245,7.5,5269,1077,4192,3,14.6,4687,1578,3109,4.4,13,582,1.6,26,0,160,160,961
1994,33,i) 16 to 20,1109,1538,23610,23416,80,5.1,114,7.3,3190,784,2406,3.3,13.6,2802,663,2139,2.8,12,388,1.6,24,0,55,55,216
1994,33,l) Left Censored,5247,8464,244081,241838,409,4.8,577,6.7,27865,5970,21895,2.5,11.5,23379,7403,15976,3.1,9.7,4486,1.8,19.4,0,199,200,1454
1994,34,a) 0,15292,15339,81018,40642,15231,198.6,0,0,80752,80752,0,198.7,198.7,0,0,0,0,0,80752,198.7,0,0,,,
1994,34,b) 1,11828,11875,77096,75291,38,0.3,2914,21.6,24027,1519,22508,2,31.9,20417,11524,8893,15.3,27.1,3610,4.8,54.2,0,2196,2196,8961
1994,34,c) 2,9608,9808,70061,74500,316,3,1677,15.9,15188,1343,13845,1.8,20.4,24065,13815,10250,18.5,32.3,-8877,-11.9,40.8,0,1329,1329,12188
1994,34,d) 3,8771,8949,62044,64548,313,3.3,1363,14.4,11504,1293,10211,2,17.8,16512,7498,9014,11.6,25.6,-5008,-7.8,35.6,0,1036,1036,5773
1994,34,e) 4,8366,8521,63565,66010,342,3.8,1208,13.5,10935,1467,9468,2.2,16.6,15824,6560,9264,9.9,24,-4889,-7.4,33.2,0,930,932,4886
1994,34,f) 5,8085,8330,75478,76268,295,3.4,1031,11.9,12652,1615,11037,2.1,16.6,14231,5421,8810,7.1,18.7,-1579,-2.1,33.2,0,787,787,4338
1994,34,g) 6 to 10,33250,34842,394877,402222,1109,3.1,3746,10.3,51118,7402,43716,1.8,12.7,65808,23389,42419,5.8,16.4,-14690,-3.7,25.4,0,2696,2707,17299
1994,34,h) 11 to 15,20535,22305,261309,264476,662,2.9,1787,7.8,33738,6959,26779,2.6,12.8,40071,10672,29399,4,15.2,-6333,-2.4,25.6,0,1185,1202,6669
1994,34,i) 16 to 20,7408,8796,135535,137183,239,2.6,672,7.4,16400,3050,13350,2.2,12,19696,4481,15215,3.3,14.4,-3296,-2.4,24,0,382,411,2939
1994,34,l) Left Censored,38003,59368,1843347,1859214,2774,4.6,4336,7.2,209522,60709,148813,3.3,11.3,241256,75222,166034,4,13,-31734,-1.7,22.6,0,1725,1747,14325
1994,35,a) 0,3460,3489,19503,9814,3452,197.9,0,0,19379,19379,0,197.5,197.5,0,0,0,0,0,19379,197.5,0,0,,,
1994,35,b) 1,2359,2374,16256,16522,10,0.4,671,24.5,4756,388,4368,2.3,28.8,5288,3377,1911,20.4,32,-532,-3.2,57.6,0,531,531,2532
1994,35,c) 2,1931,2003,15582,16177,72,3.3,417,19.1,3354,433,2921,2.7,20.7,4544,2489,2055,15.4,28.1,-1190,-7.4,41.4,0,337,337,1930
1994,35,d) 3,1807,1916,15287,15619,72,3.5,334,16.3,3311,699,2612,4.5,21.2,3975,1935,2040,12.4,25.4,-664,-4.2,42.4,0,257,257,1507
1994,35,e) 4,1575,1603,12498,13121,63,3.7,254,14.9,2398,354,2044,2.7,18.3,3644,1749,1895,13.3,27.8,-1246,-9.5,36.6,0,196,196,1402
1994,35,f) 5,1427,1493,11769,12195,51,3.3,195,12.4,2200,339,1861,2.8,18,3052,1468,1584,12,25,-852,-7,36,0,145,145,1130
1994,35,g) 6 to 10,5612,6078,68023,68565,246,3.9,648,10.3,9856,1259,8597,1.8,14.4,10940,4019,6921,5.9,16,-1084,-1.6,28.8,0,474,476,2772
1994,35,h) 11 to 15,4076,4669,53885,53351,180,3.8,355,7.5,8556,1684,6872,3.2,16,7487,2168,5319,4.1,14,1069,2,28,0,254,257,1324
1994,35,i) 16 to 20,1458,1928,22165,22090,94,4.8,143,7.3,3266,989,2277,4.5,14.8,3115,1063,2052,4.8,14.1,151,0.7,28.2,0,80,81,516
1994,35,l) Left Censored,5586,9410,235840,232870,534,5.7,573,6.1,32353,9196,23157,3.9,13.9,26414,7728,18686,3.3,11.3,5939,2.6,22.6,0,217,219,1107
1994,36,a) 0,33810,33870,181017,90789,33634,198.6,0,0,180456,180456,0,198.8,198.8,0,0,0,0,0,180456,198.8,0,0,,,
1994,36,b) 1,25833,26019,169583,170903,102,0.3,6992,23.5,47240,3094,44146,1.8,27.6,49880,29554,20326,17.3,29.2,-2640,-1.6,55.2,0,5532,5532,24766
1994,36,c) 2,21125,21559,155166,171634,670,2.8,4383,18.6,30018,3646,26372,2.1,17.5,62954,26188,36766,15.3,36.7,-32936,-19.2,35,0,3578,3581,20824
1994,36,d) 3,19413,19794,146513,153712,635,3,3309,15.6,25860,3596,22264,2.3,16.8,40257,19670,20587,12.8,26.2,-14397,-9.4,33.6,0,2614,2620,16489
1994,36,e) 4,18154,18544,138033,142265,623,3.2,2811,14.3,24338,2341,21997,1.6,17.1,32802,14100,18702,9.9,23.1,-8464,-6,34.2,0,2256,2263,12067
1994,36,f) 5,17218,17650,137566,143027,547,2.9,2606,13.9,21572,2243,19329,1.6,15.1,32493,14951,17542,10.5,22.7,-10921,-7.6,30.2,0,2068,2083,11408
1994,36,g) 6 to 10,70028,73452,798052,810690,2241,2.9,8088,10.6,97738,15225,82513,1.9,12.1,123013,44157,78856,5.4,15.2,-25275,-3.1,24.2,0,6109,6118,32818
1994,36,h) 11 to 15,42127,46216,585997,593807,1233,2.6,4190,8.8,71070,11352,59718,1.9,12,86690,27593,59097,4.6,14.6,-15620,-2.6,24,0,2895,2908,17247
1994,36,i) 16 to 20,15053,19271,336421,338275,565,2.9,1561,7.9,39510,6905,32605,2,11.7,43218,12568,30650,3.7,12.8,-3708,-1.1,23.4,0,879,920,6524
1994,36,l) Left Censored,83459,128248,3925702,3962860,5657,4.3,9720,7.5,423823,108694,315129,2.7,10.7,498140,131047,367093,3.3,12.6,-74317,-1.9,21.4,0,4493,4566,34278
1994,37,a) 0,13454,13533,76850,38555,13439,198.6,0,0,76590,76590,0,198.7,198.7,0,0,0,0,0,76590,198.7,0,0,,,
1994,37,b) 1,9609,9673,64268,64320,46,0.4,2411,22,19508,1801,17707,2.8,30.3,19612,11561,8051,18,30.5,-104,-0.2,60.6,0,1959,1959,9707
1994,37,c) 2,7790,8031,68620,70840,241,2.8,1512,17.4,13857,1211,12646,1.7,19.6,18296,9672,8624,13.7,25.8,-4439,-6.2,39.2,0,1204,1204,7607
1994,37,d) 3,7164,7451,59182,60400,231,2.9,1131,14.3,11603,1487,10116,2.5,19.2,14038,6021,8017,10,23.2,-2435,-4,38.4,0,907,907,4604
1994,37,e) 4,6862,7105,59169,60950,268,3.6,914,12.3,11058,1713,9345,2.8,18.1,14619,8071,6548,13.2,24,-3561,-5.9,36.2,0,713,713,6901
1994,37,f) 5,6132,6432,61113,61007,227,3.4,773,11.5,10880,1537,9343,2.5,17.8,10668,3972,6696,6.5,17.5,212,0.3,35,0,617,617,3282
1994,37,g) 6 to 10,27026,29541,325514,325264,1063,3.5,2624,8.6,48005,8593,39412,2.6,14.8,47504,18216,29288,5.6,14.6,501,0.2,29.2,0,1937,1943,12965
1994,37,h) 11 to 15,14699,16959,237262,235535,506,2.9,1192,6.9,32540,7045,25495,3,13.8,29086,8152,20934,3.5,12.3,3454,1.5,24.6,0,791,791,5115
1994,37,i) 16 to 20,5685,7609,121589,119865,312,4.1,453,5.9,15207,3316,11891,2.8,12.7,11759,2869,8890,2.4,9.8,3448,2.9,19.6,0,271,272,1347
1994,37,l) Left Censored,26286,50634,1732747,1715651,2227,4.4,2902,5.7,193833,50327,143506,2.9,11.3,159640,42064,117576,2.5,9.3,34193,2,18.6,0,1073,1110,7022
1994,38,a) 0,1312,1313,6227,3124,1303,198.5,0,0,6207,6207,0,198.7,198.7,0,0,0,0,0,6207,198.7,0,0,,,
1994,38,b) 1,1003,1006,6191,6127,3,0.3,247,21.7,1704,183,1521,3,27.8,1576,772,804,12.6,25.7,128,2.1,51.4,0,178,178,600
1994,38,c) 2,818,825,5290,5364,24,2.7,140,15.8,1187,142,1045,2.6,22.1,1334,564,770,10.5,24.9,-147,-2.8,44.2,0,105,106,467
1994,38,d) 3,746,764,5419,5307,23,2.8,102,12.6,1137,198,939,3.7,21.4,912,439,473,8.3,17.2,225,4.2,34.4,0,85,85,371
1994,38,e) 4,695,724,4555,4857,22,2.9,107,13.9,634,69,565,1.4,13.1,1238,443,795,9.1,25.5,-604,-12.4,26.2,0,82,82,356
1994,38,f) 5,590,607,4398,4434,18,2.8,75,11.8,646,74,572,1.7,14.6,718,233,485,5.3,16.2,-72,-1.6,29.2,0,57,57,198
1994,38,g) 6 to 10,2840,2997,25331,25641,80,2.6,228,7.4,3316,209,3107,0.8,12.9,3936,1312,2624,5.1,15.4,-620,-2.5,25.8,0,178,178,880
1994,38,h) 11 to 15,2133,2438,26051,26278,72,2.9,169,6.8,3077,464,2613,1.8,11.7,3531,943,2588,3.6,13.4,-454,-1.7,23.4,0,103,103,576
1994,38,i) 16 to 20,838,1011,11108,10984,29,2.8,67,6.5,1458,166,1292,1.5,13.3,1209,262,947,2.4,11,249,2.3,22,0,45,45,144
1994,38,l) Left Censored,4110,6136,123278,122611,206,3.3,320,5.2,11293,1694,9599,1.4,9.2,9960,2554,7406,2.1,8.1,1333,1.1,16.2,0,151,152,796
1994,39,a) 0,16651,16820,99067,49640,16725,198.9,0,0,98855,98855,0,199.1,199.1,0,0,0,0,0,98855,199.1,0,0,,,
1994,39,b) 1,12721,12867,99483,97036,86,0.6,2927,20.3,28578,3451,25127,3.6,29.5,23683,12898,10785,13.3,24.4,4895,5.1,48.8,0,2265,2265,10346
1994,39,c) 2,10566,10884,82316,85456,301,2.6,1876,16,16996,2428,14568,2.8,19.9,23275,11517,11758,13.5,27.2,-6279,-7.3,39.8,0,1517,1520,9770
1994,39,d) 3,9673,10051,83844,84467,306,2.9,1428,13.4,16857,2286,14571,2.7,20,18102,7254,10848,8.6,21.4,-1245,-1.4,40,0,1118,1118,5479
1994,39,e) 4,9181,9594,85152,86373,282,2.8,1169,11.6,14416,1988,12428,2.3,16.7,16858,6706,10152,7.8,19.5,-2442,-2.8,33.4,0,909,910,5003
1994,39,f) 5,8434,9046,96139,96718,291,3.1,1040,11,16905,2674,14231,2.8,17.5,18063,7409,10654,7.7,18.7,-1158,-1.2,35,0,811,812,4689
1994,39,g) 6 to 10,35417,38831,474048,477828,1182,3,3330,8.3,64786,10803,53983,2.3,13.6,72346,25235,47111,5.3,15.1,-7560,-1.5,27.2,0,2435,2446,17680
1994,39,h) 11 to 15,22654,26126,367102,367775,749,2.8,1888,7.1,45434,7977,37457,2.2,12.4,46781,14885,31896,4,12.7,-1347,-0.3,24.8,0,1263,1302,8765
1994,39,i) 16 to 20,9103,12608,204638,203438,497,3.9,805,6.3,28483,6901,21582,3.4,14,26082,7813,18269,3.8,12.8,2401,1.2,25.6,0,417,429,2415
1994,39,l) Left Censored,47809,86035,2732223,2723478,3771,4.3,5305,6.1,308222,85146,223076,3.1,11.3,290732,78092,212640,2.9,10.7,17490,0.6,21.4,0,1958,2024,13737
1994,40,a) 0,6455,6473,35462,17772,6438,198.9,0,0,35380,35380,0,199.1,199.1,0,0,0,0,0,35380,199.1,0,0,,,
1994,40,b) 1,4647,4675,31430,31059,28,0.5,1375,25.4,9330,514,8816,1.7,30,8587,5199,3388,16.7,27.6,743,2.4,55.2,0,1135,1135,4595
1994,40,c) 2,3769,3858,27410,28917,103,2.4,817,19.3,5977,731,5246,2.5,20.7,8990,5117,3873,17.7,31.1,-3013,-10.4,41.4,0,672,672,4524
1994,40,d) 3,3330,3442,25658,26357,134,3.7,563,15.4,4814,515,4299,2,18.3,6212,3484,2728,13.2,23.6,-1398,-5.3,36.6,0,447,447,3046
1994,40,e) 4,3068,3158,24990,25410,113,3.4,463,13.9,4636,509,4127,2,18.2,5476,2368,3108,9.3,21.6,-840,-3.4,36.4,0,364,364,2002
1994,40,f) 5,2618,2709,24579,25509,91,3.2,330,11.7,3463,477,2986,1.9,13.6,5322,1909,3413,7.5,20.9,-1859,-7.3,27.2,0,268,268,1644
1994,40,g) 6 to 10,11423,12316,132714,134412,416,3.3,1070,8.5,17027,2512,14515,1.9,12.7,20422,6561,13861,4.9,15.2,-3395,-2.5,25.4,0,812,813,4933
1994,40,h) 11 to 15,8521,9655,110571,110143,355,3.6,721,7.3,15050,3350,11700,3,13.7,14193,3903,10290,3.5,12.9,857,0.8,25.8,0,487,487,2412
1994,40,i) 16 to 20,2814,3725,50302,50400,135,3.5,290,7.6,7095,1578,5517,3.1,14.1,7290,2778,4512,5.5,14.5,-195,-0.4,28.2,0,166,167,1057
1994,40,l) Left Censored,12557,21608,533258,536005,896,4.1,1313,6,56490,12859,43631,2.4,10.5,61983,16635,45348,3.1,11.6,-5493,-1.1,21,0,562,565,3036
1994,41,a) 0,8132,8196,38284,19198,8142,198.7,0,0,38173,38173,0,198.8,198.8,0,0,0,0,0,38173,198.8,0,0,,,
1994,41,b) 1,5539,5587,32642,33056,31,0.5,1466,23,9354,917,8437,2.8,28.3,10181,5174,5007,15.7,30.8,-827,-2.5,56.6,0,1145,1146,4068
1994,41,c) 2,4577,4713,35738,36285,191,3.8,845,16.7,7987,1050,6937,2.9,22,9081,4283,4798,11.8,25,-1094,-3,44,0,658,658,3206
1994,41,d) 3,4088,4198,29321,29847,154,3.5,622,14,5768,666,5102,2.2,19.3,6820,3354,3466,11.2,22.8,-1052,-3.5,38.6,0,480,480,2756
1994,41,e) 4,4126,4253,33642,33153,171,3.9,523,11.8,7150,1315,5835,4,21.6,6172,2504,3668,7.6,18.6,978,3,37.2,0,389,389,1961
1994,41,f) 5,2797,2910,26435,26733,107,3.5,385,12.6,4937,1053,3884,3.9,18.5,5532,2302,3230,8.6,20.7,-595,-2.2,37,0,307,307,1721
1994,41,g) 6 to 10,12914,13848,151056,150000,527,3.7,1381,9.7,26160,4414,21746,2.9,17.4,24048,8585,15463,5.7,16,2112,1.4,32,0,964,968,5808
1994,41,h) 11 to 15,8513,9675,120628,120046,325,3.3,783,7.9,17246,2872,14374,2.4,14.4,16082,5745,10337,4.8,13.4,1164,1,26.8,0,493,499,3014
1994,41,i) 16 to 20,3198,4148,60664,60263,174,4.1,288,6.8,8486,2384,6102,4,14.1,7684,2502,5182,4.2,12.8,802,1.3,25.6,0,151,151,919
1994,41,l) Left Censored,12478,21551,580259,573143,1238,5.7,1331,6.2,72728,22175,50553,3.9,12.7,58495,16987,41508,3,10.2,14233,2.5,20.4,0,487,489,2938
1994,42,a) 0,16154,16263,104953,52594,16149,198.6,0,0,104718,104718,0,199.1,199.1,0,0,0,0,0,104718,199.1,0,0,,,
1994,42,b) 1,12950,13054,94353,93411,64,0.4,2994,20.4,26619,1513,25106,1.6,28.5,24734,13101,11633,14,26.5,1885,2,53,0,2452,2452,11038
1994,42,c) 2,11579,11968,88207,96433,331,2.6,1960,15.3,17149,2521,14628,2.6,17.8,33600,18596,15004,19.3,34.8,-16451,-17,35.6,0,1582,1584,16233
1994,42,d) 3,10922,11307,87641,90852,321,2.7,1558,13,16164,1816,14348,2,17.8,22585,10442,12143,11.5,24.9,-6421,-7.1,35.6,0,1241,1244,7503
1994,42,e) 4,10609,10946,86863,89587,294,2.6,1358,11.8,13844,1687,12157,1.9,15.5,19292,8060,11232,9,21.5,-5448,-6,31,0,1065,1066,6332
1994,42,f) 5,10248,10783,95713,97444,332,3,1217,10.8,15458,3232,12226,3.3,15.9,18920,7187,11733,7.4,19.4,-3462,-3.5,31.8,0,970,972,6117
1994,42,g) 6 to 10,42717,45900,519829,527653,1210,2.5,4209,8.9,68388,10454,57934,2,13,84036,31272,52764,5.9,15.9,-15648,-2.9,26,0,3100,3119,20292
1994,42,h) 11 to 15,25277,28344,368230,371175,684,2.4,2089,7.2,45480,7693,37787,2.1,12.3,51369,16517,34852,4.4,13.8,-5889,-1.5,24.6,0,1444,1459,9897
1994,42,i) 16 to 20,9957,13297,222619,223545,477,3.5,972,7.2,23391,4519,18872,2,10.5,25242,7453,17789,3.3,11.3,-1851,-0.8,21,0,518,523,3478
1994,42,l) Left Censored,53824,91875,2847346,2859738,3906,4.2,6005,6.5,295355,81313,214042,2.8,10.3,320139,94191,225948,3.3,11.2,-24784,-0.9,20.6,0,2526,2591,19386
1994,44,a) 0,1950,1958,13598,6813,1943,198.5,0,0,13570,13570,0,199.2,199.2,0,0,0,0,0,13570,199.2,0,0,,,
1994,44,b) 1,1439,1442,7852,8126,6,0.4,356,21.8,2164,183,1981,2.3,26.6,2712,1814,898,22.3,33.4,-548,-6.8,53.2,0,272,272,1312
1994,44,c) 2,1176,1188,8830,11975,38,3,229,17.8,1593,96,1497,0.8,13.3,7883,1691,6192,14.1,65.8,-6290,-52.5,26.6,0,178,178,1547
1994,44,d) 3,1037,1052,7774,8360,39,3.5,160,14.3,1648,325,1323,3.9,19.7,2820,964,1856,11.5,33.7,-1172,-14,39.4,0,130,130,840
1994,44,e) 4,1046,1068,7045,7278,33,2.9,134,12,1072,116,956,1.6,14.7,1537,549,988,7.5,21.1,-465,-6.4,29.4,0,100,100,417
1994,44,f) 5,1092,1111,10167,10717,52,4.5,175,15,1476,216,1260,2,13.8,2575,1135,1440,10.6,24,-1099,-10.2,27.6,0,121,121,665
1994,44,g) 6 to 10,4302,4473,40181,41469,173,3.7,490,10.6,5130,1023,4107,2.5,12.4,7705,2308,5397,5.6,18.6,-2575,-6.2,24.8,0,364,364,1795
1994,44,h) 11 to 15,2481,2668,33013,32939,89,3.2,230,8.4,5369,1073,4296,3.3,16.3,5220,2514,2706,7.6,15.8,149,0.5,31.6,0,151,154,862
1994,44,i) 16 to 20,990,1163,16443,16849,43,3.6,91,7.6,1798,337,1461,2,10.7,2609,793,1816,4.7,15.5,-811,-4.8,21.4,0,43,43,258
1994,44,l) Left Censored,5827,7818,221332,225048,252,3.2,520,6.5,19615,5069,14546,2.3,8.7,27046,7869,19177,3.5,12,-7431,-3.3,17.4,0,242,243,1912
1994,45,a) 0,6682,6726,44275,22203,6678,198.6,0,0,44144,44144,0,198.8,198.8,0,0,0,0,0,44144,198.8,0,0,,,
1994,45,b) 1,4831,4884,33793,33508,31,0.5,1387,24.6,10228,643,9585,1.9,30.5,9658,5684,3974,17,28.8,570,1.7,57.6,0,1126,1126,4836
1994,45,c) 2,4013,4102,35828,37034,109,2.4,812,18.2,7907,629,7278,1.7,21.4,10319,4479,5840,12.1,27.9,-2412,-6.5,42.8,0,662,663,3638
1994,45,d) 3,3629,3806,29250,30149,120,3,615,15.1,5287,551,4736,1.8,17.5,7084,3265,3819,10.8,23.5,-1797,-6,35,0,487,487,2683
1994,45,e) 4,3287,3386,28088,28574,119,3.3,537,14.9,5873,795,5078,2.8,20.6,6844,3832,3012,13.4,24,-971,-3.4,41.2,0,421,422,3181
1994,45,f) 5,2901,3148,29609,30147,120,3.6,431,13,5246,873,4373,2.9,17.4,6322,2492,3830,8.3,21,-1076,-3.6,34.8,0,326,326,1841
1994,45,g) 6 to 10,12951,14263,158750,159917,495,3.4,1320,9,22796,4388,18408,2.7,14.3,25129,8661,16468,5.4,15.7,-2333,-1.4,28.6,0,946,950,6697
1994,45,h) 11 to 15,7239,8272,111898,111837,258,3,663,7.8,16826,4039,12787,3.6,15,16703,6506,10197,5.8,14.9,123,0.1,29.8,0,421,423,3020
1994,45,i) 16 to 20,2729,3635,50801,49975,165,4.5,257,7,8390,1882,6508,3.8,16.8,6737,2200,4537,4.4,13.5,1653,3.3,27,0,137,137,760
1994,45,l) Left Censored,12759,24051,795727,792652,1148,4.7,1432,5.9,85628,25844,59784,3.3,10.8,79478,24304,55174,3.1,10,6150,0.8,20,0,520,529,5565
1994,46,a) 0,1702,1712,8984,4528,1697,198.2,0,0,8912,8912,0,196.8,196.8,0,0,0,0,0,8912,196.8,0,0,,,
1994,46,b) 1,1201,1209,7216,7428,3,0.2,293,21.4,1761,8,1753,0.1,23.7,2185,1290,895,17.4,29.4,-424,-5.7,47.4,0,219,219,1071
1994,46,c) 2,1028,1059,6654,7453,39,3.5,176,15.6,1166,90,1076,1.2,15.6,2763,1333,1430,17.9,37.1,-1597,-21.5,31.2,0,137,137,1170
1994,46,d) 3,926,946,7334,7688,23,2.3,131,13,1069,61,1008,0.8,13.9,1777,870,907,11.3,23.1,-708,-9.2,27.8,0,106,106,753
1994,46,e) 4,904,923,7369,7502,39,4,138,14.2,1159,133,1026,1.8,15.4,1425,705,720,9.4,19,-266,-3.6,30.8,0,105,105,491
1994,46,f) 5,699,726,5821,5951,17,2.2,73,9.7,970,95,875,1.6,16.3,1229,360,869,6,20.7,-259,-4.4,32.6,0,55,55,294
1994,46,g) 6 to 10,3178,3357,34487,34482,103,3,291,8.4,5135,666,4469,1.9,14.9,5125,2093,3032,6.1,14.9,10,0,29.8,0,216,217,1771
1994,46,h) 11 to 15,2034,2295,27000,27508,71,3,169,7.2,2862,308,2554,1.1,10.4,3878,1040,2838,3.8,14.1,-1016,-3.7,20.8,0,99,99,510
1994,46,i) 16 to 20,890,1111,12377,12230,36,3.2,82,7.2,1825,582,1243,4.8,14.9,1531,391,1140,3.2,12.5,294,2.4,25,0,51,51,229
1994,46,l) Left Censored,4368,6344,135093,133312,272,4.3,341,5.3,15116,4520,10596,3.4,11.3,11554,3885,7669,2.9,8.7,3562,2.6,17.4,0,189,191,1000
1994,47,a) 0,9413,9472,61125,30689,9401,198.5,0,0,60873,60873,0,198.4,198.4,0,0,0,0,0,60873,198.4,0,0,,,
1994,47,b) 1,6962,7049,52880,53320,41,0.5,1952,24.1,15841,755,15086,1.4,29.7,16720,10294,6426,19.3,31.4,-879,-1.7,59.4,0,1608,1608,8682
1994,47,c) 2,5478,5674,51886,53272,160,2.6,1143,18.5,12542,1679,10863,3.2,23.5,15313,7499,7814,14.1,28.7,-2771,-5.2,47,0,937,937,5363
1994,47,d) 3,4843,5077,47924,49768,189,3.5,790,14.7,9177,1662,7515,3.3,18.4,12865,5787,7078,11.6,25.8,-3688,-7.4,36.8,0,601,601,4591
1994,47,e) 4,4460,4611,39440,41528,129,2.6,638,13.1,6696,583,6113,1.4,16.1,10871,4827,6044,11.6,26.2,-4175,-10.1,32.2,0,508,511,3406
1994,47,f) 5,4067,4328,40932,41298,142,3.1,510,11.3,7024,1195,5829,2.9,17,7756,3016,4740,7.3,18.8,-732,-1.8,34,0,396,397,2317
1994,47,g) 6 to 10,17951,19486,240084,241686,635,3.2,1692,8.5,33538,4968,28570,2.1,13.9,36741,14060,22681,5.8,15.2,-3203,-1.3,27.8,0,1232,1237,9864
1994,47,h) 11 to 15,10181,11617,156077,157566,340,2.9,911,7.6,19811,3792,16019,2.4,12.6,22788,7775,15013,4.9,14.5,-2977,-1.9,25.2,0,597,602,4796
1994,47,i) 16 to 20,4228,6275,123633,124062,251,4,372,5.9,14900,3883,11017,3.1,12,15758,3101,12657,2.5,12.7,-858,-0.7,24,0,207,212,1392
1994,47,l) Left Censored,19068,35433,1193059,1182463,1695,4.7,2231,6.2,140958,42410,98548,3.6,11.9,119766,39765,80001,3.4,10.1,21192,1.8,20.2,0,846,863,5375
1994,48,a) 0,36520,36928,230089,115601,36671,198.6,0,0,228977,228977,0,198.1,198.1,0,0,0,0,0,228977,198.1,0,0,,,
1994,48,b) 1,26488,26853,221401,219574,162,0.5,7760,25,71804,4087,67717,1.9,32.7,68150,40687,27463,18.5,31,3654,1.7,62,0,6409,6409,35111
1994,48,c) 2,21858,22625,212869,226659,672,2.7,4694,19,46753,4788,41965,2.1,20.6,74333,38991,35342,17.2,32.8,-27580,-12.2,41.2,0,3849,3851,27839
1994,48,d) 3,19205,20163,187519,197977,669,3.1,3336,15.5,39189,4615,34574,2.3,19.8,60104,23189,36915,11.7,30.4,-20915,-10.6,39.6,0,2658,2661,19198
1994,48,e) 4,16870,17786,172193,177264,627,3.3,2633,14,33600,5930,27670,3.3,19,43741,18546,25195,10.5,24.7,-10141,-5.7,38,0,2029,2042,14575
1994,48,f) 5,14090,15109,156894,158712,567,3.6,2038,12.8,29750,5578,24172,3.5,18.7,33385,12942,20443,8.2,21,-3635,-2.3,37.4,0,1581,1585,9747
1994,48,g) 6 to 10,58131,64800,762033,775659,2478,3.7,6718,10,117013,20151,96862,2.6,15.1,144265,55610,88655,7.2,18.6,-27252,-3.5,30.2,0,4781,4820,32601
1994,48,h) 11 to 15,41728,48398,622242,622221,1741,3.5,3883,7.8,92701,21792,70909,3.5,14.9,92658,29679,62979,4.8,14.9,43,0,29.8,0,2430,2453,13217
1994,48,i) 16 to 20,12956,18405,280125,279691,874,4.7,1509,8.1,40008,9794,30214,3.5,14.3,39139,12385,26754,4.4,14,869,0.3,28,0,738,741,4199
1994,48,l) Left Censored,50192,110061,3451828,3463137,6296,5.7,7661,6.9,427004,126605,300399,3.7,12.3,449623,116259,333364,3.4,13,-22619,-0.7,24.6,0,2468,2520,16332
1994,49,a) 0,4348,4404,28473,14265,4384,199.1,0,0,28416,28416,0,199.2,199.2,0,0,0,0,0,28416,199.2,0,0,,,
1994,49,b) 1,2860,2894,22836,23014,22,0.7,820,24.7,6828,274,6554,1.2,29.7,7183,4377,2806,19,31.2,-355,-1.5,59.4,0,661,661,3620
1994,49,c) 2,2291,2339,19477,21553,78,3.1,478,18.7,4725,428,4297,2,21.9,8877,4336,4541,20.1,41.2,-4152,-19.3,43.8,0,395,395,3529
1994,49,d) 3,1909,1985,19131,19644,52,2.5,291,13.8,3893,542,3351,2.8,19.8,4918,2584,2334,13.2,25,-1025,-5.2,39.6,0,229,229,1953
1994,49,e) 4,1613,1694,17719,18357,78,4.4,216,12.2,3441,531,2910,2.9,18.7,4716,2474,2242,13.5,25.7,-1275,-7,37.4,0,162,164,2024
1994,49,f) 5,1442,1509,21085,22130,56,3.6,182,11.6,3518,361,3157,1.6,15.9,5608,2033,3575,9.2,25.3,-2090,-9.4,31.8,0,155,155,1456
1994,49,g) 6 to 10,5447,5910,92933,90679,230,3.8,588,9.7,16949,2780,14169,3.1,18.7,12440,5386,7054,5.9,13.7,4509,5,27.4,0,415,418,3418
1994,49,h) 11 to 15,3832,4407,69491,69325,154,3.4,359,8,9151,1262,7889,1.8,13.2,8819,2518,6301,3.6,12.7,332,0.5,25.4,0,225,226,1287
1994,49,i) 16 to 20,1432,1825,30826,30751,97,5.2,157,8.5,4006,1002,3004,3.3,13,3856,1302,2554,4.2,12.5,150,0.5,25,0,79,82,487
1994,49,l) Left Censored,5860,10477,367012,358458,631,6,716,6.8,46892,11480,35412,3.2,13.1,29783,9336,20447,2.6,8.3,17109,4.8,16.6,0,297,297,1963
1994,50,a) 0,1431,1445,6346,3189,1433,198.3,0,0,6315,6315,0,198,198,0,0,0,0,0,6315,198,0,0,,,
1994,50,b) 1,1179,1184,6058,6053,7,0.5,286,21.4,1451,40,1411,0.7,24,1441,721,720,11.9,23.8,10,0.2,47.6,0,217,217,574
1994,50,c) 2,919,933,6088,6267,34,3.4,142,14.3,1052,93,959,1.5,16.8,1410,485,925,7.7,22.5,-358,-5.7,33.6,0,116,116,429
1994,50,d) 3,850,870,5318,5273,24,2.6,113,12.3,1080,109,971,2.1,20.5,989,474,515,9,18.8,91,1.7,37.6,0,87,87,413
1994,50,e) 4,924,949,5756,5696,34,3.4,118,11.9,1073,171,902,3,18.8,952,366,586,6.4,16.7,121,2.1,33.4,0,81,81,272
1994,50,f) 5,928,953,7504,7409,31,3.1,117,11.7,1334,238,1096,3.2,18,1143,536,607,7.2,15.4,191,2.6,30.8,0,91,91,450
1994,50,g) 6 to 10,3597,3745,30666,30639,122,3.2,315,8.2,4347,860,3487,2.8,14.2,4293,1330,2963,4.3,14,54,0.2,28,0,234,235,1023
1994,50,h) 11 to 15,1889,2058,20340,20385,57,2.7,141,6.7,2420,254,2166,1.2,11.9,2510,602,1908,3,12.3,-90,-0.4,23.8,0,106,106,418
1994,50,i) 16 to 20,712,881,13056,13223,25,2.8,70,7.7,1254,184,1070,1.4,9.5,1588,481,1107,3.6,12,-334,-2.5,19,0,37,37,128
1994,50,l) Left Censored,3276,4738,116369,117362,161,3.4,287,6,9918,1816,8102,1.5,8.5,11903,4188,7715,3.6,10.1,-1985,-1.6,17,0,117,121,1268
1994,51,a) 0,11778,11855,60878,30538,11777,198.7,0,0,60680,60680,0,198.7,198.7,0,0,0,0,0,60680,198.7,0,0,,,
1994,51,b) 1,8936,8996,62304,61068,50,0.5,2235,21.9,18265,957,17308,1.6,29.9,15792,8884,6908,14.5,25.9,2473,4,51.8,0,1789,1789,7419
1994,51,c) 2,7323,7597,62508,64074,268,3.3,1420,17.3,13895,2160,11735,3.4,21.7,17027,8230,8797,12.8,26.6,-3132,-4.9,43.4,0,1104,1104,6349
1994,51,d) 3,6514,6727,54279,55326,214,3,1034,14.5,10180,986,9194,1.8,18.4,12273,6093,6180,11,22.2,-2093,-3.8,36.8,0,798,798,4115
1994,51,e) 4,6313,6555,54300,54861,218,3.2,882,12.8,10331,1228,9103,2.2,18.8,11453,4873,6580,8.9,20.9,-1122,-2.1,37.6,0,655,655,3728
1994,51,f) 5,5629,5900,49894,50772,201,3.3,718,11.7,7989,1431,6558,2.8,15.7,9744,3764,5980,7.4,19.2,-1755,-3.5,31.4,0,557,559,3022
1994,51,g) 6 to 10,23838,26122,295791,296132,910,3.4,2369,8.8,43085,7956,35129,2.7,14.5,43766,14066,29700,4.7,14.8,-681,-0.3,29,0,1639,1644,9563
1994,51,h) 11 to 15,13071,15035,212785,214849,461,3,1068,7,26445,5944,20501,2.8,12.3,30572,9220,21352,4.3,14.2,-4127,-1.9,24.6,0,678,683,5113
1994,51,i) 16 to 20,4859,6925,108360,107564,273,3.9,480,6.8,13799,3819,9980,3.6,12.8,12207,3625,8582,3.4,11.3,1592,1.5,22.6,0,225,234,1383
1994,51,l) Left Censored,22589,45236,1380641,1426683,2161,4.7,3004,6.6,165594,48230,117364,3.4,11.6,257678,45603,212075,3.2,18.1,-92084,-6.5,23.2,0,926,951,5443
1994,53,a) 0,13427,13499,63332,31832,13380,198.2,0,0,63000,63000,0,197.9,197.9,0,0,0,0,0,63000,197.9,0,0,,,
1994,53,b) 1,9474,9573,59701,59746,62,0.6,2840,25.5,17048,1097,15951,1.8,28.5,17137,9422,7715,15.8,28.7,-89,-0.2,57,0,2192,2192,7888
1994,53,c) 2,8002,8234,58397,60763,296,3.3,1677,18.7,12640,1967,10673,3.2,20.8,17371,7573,9798,12.5,28.6,-4731,-7.8,41.6,0,1315,1315,6165
1994,53,d) 3,6868,7066,53376,55457,243,3.2,1180,15.6,10188,1462,8726,2.6,18.4,14349,5733,8616,10.3,25.9,-4161,-7.5,36.8,0,902,903,4468
1994,53,e) 4,7072,7329,59402,61049,253,3.3,1112,14.3,11137,1130,10007,1.9,18.2,14431,5474,8957,9,23.6,-3294,-5.4,36.4,0,810,812,4163
1994,53,f) 5,4441,4637,43807,45114,184,3.8,620,12.7,7744,1625,6119,3.6,17.2,10357,4550,5807,10.1,23,-2613,-5.8,34.4,0,472,472,3417
1994,53,g) 6 to 10,21326,23089,258574,261674,875,3.7,2315,9.7,37947,5858,32089,2.2,14.5,44146,14821,29325,5.7,16.9,-6199,-2.4,29,0,1617,1622,8885
1994,53,h) 11 to 15,13393,15319,203973,205532,564,3.6,1193,7.6,29885,6413,23472,3.1,14.5,33003,10428,22575,5.1,16.1,-3118,-1.6,29,0,781,784,6890
1994,53,i) 16 to 20,5119,6753,98726,98121,248,3.6,483,7,13793,2253,11540,2.3,14.1,12582,3416,9166,3.5,12.8,1211,1.3,25.6,0,241,241,1539
1994,53,l) Left Censored,18670,33631,961240,964915,1781,5.3,2283,6.7,107254,29005,78249,3,11.1,114604,26753,87851,2.8,11.9,-7350,-0.8,22.2,0,805,820,4736
1994,54,a) 0,2705,2719,12861,6447,2700,198.6,0,0,12828,12828,0,199,199,0,0,0,0,0,12828,199,0,0,,,
1994,54,b) 1,2105,2112,11539,11654,9,0.4,389,16.7,3265,298,2967,2.6,28,3495,1816,1679,15.6,30,-230,-2,56,0,285,285,1502
1994,54,c) 2,1708,1747,10943,11516,44,2.3,293,15.6,2109,292,1817,2.5,18.3,3255,1481,1774,12.9,28.3,-1146,-10,36.6,0,237,237,1230
1994,54,d) 3,1576,1685,16554,17142,50,2.8,236,13.3,2662,269,2393,1.6,15.5,3838,1520,2318,8.9,22.4,-1176,-6.9,31,0,186,186,932
1994,54,e) 4,1473,1495,11079,11277,46,2.9,195,12.4,2177,237,1940,2.1,19.3,2572,1065,1507,9.4,22.8,-395,-3.5,38.6,0,156,156,886
1994,54,f) 5,1315,1355,12766,13085,43,3,157,11.1,1723,155,1568,1.2,13.2,2360,539,1821,4.1,18,-637,-4.8,26.4,0,128,128,456
1994,54,g) 6 to 10,5746,6144,66923,68253,205,3.2,564,8.9,8005,1648,6357,2.4,11.7,10665,3608,7057,5.3,15.6,-2660,-3.9,23.4,0,420,423,2263
1994,54,h) 11 to 15,3565,3953,43172,43603,119,3,267,6.6,4797,1021,3776,2.3,11,5658,1982,3676,4.5,13,-861,-2,22,0,173,173,873
1994,54,i) 16 to 20,1484,2048,28269,27781,122,5.9,127,6.2,4183,1383,2800,5,15.1,3207,681,2526,2.5,11.5,976,3.6,23,0,71,71,279
1994,54,l) Left Censored,7756,12567,284250,281651,533,4.2,735,5.8,34464,9218,25246,3.3,12.2,29265,8378,20887,3,10.4,5199,1.8,20.8,0,327,329,2046
1994,55,a) 0,8789,8838,48202,24172,8767,198.4,0,0,48060,48060,0,198.8,198.8,0,0,0,0,0,48060,198.8,0,0,,,
1994,55,b) 1,6903,6977,47324,46010,52,0.7,1592,20.3,13650,2804,10846,6.1,29.7,11021,6030,4991,13.1,24,2629,5.7,48,0,1246,1250,4961
1994,55,c) 2,5633,5732,42890,44829,166,2.7,974,15.8,7276,768,6508,1.7,16.2,11153,5092,6061,11.4,24.9,-3877,-8.7,32.4,0,768,768,4233
1994,55,d) 3,5268,5488,42744,44349,150,2.6,705,12.2,7070,1275,5795,2.9,15.9,10280,3966,6314,8.9,23.2,-3210,-7.3,31.8,0,555,561,3249
1994,55,e) 4,4976,5237,44225,45050,152,2.8,634,11.5,7208,1012,6196,2.2,16,8857,3905,4952,8.7,19.7,-1649,-3.7,32,0,466,466,2687
1994,55,f) 5,4484,4647,41183,42520,133,2.7,514,10.6,7234,636,6598,1.5,17,9907,2946,6961,6.9,23.3,-2673,-6.3,34,0,401,405,2489
1994,55,g) 6 to 10,19103,20642,241732,244101,565,2.7,1727,8.1,29304,4582,24722,1.9,12,34043,11476,22567,4.7,13.9,-4739,-1.9,24,0,1292,1300,8604
1994,55,h) 11 to 15,11555,13076,171576,172789,348,2.6,931,7,19890,3329,16561,1.9,11.5,22316,6381,15935,3.7,12.9,-2426,-1.4,23,0,644,645,4196
1994,55,i) 16 to 20,4858,6620,108599,107371,218,3.2,394,5.9,14486,2353,12133,2.2,13.5,12030,2923,9107,2.7,11.2,2456,2.3,22.4,0,228,229,1285
1994,55,l) Left Censored,24961,39883,1287796,1279711,1477,3.7,2233,5.5,123053,29424,93629,2.3,9.6,106884,26678,80206,2.1,8.4,16169,1.2,16.8,0,975,992,6705
1994,56,a) 0,1388,1392,6758,3386,1383,198.7,0,0,6745,,,,199.2,0,0,0,0,0,6745,199.2,0,1,,,
1994,56,b) 1,1006,1013,6515,6334,3,0.3,232,20.3,1876,,,,29.6,1514,820,694,12.9,23.9,362,5.7,47.8,1,184,184,697
1994,56,c) 2,786,788,4434,4634,26,3.1,127,15.1,892,133,759,2.9,19.2,1291,489,802,10.6,27.9,-399,-8.7,38.4,0,99,99,436
1994,56,d) 3,695,702,3866,4148,24,3.3,92,12.5,629,67,562,1.6,15.2,1193,524,669,12.6,28.8,-564,-13.6,30.4,0,72,72,413
1994,56,e) 4,613,621,3912,3887,20,3.1,80,12.3,748,86,662,2.2,19.2,697,303,394,7.8,17.9,51,1.3,35.8,0,53,53,225
1994,56,f) 5,515,545,3913,4019,26,4.6,62,11,659,107,552,2.7,16.4,871,357,514,8.9,21.7,-212,-5.3,32.8,0,40,40,175
1994,56,g) 6 to 10,2222,2323,19899,20228,85,3.5,249,10.3,2814,552,2262,2.7,13.9,3471,1294,2177,6.4,17.2,-657,-3.3,27.8,0,183,183,1021
1994,56,h) 11 to 15,1901,2149,18982,18787,85,3.9,142,6.5,2914,742,2172,3.9,15.5,2523,682,1841,3.6,13.4,391,2.1,26.8,0,94,96,399
1994,56,i) 16 to 20,705,868,10576,10546,39,4.5,48,5.5,1636,561,1075,5.3,15.5,1575,527,1048,5,14.9,61,0.6,29.8,0,27,27,137
1994,56,l) Left Censored,2559,3995,68468,68103,171,4.2,234,5.8,7955,1662,6293,2.4,11.7,7225,1728,5497,2.5,10.6,730,1.1,21.2,0,99,99,617
1995,01,a) 0,7801,7840,46028,23119,7775,198.3,0,0,45819,45819,0,198.2,198.2,0,0,0,0,0,45819,198.2,0,0,,,
1995,01,b) 1,5959,6032,49102,48291,23,0.3,1644,23.8,14507,806,13701,1.7,30,12885,6955,5930,14.4,26.7,1622,3.3,53.4,0,1357,1357,6008
1995,01,c) 2,4593,4646,37347,37312,138,2.7,925,18.2,9524,1111,8413,3,25.5,9454,5057,4397,13.6,25.3,70,0.2,50.6,0,772,778,4483
1995,01,d) 3,3842,3938,36340,36939,135,3.2,646,15.4,7041,611,6430,1.7,19.1,8238,3674,4564,9.9,22.3,-1197,-3.2,38.2,0,534,534,3154
1995,01,e) 4,3388,3579,30983,31415,130,3.5,453,12.1,5879,905,4974,2.9,18.7,6742,2959,3783,9.4,21.5,-863,-2.8,37.4,0,354,354,2105
1995,01,f) 5,3214,3331,30817,30542,108,3.1,429,12.3,6017,555,5462,1.8,19.7,5467,2384,3083,7.8,17.9,550,1.8,35.8,0,350,350,1918
1995,01,g) 6 to 10,12994,14297,185463,183903,497,3.4,1321,9,27540,4757,22783,2.6,15,24420,8438,15982,4.6,13.3,3120,1.7,26.6,0,1001,1006,5973
1995,01,h) 11 to 15,8772,9798,134742,134227,338,3.4,672,6.7,18510,3649,14861,2.7,13.8,17480,5806,11674,4.3,13,1030,0.8,26,0,448,454,3775
1995,01,i) 16 to 20,4659,6579,111639,110098,264,4,434,6.5,14955,3792,11163,3.4,13.6,11874,3455,8419,3.1,10.8,3081,2.8,21.6,0,254,256,2181
1995,01,l) Left Censored,13808,25929,842742,831375,1222,4.7,1640,6.3,101050,24481,76569,2.9,12.2,78316,21276,57040,2.6,9.4,22734,2.8,18.8,0,601,625,3994
1995,02,a) 0,1390,1399,6197,3131,1380,197.3,0,0,6132,6132,0,195.8,195.8,0,0,0,0,0,6132,195.8,0,0,,,
1995,02,b) 1,966,969,5351,5600,4,0.4,300,26.4,1399,23,1376,0.4,25,1896,1119,777,20,33.9,-497,-8.9,50,0,223,223,895
1995,02,c) 2,846,859,5839,5813,37,4,165,17.8,1395,114,1281,2,24,1342,618,724,10.6,23.1,53,0.9,46.2,0,125,125,505
1995,02,d) 3,658,696,4377,4493,25,3.4,118,15.9,1037,106,931,2.4,23.1,1269,508,761,11.3,28.2,-232,-5.1,46.2,0,87,87,376
1995,02,e) 4,666,690,4654,5067,29,4,99,13.6,1053,307,746,6.1,20.8,1879,416,1463,8.2,37.1,-826,-16.3,41.6,0,74,74,340
1995,02,f) 5,644,663,4343,4511,35,5.1,85,12.3,715,140,575,3.1,15.9,1051,395,656,8.8,23.3,-336,-7.4,31.8,0,64,64,248
1995,02,g) 6 to 10,2297,2481,25414,26052,91,3.5,283,11,3307,409,2898,1.6,12.7,4582,1794,2788,6.9,17.6,-1275,-4.9,25.4,0,189,190,1446
1995,02,h) 11 to 15,1727,1950,19249,19331,77,3.9,140,7.1,2846,545,2301,2.8,14.7,3009,838,2171,4.3,15.6,-163,-0.9,29.4,0,86,86,450
1995,02,i) 16 to 20,845,1119,14669,14848,44,3.9,84,7.4,1857,372,1485,2.5,12.5,2214,765,1449,5.2,14.9,-357,-2.4,25,0,42,43,387
1995,02,l) Left Censored,1810,3327,84274,83836,164,4.9,202,6,11379,3564,7815,4.3,13.6,10503,2403,8100,2.9,12.5,876,1.1,25,0,56,63,313
1995,04,a) 0,9453,9513,58291,29224,9451,198.7,0,0,58135,58135,0,198.9,198.9,0,0,0,0,0,58135,198.9,0,0,,,
1995,04,b) 1,6884,7024,54883,55582,61,0.8,2035,25.1,15944,1094,14850,2,28.7,17342,10085,7257,18.1,31.2,-1398,-2.5,57.4,0,1677,1677,8514
1995,04,c) 2,5143,5232,45591,45848,190,3.3,1123,19.6,11184,1633,9551,3.6,24.4,11697,6622,5075,14.4,25.5,-513,-1.1,48.8,0,928,928,5535
1995,04,d) 3,4352,4527,53462,50658,193,4,809,16.7,16550,2155,14395,4.3,32.7,10942,5208,5734,10.3,21.6,5608,11.1,43.2,0,639,639,4319
1995,04,e) 4,3961,4114,38799,39211,169,3.9,597,13.7,7514,1011,6503,2.6,19.2,8338,4014,4324,10.2,21.3,-824,-2.1,38.4,0,481,487,3216
1995,04,f) 5,3588,3732,40568,40012,153,3.9,477,12.2,8771,1349,7422,3.4,21.9,7658,3397,4261,8.5,19.1,1113,2.8,38.2,0,385,386,2633
1995,04,g) 6 to 10,14254,15673,210310,208394,682,4.2,1648,10.2,37114,8498,28616,4.1,17.8,33282,12008,21274,5.8,16,3832,1.8,32,0,1194,1199,8907
1995,04,h) 11 to 15,9117,10893,172293,171199,458,4.1,934,8.4,25913,6209,19704,3.6,15.1,23725,6829,16896,4,13.9,2188,1.2,27.8,0,552,556,3332
1995,04,i) 16 to 20,4012,5302,101525,101077,245,4.5,445,8.2,15292,3070,12222,3,15.1,14396,4879,9517,4.8,14.2,896,0.9,28.4,0,227,238,2090
1995,04,l) Left Censored,9399,20637,704026,690863,1353,6.5,1486,7.2,98762,31661,67101,4.6,14.3,72435,21055,51380,3,10.5,26327,3.8,21,0,359,436,2980
1995,05,a) 0,5188,5219,28256,14192,5173,198.2,0,0,28129,28129,0,198.2,198.2,0,0,0,0,0,28129,198.2,0,0,,,
1995,05,b) 1,3737,3776,25814,25714,14,0.3,1109,25.3,6794,159,6635,0.6,26.4,6593,4149,2444,16.1,25.6,201,0.8,51.2,0,927,928,3595
1995,05,c) 2,3104,3139,21860,21514,96,2.8,571,16.9,5309,557,4752,2.6,24.7,4616,2389,2227,11.1,21.5,693,3.2,43,0,475,475,2101
1995,05,d) 3,2486,2584,20635,22440,78,2.8,451,16.2,3716,912,2804,4.1,16.6,7325,4220,3105,18.8,32.6,-3609,-16,33.2,0,353,354,3507
1995,05,e) 4,2138,2256,18465,18865,72,3,323,13.5,3313,386,2927,2,17.6,4113,1697,2416,9,21.8,-800,-4.2,35.2,0,253,253,1124
1995,05,f) 5,2084,2177,17259,17277,70,3.1,252,11.1,3114,607,2507,3.5,18,3149,1408,1741,8.1,18.2,-35,-0.2,36,0,206,206,1072
1995,05,g) 6 to 10,7735,8270,91850,93611,288,3.4,807,9.5,13874,2614,11260,2.8,14.8,17396,8901,8495,9.5,18.6,-3522,-3.8,29.6,0,618,619,6770
1995,05,h) 11 to 15,5946,6595,83037,81273,199,3,464,6.9,13164,2062,11102,2.5,16.2,9635,3141,6494,3.9,11.9,3529,4.3,23.8,0,327,327,2256
1995,05,i) 16 to 20,3249,3977,57671,56516,138,3.4,292,7.2,8681,2107,6574,3.7,15.4,6371,1625,4746,2.9,11.3,2310,4.1,22.6,0,185,185,788
1995,05,l) Left Censored,9012,15561,510002,501207,780,5,996,6.4,60761,13204,47557,2.6,12.1,43173,14292,28881,2.9,8.6,17588,3.5,17.2,0,410,412,2175
1995,06,a) 0,57960,58278,366269,184190,57778,198.3,0,0,364158,364158,0,197.7,197.7,0,0,0,0,0,364158,197.7,0,0,,,
1995,06,b) 1,42314,43059,362370,361817,289,0.6,12594,25.2,109441,8054,101387,2.2,30.2,108334,61143,47191,16.9,29.9,1107,0.3,59.8,0,10130,10135,50013
1995,06,c) 2,33942,34548,311538,315828,1338,3.5,7333,19.4,77329,9009,68320,2.9,24.5,85909,45795,40114,14.5,27.2,-8580,-2.7,49,0,6024,6024,39455
1995,06,d) 3,30494,31881,304446,308712,1394,4.1,5607,16.4,62448,10040,52408,3.3,20.2,70979,33661,37318,10.9,23,-8531,-2.8,40.4,0,4390,4404,26489
1995,06,e) 4,28917,30252,279138,284514,1303,4.1,4869,15.1,53876,7547,46329,2.7,18.9,64628,29580,35048,10.4,22.7,-10752,-3.8,37.8,0,3679,3710,22201
1995,06,f) 5,27888,29152,280351,283311,1364,4.4,4366,14.2,53722,8381,45341,3,19,59641,25830,33811,9.1,21.1,-5919,-2.1,38,0,3199,3221,18866
1995,06,g) 6 to 10,110614,120428,1499740,1507772,5049,4,14173,11.3,233510,38250,195260,2.5,15.5,249575,95229,154346,6.3,16.6,-16065,-1.1,31,0,9985,10074,65711
1995,06,h) 11 to 15,74820,86538,1262399,1258771,3324,3.7,7815,8.8,186194,34907,151287,2.8,14.8,178938,59223,119715,4.7,14.2,7256,0.6,28.4,0,4902,4958,31072
1995,06,i) 16 to 20,36748,48835,887034,875024,1867,3.7,4069,8.1,136945,27431,109514,3.1,15.7,112924,34776,78148,4,12.9,24021,2.8,25.8,0,2233,2284,12691
1995,06,l) Left Censored,82960,165846,5220909,5235085,8685,5.2,12997,7.7,604895,160909,443986,3.1,11.6,633247,176926,456321,3.4,12.1,-28352,-0.5,23.2,0,4411,4558,29894
1995,08,a) 0,11412,11483,60134,30227,11426,199,0,0,59814,59814,0,197.9,197.9,0,0,0,0,0,59814,197.9,0,0,,,
1995,08,b) 1,8555,8665,60106,59728,46,0.5,2349,23.7,17370,1870,15500,3.1,29.1,16614,9440,7174,15.8,27.8,756,1.3,55.6,0,1844,1846,7841
1995,08,c) 2,6625,6678,48230,49850,234,3.2,1277,17.7,11424,1800,9624,3.6,22.9,14664,7917,6747,15.9,29.4,-3240,-6.5,45.8,0,1045,1045,7029
1995,08,d) 3,5332,5431,45725,46095,188,3.3,845,14.6,9065,1365,7700,3,19.7,9804,4899,4905,10.6,21.3,-739,-1.6,39.4,0,653,655,4129
1995,08,e) 4,4771,4967,40479,40948,189,3.6,690,13.2,7669,1617,6052,3.9,18.7,8606,3795,4811,9.3,21,-937,-2.3,37.4,0,504,506,2715
1995,08,f) 5,4117,4279,39350,39145,168,3.8,505,11.3,7746,1454,6292,3.7,19.8,7335,3082,4253,7.9,18.7,411,1.1,37.4,0,383,385,2434
1995,08,g) 6 to 10,15902,17056,198781,199598,605,3.4,1655,9.4,31432,5110,26322,2.6,15.7,33066,12795,20271,6.4,16.6,-1634,-0.9,31.4,0,1184,1190,9467
1995,08,h) 11 to 15,10837,12383,181377,178355,478,3.8,945,7.5,29746,6772,22974,3.8,16.7,23702,6327,17375,3.5,13.3,6044,3.4,26.6,0,599,601,3891
1995,08,i) 16 to 20,5225,6807,103790,101012,328,4.7,534,7.7,18344,4538,13806,4.5,18.2,12788,3318,9470,3.3,12.7,5556,5.5,25.4,0,275,275,1510
1995,08,l) Left Censored,12695,23838,744577,733052,1560,6.5,1660,6.9,105519,34583,70936,4.7,14.4,82469,22566,59903,3.1,11.3,23050,3.1,22.6,0,488,494,3751
1995,09,a) 0,5920,5957,31712,15906,5910,198.4,0,0,31612,31612,0,198.7,198.7,0,0,0,0,0,31612,198.7,0,0,,,
1995,09,b) 1,4581,4610,31736,31693,15,0.3,996,19.3,8660,144,8516,0.5,27.3,8573,4127,4446,13,27.1,87,0.2,54.2,0,788,788,3608
1995,09,c) 2,3858,3891,30340,31405,121,2.9,641,15.4,6605,487,6118,1.6,21,8735,3315,5420,10.6,27.8,-2130,-6.8,42,0,509,509,2721
1995,09,d) 3,3305,3407,27746,28230,114,3.2,503,13.9,4722,574,4148,2,16.7,5689,2653,3036,9.4,20.2,-967,-3.5,33.4,0,389,409,2299
1995,09,e) 4,3004,3116,25718,26208,119,3.7,377,11.6,4372,660,3712,2.5,16.7,5351,2225,3126,8.5,20.4,-979,-3.7,33.4,0,299,299,1777
1995,09,f) 5,3095,3182,26262,26589,123,3.7,416,12.5,4263,357,3906,1.3,16,4916,2241,2675,8.4,18.5,-653,-2.5,32,0,307,308,1744
1995,09,g) 6 to 10,14209,14985,158480,158445,557,3.6,1486,9.6,22379,3264,19115,2.1,14.1,22309,7124,15185,4.5,14.1,70,0,28.2,0,1056,1063,4468
1995,09,h) 11 to 15,8985,9795,110886,111224,296,3,755,7.5,14168,1848,12320,1.7,12.7,14843,4696,10147,4.2,13.3,-675,-0.6,25.4,0,530,532,3188
1995,09,i) 16 to 20,4557,5573,80324,79505,201,3.5,407,7.2,9962,1349,8613,1.7,12.5,8323,2291,6032,2.9,10.5,1639,2,21,0,230,233,1070
1995,09,l) Left Censored,17218,26478,870378,875562,1197,4.5,1781,6.7,90506,33168,57338,3.8,10.3,100873,28291,72582,3.2,11.5,-10367,-1.2,20.6,0,679,702,5027
1995,10,a) 0,1618,1626,9002,4521,1611,198.2,0,0,8963,8963,0,198.3,198.3,0,0,0,0,0,8963,198.3,0,0,,,
1995,10,b) 1,1251,1262,9082,8585,16,1.1,281,19.9,3251,355,2896,4.1,37.9,2256,1557,699,18.1,26.3,995,11.6,52.6,0,236,236,1405
1995,10,c) 2,1023,1027,6436,6665,27,2.4,172,15.6,1361,72,1289,1.1,20.4,1819,1053,766,15.8,27.3,-458,-6.9,40.8,0,132,132,537
1995,10,d) 3,814,839,5715,6015,28,3.1,143,15.9,975,94,881,1.6,16.2,1575,1010,565,16.8,26.2,-600,-10,32.4,0,112,112,805
1995,10,e) 4,761,789,6392,6294,35,4.3,99,12.1,1242,169,1073,2.7,19.7,1046,329,717,5.2,16.6,196,3.1,33.2,0,85,85,284
1995,10,f) 5,726,752,5314,5517,25,3.2,88,11.2,834,138,696,2.5,15.1,1240,691,549,12.5,22.5,-406,-7.4,30.2,0,62,62,385
1995,10,g) 6 to 10,2835,3005,31697,31497,101,3.2,312,10,5468,1038,4430,3.3,17.4,5068,1867,3201,5.9,16.1,400,1.3,32.2,0,227,227,1155
1995,10,h) 11 to 15,1703,1868,25278,25006,61,3.2,127,6.7,3516,576,2940,2.3,14.1,2971,811,2160,3.2,11.9,545,2.2,23.8,0,77,77,437
1995,10,i) 16 to 20,918,1139,27092,26205,54,4.7,63,5.5,3658,822,2836,3.1,14,1884,286,1598,1.1,7.2,1774,6.8,14.4,0,38,38,136
1995,10,l) Left Censored,3532,5827,197255,193760,360,6.1,441,7.5,26875,5231,21644,2.7,13.9,19885,5657,14228,2.9,10.3,6990,3.6,20.6,0,118,123,890
1995,11,a) 0,1098,1118,7790,3912,1110,198.6,0,0,7756,7756,0,198.3,198.3,0,0,0,0,0,7756,198.3,0,0,,,
1995,11,b) 1,896,915,7397,7570,15,1.5,202,19.7,2058,224,1834,3,27.2,2403,1448,955,19.1,31.7,-345,-4.5,54.4,0,162,162,1330
1995,11,c) 2,739,742,6937,7050,23,2.9,116,14.7,1264,167,1097,2.4,17.9,1490,856,634,12.1,21.1,-226,-3.2,35.8,0,81,81,646
1995,11,d) 3,689,722,27600,27317,30,4,102,13.5,2165,517,1648,1.9,7.9,1599,1005,594,3.7,5.9,566,2,11.8,0,74,74,520
1995,11,e) 4,624,635,6298,6353,18,2.7,68,10.3,969,84,885,1.3,15.3,1079,269,810,4.2,17,-110,-1.7,30.6,0,50,50,214
1995,11,f) 5,609,646,6994,6940,18,2.7,63,9.5,1322,235,1087,3.4,19,1213,476,737,6.9,17.5,109,1.5,35,0,53,53,447
1995,11,g) 6 to 10,2634,2790,37896,38343,91,3.2,280,9.7,4876,830,4046,2.2,12.7,5770,1888,3882,4.9,15,-894,-2.3,25.4,0,183,185,1072
1995,11,h) 11 to 15,2022,2261,35063,35484,100,4.3,213,9.2,4717,1048,3669,3,13.3,5558,1775,3783,5,15.7,-841,-2.4,26.6,0,116,116,1009
1995,11,i) 16 to 20,1052,1293,45530,48282,37,2.8,92,6.9,4610,414,4196,0.9,9.5,10113,731,9382,1.5,20.9,-5503,-11.4,19,0,44,45,338
1995,11,l) Left Censored,4402,6665,228064,228279,370,5.5,516,7.7,27390,6644,20746,2.9,12,27821,9440,18381,4.1,12.2,-431,-0.2,24,0,161,164,1866
1995,12,a) 0,37216,37420,205016,102904,37168,198.7,0,0,204225,204225,0,198.5,198.5,0,0,0,0,0,204225,198.5,0,0,,,
1995,12,b) 1,28468,28819,206446,207868,146,0.4,8792,26.3,60956,4157,56799,2,29.3,63800,39278,24522,18.9,30.7,-2844,-1.4,58.6,0,7299,7306,34462
1995,12,c) 2,23238,23540,191634,196923,841,3.2,5476,21.1,43699,6265,37434,3.2,22.2,54276,31986,22290,16.2,27.6,-10577,-5.4,44.4,0,4619,4619,27622
1995,12,d) 3,19535,20055,170960,179454,789,3.7,3639,16.9,36151,4467,31684,2.5,20.1,53138,22142,30996,12.3,29.6,-16987,-9.5,40.2,0,3027,3031,17941
1995,12,e) 4,16897,17446,149943,153261,608,3.3,2770,14.9,31233,3970,27263,2.6,20.4,37869,20511,17358,13.4,24.7,-6636,-4.3,40.8,0,2187,2190,15489
1995,12,f) 5,15718,16241,149322,150321,586,3.4,2304,13.5,27434,5053,22381,3.4,18.3,29432,13721,15711,9.1,19.6,-1998,-1.3,36.6,0,1859,1860,11688
1995,12,g) 6 to 10,57695,62626,732813,732544,2206,3.4,7122,10.9,145050,49852,95198,6.8,19.8,144512,55720,88792,7.6,19.7,538,0.1,39.4,0,5304,5374,39882
1995,12,h) 11 to 15,34353,39295,511538,512350,1555,3.9,3438,8.5,85970,30595,55375,6,16.8,87593,30214,57379,5.9,17.1,-1623,-0.3,33.6,0,2290,2324,15392
1995,12,i) 16 to 20,15111,20294,314096,312678,781,3.8,1783,8.6,47586,12659,34927,4,15.2,44749,14308,30441,4.6,14.3,2837,0.9,28.6,0,972,988,5863
1995,12,l) Left Censored,35562,81237,2492545,2465400,5045,6.2,5922,7.2,326383,98175,228208,4,13.2,272093,80549,191544,3.3,11,54290,2.2,22,0,1775,1813,12286
1995,13,a) 0,15523,15718,98595,49428,15617,198.7,0,0,98335,98335,0,198.9,198.9,0,0,0,0,0,98335,198.9,0,0,,,
1995,13,b) 1,11590,11779,91238,91485,72,0.5,3229,23.9,27454,2958,24496,3.2,30,27948,15354,12594,16.8,30.5,-494,-0.5,60,0,2634,2634,12736
1995,13,c) 2,9154,9261,78099,82589,338,3.4,1892,18.8,16626,2255,14371,2.7,20.1,25606,14951,10655,18.1,31,-8980,-10.9,40.2,0,1551,1554,13498
1995,13,d) 3,7532,7771,71376,72243,287,3.5,1269,15.3,14815,2884,11931,4,20.5,16548,8691,7857,12,22.9,-1733,-2.4,41,0,1004,1005,7533
1995,13,e) 4,6562,6841,67290,68177,254,3.5,956,13.3,12836,1833,11003,2.7,18.8,14609,6917,7692,10.1,21.4,-1773,-2.6,37.6,0,730,733,4881
1995,13,f) 5,5957,6141,62115,62700,236,3.7,811,12.6,11888,2120,9768,3.4,19,13057,6357,6700,10.1,20.8,-1169,-1.8,38,0,616,616,4591
1995,13,g) 6 to 10,24011,26215,344268,340593,1060,3.9,2606,9.6,58461,14397,44064,4.2,17.2,51111,19699,31412,5.8,15,7350,2.2,30,0,1835,1859,13085
1995,13,h) 11 to 15,15085,17550,237092,236527,660,3.7,1405,7.8,34014,6686,27328,2.8,14.4,32883,11470,21413,4.8,13.9,1131,0.5,27.8,0,876,882,6116
1995,13,i) 16 to 20,7454,9760,173854,170354,413,4.2,718,7.2,30237,9297,20940,5.5,17.7,23237,6880,16357,4,13.6,7000,4.1,27.2,0,387,388,2930
1995,13,l) Left Censored,21634,46014,1633992,1597858,2843,6.2,3054,6.6,232311,70300,162011,4.4,14.5,160043,50072,109971,3.1,10,72268,4.5,20,0,910,925,6341
1995,15,a) 0,1952,1960,10923,5479,1946,198.6,0,0,10888,10888,0,198.7,198.7,0,0,0,0,0,10888,198.7,0,0,,,
1995,15,b) 1,1511,1526,17361,17031,7,0.4,415,23.6,3558,,,,20.9,2898,1514,1384,8.9,17,660,3.9,34,1,349,349,1300
1995,15,c) 2,1260,1295,9707,10050,34,2.4,262,18.5,2106,282,1824,2.8,21,2791,1128,1663,11.2,27.8,-685,-6.8,42,0,212,212,957
1995,15,d) 3,1138,1199,12167,12337,41,3.2,180,14.2,1706,,,,13.8,2046,759,1287,6.2,16.6,-340,-2.8,27.6,1,151,151,602
1995,15,e) 4,1142,1183,12514,13200,39,3.1,182,14.5,1394,205,1189,1.6,10.6,2766,1012,1754,7.7,21,-1372,-10.4,21.2,0,150,151,778
1995,15,f) 5,1026,1111,9328,9427,41,3.5,168,14.3,1337,231,1106,2.5,14.2,1534,663,871,7,16.3,-197,-2.1,28.4,0,132,132,478
1995,15,g) 6 to 10,4205,4701,55749,56942,155,3.2,516,10.6,6430,1268,5162,2.2,11.3,8816,2871,5945,5,15.5,-2386,-4.2,22.6,0,378,380,1905
1995,15,h) 11 to 15,3065,3583,39544,40496,110,3,262,7.2,4094,650,3444,1.6,10.1,5997,1627,4370,4,14.8,-1903,-4.7,20.2,0,173,174,1020
1995,15,i) 16 to 20,1598,2206,35701,35123,81,3.6,136,6.1,6122,3520,2602,10,17.4,4965,1263,3702,3.6,14.1,1157,3.3,28.2,0,76,78,372
1995,15,l) Left Censored,4648,8407,218890,221342,384,4.5,520,6.1,19701,6903,12798,3.1,8.9,24605,7939,16666,3.6,11.1,-4904,-2.2,17.8,0,166,169,1033
1995,16,a) 0,3054,3068,14052,7047,3047,198.6,0,0,14011,14011,0,198.8,198.8,0,0,0,0,0,14011,198.8,0,0,,,
1995,16,b) 1,2314,2338,14368,14554,10,0.4,666,24.6,3854,679,3175,4.7,26.5,4225,2427,1798,16.7,29,-371,-2.5,53,0,510,511,1901
1995,16,c) 2,1709,1724,11358,11701,60,3.2,332,17.7,2480,480,2000,4.1,21.2,3165,1533,1632,13.1,27,-685,-5.8,42.4,0,263,263,1248
1995,16,d) 3,1480,1507,10747,11143,56,3.5,266,16.5,1861,159,1702,1.4,16.7,2652,1247,1405,11.2,23.8,-791,-7.1,33.4,0,203,203,920
1995,16,e) 4,1231,1262,9457,9402,53,4,158,12,1764,363,1401,3.9,18.8,1653,642,1011,6.8,17.6,111,1.2,35.2,0,120,120,462
1995,16,f) 5,1241,1276,10258,10411,55,4.1,172,12.9,1849,211,1638,2,17.8,2154,889,1265,8.5,20.7,-305,-2.9,35.6,0,126,126,610
1995,16,g) 6 to 10,4245,4558,51755,51487,161,3.4,433,9.2,7736,1320,6416,2.6,15,7199,2497,4702,4.8,14,537,1,28,0,305,305,1858
1995,16,h) 11 to 15,2869,3198,35836,35663,122,3.7,245,7.5,5440,1284,4156,3.6,15.3,5094,1604,3490,4.5,14.3,346,1,28.6,0,157,157,775
1995,16,i) 16 to 20,1648,1973,33885,32854,101,5.1,126,6.3,5262,606,4656,1.8,16,3199,870,2329,2.6,9.7,2063,6.3,19.4,0,78,80,460
1995,16,l) Left Censored,4269,7268,176329,177436,333,4.5,474,6.5,20511,5099,15412,2.9,11.6,22724,10021,12703,5.6,12.8,-2213,-1.2,23.2,0,178,180,894
1995,17,a) 0,20468,20562,119702,60064,20403,198.5,0,0,119277,119277,0,198.6,198.6,0,0,0,0,0,119277,198.6,0,0,,,
1995,17,b) 1,15804,15986,124904,122133,93,0.5,3781,21,38400,2929,35471,2.4,31.4,32858,16814,16044,13.8,26.9,5542,4.5,53.8,0,2953,2955,13692
1995,17,c) 2,13329,13469,111006,110928,374,2.6,2317,16,27799,2014,25785,1.8,25.1,27642,14857,12785,13.4,24.9,157,0.2,49.8,0,1843,1843,12299
1995,17,d) 3,11548,11973,109336,110698,434,3.4,1671,13.2,20277,3161,17116,2.9,18.3,23001,12114,10887,10.9,20.8,-2724,-2.5,36.6,0,1308,1311,9904
1995,17,e) 4,10581,11112,101955,102136,354,3,1368,11.7,18381,2662,15719,2.6,18,18742,7567,11175,7.4,18.4,-361,-0.4,36,0,1028,1034,5929
1995,17,f) 5,10094,10420,119012,119610,351,3.2,1254,11.5,18410,2421,15989,2,15.4,19606,8623,10983,7.2,16.4,-1196,-1,30.8,0,966,969,5280
1995,17,g) 6 to 10,40702,43617,549508,550064,1363,3,3984,8.9,77101,14790,62311,2.7,14,78213,29786,48427,5.4,14.2,-1112,-0.2,28,0,2774,2782,20661
1995,17,h) 11 to 15,27919,31313,469839,467335,994,3.1,2216,6.9,61601,12684,48917,2.7,13.2,56592,17857,38735,3.8,12.1,5009,1.1,24.2,0,1449,1460,10018
1995,17,i) 16 to 20,14235,18097,296698,294236,565,3.1,1224,6.6,41150,9424,31726,3.2,14,36225,8644,27581,2.9,12.3,4925,1.7,24.6,0,709,720,4487
1995,17,l) Left Censored,48729,83456,2873112,2865862,4028,4.8,5532,6.6,324574,89026,235548,3.1,11.3,310075,81569,228506,2.8,10.8,14499,0.5,21.6,0,2006,2049,15441
1995,18,a) 0,10021,10093,58700,29439,10030,198.8,0,0,58522,58522,0,198.8,198.8,0,0,0,0,0,58522,198.8,0,0,,,
1995,18,b) 1,7651,7760,55964,55528,41,0.5,1995,22.6,15784,641,15143,1.2,28.4,14912,8651,6261,15.6,26.9,872,1.5,53.8,0,1652,1652,7458
1995,18,c) 2,6320,6408,46830,47295,187,2.7,1160,16.8,10230,1041,9189,2.2,21.6,11159,5799,5360,12.3,23.6,-929,-2,43.2,0,950,950,4838
1995,18,d) 3,5422,5650,52009,52569,191,3.2,858,14.3,9648,2151,7497,4.1,18.4,10768,4599,6169,8.7,20.5,-1120,-2.1,36.8,0,707,709,3818
1995,18,e) 4,5080,5348,48405,48686,178,3.2,661,11.8,9143,1120,8023,2.3,18.8,9705,4860,4845,10,19.9,-562,-1.1,37.6,0,514,516,3391
1995,18,f) 5,4825,5068,48897,49310,157,3,535,10.2,7742,1141,6601,2.3,15.7,8568,3029,5539,6.1,17.4,-826,-1.7,31.4,0,433,433,2274
1995,18,g) 6 to 10,18767,20588,266887,264990,664,3.1,1771,8.4,39143,6326,32817,2.4,14.8,35348,11198,24150,4.2,13.3,3795,1.5,26.6,0,1292,1304,7405
1995,18,h) 11 to 15,12875,14526,193093,191223,451,3.1,912,6.2,26632,5313,21319,2.8,13.9,22891,7189,15702,3.8,12,3741,1.9,24,0,607,612,4636
1995,18,i) 16 to 20,6672,8825,147811,147523,280,3.1,622,6.9,17934,3396,14538,2.3,12.2,17357,5054,12303,3.4,11.8,577,0.4,23.6,0,355,362,2855
1995,18,l) Left Censored,23165,42580,1443552,1424291,2240,5.2,2647,6.2,171797,47218,124579,3.3,12.1,133274,34863,98411,2.4,9.4,38523,2.7,18.8,0,990,994,6843
1995,19,a) 0,5008,5043,27309,13708,5009,198.7,0,0,27203,27203,0,198.4,198.4,0,0,0,0,0,27203,198.4,0,0,,,
1995,19,b) 1,3921,3963,25049,24923,22,0.5,984,21.9,6980,913,6067,3.7,28,6727,3801,2926,15.3,27,253,1,54,0,776,776,3264
1995,19,c) 2,3133,3150,21194,21251,99,2.9,573,16.8,4852,609,4243,2.9,22.8,4965,2756,2209,13,23.4,-113,-0.6,45.6,0,476,476,2394
1995,19,d) 3,2805,2919,22580,24466,88,2.8,461,14.8,3920,616,3304,2.5,16,7691,5441,2250,22.2,31.4,-3771,-15.4,32,0,370,370,1804
1995,19,e) 4,2594,2703,21267,23274,91,3.2,346,12.2,3304,473,2831,2,14.2,7317,1574,5743,6.8,31.4,-4013,-17.2,28.4,0,280,282,1239
1995,19,f) 5,2424,2501,20202,20052,74,2.8,295,11.3,3996,1024,2972,5.1,19.9,3695,1764,1931,8.8,18.4,301,1.5,36.8,0,234,235,1134
1995,19,g) 6 to 10,9622,10414,126674,126423,339,3.2,1006,9.4,17964,2835,15129,2.2,14.2,17461,6836,10625,5.4,13.8,503,0.4,27.6,0,735,736,4698
1995,19,h) 11 to 15,7778,8823,98239,99040,249,2.8,622,6.9,11577,1444,10133,1.5,11.7,13179,5677,7502,5.7,13.3,-1602,-1.6,23.4,0,416,418,2451
1995,19,i) 16 to 20,4455,6005,75059,74624,171,2.8,354,5.8,9235,1359,7876,1.8,12.4,8365,2298,6067,3.1,11.2,870,1.2,22.4,0,189,190,979
1995,19,l) Left Censored,15469,25066,670619,660205,1017,4,1368,5.4,70736,17143,53593,2.6,10.7,49908,13196,36712,2,7.6,20828,3.1,15.2,0,576,583,2865
1995,20,a) 0,5150,5187,28741,14414,5146,198.4,0,0,28655,28655,0,198.8,198.8,0,0,0,0,0,28655,198.8,0,0,,,
1995,20,b) 1,3944,3993,26200,26410,20,0.4,1040,22.8,6950,289,6661,1.1,26.3,7369,4014,3355,15.2,27.9,-419,-1.6,52.6,0,856,856,3504
1995,20,c) 2,3152,3182,23295,23930,92,2.7,615,17.7,4707,435,4272,1.8,19.7,5977,2937,3040,12.3,25,-1270,-5.3,39.4,0,511,511,2578
1995,20,d) 3,2738,2820,22630,23010,103,3.4,457,15.2,4483,901,3582,3.9,19.5,5243,2065,3178,9,22.8,-760,-3.3,39,0,360,366,1739
1995,20,e) 4,2427,2551,19724,20148,101,3.8,347,12.9,3426,444,2982,2.2,17,4274,1945,2329,9.7,21.2,-848,-4.2,34,0,273,274,1621
1995,20,f) 5,2192,2286,20668,20695,86,3.6,287,12,3532,469,3063,2.3,17.1,3585,1493,2092,7.2,17.3,-53,-0.2,34.2,0,229,229,1213
1995,20,g) 6 to 10,9221,9855,106425,107136,367,3.6,958,9.4,13039,2323,10716,2.2,12.2,14460,5764,8696,5.4,13.5,-1421,-1.3,24.4,0,697,699,3933
1995,20,h) 11 to 15,7146,7905,88598,88721,231,2.9,613,7.6,11701,2087,9614,2.4,13.2,11947,3997,7950,4.5,13.5,-246,-0.3,26.4,0,411,411,2451
1995,20,i) 16 to 20,3633,4825,68944,68792,178,3.6,339,6.9,8231,1997,6234,2.9,12,7926,2674,5252,3.9,11.5,305,0.5,23,0,183,187,895
1995,20,l) Left Censored,12518,20668,551080,548192,810,3.9,1174,5.6,55058,13221,41837,2.4,10,49281,13208,36073,2.4,9,5777,1,18,0,470,480,2731
1995,21,a) 0,6402,6454,38658,19351,6430,199.3,0,0,38614,38614,0,199.5,199.5,0,0,0,0,0,38614,199.5,0,0,,,
1995,21,b) 1,4790,4862,36194,36639,36,0.7,1291,23.3,10003,1068,8935,2.9,27.3,10893,6401,4492,17.5,29.7,-890,-2.4,54.6,0,1062,1062,5184
1995,21,c) 2,4079,4138,34297,34681,89,2,799,17.7,7810,1768,6042,5.1,22.5,8577,4393,4184,12.7,24.7,-767,-2.2,45,0,673,673,3839
1995,21,d) 3,3494,3621,29357,31063,111,2.9,511,13.3,5718,856,4862,2.8,18.4,9129,3611,5518,11.6,29.4,-3411,-11,36.8,0,409,409,2251
1995,21,e) 4,2996,3100,25155,26272,120,3.7,415,12.7,4761,1159,3602,4.4,18.1,6994,3033,3961,11.5,26.6,-2233,-8.5,36.2,0,340,340,2381
1995,21,f) 5,2933,3051,29250,29445,89,2.8,399,12.4,4679,625,4054,2.1,15.9,5069,2288,2781,7.8,17.2,-390,-1.3,31.8,0,305,306,1727
1995,21,g) 6 to 10,11741,12770,167852,166491,383,2.9,1188,9,25429,4655,20774,2.8,15.3,22706,8315,14391,5,13.6,2723,1.7,27.2,0,927,928,6081
1995,21,h) 11 to 15,7992,8908,121909,121281,283,3.1,594,6.5,16135,2498,13637,2.1,13.3,14879,4096,10783,3.4,12.3,1256,1,24.6,0,411,413,2482
1995,21,i) 16 to 20,4085,5241,89980,87690,182,3.4,353,6.6,13985,3073,10912,3.5,15.9,9404,3088,6316,3.5,10.7,4581,5.2,21.4,0,199,213,1408
1995,21,l) Left Censored,13790,24727,753123,745486,1213,4.9,1556,6.2,86566,22832,63734,3.1,11.6,71291,22856,48435,3.1,9.6,15275,2,19.2,0,557,559,4787
1995,22,a) 0,7041,7081,49705,24947,7038,198.8,0,0,49516,49516,0,198.5,198.5,0,0,0,0,0,49516,198.5,0,0,,,
1995,22,b) 1,5618,5716,50885,50260,38,0.6,1531,23.4,16417,849,15568,1.7,32.7,15166,8504,6662,16.9,30.2,1251,2.5,60.4,0,1268,1270,7467
1995,22,c) 2,4494,4546,40957,43491,136,2.8,840,17.1,7716,854,6862,2,17.7,12784,7838,4946,18,29.4,-5068,-11.7,35.4,0,699,705,7185
1995,22,d) 3,3840,3971,34952,36240,122,2.9,610,14.5,7520,1011,6509,2.8,20.8,10096,5583,4513,15.4,27.9,-2576,-7.1,41.6,0,471,473,4412
1995,22,e) 4,3378,3564,36943,36596,131,3.5,472,12.6,7490,892,6598,2.4,20.5,6796,2868,3928,7.8,18.6,694,1.9,37.2,0,381,381,2214
1995,22,f) 5,3046,3155,33740,32924,90,2.7,384,11.6,7333,552,6781,1.7,22.3,5701,2205,3496,6.7,17.3,1632,5,34.6,0,284,284,1706
1995,22,g) 6 to 10,11978,13048,154180,155521,434,3.2,1316,9.7,22703,4815,17888,3.1,14.6,25384,10163,15221,6.5,16.3,-2681,-1.7,29.2,0,977,977,6850
1995,22,h) 11 to 15,10506,11870,152967,150500,507,4.2,809,6.7,23964,7640,16324,5.1,15.9,19029,5629,13400,3.7,12.6,4935,3.3,25.2,0,550,555,2923
1995,22,i) 16 to 20,5095,6433,95096,94461,214,3.3,396,6.1,14406,2407,11999,2.5,15.3,13136,3839,9297,4.1,13.9,1270,1.4,27.8,0,226,236,1585
1995,22,l) Left Censored,14889,27171,737140,738709,1179,4.3,1818,6.6,86516,23890,62626,3.2,11.7,89654,29604,60050,4,12.1,-3138,-0.4,23.4,0,636,665,4599
1995,23,a) 0,2739,2745,11392,5708,2727,198.7,0,0,11368,11368,0,199.2,199.2,0,0,0,0,0,11368,199.2,0,0,,,
1995,23,b) 1,1940,1955,11323,11448,7,0.3,520,23.2,3179,135,3044,1.2,27.8,3428,1895,1533,16.6,29.9,-249,-2.1,55.6,0,411,411,1506
1995,23,c) 2,1610,1633,10866,11078,51,2.9,267,15.3,1997,174,1823,1.6,18,2421,1233,1188,11.1,21.9,-424,-3.9,36,0,220,220,1089
1995,23,d) 3,1320,1371,9259,9568,38,2.6,217,14.8,1473,169,1304,1.8,15.4,2090,1143,947,11.9,21.8,-617,-6.4,30.8,0,152,154,838
1995,23,e) 4,1213,1268,8675,8770,32,2.4,171,12.8,1468,282,1186,3.2,16.7,1658,712,946,8.1,18.9,-190,-2.2,33.4,0,133,133,601
1995,23,f) 5,1256,1275,9493,9639,39,2.9,170,12.7,1602,129,1473,1.3,16.6,1893,948,945,9.8,19.6,-291,-3,33.2,0,125,125,626
1995,23,g) 6 to 10,5798,6134,57449,57226,208,3.3,641,10.1,8477,1933,6544,3.4,14.8,8031,2822,5209,4.9,14,446,0.8,28,0,456,458,2084
1995,23,h) 11 to 15,3280,3650,44105,43638,140,3.8,282,7.6,5785,833,4952,1.9,13.3,4850,1527,3323,3.5,11.1,935,2.2,22.2,0,202,202,1108
1995,23,i) 16 to 20,1741,2277,32412,31547,91,3.9,152,6.6,5009,930,4079,2.9,15.9,3278,799,2479,2.5,10.4,1731,5.5,20.8,0,88,89,472
1995,23,l) Left Censored,5283,8396,226138,225946,323,3.8,566,6.6,23121,6127,16994,2.7,10.2,22737,6014,16723,2.7,10.1,384,0.1,20.2,0,224,224,1599
1995,24,a) 0,9176,9252,48442,24324,9193,198.7,0,0,48237,48237,0,198.3,198.3,0,0,0,0,0,48237,198.3,0,0,,,
1995,24,b) 1,6851,6951,49757,50125,46,0.6,1760,22.3,14265,1121,13144,2.2,28.5,15001,7990,7011,15.9,29.9,-736,-1.4,57,0,1423,1423,7026
1995,24,c) 2,5798,5882,51557,50347,192,3,1099,17.3,13054,1321,11733,2.6,25.9,10634,5798,4836,11.5,21.1,2420,4.8,42.2,0,869,869,4685
1995,24,d) 3,4865,5057,41960,42070,191,3.6,752,14.1,8382,1224,7158,2.9,19.9,8601,4489,4112,10.7,20.4,-219,-0.5,39.8,0,570,573,3574
1995,24,e) 4,4545,4736,43225,42722,214,4.3,590,12,8596,1443,7153,3.4,20.1,7589,3141,4448,7.4,17.8,1007,2.3,35.6,0,458,458,2395
1995,24,f) 5,4477,4597,41366,40912,183,3.8,545,11.4,8084,1269,6815,3.1,19.8,7176,2827,4349,6.9,17.5,908,2.3,35,0,426,427,2129
1995,24,g) 6 to 10,18289,19599,230776,230495,662,3.3,1965,9.7,34862,5936,28926,2.6,15.1,34300,12212,22088,5.3,14.9,562,0.2,29.8,0,1406,1416,8719
1995,24,h) 11 to 15,10754,12165,167548,166251,429,3.5,929,7.5,25138,5878,19260,3.5,15.1,22543,7134,15409,4.3,13.6,2595,1.5,27.2,0,604,607,3314
1995,24,i) 16 to 20,5281,6995,116029,114585,224,3.1,485,6.8,15767,3470,12297,3,13.8,12878,4003,8875,3.5,11.2,2889,2.6,22.4,0,280,281,1621
1995,24,l) Left Censored,17587,32448,1008752,1001483,1739,5.3,2357,7.2,121732,33486,88246,3.3,12.2,107194,34151,73043,3.4,10.7,14538,1.5,21.4,0,730,758,7326
1995,25,a) 0,10994,11067,61618,30919,10978,198.4,0,0,61399,61399,0,198.6,198.6,0,0,0,0,0,61399,198.6,0,0,,,
1995,25,b) 1,8410,8459,61650,59674,39,0.4,1871,19.8,19082,1557,17525,2.6,32,15130,8754,6376,14.7,25.4,3952,6.6,50.8,0,1477,1477,7651
1995,25,c) 2,6634,6688,53722,54333,192,2.7,1093,15.3,12469,1470,10999,2.7,22.9,13690,6865,6825,12.6,25.2,-1221,-2.3,45.8,0,910,910,6035
1995,25,d) 3,5624,5928,58535,58210,228,3.6,860,13.8,11240,1413,9827,2.4,19.3,10589,4887,5702,8.4,18.2,651,1.1,36.4,0,647,654,3528
1995,25,e) 4,4991,5192,48620,48500,201,3.7,665,12.2,9329,1171,8158,2.4,19.2,9089,4242,4847,8.7,18.7,240,0.5,37.4,0,525,525,3185
1995,25,f) 5,5003,5219,51819,51619,180,3.3,619,11.4,9150,1281,7869,2.5,17.7,8749,3551,5198,6.9,16.9,401,0.8,33.8,0,466,466,2631
1995,25,g) 6 to 10,24090,25658,312666,312410,935,3.5,2441,9.2,43174,5345,37829,1.7,13.8,42662,15493,27169,5,13.7,512,0.1,27.4,0,1736,1749,10800
1995,25,h) 11 to 15,15073,17025,255847,255018,659,3.8,1250,7.2,35465,6812,28653,2.7,13.9,33807,11296,22511,4.4,13.3,1658,0.6,26.6,0,820,829,6715
1995,25,i) 16 to 20,7410,9827,197025,196155,384,3.8,702,7,23062,5679,17383,2.9,11.8,21322,6933,14389,3.5,10.9,1740,0.9,21.8,0,343,355,3242
1995,25,l) Left Censored,29179,46827,1584772,1581692,2261,4.8,3358,7.1,182279,48646,133633,3.1,11.5,176118,50118,126000,3.2,11.1,6161,0.4,22.2,0,1288,1322,11071
1995,26,a) 0,16274,16353,98944,49652,16239,198.6,0,0,98584,98584,0,198.5,198.5,0,0,0,0,0,98584,198.5,0,0,,,
1995,26,b) 1,12133,12269,97631,92950,70,0.5,2618,19.2,32384,3364,29020,3.6,34.8,23022,11410,11612,12.3,24.8,9362,10,49.6,0,2041,2041,9339
1995,26,c) 2,10120,10262,84744,85101,337,3.1,1693,15.4,18960,3222,15738,3.8,22.3,19673,10012,9661,11.8,23.1,-713,-0.8,44.6,0,1370,1370,8634
1995,26,d) 3,8787,9091,78079,78742,281,2.9,1260,13.1,15185,1810,13375,2.3,19.3,16510,7443,9067,9.5,21,-1325,-1.7,38.6,0,1040,1041,6372
1995,26,e) 4,8229,8570,76043,77208,246,2.7,1084,12,13924,1621,12303,2.1,18,16254,7083,9171,9.2,21.1,-2330,-3.1,36,0,852,852,5909
1995,26,f) 5,7958,8253,79235,81278,219,2.5,979,11.3,14250,2771,11479,3.4,17.5,18336,6696,11640,8.2,22.6,-4086,-5.1,35,0,753,755,4870
1995,26,g) 6 to 10,31527,34190,404304,401032,1050,3,3105,8.8,63140,13649,49491,3.4,15.7,56596,20473,36123,5.1,14.1,6544,1.6,28.2,0,2291,2313,14276
1995,26,h) 11 to 15,20508,23309,316359,312004,678,2.9,1540,6.5,44779,7603,37176,2.4,14.4,36068,12805,23263,4.1,11.6,8711,2.8,23.2,0,1041,1050,8062
1995,26,i) 16 to 20,10769,14114,220664,218669,397,2.8,938,6.5,29028,5016,24012,2.3,13.3,25038,7641,17397,3.5,11.5,3990,1.8,23,0,555,558,3457
1995,26,l) Left Censored,34904,62984,2199555,2174062,2790,4.4,3934,6.2,267429,70789,196640,3.3,12.3,216442,61379,155063,2.8,10,50987,2.3,20,0,1429,1445,11713
1995,27,a) 0,8877,8922,61135,30659,8876,199,0,0,60953,60953,0,198.8,198.8,0,0,0,0,0,60953,198.8,0,0,,,
1995,27,b) 1,7087,7162,49719,50395,45,0.6,1594,19.8,13539,1268,12271,2.5,26.9,14891,8433,6458,16.7,29.5,-1352,-2.6,53.8,0,1212,1213,7444
1995,27,c) 2,5853,5965,48806,49496,195,3.1,977,15.3,10505,2317,8188,4.7,21.2,11884,6818,5066,13.8,24,-1379,-2.8,42.4,0,742,742,5695
1995,27,d) 3,5008,5204,41377,41691,188,3.4,748,13.6,7572,1187,6385,2.8,18.2,8200,4139,4061,9.9,19.7,-628,-1.5,36.4,0,571,571,3230
1995,27,e) 4,4691,4905,46250,46209,127,2.5,522,10.2,7794,986,6808,2.1,16.9,7712,2942,4770,6.4,16.7,82,0.2,33.4,0,390,390,2148
1995,27,f) 5,4286,4460,41744,42228,132,2.8,511,11,7278,1515,5763,3.6,17.2,8246,3310,4936,7.8,19.5,-968,-2.3,34.4,0,357,360,2416
1995,27,g) 6 to 10,16968,18389,228528,227945,538,2.8,1637,8.6,31924,4673,27251,2.1,14,30757,10873,19884,4.8,13.5,1167,0.5,27,0,1171,1180,7708
1995,27,h) 11 to 15,11331,12940,196612,194164,446,3.4,884,6.7,27561,6283,21278,3.2,14.2,22664,6821,15843,3.5,11.7,4897,2.5,23.4,0,576,586,4234
1995,27,i) 16 to 20,6236,8055,127712,125588,238,2.9,558,6.8,16788,2970,13818,2.4,13.4,12540,3822,8718,3,10,4248,3.4,20,0,277,285,1888
1995,27,l) Left Censored,20156,34032,1204121,1191256,1414,4.1,2079,6,129657,36931,92726,3.1,10.9,103928,27426,76502,2.3,8.7,25729,2.2,17.4,0,782,791,5511
1995,28,a) 0,4534,4563,27649,13869,4534,198.7,0,0,27561,27561,0,198.7,198.7,0,0,0,0,0,27561,198.7,0,0,,,
1995,28,b) 1,3453,3488,32422,32078,16,0.4,962,24,10329,1053,9276,3.3,32.2,9640,4916,4724,15.3,30.1,689,2.1,60.2,0,806,806,4354
1995,28,c) 2,2759,2809,25692,27169,107,3.5,549,18,6674,1940,4734,7.1,24.6,9627,4719,4908,17.4,35.4,-2953,-10.8,49.2,0,469,469,4320
1995,28,d) 3,2132,2228,18678,18901,71,3,353,14.9,3118,603,2515,3.2,16.5,3564,1627,1937,8.6,18.9,-446,-2.4,33,0,285,285,1322
1995,28,e) 4,1995,2091,19302,19204,72,3.3,306,13.8,3314,472,2842,2.5,17.3,3117,1243,1874,6.5,16.2,197,1.1,32.4,0,225,225,999
1995,28,f) 5,1890,1942,16340,16603,61,3,275,13.4,2785,253,2532,1.5,16.8,3311,1560,1751,9.4,19.9,-526,-3.1,33.6,0,211,211,1107
1995,28,g) 6 to 10,7159,7717,93328,93459,285,3.6,820,10.3,12910,2452,10458,2.6,13.8,13171,4286,8885,4.6,14.1,-261,-0.3,27.6,0,635,635,3266
1995,28,h) 11 to 15,5644,6195,75235,75198,192,3,469,7.4,11521,2427,9094,3.2,15.3,11447,4301,7146,5.7,15.2,74,0.1,30.4,0,317,317,2264
1995,28,i) 16 to 20,2987,3749,51741,51625,135,3.5,278,7.3,7104,1930,5174,3.7,13.8,6872,1996,4876,3.9,13.3,232,0.5,26.6,0,164,164,754
1995,28,l) Left Censored,9241,16391,487943,483665,763,4.6,1009,6.1,59892,20483,39409,4.2,12.4,51337,15469,35868,3.2,10.6,8555,1.8,21.2,0,411,418,4339
1995,29,a) 0,10963,11029,58581,29454,10943,198.4,0,0,58254,58254,0,197.8,197.8,0,0,0,0,0,58254,197.8,0,0,,,
1995,29,b) 1,8307,8445,59324,59118,61,0.6,2444,25.1,17729,2108,15621,3.6,30,17317,10251,7066,17.3,29.3,412,0.7,58.6,0,1955,1957,8582
1995,29,c) 2,6545,6659,51474,52210,206,2.8,1357,18.7,12518,1320,11198,2.5,24,13989,7367,6622,14.1,26.8,-1471,-2.8,48,0,1121,1121,6336
1995,29,d) 3,5494,5667,50992,51482,193,3.2,942,15.5,10800,1436,9364,2.8,21,11779,6225,5554,12.1,22.9,-979,-1.9,42,0,748,748,3832
1995,29,e) 4,4961,5243,44778,45062,160,2.9,677,12.3,7914,1384,6530,3.1,17.6,8482,3588,4894,8,18.8,-568,-1.2,35.2,0,542,543,2962
1995,29,f) 5,4622,4789,45839,45418,170,3.4,592,11.8,10561,3022,7539,6.7,23.3,9718,3579,6139,7.9,21.4,843,1.9,42.8,0,471,471,2817
1995,29,g) 6 to 10,19460,20955,235107,236620,701,3.2,2055,9.5,33311,5442,27869,2.3,14.1,36336,14862,21474,6.3,15.4,-3025,-1.3,28.2,0,1534,1537,9394
1995,29,h) 11 to 15,12763,14603,191607,190285,532,3.6,1088,7.3,26439,6340,20099,3.3,13.9,23794,7904,15890,4.2,12.5,2645,1.4,25,0,728,732,4617
1995,29,i) 16 to 20,6664,8717,132650,132946,283,3.2,650,7.3,16047,4108,11939,3.1,12.1,16639,4307,12332,3.2,12.5,-592,-0.4,24.2,0,381,385,2601
1995,29,l) Left Censored,22218,38872,1265519,1256209,1776,4.5,2482,6.3,148043,34668,113375,2.8,11.8,129423,35303,94120,2.8,10.3,18620,1.5,20.6,0,929,955,6225
1995,30,a) 0,2581,2590,11578,5818,2576,198.9,0,0,11521,11521,0,198,198,0,0,0,0,0,11521,198,0,0,,,
1995,30,b) 1,1801,1814,9834,10099,7,0.3,523,24.9,2430,,,,24.1,2959,1754,1205,17.4,29.3,-529,-5.2,48.2,1,405,405,1347
1995,30,c) 2,1445,1465,8593,8707,56,3.5,260,16.5,1914,487,1427,5.6,22,2141,1107,1034,12.7,24.6,-227,-2.6,44,0,206,206,908
1995,30,d) 3,1254,1277,17953,13202,47,3.5,197,14.5,11386,,,,86.2,1884,821,1063,6.2,14.3,9502,71.9,28.6,1,157,157,674
1995,30,e) 4,1073,1101,8035,8070,22,1.9,134,11.5,1341,251,1090,3.1,16.6,1411,662,749,8.2,17.5,-70,-0.9,33.2,0,103,103,557
1995,30,f) 5,950,962,7476,7472,28,2.7,132,12.9,1358,140,1218,1.9,18.2,1349,616,733,8.2,18.1,9,0.1,36.2,0,103,103,506
1995,30,g) 6 to 10,3820,4049,36496,36870,178,4.2,444,10.6,5319,1096,4223,3,14.4,6067,2682,3385,7.3,16.5,-748,-2.1,28.8,0,329,331,1841
1995,30,h) 11 to 15,2910,3228,30624,30283,115,3.5,234,7.1,4532,1206,3326,4,15,3850,1167,2683,3.9,12.7,682,2.3,25.4,0,159,159,791
1995,30,i) 16 to 20,1619,1980,21375,21116,55,2.7,135,6.7,2780,291,2489,1.4,13.2,2261,779,1482,3.7,10.7,519,2.5,21.4,0,92,93,558
1995,30,l) Left Censored,4061,6461,114492,114100,252,3.9,353,5.4,11239,2692,8547,2.4,9.9,10454,3226,7228,2.8,9.2,785,0.7,18.4,0,176,176,1369
1995,31,a) 0,3101,3128,17507,8783,3103,198.4,0,0,17448,17448,0,198.7,198.7,0,0,0,0,0,17448,198.7,0,0,,,
1995,31,b) 1,2446,2487,17561,17100,9,0.3,626,22.1,5297,414,4883,2.4,31,4375,2334,2041,13.6,25.6,922,5.4,51.2,0,494,494,1902
1995,31,c) 2,2038,2066,15340,15292,68,3.1,316,14.3,3387,663,2724,4.3,22.1,3290,1570,1720,10.3,21.5,97,0.6,43,0,256,256,1364
1995,31,d) 3,1783,1823,13136,13379,54,2.8,273,14.1,2291,291,2000,2.2,17.1,2777,1377,1400,10.3,20.8,-486,-3.7,34.2,0,212,214,1082
1995,31,e) 4,1560,1624,13101,13003,58,3.4,221,13,2928,292,2636,2.2,22.5,2731,1430,1301,11,21,197,1.5,42,0,175,175,844
1995,31,f) 5,1512,1609,14532,14625,53,3.1,200,11.9,2123,222,1901,1.5,14.5,2309,1082,1227,7.4,15.8,-186,-1.3,29,0,153,154,769
1995,31,g) 6 to 10,6298,6784,88986,87824,195,2.8,604,8.6,12314,1472,10842,1.7,14,9990,3588,6402,4.1,11.4,2324,2.6,22.8,0,448,450,2317
1995,31,h) 11 to 15,4756,5376,60779,60613,151,2.7,381,6.9,8174,1712,6462,2.8,13.5,7841,2477,5364,4.1,12.9,333,0.6,25.8,0,255,256,1377
1995,31,i) 16 to 20,2703,3430,42671,42586,88,2.5,191,5.5,4921,852,4069,2,11.6,4751,1320,3431,3.1,11.2,170,0.4,22.4,0,128,128,780
1995,31,l) Left Censored,8986,14031,375552,371012,510,3.6,747,5.3,39205,8482,30723,2.3,10.6,30125,8781,21344,2.4,8.1,9080,2.5,16.2,0,328,332,1806
1995,32,a) 0,3984,3997,31584,15864,3961,198.2,0,0,31440,31440,0,198.2,198.2,0,0,0,0,0,31440,198.2,0,0,,,
1995,32,b) 1,2769,2806,27489,26606,23,0.7,840,25.8,9169,1084,8085,4.1,34.5,7403,4174,3229,15.7,27.8,1766,6.7,55.6,0,704,704,3723
1995,32,c) 2,1991,2012,20949,21510,76,3.4,485,21.8,4844,608,4236,2.8,22.5,5965,3477,2488,16.2,27.7,-1121,-5.2,45,0,402,402,2865
1995,32,d) 3,1597,1659,18222,18284,75,4.2,309,17.3,4322,443,3879,2.4,23.6,4446,2043,2403,11.2,24.3,-124,-0.7,47.2,0,238,238,1441
1995,32,e) 4,1496,1548,17734,17494,82,5,229,14.1,3582,436,3146,2.5,20.5,3101,1472,1629,8.4,17.7,481,2.8,35.4,0,170,170,1079
1995,32,f) 5,1384,1438,17343,17080,74,4.9,204,13.6,3755,738,3017,4.3,22,3229,1113,2116,6.5,18.9,526,3.1,37.8,0,150,150,782
1995,32,g) 6 to 10,4893,5400,83365,82766,252,4.5,609,10.9,14864,2301,12563,2.8,18,13666,5399,8267,6.5,16.5,1198,1.5,33,0,443,446,3580
1995,32,h) 11 to 15,3148,3672,65898,64902,170,4.5,310,8.3,9281,2269,7012,3.5,14.3,7289,1985,5304,3.1,11.2,1992,3.1,22.4,0,187,187,1000
1995,32,i) 16 to 20,1669,2202,58626,58936,134,6.1,141,6.4,7182,3414,3768,5.8,12.2,7802,2964,4838,5,13.2,-620,-1,24.4,0,85,85,2326
1995,32,l) Left Censored,3969,7217,321295,317127,562,7.8,491,6.8,37016,11426,25590,3.6,11.7,28679,6379,22300,2,9,8337,2.7,18,0,143,145,1078
1995,33,a) 0,2686,2693,14808,7423,2675,198.7,0,0,14771,14771,0,199,199,0,0,0,0,0,14771,199,0,0,,,
1995,33,b) 1,2032,2046,12562,12767,6,0.3,480,20.8,3349,127,3222,1,26.2,3758,1958,1800,15.3,29.4,-409,-3.2,52.4,0,389,389,1698
1995,33,c) 2,1573,1592,11127,11079,55,3.2,279,16.4,2821,484,2337,4.4,25.5,2724,1540,1184,13.9,24.6,97,0.9,49.2,0,225,225,1348
1995,33,d) 3,1350,1406,10639,10769,46,3.1,198,13.4,2057,266,1791,2.5,19.1,2316,1046,1270,9.7,21.5,-259,-2.4,38.2,0,146,146,795
1995,33,e) 4,1217,1258,10415,10258,52,4,153,11.7,1946,208,1738,2,19,1631,837,794,8.2,15.9,315,3.1,31.8,0,117,117,504
1995,33,f) 5,1211,1248,9793,9878,58,4.5,134,10.4,1627,216,1411,2.2,16.5,1797,523,1274,5.3,18.2,-170,-1.7,33,0,105,105,399
1995,33,g) 6 to 10,5786,6102,69678,69034,241,3.8,641,10.2,10199,1531,8668,2.2,14.8,8910,3449,5461,5,12.9,1289,1.9,25.8,0,480,482,2805
1995,33,h) 11 to 15,3170,3472,40880,40472,147,4.1,289,8.1,5935,1375,4560,3.4,14.7,5118,1988,3130,4.9,12.6,817,2.1,25.2,0,201,203,1205
1995,33,i) 16 to 20,1613,2105,32124,31285,108,5.1,135,6.4,4982,1745,3237,5.6,15.9,3304,777,2527,2.5,10.6,1678,5.3,21.2,0,76,76,399
1995,33,l) Left Censored,5091,8393,247960,245932,449,5.3,550,6.5,28209,9670,18539,3.9,11.5,24152,8013,16139,3.3,9.8,4057,1.7,19.6,0,167,170,1592
1995,34,a) 0,17008,17125,89108,44719,17007,198.6,0,0,88778,88778,0,198.5,198.5,0,0,0,0,0,88778,198.5,0,0,,,
1995,34,b) 1,12125,12201,80073,80252,36,0.3,2883,20.9,21710,656,21054,0.8,27.1,22067,11870,10197,14.8,27.5,-357,-0.4,54.2,0,2247,2247,9904
1995,34,c) 2,10284,10347,75850,76319,355,3.2,1796,16.2,16830,1318,15512,1.7,22.1,17768,9575,8193,12.5,23.3,-938,-1.2,44.2,0,1462,1462,7593
1995,34,d) 3,8574,8763,67122,68513,286,3.1,1271,13.7,12400,1050,11350,1.5,18.1,15181,6910,8271,10.1,22.2,-2781,-4.1,36.2,0,980,981,5349
1995,34,e) 4,7953,8123,61112,61385,294,3.4,1065,12.5,12095,1335,10760,2.2,19.7,12641,5258,7383,8.6,20.6,-546,-0.9,39.4,0,805,806,3990
1995,34,f) 5,7663,7822,64606,64023,274,3.4,938,11.5,11626,1231,10395,1.9,18.2,10460,4530,5930,7.1,16.3,1166,1.9,32.6,0,706,716,3449
1995,34,g) 6 to 10,33388,34833,387241,389465,1256,3.5,3664,10.2,56177,9580,46597,2.5,14.4,60625,24036,36589,6.2,15.6,-4448,-1.2,28.8,0,2662,2673,16018
1995,34,h) 11 to 15,21143,22893,290532,291583,723,3.1,1767,7.5,38457,6337,32120,2.2,13.2,40558,13172,27386,4.5,13.9,-2101,-0.7,26.4,0,1214,1218,8344
1995,34,i) 16 to 20,10640,12380,188703,185594,405,3.2,914,7.2,28225,5678,22547,3.1,15.2,22007,6826,15181,3.7,11.9,6218,3.3,23.8,0,545,551,2844
1995,34,l) Left Censored,36373,57956,1834858,1839012,2578,4.4,4035,6.9,201448,55780,145668,3,11,209755,63738,146017,3.5,11.4,-8307,-0.4,22,0,1626,1698,13191
1995,35,a) 0,3510,3528,20341,10197,3503,198.6,0,0,20288,20288,0,199,199,0,0,0,0,0,20288,199,0,0,,,
1995,35,b) 1,2600,2648,19062,19605,17,0.6,771,25.1,4951,201,4750,1,25.3,6037,3519,2518,17.9,30.8,-1086,-5.5,50.6,0,623,623,2902
1995,35,c) 2,2008,2025,15659,15872,84,3.8,400,18.2,3716,837,2879,5.3,23.4,4141,2295,1846,14.5,26.1,-425,-2.7,46.8,0,338,338,2019
1995,35,d) 3,1655,1727,14462,14928,64,3.4,323,17.3,2864,560,2304,3.8,19.2,3795,2115,1680,14.2,25.4,-931,-6.2,38.4,0,256,256,1629
1995,35,e) 4,1612,1727,15137,14997,69,3.8,232,12.7,2911,503,2408,3.4,19.4,2631,1235,1396,8.2,17.5,280,1.9,35,0,187,187,979
1995,35,f) 5,1428,1458,12227,12208,59,3.9,177,11.6,2371,531,1840,4.3,19.4,2333,945,1388,7.7,19.1,38,0.3,38.2,0,138,138,798
1995,35,g) 6 to 10,5518,5961,68081,68305,233,3.8,662,10.7,9540,1414,8126,2.1,14,9988,4126,5862,6,14.6,-448,-0.6,28,0,459,462,2447
1995,35,h) 11 to 15,4079,4638,56916,55448,188,4,416,8.7,10234,2369,7865,4.3,18.5,7297,2469,4828,4.5,13.2,2937,5.3,26.4,0,269,270,1465
1995,35,i) 16 to 20,2136,2725,33392,33301,113,4,235,8.4,4933,983,3950,3,14.8,4750,1811,2939,5.4,14.3,183,0.5,28.6,0,135,135,766
1995,35,l) Left Censored,5395,9306,236106,235407,493,5.3,591,6.3,27163,6903,20260,2.9,11.5,25765,8222,17543,3.5,10.9,1398,0.6,21.8,0,202,210,1334
1995,36,a) 0,35549,35730,182638,91892,35458,198.5,0,0,181492,181492,0,197.5,197.5,0,0,0,0,0,181492,197.5,0,0,,,
1995,36,b) 1,26362,26502,182481,181447,75,0.2,6901,22.8,52478,1898,50580,1,28.9,50410,27298,23112,15,27.8,2068,1.1,55.6,0,5523,5523,22970
1995,36,c) 2,21980,22193,165175,168056,743,3.1,4374,18.2,36767,4716,32051,2.8,21.9,42529,23302,19227,13.9,25.3,-5762,-3.4,43.8,0,3589,3589,19559
1995,36,d) 3,18577,18996,148080,150714,683,3.4,3170,15.6,29597,3788,25809,2.5,19.6,34865,19021,15844,12.6,23.1,-5268,-3.5,39.2,0,2529,2532,15371
1995,36,e) 4,17333,17738,142487,144089,622,3.3,2588,13.8,29249,2966,26283,2.1,20.3,32452,13594,18858,9.4,22.5,-3203,-2.2,40.6,0,2055,2055,11547
1995,36,f) 5,16411,16802,131746,134944,539,3.1,2183,12.4,22173,2483,19690,1.8,16.4,28569,12026,16543,8.9,21.2,-6396,-4.8,32.8,0,1730,1731,9302
1995,36,g) 6 to 10,69586,72599,787966,793564,2237,3,7714,10.2,95830,14897,80933,1.9,12.1,107025,42499,64526,5.4,13.5,-11195,-1.4,24.2,0,5823,5851,30654
1995,36,h) 11 to 15,43938,48029,611972,613125,1413,2.9,3938,8,77717,14258,63459,2.3,12.7,80023,26472,53551,4.3,13.1,-2306,-0.4,25.4,0,2731,2753,16430
1995,36,i) 16 to 20,21211,26408,432242,433936,841,3.1,2016,7.5,53299,11582,41717,2.7,12.3,56686,15188,41498,3.5,13.1,-3387,-0.8,24.6,0,1305,1321,7261
1995,36,l) Left Censored,79354,124320,3880531,3907848,5061,4,8994,7.1,420159,118503,301656,3,10.8,474793,113718,361075,2.9,12.1,-54634,-1.3,21.6,0,4003,4048,27433
1995,37,a) 0,14397,14489,78750,39595,14381,198.5,0,0,78311,78311,0,197.8,197.8,0,0,0,0,0,78311,197.8,0,0,,,
1995,37,b) 1,10566,10709,81634,78357,76,0.6,2654,21.9,26135,3087,23048,3.9,33.4,19581,10969,8612,14,25,6554,8.4,50,0,2168,2168,9641
1995,37,c) 2,8190,8286,61821,62935,264,2.9,1549,17.3,13807,1779,12028,2.8,21.9,16035,8819,7216,14,25.5,-2228,-3.6,43.8,0,1300,1302,7754
1995,37,d) 3,6949,7215,67566,67922,244,3.2,1014,13.3,12374,1642,10732,2.4,18.2,13085,6436,6649,9.5,19.3,-711,-1.1,36.4,0,817,817,5553
1995,37,e) 4,6471,6768,60380,60390,220,3.1,896,12.6,11494,2072,9422,3.4,19,11513,5307,6206,8.8,19.1,-19,-0.1,38,0,692,693,3887
1995,37,f) 5,6306,6539,60225,59801,216,3.2,759,11.1,11049,1323,9726,2.2,18.5,10201,4547,5654,7.6,17.1,848,1.4,34.2,0,590,592,3656
1995,37,g) 6 to 10,25441,27754,337868,333793,1022,3.6,2608,9.1,52145,9379,42766,2.8,15.6,43994,16226,27768,4.9,13.2,8151,2.4,26.4,0,1895,1904,10444
1995,37,h) 11 to 15,17142,19658,257923,255006,692,3.5,1303,6.5,35571,7954,27617,3.1,13.9,29736,9471,20265,3.7,11.7,5835,2.2,23.4,0,825,826,5213
1995,37,i) 16 to 20,8120,10616,171253,168914,415,3.9,650,6.1,23809,5871,17938,3.5,14.1,19130,4789,14341,2.8,11.3,4679,2.8,22.6,0,384,384,1947
1995,37,l) Left Censored,25246,49930,1764568,1748204,2226,4.4,2855,5.7,191824,48042,143782,2.7,11,159095,43692,115403,2.5,9.1,32729,1.9,18.2,0,1025,1040,8696
1995,38,a) 0,1277,1277,6866,3443,1272,199.2,0,0,6846,6846,0,198.8,198.8,0,0,0,0,0,6846,198.8,0,0,,,
1995,38,b) 1,1081,1086,6388,6267,8,0.7,200,16.7,1697,124,1573,2,27.1,1455,756,699,12.1,23.2,242,3.9,46.4,0,152,152,646
1995,38,c) 2,872,875,5954,6003,28,3,130,13.9,1173,177,996,2.9,19.5,1271,717,554,11.9,21.2,-98,-1.7,39,0,109,110,655
1995,38,d) 3,742,751,5365,5323,32,4.1,100,12.7,1031,186,845,3.5,19.4,947,414,533,7.8,17.8,84,1.6,35.6,0,70,70,317
1995,38,e) 4,669,692,5369,5378,19,2.6,84,11.6,763,69,694,1.3,14.2,781,349,432,6.5,14.5,-18,-0.3,28.4,0,63,63,266
1995,38,f) 5,638,671,4349,4453,21,3,70,10.1,624,55,569,1.2,14,832,318,514,7.1,18.7,-208,-4.7,28,0,50,50,245
1995,38,g) 6 to 10,2678,2820,25966,25668,90,3.1,242,8.3,3678,418,3260,1.6,14.3,3081,1126,1955,4.4,12,597,2.3,24,0,192,192,941
1995,38,h) 11 to 15,2195,2468,25035,24852,53,2.1,163,6.4,2896,284,2612,1.1,11.7,2529,666,1863,2.7,10.2,367,1.5,20.4,0,99,99,444
1995,38,i) 16 to 20,1178,1411,16440,16238,40,2.8,104,7.2,2381,701,1680,4.3,14.7,1977,620,1357,3.8,12.2,404,2.5,24.4,0,66,71,383
1995,38,l) Left Censored,3959,5998,125371,124382,207,3.4,318,5.2,13678,2740,10938,2.2,11,11701,3883,7818,3.1,9.4,1977,1.6,18.8,0,144,144,1005
1995,39,a) 0,17383,17512,100119,50214,17407,198.8,0,0,99810,99810,0,198.8,198.8,0,0,0,0,0,99810,198.8,0,0,,,
1995,39,b) 1,13264,13513,101185,99203,111,0.7,3102,20.5,28523,2248,26275,2.3,28.8,24559,13876,10683,14,24.8,3964,4,49.6,0,2494,2495,11970
1995,39,c) 2,11011,11195,96731,97718,351,2.9,1898,15.8,22034,3913,18121,4,22.5,24008,11468,12540,11.7,24.6,-1974,-2.1,45,0,1569,1569,10310
1995,39,d) 3,9364,9699,82676,82165,290,2.8,1394,13.6,16177,2154,14023,2.6,19.7,15154,7196,7958,8.8,18.4,1023,1.3,36.8,0,1111,1111,5639
1995,39,e) 4,8779,9206,85070,84812,301,3.1,1133,11.7,15935,2304,13631,2.7,18.8,15418,7212,8206,8.5,18.2,517,0.6,36.4,0,876,876,5310
1995,39,f) 5,8370,8770,85457,84974,264,2.9,1014,11.1,15212,2175,13037,2.6,17.9,14246,5964,8282,7,16.8,966,1.1,33.6,0,760,761,4307
1995,39,g) 6 to 10,34783,38306,496359,496647,1231,3.1,3436,8.7,73029,13260,59769,2.7,14.7,73604,25346,48258,5.1,14.8,-575,-0.1,29.4,0,2493,2506,17038
1995,39,h) 11 to 15,23628,27208,375847,373152,835,3,1853,6.7,48715,9480,39235,2.5,13.1,43324,14210,29114,3.8,11.6,5391,1.5,23.2,0,1189,1208,7806
1995,39,i) 16 to 20,13035,17238,288504,286598,567,3.2,1032,5.9,37241,8775,28466,3.1,13,33428,10967,22461,3.8,11.7,3813,1.3,23.4,0,569,583,6316
1995,39,l) Left Censored,45918,84415,2775116,2747318,3639,4.3,5190,6.1,311885,81543,230342,3,11.4,256290,65983,190307,2.4,9.3,55595,2.1,18.6,0,1830,1885,10608
1995,40,a) 0,6364,6396,34605,17376,6347,198.5,0,0,34458,34458,0,198.3,198.3,0,0,0,0,0,34458,198.3,0,0,,,
1995,40,b) 1,4864,4900,32447,33692,24,0.4,1463,25.7,8496,419,8077,1.2,25.2,10986,6479,4507,19.2,32.6,-2490,-7.4,50.4,0,1223,1223,5070
1995,40,c) 2,3903,3939,28203,29706,118,2.7,797,18.5,6572,687,5885,2.3,22.1,9578,6013,3565,20.2,32.2,-3006,-10.1,44.2,0,667,667,5145
1995,40,d) 3,3326,3416,26734,27069,96,2.6,517,14.2,4807,664,4143,2.5,17.8,5477,2601,2876,9.6,20.2,-670,-2.4,35.6,0,421,421,2225
1995,40,e) 4,2987,3095,24395,24987,96,2.9,410,12.6,3848,437,3411,1.7,15.4,5031,2150,2881,8.6,20.1,-1183,-4.7,30.8,0,333,335,1467
1995,40,f) 5,2746,2848,24410,24670,97,3.2,362,12.1,4104,590,3514,2.4,16.6,4623,1995,2628,8.1,18.7,-519,-2.1,33.2,0,291,291,1615
1995,40,g) 6 to 10,10537,11303,133479,133584,380,3.2,1207,10.3,18876,2769,16107,2.1,14.1,19085,7391,11694,5.5,14.3,-209,-0.2,28.2,0,906,914,4697
1995,40,h) 11 to 15,9061,10173,115419,115124,310,3,814,7.8,15924,2598,13326,2.3,13.8,15334,5506,9828,4.8,13.3,590,0.5,26.6,0,559,564,2961
1995,40,i) 16 to 20,4147,5374,73897,73078,226,4.1,369,6.8,9584,2101,7483,2.9,13.1,7946,2524,5422,3.5,10.9,1638,2.2,21.8,0,243,243,1269
1995,40,l) Left Censored,11982,21113,529439,529718,908,4.3,1361,6.4,57421,14963,42458,2.8,10.8,57979,16600,41379,3.1,10.9,-558,-0.1,21.6,0,537,539,2708
1995,41,a) 0,8307,8341,40688,20497,8283,198.6,0,0,40383,40383,0,197,197,0,0,0,0,0,40383,197,0,0,,,
1995,41,b) 1,6221,6307,38054,37965,43,0.6,1741,24,10931,844,10087,2.2,28.8,10753,6303,4450,16.6,28.3,178,0.5,56.6,0,1368,1368,5130
1995,41,c) 2,4658,4719,31071,31618,153,3,939,18.2,7281,929,6352,2.9,23,8375,4674,3701,14.8,26.5,-1094,-3.5,46,0,742,742,3788
1995,41,d) 3,4013,4190,35347,35554,176,4,662,14.9,7203,1149,6054,3.2,20.3,7616,3357,4259,9.4,21.4,-413,-1.1,40.6,0,520,520,2800
1995,41,e) 4,3652,3776,28598,28669,157,3.9,565,14.2,5812,869,4943,3,20.3,5953,2808,3145,9.8,20.8,-141,-0.5,40.6,0,446,449,2287
1995,41,f) 5,3759,3892,34761,34206,157,3.9,503,12.4,7072,1030,6042,3,20.7,5961,2684,3277,7.8,17.4,1111,3.3,34.8,0,387,387,1804
1995,41,g) 6 to 10,12570,13420,144702,144132,565,4.1,1389,10,23951,3811,20140,2.6,16.6,22810,7937,14873,5.5,15.8,1141,0.8,31.6,0,981,987,5869
1995,41,h) 11 to 15,8702,9853,134278,132832,380,3.8,757,7.5,20966,4870,16096,3.7,15.8,18074,5837,12237,4.4,13.6,2892,2.2,27.2,0,467,469,2758
1995,41,i) 16 to 20,4594,5815,86919,85143,220,3.7,399,6.7,12124,2459,9665,2.9,14.2,8572,2677,5895,3.1,10.1,3552,4.1,20.2,0,231,238,1653
1995,41,l) Left Censored,11962,21021,587495,582588,1058,5,1556,7.3,72233,20943,51290,3.6,12.4,62419,17640,44779,3,10.7,9814,1.7,21.4,0,518,563,4708
1995,42,a) 0,17789,17948,107308,53998,17818,198.6,0,0,106620,106620,0,197.5,197.5,0,0,0,0,0,106620,197.5,0,0,,,
1995,42,b) 1,13031,13231,112384,109374,90,0.6,2841,19.3,30342,3100,27242,2.8,27.7,24322,13875,10447,12.7,22.2,6020,5.5,44.4,0,2315,2319,11397
1995,42,c) 2,11277,11402,89097,90422,313,2.6,1810,14.8,18871,2531,16340,2.8,20.9,21520,11570,9950,12.8,23.8,-2649,-2.9,41.8,0,1502,1502,10264
1995,42,d) 3,10355,10773,86614,87639,340,3,1469,12.9,16831,2449,14382,2.8,19.2,18880,9055,9825,10.3,21.5,-2049,-2.3,38.4,0,1211,1214,6763
1995,42,e) 4,9979,10416,87080,87584,318,2.9,1176,10.8,15875,1977,13898,2.3,18.1,16882,7220,9662,8.2,19.3,-1007,-1.2,36.2,0,924,925,5341
1995,42,f) 5,9822,10152,87307,86674,323,3.1,1034,9.8,15481,2361,13120,2.7,17.9,14214,6042,8172,7,16.4,1267,1.5,32.8,0,789,791,4516
1995,42,g) 6 to 10,42289,45121,504344,506850,1430,3.1,4039,8.7,67783,10035,57748,2,13.4,72795,26662,46133,5.3,14.4,-5012,-1,26.8,0,2963,2983,19189
1995,42,h) 11 to 15,26941,30173,409236,407726,816,2.6,2112,6.8,51377,9134,42243,2.2,12.6,48357,16211,32146,4,11.9,3020,0.7,23.8,0,1433,1435,9376
1995,42,i) 16 to 20,14095,18081,290832,287459,551,3,1133,6.2,36426,7864,28562,2.7,12.7,29680,9873,19807,3.4,10.3,6746,2.4,20.6,0,688,695,5147
1995,42,l) Left Censored,51387,89873,2863767,2855632,3877,4.3,5924,6.5,295805,80133,215672,2.8,10.4,279534,81916,197618,2.9,9.8,16271,0.6,19.6,0,2330,2364,19721
1995,44,a) 0,1844,1852,7981,4032,1834,198.1,0,0,7899,7899,0,195.9,195.9,0,0,0,0,0,7899,195.9,0,0,,,
1995,44,b) 1,1519,1531,13667,13732,8,0.5,389,22.3,2784,347,2437,2.5,20.3,2913,1278,1635,9.3,21.2,-129,-0.9,40.6,0,303,304,1079
1995,44,c) 2,1244,1248,7596,7941,44,3.3,232,17.3,1440,188,1252,2.4,18.1,2129,1249,880,15.7,26.8,-689,-8.7,36.2,0,181,181,909
1995,44,d) 3,1044,1056,8230,8375,35,3.1,158,14.1,1449,132,1317,1.6,17.3,1739,838,901,10,20.8,-290,-3.5,34.6,0,125,125,749
1995,44,e) 4,926,945,8289,8148,24,2.4,130,13,1915,551,1364,6.8,23.5,1633,932,701,11.4,20,282,3.5,40,0,102,103,768
1995,44,f) 5,937,960,6428,6728,33,3.3,136,13.4,977,86,891,1.3,14.5,1577,816,761,12.1,23.4,-600,-8.9,29,0,114,114,657
1995,44,g) 6 to 10,4389,4573,43604,43067,196,4.2,433,9.2,6827,1271,5556,3,15.9,5752,2040,3712,4.7,13.4,1075,2.5,26.8,0,320,320,1375
1995,44,h) 11 to 15,2598,2799,35291,34519,109,3.8,197,6.9,5527,1437,4090,4.2,16,3983,1002,2981,2.9,11.5,1544,4.5,23,0,130,130,558
1995,44,i) 16 to 20,1432,1627,22750,22272,64,3.9,106,6.4,3368,1286,2082,5.8,15.1,2411,620,1791,2.8,10.8,957,4.3,21.6,0,66,70,285
1995,44,l) Left Censored,5623,7666,223238,222660,332,4.3,494,6.4,23208,6230,16978,2.8,10.4,22052,5423,16629,2.4,9.9,1156,0.5,19.8,0,213,215,1168
1995,45,a) 0,7248,7284,42668,21385,7240,198.8,0,0,42567,42567,0,199.1,199.1,0,0,0,0,0,42567,199.1,0,0,,,
1995,45,b) 1,5109,5184,43337,43151,34,0.6,1415,23.8,11954,1015,10939,2.4,27.7,11581,6884,4697,16,26.8,373,0.9,53.6,0,1132,1132,5536
1995,45,c) 2,4084,4144,30982,32258,140,3.1,835,18.5,6647,664,5983,2.1,20.6,9198,4863,4335,15.1,28.5,-2551,-7.9,41.2,0,691,691,3939
1995,45,d) 3,3490,3581,32012,33671,118,3.1,614,16,7031,2104,4927,6.2,20.9,10348,5100,5248,15.1,30.7,-3317,-9.8,41.8,0,487,489,2717
1995,45,e) 4,3258,3436,28331,28601,116,3.2,467,12.9,5225,784,4441,2.7,18.3,5765,2620,3145,9.2,20.2,-540,-1.9,36.6,0,367,368,2133
1995,45,f) 5,2985,3079,27145,27564,119,3.7,402,12.5,5202,888,4314,3.2,18.9,6039,3047,2992,11.1,21.9,-837,-3,37.8,0,319,319,2275
1995,45,g) 6 to 10,12303,13586,161410,159855,512,3.7,1317,9.4,25988,7600,18388,4.8,16.3,22877,9177,13700,5.7,14.3,3111,2,28.6,0,950,951,5650
1995,45,h) 11 to 15,8147,9362,117894,118125,296,3.1,717,7.5,16031,2781,13250,2.4,13.6,16492,6274,10218,5.3,14,-461,-0.4,27.2,0,462,464,3573
1995,45,i) 16 to 20,3868,4967,76924,76436,163,3.2,348,6.9,10844,2831,8013,3.7,14.2,9867,2030,7837,2.7,12.9,977,1.3,25.8,0,203,212,1050
1995,45,l) Left Censored,12201,23687,808143,801945,1124,4.7,1456,6.1,85467,21194,64273,2.6,10.7,73072,20121,52951,2.5,9.1,12395,1.6,18.2,0,543,558,3502
1995,46,a) 0,1615,1627,7778,3917,1617,198.8,0,0,7723,7723,0,197.2,197.2,0,0,0,0,0,7723,197.2,0,0,,,
1995,46,b) 1,1368,1383,8799,8796,7,0.5,300,19.4,1995,149,1846,1.7,22.7,1989,1052,937,12,22.6,6,0.1,45.2,0,236,236,827
1995,46,c) 2,1033,1043,7059,7092,32,2.8,170,15.1,1403,243,1160,3.4,19.8,1468,692,776,9.8,20.7,-65,-0.9,39.6,0,140,140,523
1995,46,d) 3,922,954,6380,6552,27,2.7,119,11.9,933,69,864,1.1,14.2,1276,519,757,7.9,19.5,-343,-5.3,28.4,0,96,96,464
1995,46,e) 4,818,837,7161,7258,19,2.1,109,12.3,1066,165,901,2.3,14.7,1260,602,658,8.3,17.4,-194,-2.7,29.4,0,80,80,509
1995,46,f) 5,830,849,7280,7258,28,3.2,86,9.8,1056,149,907,2.1,14.5,1011,400,611,5.5,13.9,45,0.6,27.8,0,61,61,286
1995,46,g) 6 to 10,2973,3120,35870,35388,88,2.7,301,9.3,5109,446,4663,1.3,14.4,4144,1856,2288,5.2,11.7,965,2.7,23.4,0,214,214,1208
1995,46,h) 11 to 15,2215,2491,25562,25041,68,2.7,172,6.7,3640,1059,2581,4.2,14.5,2598,729,1869,2.9,10.4,1042,4.1,20.8,0,114,114,521
1995,46,i) 16 to 20,1227,1488,18357,18145,48,3.2,96,6.3,2493,380,2113,2.1,13.7,2069,519,1550,2.9,11.4,424,2.3,22.8,0,68,69,353
1995,46,l) Left Censored,4214,6213,140275,138759,216,3.4,324,5.2,13477,2178,11299,1.6,9.7,10445,3970,6475,2.9,7.5,3032,2.2,15,0,156,156,716
1995,47,a) 0,9818,9892,61514,30926,9812,198.4,0,0,61177,61177,0,197.8,197.8,0,0,0,0,0,61177,197.8,0,0,,,
1995,47,b) 1,7176,7265,63258,62748,46,0.5,2030,24.3,17644,928,16716,1.5,28.1,16624,9681,6943,15.4,26.5,1020,1.6,53,0,1701,1701,8493
1995,47,c) 2,5874,5996,69045,60658,201,3.1,1188,18.2,29670,1488,28182,2.5,48.9,12895,6777,6118,11.2,21.3,16775,27.6,42.6,0,982,982,5357
1995,47,d) 3,4865,5055,49741,50530,175,3.3,746,13.9,10630,1886,8744,3.7,21,12207,5732,6475,11.3,24.2,-1577,-3.2,42,0,593,595,4782
1995,47,e) 4,4362,4578,47291,47730,165,3.4,655,13.6,8130,1037,7093,2.2,17,9008,4572,4436,9.6,18.9,-878,-1.9,34,0,491,493,2961
1995,47,f) 5,4048,4213,39947,39700,157,3.6,524,11.9,7698,1477,6221,3.7,19.4,7203,3331,3872,8.4,18.1,495,1.3,36.2,0,415,415,2759
1995,47,g) 6 to 10,16888,18439,234537,234337,627,3.3,1781,9.4,35072,5037,30035,2.1,15,34671,12052,22619,5.1,14.8,401,0.2,29.6,0,1300,1313,8212
1995,47,h) 11 to 15,11575,13131,175379,172900,425,3.2,903,6.8,25977,4873,21104,2.8,15,21018,6949,14069,4,12.2,4959,2.8,24.4,0,590,595,3890
1995,47,i) 16 to 20,5939,8340,161720,157950,362,4.3,516,6.1,25720,6395,19325,4,16.3,18181,4571,13610,2.9,11.5,7539,4.8,23,0,276,290,1703
1995,47,l) Left Censored,18324,34984,1233963,1214982,1736,4.9,2152,6.1,149723,40474,109249,3.3,12.3,111761,28786,82975,2.4,9.2,37962,3.1,18.4,0,750,766,5235
1995,48,a) 0,36962,37317,242731,121934,37081,198.7,0,0,241595,241595,0,198.1,198.1,0,0,0,0,0,241595,198.1,0,0,,,
1995,48,b) 1,27585,28222,231657,229954,218,0.7,8167,25.1,74346,5225,69121,2.3,32.3,70940,42089,28851,18.3,30.8,3406,1.5,61.6,0,6789,6791,35570
1995,48,c) 2,22112,22550,203686,207132,776,3.1,4692,19,51785,6015,45770,2.9,25,58678,33563,25115,16.2,28.3,-6893,-3.3,50,0,3926,3936,29380
1995,48,d) 3,18933,19752,202193,206921,710,3.4,3375,15.9,39000,7139,31861,3.5,18.8,48455,24315,24140,11.8,23.4,-9455,-4.6,37.6,0,2695,2703,18933
1995,48,e) 4,17091,18040,187232,186636,610,3.2,2541,13.3,40844,5833,35011,3.1,21.9,39652,17514,22138,9.4,21.2,1192,0.7,42.4,0,1994,2003,13878
1995,48,f) 5,15133,16030,170986,171577,591,3.5,2135,12.7,33384,6847,26537,4,19.5,34566,14331,20235,8.4,20.1,-1182,-0.6,39,0,1646,1676,11490
1995,48,g) 6 to 10,56118,62336,759359,763275,2224,3.4,6634,10.3,123982,27499,96483,3.6,16.2,131813,54386,77427,7.1,17.3,-7831,-1.1,32.4,0,4761,4837,34631
1995,48,h) 11 to 15,43471,50025,670199,660102,1789,3.5,3973,7.8,114072,24589,89483,3.7,17.3,93878,33024,60854,5,14.2,20194,3.1,28.4,0,2538,2555,17714
1995,48,i) 16 to 20,19205,26499,412096,404776,1109,4.1,1898,7,64796,17106,47690,4.2,16,50156,14274,35882,3.5,12.4,14640,3.6,24.8,0,1081,1099,5878
1995,48,l) Left Censored,47771,108748,3517736,3487102,6652,6.1,7897,7.2,457773,138752,319021,4,13.1,396505,103237,293268,3,11.4,61268,1.7,22.8,0,2358,2467,13552
1995,49,a) 0,4504,4540,32190,16149,4500,198.2,0,0,32083,32083,0,198.7,198.7,0,0,0,0,0,32083,198.7,0,0,,,
1995,49,b) 1,3267,3362,27571,27724,42,1.1,1004,25.8,7912,531,7381,1.9,28.5,8218,4505,3713,16.2,29.6,-306,-1.1,57,0,804,804,3679
1995,49,c) 2,2436,2475,21727,22069,82,3.1,468,17.5,4820,545,4275,2.5,21.8,5503,2852,2651,12.9,24.9,-683,-3.1,43.6,0,392,392,2542
1995,49,d) 3,2012,2069,19437,19347,72,3.3,330,15,4741,519,4222,2.7,24.5,4561,2399,2162,12.4,23.6,180,0.9,47.2,0,248,248,1881
1995,49,e) 4,1720,1788,19058,19045,68,3.6,248,13.2,3793,989,2804,5.2,19.9,3766,1659,2107,8.7,19.8,27,0.1,39.6,0,173,174,1241
1995,49,f) 5,1450,1534,17752,17564,49,3,193,12,3591,400,3191,2.3,20.4,3214,1569,1645,8.9,18.3,377,2.1,36.6,0,163,164,1363
1995,49,g) 6 to 10,5500,5997,98234,98323,223,3.6,631,10.2,18421,2751,15670,2.8,18.7,18599,6334,12265,6.4,18.9,-178,-0.2,37.4,0,458,458,5043
1995,49,h) 11 to 15,3771,4304,69387,70018,149,3.4,353,8,10202,1362,8840,1.9,14.6,11464,2918,8546,4.2,16.4,-1262,-1.8,29.2,0,222,224,1553
1995,49,i) 16 to 20,2135,2658,46902,46348,126,4.7,186,6.9,6655,1461,5194,3.2,14.4,5546,1918,3628,4.1,12,1109,2.4,24,0,101,104,1203
1995,49,l) Left Censored,5685,10453,380836,373710,641,6.1,623,6,46851,13675,33176,3.7,12.5,32599,9593,23006,2.6,8.7,14252,3.8,17.4,0,205,212,1758
1995,50,a) 0,1430,1432,6491,3262,1421,198.5,0,0,6459,6459,0,198,198,0,0,0,0,0,6459,198,0,0,,,
1995,50,b) 1,1168,1185,6340,6395,3,0.2,246,18.7,1505,31,1474,0.5,23.5,1614,888,726,13.9,25.2,-109,-1.7,47,0,189,189,777
1995,50,c) 2,1021,1027,5555,5704,32,2.9,169,15.3,910,78,832,1.4,16,1208,600,608,10.5,21.2,-298,-5.2,32,0,144,144,532
1995,50,d) 3,813,830,5711,5892,24,2.7,124,14.1,827,73,754,1.2,14,1188,486,702,8.2,20.2,-361,-6.2,28,0,99,99,390
1995,50,e) 4,782,804,5182,5241,24,2.9,85,10.2,722,58,664,1.1,13.8,840,273,567,5.2,16,-118,-2.2,27.6,0,70,70,223
1995,50,f) 5,827,852,5123,5486,27,3,101,11.3,744,74,670,1.3,13.6,1470,651,819,11.9,26.8,-726,-13.2,27.2,0,87,87,543
1995,50,g) 6 to 10,3632,3771,31320,31342,113,2.9,350,9,4076,539,3537,1.7,13,4120,1589,2531,5.1,13.1,-44,-0.1,26,0,265,265,1274
1995,50,h) 11 to 15,2094,2274,23068,22928,67,2.9,151,6.5,2824,482,2342,2.1,12.3,2544,843,1701,3.7,11.1,280,1.2,22.2,0,109,109,622
1995,50,i) 16 to 20,992,1206,17662,17608,44,3.6,86,7,2530,933,1597,5.3,14.4,2421,1108,1313,6.3,13.7,109,0.7,27.4,0,46,46,339
1995,50,l) Left Censored,3161,4613,115233,115593,178,3.8,300,6.4,11914,1895,10019,1.6,10.3,12634,5145,7489,4.5,10.9,-720,-0.6,20.6,0,130,131,1563
1995,51,a) 0,12563,12650,68312,34252,12574,198.8,0,0,68120,68120,0,198.9,198.9,0,0,0,0,0,68120,198.9,0,0,,,
1995,51,b) 1,9099,9230,65466,64711,60,0.6,2490,23.6,19442,3015,16427,4.7,30,17931,10349,7582,16,27.7,1511,2.3,55.4,0,2020,2020,9011
1995,51,c) 2,7699,7783,56904,58171,265,3.2,1386,16.5,13529,1652,11877,2.8,23.3,16062,8661,7401,14.9,27.6,-2533,-4.3,46.6,0,1141,1142,7266
1995,51,d) 3,6440,6713,57777,58905,223,3.1,1071,15,11064,1460,9604,2.5,18.8,13319,5989,7330,10.2,22.6,-2255,-3.8,37.6,0,833,838,4342
1995,51,e) 4,5906,6108,54073,54449,206,3.2,796,12.4,10533,1299,9234,2.4,19.3,11285,5087,6198,9.3,20.7,-752,-1.4,38.6,0,601,603,3200
1995,51,f) 5,5784,6031,53393,53495,242,3.9,708,11.3,10413,1654,8759,3.1,19.5,10617,4393,6224,8.2,19.8,-204,-0.3,39,0,551,553,3619
1995,51,g) 6 to 10,23483,25727,303311,301108,913,3.4,2418,9.1,47648,7992,39656,2.7,15.8,43242,16995,26247,5.6,14.4,4406,1.4,28.8,0,1678,1691,10649
1995,51,h) 11 to 15,14312,16276,226015,223317,544,3.3,1190,7.2,30995,7263,23732,3.3,13.9,25599,7287,18312,3.3,11.5,5396,2.4,23,0,708,710,3709
1995,51,i) 16 to 20,6885,9371,150015,149097,303,3.2,663,6.9,20836,6156,14680,4.1,14,18999,6891,12108,4.6,12.7,1837,1.3,25.4,0,358,366,2428
1995,51,l) Left Censored,21721,44619,1393175,1384696,2236,5,2824,6.3,161107,44872,116235,3.2,11.6,144148,42007,102141,3,10.4,16959,1.2,20.8,0,831,843,5684
1995,53,a) 0,13341,13419,67629,33978,13291,198.1,0,0,67302,67302,0,198.1,198.1,0,0,0,0,0,67302,198.1,0,0,,,
1995,53,b) 1,9862,9984,60322,61735,61,0.5,3238,27.6,17017,1462,15555,2.4,27.6,19843,11504,8339,18.6,32.1,-2826,-4.5,55.2,0,2523,2523,9095
1995,53,c) 2,7899,8026,54422,56838,323,3.7,1731,19.7,12278,1367,10911,2.4,21.6,17109,9577,7532,16.8,30.1,-4831,-8.5,43.2,0,1375,1375,8241
1995,53,d) 3,6913,7153,55197,56585,267,3.5,1253,16.3,10742,1240,9502,2.2,19,13517,6724,6793,11.9,23.9,-2775,-4.9,38,0,995,996,5458
1995,53,e) 4,6146,6365,52050,53008,261,3.9,905,13.5,9153,1452,7701,2.7,17.3,11069,4471,6598,8.4,20.9,-1916,-3.6,34.6,0,698,701,3584
1995,53,f) 5,6367,6635,56193,57453,295,4.2,927,13.3,10171,1323,8848,2.3,17.7,12691,5473,7218,9.5,22.1,-2520,-4.4,35.4,0,660,661,3550
1995,53,g) 6 to 10,20221,21885,250350,252334,861,3.8,2271,10,36627,7119,29508,2.8,14.5,40595,14971,25624,5.9,16.1,-3968,-1.6,29,0,1637,1646,11267
1995,53,h) 11 to 15,14087,16144,221414,220318,657,4,1307,7.9,31833,7519,24314,3.4,14.4,29640,7841,21799,3.6,13.5,2193,0.9,27,0,862,871,5285
1995,53,i) 16 to 20,7104,9169,133610,133322,352,3.8,713,7.6,17295,3316,13979,2.5,13,16719,4878,11841,3.7,12.5,576,0.5,25,0,408,417,2085
1995,53,l) Left Censored,17889,32859,961675,960279,1680,5.1,2356,7.1,108087,31274,76813,3.3,11.3,105295,32376,72919,3.4,11,2792,0.3,22,0,789,838,7976
1995,54,a) 0,2953,2969,15427,7740,2953,198.9,0,0,15375,15375,0,198.6,198.6,0,0,0,0,0,15375,198.6,0,0,,,
1995,54,b) 1,2079,2106,12769,12725,17,0.7,564,23.4,3816,312,3504,2.5,30,3727,2361,1366,18.6,29.3,89,0.7,58.6,0,472,472,2083
1995,54,c) 2,1809,1821,11520,11554,68,3.5,342,17.4,3024,464,2560,4,26.2,3092,1896,1196,16.4,26.8,-68,-0.6,52.4,0,275,275,1442
1995,54,d) 3,1539,1579,11427,11222,50,3,198,11.9,2380,338,2042,3,21.2,1969,774,1195,6.9,17.5,411,3.7,35,0,158,158,664
1995,54,e) 4,1407,1514,15844,16208,37,2.3,202,12.6,2412,157,2255,1,14.9,3139,1128,2011,7,19.4,-727,-4.5,29.8,0,146,146,780
1995,54,f) 5,1348,1368,11714,11385,48,3.4,172,12,2883,347,2536,3,25.3,2225,1413,812,12.4,19.5,658,5.8,39,0,133,133,766
1995,54,g) 6 to 10,5456,5825,69783,69316,203,3.4,566,9.4,10275,2055,8220,3,14.8,9340,3432,5908,5,13.5,935,1.3,27,0,412,412,2313
1995,54,h) 11 to 15,3982,4363,47283,47059,120,2.7,266,6,5790,1128,4662,2.4,12.3,5341,1708,3633,3.6,11.3,449,1,22.6,0,180,180,1139
1995,54,i) 16 to 20,2028,2672,36131,35493,112,4.1,185,6.8,4913,936,3977,2.6,13.8,3636,885,2751,2.5,10.2,1277,3.6,20.4,0,107,108,460
1995,54,l) Left Censored,7456,12357,285892,285199,547,4.4,768,6.2,31565,8013,23552,2.8,11.1,30178,10699,19479,3.8,10.6,1387,0.5,21.2,0,281,283,1386
1995,55,a) 0,8943,9007,49679,24970,8957,198.9,0,0,49418,49418,0,197.9,197.9,0,0,0,0,0,49418,197.9,0,0,,,
1995,55,b) 1,6936,7011,48056,47727,34,0.4,1693,21.4,12497,1268,11229,2.7,26.2,11838,6924,4914,14.5,24.8,659,1.4,49.6,0,1320,1320,5468
1995,55,c) 2,5987,6076,44052,45585,189,2.9,1009,15.5,9003,1091,7912,2.4,19.7,12068,6802,5266,14.9,26.5,-3065,-6.8,39.4,0,805,805,5986
1995,55,d) 3,5055,5166,41805,42218,169,3.1,665,12.2,7349,1495,5854,3.5,17.4,8175,3321,4854,7.9,19.4,-826,-2,34.8,0,544,545,2915
1995,55,e) 4,4805,5033,42810,42790,151,2.9,580,11,6946,1030,5916,2.4,16.2,6905,2840,4065,6.6,16.1,41,0.1,32.2,0,443,444,2056
1995,55,f) 5,4473,4712,42635,42883,150,3.1,552,11.2,6454,867,5587,2,15.1,6950,2962,3988,6.9,16.2,-496,-1.1,30.2,0,402,402,2255
1995,55,g) 6 to 10,18752,20304,246539,246262,604,2.9,1772,8.5,32794,5505,27289,2.2,13.3,32240,11262,20978,4.6,13.1,554,0.2,26.2,0,1305,1310,8237
1995,55,h) 11 to 15,12164,13680,190692,187690,380,2.7,959,6.9,25735,4598,21137,2.4,13.7,19731,7053,12678,3.8,10.5,6004,3.2,21,0,655,665,4208
1995,55,i) 16 to 20,6766,8816,137711,137273,271,3,627,7,16709,2550,14159,1.9,12.2,15832,5084,10748,3.7,11.5,877,0.7,23,0,350,401,2206
1995,55,l) Left Censored,23975,39092,1307854,1295869,1390,3.5,2140,5.4,126415,26509,99906,2,9.8,102445,23947,78498,1.8,7.9,23970,1.9,15.8,0,952,994,6312
1995,56,a) 0,1376,1382,5626,2834,1371,198.4,0,0,5585,5585,0,197.1,197.1,0,0,0,0,0,5585,197.1,0,0,,,
1995,56,b) 1,1085,1089,7679,7184,4,0.3,277,22.3,2809,,,,39.1,1818,923,895,12.8,25.3,991,13.8,50.6,1,209,209,714
1995,56,c) 2,852,860,5751,6385,20,2.1,168,17.9,985,50,935,0.8,15.4,2252,1310,942,20.5,35.3,-1267,-19.9,30.8,0,128,130,1208
1995,56,d) 3,682,685,4051,4224,15,2,109,14.9,632,,,,15,977,473,504,11.2,23.1,-345,-8.1,30,1,84,84,359
1995,56,e) 4,633,641,3986,3919,16,2.4,60,8.9,786,46,740,1.2,20.1,651,269,382,6.9,16.6,135,3.5,33.2,0,48,48,238
1995,56,f) 5,545,553,3656,3768,23,3.9,77,13.2,591,53,538,1.4,15.7,814,399,415,10.6,21.6,-223,-5.9,31.4,0,62,62,350
1995,56,g) 6 to 10,2164,2280,20695,20805,93,4,223,9.5,2692,435,2257,2.1,12.9,2912,1118,1794,5.4,14,-220,-1.1,25.8,0,157,157,775
1995,56,h) 11 to 15,1849,2082,17421,17851,68,3.2,160,7.5,2144,427,1717,2.4,12,3004,623,2381,3.5,16.8,-860,-4.8,24,0,115,115,426
1995,56,i) 16 to 20,1028,1238,15014,14783,34,2.7,92,7.3,2043,245,1798,1.7,13.8,1580,364,1216,2.5,10.7,463,3.1,21.4,0,60,61,240
1995,56,l) Left Censored,2489,3908,68745,68469,161,4.1,229,5.8,8072,2138,5934,3.1,11.8,7519,2348,5171,3.4,11,553,0.8,22,0,93,93,415
1996,01,a) 0,7847,7892,41312,20773,7825,198.3,0,0,41078,41078,0,197.7,197.7,0,0,0,0,0,41078,197.7,0,0,,,
1996,01,b) 1,5878,5929,44298,44755,29,0.4,1770,25.7,13001,2589,10412,5.8,29,13915,8261,5654,18.5,31.1,-914,-2.1,58,0,1491,1491,7362
1996,01,c) 2,4981,5078,46217,47575,167,3,1063,19.2,10919,1390,9529,2.9,23,13635,7477,6158,15.7,28.7,-2716,-5.7,46,0,891,891,6737
1996,01,d) 3,4017,4081,34486,35653,132,3,670,15.4,5856,683,5173,1.9,16.4,8190,3926,4264,11,23,-2334,-6.6,32.8,0,545,545,3098
1996,01,e) 4,3495,3588,35180,35720,125,3.3,483,12.8,5916,836,5080,2.3,16.6,6996,2640,4356,7.4,19.6,-1080,-3,33.2,0,379,379,1776
1996,01,f) 5,3073,3270,29952,30019,101,3,391,11.4,5291,619,4672,2.1,17.6,5424,2154,3270,7.2,18.1,-133,-0.5,35.2,0,312,312,1792
1996,01,g) 6 to 10,12864,13865,183977,185732,424,2.9,1519,10.5,25661,4108,21553,2.2,13.8,29170,9804,19366,5.3,15.7,-3509,-1.9,27.6,0,1116,1116,6857
1996,01,h) 11 to 15,9170,10493,145767,145311,317,3,739,6.9,18431,2998,15433,2.1,12.7,17518,5479,12039,3.8,12.1,913,0.6,24.2,0,498,498,3402
1996,01,i) 16 to 20,5796,7955,132458,132121,300,3.7,503,6.2,17612,3261,14351,2.5,13.3,16939,4475,12464,3.4,12.8,673,0.5,25.6,0,306,306,1934
1996,01,l) Left Censored,13177,25573,836596,840539,1323,5.1,1640,6.4,95269,32749,62520,3.9,11.3,103154,27837,75317,3.3,12.3,-7885,-1,22.6,0,587,587,4161
1996,02,a) 0,1350,1365,5791,2925,1336,195.8,0,0,5732,5732,0,196,196,0,0,0,0,0,5732,196,0,0,,,
1996,02,b) 1,1030,1045,5748,5842,8,0.7,323,26.4,1589,136,1453,2.3,27.2,1777,1097,680,18.8,30.4,-188,-3.2,54.4,0,231,231,804
1996,02,c) 2,840,849,5527,5430,36,4,152,16.7,1567,534,1033,9.8,28.9,1373,581,792,10.7,25.3,194,3.6,50.6,0,124,124,485
1996,02,d) 3,748,763,4562,5034,35,4.3,115,14.2,979,148,831,2.9,19.4,1922,1280,642,25.4,38.2,-943,-18.8,38.8,0,84,84,384
1996,02,e) 4,572,610,4083,4234,25,3.8,114,17.4,923,92,831,2.2,21.8,1224,574,650,13.6,28.9,-301,-7.1,43.6,0,81,81,380
1996,02,f) 5,616,641,4373,4525,27,4.1,79,11.9,660,84,576,1.9,14.6,964,509,455,11.2,21.3,-304,-6.7,29.2,0,54,54,447
1996,02,g) 6 to 10,2277,2412,24082,24343,87,3.5,269,10.7,3085,315,2770,1.3,12.7,3606,1080,2526,4.4,14.8,-521,-2.1,25.4,0,179,179,781
1996,02,h) 11 to 15,1844,2086,21182,21284,74,3.5,150,7.1,3187,305,2882,1.4,15,3391,889,2502,4.2,15.9,-204,-0.9,30,0,90,90,473
1996,02,i) 16 to 20,1088,1413,18295,18241,59,4.1,94,6.6,2392,481,1911,2.6,13.1,2283,686,1597,3.8,12.5,109,0.6,25,0,47,47,288
1996,02,l) Left Censored,1766,3261,83452,83756,166,5,223,6.8,10141,1829,8312,2.2,12.1,10749,4179,6570,5,12.8,-608,-0.7,24.2,0,43,43,425
1996,04,a) 0,9490,9557,56924,28617,9470,198.2,0,0,56615,56615,0,197.8,197.8,0,0,0,0,0,56615,197.8,0,0,,,
1996,04,b) 1,7110,7211,59359,58420,67,0.8,2161,25.9,18654,2199,16455,3.8,31.9,16776,9261,7515,15.9,28.7,1878,3.2,57.4,0,1783,1783,8170
1996,04,c) 2,5826,6003,52300,53584,238,3.7,1192,18.3,11998,1704,10294,3.2,22.4,14565,7702,6863,14.4,27.2,-2567,-4.8,44.8,0,981,981,6024
1996,04,d) 3,4507,4660,43528,44503,229,4.6,781,15.8,8967,1826,7141,4.1,20.1,10916,4503,6413,10.1,24.5,-1949,-4.4,40.2,0,629,629,3738
1996,04,e) 4,3872,4063,53330,52904,169,3.9,602,14,11833,4077,7756,7.7,22.4,10980,5469,5511,10.3,20.8,853,1.6,41.6,0,464,464,4428
1996,04,f) 5,3561,3721,38352,38179,134,3.4,519,13.3,8334,1337,6997,3.5,21.8,7987,3880,4107,10.2,20.9,347,0.9,41.8,0,388,388,3204
1996,04,g) 6 to 10,14132,15422,207801,208050,589,3.7,1700,10.6,33805,6704,27101,3.2,16.2,34302,14132,20170,6.8,16.5,-497,-0.3,32.4,0,1184,1184,9076
1996,04,h) 11 to 15,9540,11274,187491,186042,480,4.2,986,8.6,27341,5836,21505,3.1,14.7,24442,8675,15767,4.7,13.1,2899,1.6,26.2,0,552,552,3727
1996,04,i) 16 to 20,5331,7056,131519,130137,373,5.2,561,7.8,19459,5613,13846,4.3,15,16694,5307,11387,4.1,12.8,2765,2.2,25.6,0,316,316,2405
1996,04,l) Left Censored,9009,20563,728987,718257,1436,7,1520,7.4,99189,29777,69412,4.1,13.8,77729,21052,56677,2.9,10.8,21460,3,21.6,0,360,361,2340
1996,05,a) 0,4957,5020,26707,13461,4973,198.1,0,0,26492,26492,0,196.8,196.8,0,0,0,0,0,26492,196.8,0,0,,,
1996,05,b) 1,3938,3982,27521,27634,28,0.6,1160,25.2,7988,386,7602,1.4,28.9,8213,4958,3255,17.9,29.7,-225,-0.8,57.8,0,985,985,4401
1996,05,c) 2,3178,3235,23081,24209,115,3.3,620,17.7,4485,736,3749,3,18.5,6740,3224,3516,13.3,27.8,-2255,-9.3,37,0,545,545,2866
1996,05,d) 3,2678,2712,19687,20643,70,2.4,485,16.6,3410,397,3013,1.9,16.5,5321,2641,2680,12.8,25.8,-1911,-9.3,33,0,395,395,2184
1996,05,e) 4,2217,2309,20123,20395,93,3.8,360,14.7,3577,619,2958,3,17.5,4120,1952,2168,9.6,20.2,-543,-2.7,35,0,290,290,1610
1996,05,f) 5,1939,2061,17628,17993,68,3.2,252,11.7,2733,393,2340,2.2,15.2,3463,1511,1952,8.4,19.2,-730,-4,30.4,0,196,196,1204
1996,05,g) 6 to 10,7731,8260,85449,86197,252,2.9,871,10.2,12338,1862,10476,2.2,14.3,13834,5459,8375,6.3,16,-1496,-1.7,28.6,0,659,659,3693
1996,05,h) 11 to 15,5974,6547,95560,96540,193,2.9,531,7.9,12129,1679,10450,1.7,12.6,14091,3450,10641,3.6,14.6,-1962,-2,25.2,0,363,364,1976
1996,05,i) 16 to 20,4099,4978,71335,72221,170,3.3,405,7.9,8292,2874,5418,4,11.5,10063,2946,7117,4.1,13.9,-1771,-2.4,23,0,223,223,1453
1996,05,l) Left Censored,8635,15273,503919,503200,738,4.8,985,6.4,50416,11670,38746,2.3,10,48979,11298,37681,2.2,9.7,1437,0.3,19.4,0,359,359,2357
1996,06,a) 0,60164,60649,371093,186526,60153,198.4,0,0,369134,369134,0,197.9,197.9,0,0,0,0,0,369134,197.9,0,0,,,
1996,06,b) 1,44227,44725,378440,369558,283,0.5,12447,24.2,122184,4394,117790,1.2,33.1,104422,58026,46396,15.7,28.3,17762,4.8,56.6,0,9904,9904,48049
1996,06,c) 2,35830,36629,338595,346522,1348,3.4,7411,18.6,75580,9353,66227,2.7,21.8,91434,48002,43432,13.9,26.4,-15854,-4.6,43.6,0,5940,5940,40435
1996,06,d) 3,29433,30141,299799,304136,1270,3.9,5420,16.8,67549,9155,58394,3,22.2,76222,38148,38074,12.5,25.1,-8673,-2.9,44.4,0,4398,4398,32177
1996,06,e) 4,27085,28389,284099,291610,1205,4,4483,14.9,53458,9665,43793,3.3,18.3,68480,30161,38319,10.3,23.5,-15022,-5.2,36.6,0,3469,3469,23427
1996,06,f) 5,26172,27520,273320,277181,1265,4.4,3929,13.6,52341,9110,43231,3.3,18.9,60063,27280,32783,9.8,21.7,-7722,-2.8,37.8,0,2970,2970,21395
1996,06,g) 6 to 10,110268,119151,1453096,1475898,4835,3.9,13888,11.2,226195,36038,190157,2.4,15.3,271799,100226,171573,6.8,18.4,-45604,-3.1,30.6,0,9684,9686,64050
1996,06,h) 11 to 15,75320,86935,1323463,1339531,3027,3.4,8154,9.1,179365,33434,145931,2.5,13.4,211501,69165,142336,5.2,15.8,-32136,-2.4,26.8,0,5056,5057,34222
1996,06,i) 16 to 20,47413,61624,1033581,1054646,2195,3.5,4837,7.7,132822,29023,103799,2.8,12.6,174951,78900,96051,7.5,16.6,-42129,-4,25.2,0,2713,2714,14786
1996,06,l) Left Censored,78161,160516,5207377,5228538,7858,4.8,12949,7.9,664454,178378,486076,3.4,12.7,706776,221909,484867,4.2,13.5,-42322,-0.8,25.4,0,4195,4202,30696
1996,08,a) 0,11283,11358,59452,29851,11282,198.7,0,0,59202,59202,0,198.3,198.3,0,0,0,0,0,59202,198.3,0,0,,,
1996,08,b) 1,8653,8788,60707,61114,84,0.8,2546,25.1,18033,1620,16413,2.7,29.5,18847,11374,7473,18.6,30.8,-814,-1.3,59,0,2015,2015,9536
1996,08,c) 2,7343,7471,53265,55541,252,3.1,1421,17.6,11369,1472,9897,2.7,20.5,15920,7742,8178,13.9,28.7,-4551,-8.2,41,0,1153,1153,6523
1996,08,d) 3,5790,5858,45639,46687,181,2.9,965,15.4,8585,996,7589,2.1,18.4,10681,4520,6161,9.7,22.9,-2096,-4.5,36.8,0,776,776,3728
1996,08,e) 4,4783,4889,41786,43172,164,3.2,700,13.6,6865,617,6248,1.4,15.9,9636,3858,5778,8.9,22.3,-2771,-6.4,31.8,0,548,548,2975
1996,08,f) 5,4350,4542,39516,40250,191,4,610,12.8,7719,1577,6142,3.9,19.2,9187,4094,5093,10.2,22.8,-1468,-3.6,38.4,0,429,429,2796
1996,08,g) 6 to 10,15926,17070,198759,199675,627,3.5,1787,10.1,31738,7459,24279,3.7,15.9,33570,12180,21390,6.1,16.8,-1832,-0.9,31.8,0,1252,1252,8484
1996,08,h) 11 to 15,11105,12679,184974,186296,463,3.6,1098,8.4,26324,5115,21209,2.7,14.1,28967,10572,18395,5.7,15.5,-2643,-1.4,28.2,0,639,639,5064
1996,08,i) 16 to 20,6790,8677,143406,141439,403,4.6,675,7.7,24199,7529,16670,5.3,17.1,20265,5534,14731,3.9,14.3,3934,2.8,28.6,0,365,365,2261
1996,08,l) Left Censored,12179,23262,744921,743613,1446,6.2,1934,8.2,111626,44637,66989,6,15,109010,43233,65777,5.8,14.7,2616,0.3,29.4,0,482,483,3436
1996,09,a) 0,5561,5598,34043,17103,5541,198,0,0,33880,33880,0,198.1,198.1,0,0,0,0,0,33880,198.1,0,0,,,
1996,09,b) 1,4753,4811,32170,31976,28,0.5,1078,20,8640,452,8188,1.4,27,8252,4802,3450,15,25.8,388,1.2,51.6,0,822,822,4097
1996,09,c) 2,3957,3998,29653,30742,124,2.9,706,16.4,5660,843,4817,2.7,18.4,7838,3000,4838,9.8,25.5,-2178,-7.1,36.8,0,585,585,2653
1996,09,d) 3,3482,3526,30243,30149,119,3.2,466,12.6,5964,845,5119,2.8,19.8,5775,2468,3307,8.2,19.2,189,0.6,38.4,0,372,372,2149
1996,09,e) 4,3005,3100,25896,26938,83,2.6,376,11.6,3820,369,3451,1.4,14.2,5904,2316,3588,8.6,21.9,-2084,-7.7,28.4,0,285,285,1944
1996,09,f) 5,2720,2832,25282,25492,93,3.1,373,12.5,4082,481,3601,1.9,16,4502,1794,2708,7,17.7,-420,-1.7,32,0,277,277,1307
1996,09,g) 6 to 10,13914,14629,156778,156813,547,3.6,1493,9.9,23867,5409,18458,3.4,15.2,23937,9061,14876,5.8,15.3,-70,-0.1,30.4,0,1038,1038,5728
1996,09,h) 11 to 15,9359,10211,120349,122476,275,2.6,844,8,14674,3341,11333,2.7,12,18927,7102,11825,5.8,15.5,-4253,-3.5,24,0,548,549,4255
1996,09,i) 16 to 20,5775,6921,96130,95782,210,3,498,7,12793,2668,10125,2.8,13.4,12096,4223,7873,4.4,12.6,697,0.8,25.2,0,287,287,1834
1996,09,l) Left Censored,16496,25765,862564,866939,1134,4.3,1781,6.8,91965,34033,57932,3.9,10.6,100715,26661,74054,3.1,11.6,-8750,-1,21.2,0,645,645,4948
1996,10,a) 0,1562,1566,8801,4445,1546,197.4,0,0,8712,8712,0,196,196,0,0,0,0,0,8712,196,0,0,,,
1996,10,b) 1,1308,1324,8829,8903,10,0.7,284,19.3,1875,55,1820,0.6,21.1,2023,1082,941,12.2,22.7,-148,-1.6,42.2,0,219,219,826
1996,10,c) 2,1086,1102,8354,8710,26,2.2,184,15.6,2357,633,1724,7.3,27.1,3068,1289,1779,14.8,35.2,-711,-8.1,54.2,0,147,147,1182
1996,10,d) 3,919,923,6026,6232,31,3.2,138,14.2,1128,280,848,4.5,18.1,1540,527,1013,8.5,24.7,-412,-6.6,36.2,0,114,114,451
1996,10,e) 4,762,786,6019,5922,29,3.6,100,12.3,1254,209,1045,3.5,21.2,1059,412,647,7,17.9,195,3.3,35.8,0,82,82,355
1996,10,f) 5,673,696,5964,6042,15,2,115,15.5,1143,42,1101,0.7,18.9,1298,654,644,10.8,21.5,-155,-2.6,37.8,0,85,85,465
1996,10,g) 6 to 10,2886,3028,30740,30981,99,3.2,301,9.6,4554,1156,3398,3.7,14.7,5036,1509,3527,4.9,16.3,-482,-1.6,29.4,0,205,205,1024
1996,10,h) 11 to 15,1795,2007,26526,26597,76,3.7,176,8.6,3658,754,2904,2.8,13.8,3800,1388,2412,5.2,14.3,-142,-0.5,27.6,0,112,112,928
1996,10,i) 16 to 20,1145,1416,34075,33863,60,4.2,109,7.6,4145,384,3761,1.1,12.2,3721,1164,2557,3.4,11,424,1.2,22,0,54,54,336
1996,10,l) Left Censored,3437,5689,188725,192006,333,5.8,450,7.8,19691,6176,13515,3.2,10.3,26253,9055,17198,4.7,13.7,-6562,-3.4,20.6,0,100,100,1366
1996,11,a) 0,1130,1134,7527,3772,1123,198.1,0,0,7511,7511,0,199.1,199.1,0,0,0,0,0,7511,199.1,0,0,,,
1996,11,b) 1,897,926,8418,8286,15,1.5,190,18.6,2235,309,1926,3.7,27,1971,890,1081,10.7,23.8,264,3.2,47.6,0,140,140,735
1996,11,c) 2,792,814,6578,6967,23,2.7,116,13.4,978,95,883,1.4,14,1756,759,997,10.9,25.2,-778,-11.2,28,0,93,93,592
1996,11,d) 3,660,667,6362,6652,31,4.4,105,14.9,899,259,640,3.9,13.5,1479,566,913,8.5,22.2,-580,-8.7,27,0,89,89,527
1996,11,e) 4,654,718,11696,19870,34,4.6,77,10.4,1023,323,700,1.6,5.1,17371,648,16723,3.3,87.4,-16348,-82.3,10.2,0,51,51,588
1996,11,f) 5,577,593,5938,6047,32,5.2,75,12.2,1028,163,865,2.7,17,1245,537,708,8.9,20.6,-217,-3.6,34,0,58,58,418
1996,11,g) 6 to 10,2546,2701,35543,36207,94,3.3,305,10.9,4862,765,4097,2.1,13.4,6189,2283,3906,6.3,17.1,-1327,-3.7,26.8,0,196,196,1249
1996,11,h) 11 to 15,2130,2360,36585,37300,103,4.3,193,8,4605,969,3636,2.6,12.3,6034,1793,4241,4.8,16.2,-1429,-3.9,24.6,0,108,108,472
1996,11,i) 16 to 20,1318,1603,51259,50983,60,3.7,103,6.3,4199,953,3246,1.9,8.2,3646,667,2979,1.3,7.2,553,1,14.4,0,64,64,357
1996,11,l) Left Censored,4199,6376,220437,223620,325,5,529,8.2,21191,5240,15951,2.3,9.5,27556,8625,18931,3.9,12.3,-6365,-2.8,19,0,145,145,847
1996,12,a) 0,37456,37677,202121,101650,37374,198.4,0,0,200943,200943,0,197.7,197.7,0,0,0,0,0,200943,197.7,0,0,,,
1996,12,b) 1,28155,28427,187864,192847,152,0.5,8476,25.7,54057,5729,48328,3,28,64023,37353,26670,19.4,33.2,-9966,-5.2,56,0,6967,6967,31816
1996,12,c) 2,23728,24128,174615,186213,879,3.3,5300,20,41405,7682,33723,4.1,22.2,64600,37383,27217,20.1,34.7,-23195,-12.5,44.4,0,4470,4470,32821
1996,12,d) 3,20026,20422,189251,189286,722,3.3,3726,17,42613,5990,36623,3.2,22.5,42682,20866,21816,11,22.5,-69,0,45,0,3055,3055,17497
1996,12,e) 4,17120,17671,154345,161090,592,3.1,2884,15.3,30054,7121,22933,4.4,18.7,43543,19228,24315,11.9,27,-13489,-8.3,37.4,0,2352,2352,16245
1996,12,f) 5,15072,15616,142902,145873,474,2.9,2225,13.5,25760,3071,22689,2.1,17.7,31702,14992,16710,10.3,21.7,-5942,-4,35.4,0,1778,1779,11095
1996,12,g) 6 to 10,58705,63263,716470,726829,2074,3.2,7125,10.8,118586,22690,95896,3.1,16.3,139305,53353,85952,7.3,19.2,-20719,-2.9,32.6,0,5312,5312,37867
1996,12,h) 11 to 15,35649,40929,570730,578136,1422,3.4,3877,9.2,92536,18482,74054,3.2,16,107348,31963,75385,5.5,18.6,-14812,-2.6,32,0,2523,2523,18758
1996,12,i) 16 to 20,19442,25537,389055,387796,1003,3.8,2138,8.2,57752,16965,40787,4.4,14.9,55233,20740,34493,5.3,14.2,2519,0.7,28.4,0,1160,1160,7375
1996,12,l) Left Censored,33649,79282,2543805,2526367,4686,5.8,6453,8,362959,137233,225726,5.4,14.4,328083,105611,222472,4.2,13,34876,1.4,26,0,1649,1649,13689
1996,13,a) 0,16175,16295,98640,49497,16171,198.5,0,0,98287,98287,0,198.6,198.6,0,0,0,0,0,98287,198.6,0,0,,,
1996,13,b) 1,11823,12077,96743,98058,103,0.7,3490,25.1,27937,1834,26103,1.9,28.5,30567,18377,12190,18.7,31.2,-2630,-2.7,57,0,2813,2813,14788
1996,13,c) 2,9771,9997,87214,88460,317,2.9,2041,18.8,21682,2945,18737,3.3,24.5,24174,12873,11301,14.6,27.3,-2492,-2.8,49,0,1674,1674,11255
1996,13,d) 3,7988,8109,73165,75573,299,3.4,1405,16.2,15032,1811,13221,2.4,19.9,19847,10051,9796,13.3,26.3,-4815,-6.4,39.8,0,1155,1155,7906
1996,13,e) 4,6739,6999,67688,69478,270,3.7,1017,13.8,13373,3358,10015,4.8,19.2,16952,8652,8300,12.5,24.4,-3579,-5.2,38.4,0,794,794,6762
1996,13,f) 5,5998,6309,68365,67626,277,4.2,778,11.9,13554,3118,10436,4.6,20,12076,5315,6761,7.9,17.9,1478,2.1,35.8,0,593,593,4083
1996,13,g) 6 to 10,23766,25850,336707,341067,924,3.5,2735,10.2,49202,10238,38964,3,14.4,57921,21704,36217,6.4,17,-8719,-2.6,28.8,0,1944,1944,14544
1996,13,h) 11 to 15,16176,18543,270273,264049,716,3.8,1440,7.6,51244,8670,42574,3.3,19.4,38795,12780,26015,4.8,14.7,12449,4.7,29.4,0,927,927,6061
1996,13,i) 16 to 20,9306,12307,213173,212956,543,4.3,967,7.7,29946,7808,22138,3.7,14.1,29512,9645,19867,4.5,13.9,434,0.2,27.8,0,506,506,3890
1996,13,l) Left Censored,20617,45151,1637645,1637810,2817,6.2,3623,8,215591,71598,143993,4.4,13.2,215920,75473,140447,4.6,13.2,-329,0,26.4,0,881,881,6965
1996,15,a) 0,1976,2021,13183,6816,1995,197.4,0,0,12734,,,,186.8,0,0,0,0,0,12734,186.8,0,1,,,
1996,15,b) 1,1475,1493,11771,11287,13,0.8,436,25.2,3966,,,,35.1,2998,1831,1167,16.2,26.6,968,8.5,53.2,1,347,347,1490
1996,15,c) 2,1248,1267,15973,16595,34,2.4,275,19.7,1868,245,1623,1.5,11.3,3112,1075,2037,6.5,18.8,-1244,-7.5,22.6,0,229,229,917
1996,15,d) 3,1085,1114,8753,9276,43,3.6,217,18,1089,150,939,1.6,11.7,2134,950,1184,10.2,23,-1045,-11.3,23.4,0,163,163,699
1996,15,e) 4,1003,1042,11192,11649,30,2.7,173,15.5,1589,206,1383,1.8,13.6,2502,1162,1340,10,21.5,-913,-7.9,27.2,0,133,133,782
1996,15,f) 5,1033,1074,11926,12201,35,3.1,140,12.4,1435,222,1213,1.8,11.8,1985,818,1167,6.7,16.3,-550,-4.5,23.6,0,106,106,634
1996,15,g) 6 to 10,4048,4498,50611,52144,156,3.3,546,11.6,6254,1391,4863,2.7,12,9319,3027,6292,5.8,17.9,-3065,-5.9,24,0,381,381,2009
1996,15,h) 11 to 15,3108,3610,42823,43809,103,2.8,274,7.4,4922,1193,3729,2.7,11.2,6893,2260,4633,5.2,15.7,-1971,-4.5,22.4,0,174,174,977
1996,15,i) 16 to 20,2066,2823,40284,41815,63,2.2,163,5.7,3358,679,2679,1.6,8,6420,1414,5006,3.4,15.4,-3062,-7.4,16,0,86,86,418
1996,15,l) Left Censored,4454,8121,215324,216761,343,4.2,611,7.4,23555,9151,14404,4.2,10.9,26428,7954,18474,3.7,12.2,-2873,-1.3,21.8,0,165,165,1163
1996,16,a) 0,3171,3186,15600,7843,3152,197.9,0,0,15515,15515,0,197.8,197.8,0,0,0,0,0,15515,197.8,0,0,,,
1996,16,b) 1,2331,2348,13340,13573,8,0.3,647,23.9,3590,137,3453,1,26.4,4055,2159,1896,15.9,29.9,-465,-3.5,52.8,0,500,500,1779
1996,16,c) 2,1935,1965,13171,13707,79,3.7,413,19.2,2935,361,2574,2.6,21.4,4007,2362,1645,17.2,29.2,-1072,-7.8,42.8,0,325,325,2099
1996,16,d) 3,1457,1476,10587,11141,51,3.2,282,17.6,1893,237,1656,2.1,17,3000,1408,1592,12.6,26.9,-1107,-9.9,34,0,215,215,1205
1996,16,e) 4,1351,1383,9814,10273,72,5,180,12.5,1608,360,1248,3.5,15.7,2525,874,1651,8.5,24.6,-917,-8.9,31.4,0,142,142,724
1996,16,f) 5,1119,1154,8594,9016,37,3.1,140,11.6,1486,327,1159,3.6,16.5,2329,969,1360,10.7,25.8,-843,-9.3,33,0,110,110,795
1996,16,g) 6 to 10,4355,4656,49095,50379,178,3.7,483,10,6618,1313,5305,2.6,13.1,9186,3544,5642,7,18.2,-2568,-5.1,26.2,0,362,362,2825
1996,16,h) 11 to 15,2980,3343,41060,40993,126,3.7,263,7.7,6056,1454,4602,3.5,14.8,5921,2007,3914,4.9,14.4,135,0.4,28.8,0,171,171,1502
1996,16,i) 16 to 20,2072,2473,42964,41310,129,5.1,211,8.4,7608,2199,5409,5.3,18.4,4300,1097,3203,2.7,10.4,3308,8,20.8,0,125,125,503
1996,16,l) Left Censored,4059,7096,174548,174918,342,4.8,472,6.6,22605,5035,17570,2.9,12.9,23344,7531,15813,4.3,13.3,-739,-0.4,25.8,0,180,180,1067
1996,17,a) 0,20544,20633,117177,58936,20411,197.8,0,0,116483,116483,0,197.6,197.6,0,0,0,0,0,116483,197.6,0,0,,,
1996,17,b) 1,16148,16353,122408,120796,138,0.7,3993,21.6,36485,2623,33862,2.2,30.2,33260,16837,16423,13.9,27.5,3225,2.7,55,0,3090,3090,12968
1996,17,c) 2,13662,13857,113716,118753,402,2.7,2441,16.4,21300,2607,18693,2.2,17.9,31373,14393,16980,12.1,26.4,-10073,-8.5,35.8,0,1926,1926,11655
1996,17,d) 3,11886,12079,116313,113598,406,3.2,1718,13.5,27135,2702,24433,2.4,23.9,21706,9210,12496,8.1,19.1,5429,4.8,38.2,0,1362,1362,7890
1996,17,e) 4,10483,10908,105336,106153,323,2.8,1383,12.1,17982,3211,14771,3,16.9,19615,8227,11388,7.8,18.5,-1633,-1.6,33.8,0,1060,1060,5823
1996,17,f) 5,9716,10292,96237,98551,363,3.4,1151,10.8,14388,2662,11726,2.7,14.6,19016,6103,12913,6.2,19.3,-4628,-4.7,29.2,0,900,900,4783
1996,17,g) 6 to 10,40510,43253,535107,545328,1358,3,4146,9.3,69431,13716,55715,2.5,12.7,89873,28260,61613,5.2,16.5,-20442,-3.8,25.4,0,2963,2964,20120
1996,17,h) 11 to 15,28800,32212,498870,498325,873,2.6,2495,7.6,62133,9910,52223,2,12.5,61042,18902,42140,3.8,12.2,1091,0.3,24.4,0,1664,1664,9493
1996,17,i) 16 to 20,18041,22563,354113,361192,706,3.1,1705,7.4,37611,8122,29489,2.2,10.4,51769,13274,38495,3.7,14.3,-14158,-3.9,20.8,0,933,933,5670
1996,17,l) Left Censored,46326,81222,2873092,2882881,3896,4.7,6055,7.4,324024,99361,224663,3.4,11.2,343602,91132,252470,3.2,11.9,-19578,-0.7,22.4,0,2068,2069,15203
1996,18,a) 0,9912,9997,56126,28183,9923,198.5,0,0,55886,55886,0,198.3,198.3,0,0,0,0,0,55886,198.3,0,0,,,
1996,18,b) 1,7782,7869,55550,56385,48,0.5,2081,23.2,14018,884,13134,1.6,24.9,15688,8445,7243,15,27.8,-1670,-2.9,49.8,0,1703,1703,7001
1996,18,c) 2,6565,6681,53211,54310,177,2.5,1218,16.9,11347,1844,9503,3.4,20.9,13545,6619,6926,12.2,24.9,-2198,-4,41.8,0,1000,1000,5311
1996,18,d) 3,5620,5732,43606,44826,212,3.5,865,14.3,7980,1433,6547,3.2,17.8,10420,4976,5444,11.1,23.2,-2440,-5.4,35.6,0,710,710,4286
1996,18,e) 4,4924,5150,51572,51984,147,2.7,652,12.1,9607,1805,7802,3.5,18.5,10430,3289,7141,6.3,20.1,-823,-1.6,37,0,507,507,2685
1996,18,f) 5,4657,4920,46823,47297,138,2.7,568,11.1,7266,1219,6047,2.6,15.4,8214,3232,4982,6.8,17.4,-948,-2,30.8,0,451,451,2440
1996,18,g) 6 to 10,18595,20386,267309,270034,655,3.1,1981,9.4,36529,7286,29243,2.7,13.5,41978,14139,27839,5.2,15.5,-5449,-2,27,0,1485,1486,9188
1996,18,h) 11 to 15,13508,15323,206664,208798,480,3.1,1139,7.3,25578,5750,19828,2.8,12.3,29845,9805,20040,4.7,14.3,-4267,-2,24.6,0,719,719,5161
1996,18,i) 16 to 20,8501,10826,186928,184144,284,2.6,827,7.5,27581,3992,23589,2.2,15,22012,6240,15772,3.4,12,5569,3,24,0,430,430,2666
1996,18,l) Left Censored,22071,41537,1413830,1430507,2026,4.8,2964,7.1,149251,47133,102118,3.3,10.4,182604,61017,121587,4.3,12.8,-33353,-2.4,20.8,0,964,964,10288
1996,19,a) 0,4931,4961,26281,13283,4908,197.9,0,0,25996,25996,0,195.7,195.7,0,0,0,0,0,25996,195.7,0,0,,,
1996,19,b) 1,4000,4054,26502,26405,37,0.8,932,20.5,7463,820,6643,3.1,28.3,7269,3469,3800,13.1,27.5,194,0.8,55,0,721,721,2526
1996,19,c) 2,3429,3476,23509,24030,122,3.3,569,15.3,4883,581,4302,2.4,20.3,5924,3272,2652,13.6,24.7,-1041,-4.4,40.6,0,455,455,2804
1996,19,d) 3,2796,2824,22294,21701,86,2.9,398,13.3,5817,2863,2954,13.2,26.8,4630,2232,2398,10.3,21.3,1187,5.5,42.6,0,331,331,2018
1996,19,e) 4,2483,2601,22215,22586,75,2.7,378,13.7,3630,901,2729,4,16.1,4371,1872,2499,8.3,19.4,-741,-3.3,32.2,0,311,311,1382
1996,19,f) 5,2364,2500,22016,21614,87,3.3,293,11.3,3790,495,3295,2.3,17.5,2986,1265,1721,5.9,13.8,804,3.7,27.6,0,222,222,1040
1996,19,g) 6 to 10,9542,10364,126815,126233,368,3.5,956,9,18207,5624,12583,4.5,14.4,17042,5699,11343,4.5,13.5,1165,0.9,27,0,718,718,3765
1996,19,h) 11 to 15,7745,8793,107444,107046,254,2.8,639,7.1,13033,3366,9667,3.1,12.2,12237,3971,8266,3.7,11.4,796,0.8,22.8,0,419,419,2216
1996,19,i) 16 to 20,5594,7327,87654,88177,189,2.5,482,6.4,9578,2187,7391,2.5,10.9,10624,3417,7207,3.9,12,-1046,-1.1,21.8,0,306,306,1775
1996,19,l) Left Censored,14915,24365,675744,673652,798,3.2,1439,5.8,66925,16115,50810,2.4,9.9,62741,15706,47035,2.3,9.3,4184,0.6,18.6,0,553,554,3539
1996,20,a) 0,5163,5197,27027,13555,5169,198.9,0,0,26944,26944,0,198.8,198.8,0,0,0,0,0,26944,198.8,0,0,,,
1996,20,b) 1,3993,4053,29512,29343,35,0.8,1085,23.5,9311,1602,7709,5.5,31.7,8973,5159,3814,17.6,30.6,338,1.1,61.2,0,889,889,4542
1996,20,c) 2,3310,3364,24523,25229,95,2.6,706,19.2,4909,600,4309,2.4,19.5,6320,3673,2647,14.6,25.1,-1411,-5.6,39,0,566,566,3204
1996,20,d) 3,2783,2817,22155,22607,87,2.9,436,14.6,4034,739,3295,3.3,17.8,4938,2148,2790,9.5,21.8,-904,-4,35.6,0,366,366,1930
1996,20,e) 4,2485,2574,21915,22251,77,2.9,320,11.9,3528,370,3158,1.7,15.9,4200,1705,2495,7.7,18.9,-672,-3,31.8,0,256,256,1458
1996,20,f) 5,2192,2317,19975,19769,75,3.1,297,12.2,3579,383,3196,1.9,18.1,3167,1353,1814,6.8,16,412,2.1,32,0,234,234,1073
1996,20,g) 6 to 10,8987,9592,108382,109664,329,3.3,1023,10.3,13712,2686,11026,2.4,12.5,16276,6195,10081,5.6,14.8,-2564,-2.3,25,0,769,769,4463
1996,20,h) 11 to 15,7307,8122,90925,91167,294,3.5,607,7.3,12798,3207,9591,3.5,14,13281,5210,8071,5.7,14.6,-483,-0.6,28,0,409,409,3240
1996,20,i) 16 to 20,4575,5864,84584,85102,177,3,426,7.1,9557,2189,7368,2.6,11.2,10593,4215,6378,5,12.4,-1036,-1.2,22.4,0,225,225,1787
1996,20,l) Left Censored,12063,20338,559257,554574,886,4.3,1198,5.8,64148,18940,45208,3.4,11.6,54781,15123,39658,2.7,9.9,9367,1.7,19.8,0,457,457,2758
1996,21,a) 0,6169,6244,41622,21005,6193,198.4,0,0,41234,41234,0,196.3,196.3,0,0,0,0,0,41234,196.3,0,0,,,
1996,21,b) 1,4957,5057,40735,40680,39,0.7,1359,23.6,12013,3682,8331,9.1,29.5,11903,6207,5696,15.3,29.3,110,0.2,58.6,0,1138,1138,5597
1996,21,c) 2,4049,4133,33689,34653,132,2.9,818,18.2,7115,1281,5834,3.7,20.5,9043,4822,4221,13.9,26.1,-1928,-5.6,41,0,675,675,4402
1996,21,d) 3,3560,3631,31840,32982,116,3,594,15.3,5251,628,4623,1.9,15.9,7535,3470,4065,10.5,22.8,-2284,-6.9,31.8,0,502,502,2864
1996,21,e) 4,3140,3259,28207,28804,88,2.6,448,13,5127,1139,3988,4,17.8,6321,2733,3588,9.5,21.9,-1194,-4.1,35.6,0,354,354,2346
1996,21,f) 5,2707,2821,24537,24952,92,3.1,375,12.7,4401,810,3591,3.2,17.6,5230,2412,2818,9.7,21,-829,-3.4,35.2,0,302,302,1849
1996,21,g) 6 to 10,11694,12673,167539,166693,387,3,1235,9.4,28403,4248,24155,2.5,17,26710,9000,17710,5.4,16,1693,1,32,0,919,919,5929
1996,21,h) 11 to 15,8461,9380,129100,131458,264,2.8,679,7.1,15866,4200,11666,3.2,12.1,20581,5805,14776,4.4,15.7,-4715,-3.6,24.2,0,440,440,3558
1996,21,i) 16 to 20,5028,6322,107906,108519,200,3.1,496,7.7,12269,2488,9781,2.3,11.3,13494,4229,9265,3.9,12.4,-1225,-1.1,22.6,0,275,275,1636
1996,21,l) Left Censored,13213,24514,752181,753266,1327,5.4,1543,6.3,84147,24629,59518,3.3,11.2,86316,22670,63646,3,11.5,-2169,-0.3,22.4,0,549,549,3649
1996,22,a) 0,7132,7150,43855,21996,7096,198.5,0,0,43719,43719,0,198.8,198.8,0,0,0,0,0,43719,198.8,0,0,,,
1996,22,b) 1,5461,5517,52094,50548,30,0.5,1462,23.2,17292,857,16435,1.7,34.2,14200,7710,6490,15.3,28.1,3092,6.1,56.2,0,1203,1203,6455
1996,22,c) 2,4813,4919,44167,46204,161,3,908,17.1,8619,1070,7549,2.3,18.7,12693,6287,6406,13.6,27.5,-4074,-8.8,37.4,0,750,750,5188
1996,22,d) 3,3970,4041,39739,40632,131,3.1,614,14.3,7639,1059,6580,2.6,18.8,9425,4134,5291,10.2,23.2,-1786,-4.4,37.6,0,512,512,3786
1996,22,e) 4,3477,3618,34352,34852,115,3,463,12.2,6044,938,5106,2.7,17.3,7043,2914,4129,8.4,20.2,-999,-2.9,34.6,0,357,357,2281
1996,22,f) 5,3123,3315,34753,36012,109,3.2,349,10.1,5321,1448,3873,4,14.8,7839,2277,5562,6.3,21.8,-2518,-7,29.6,0,264,264,1677
1996,22,g) 6 to 10,11919,12868,164789,164670,423,3.2,1176,8.9,24999,4303,20696,2.6,15.2,24761,9053,15708,5.5,15,238,0.2,30,0,884,884,6155
1996,22,h) 11 to 15,10595,12081,156300,157218,343,2.8,802,6.5,19090,2738,16352,1.7,12.1,20926,6532,14394,4.2,13.3,-1836,-1.2,24.2,0,542,542,3296
1996,22,i) 16 to 20,6516,8125,123016,123358,242,2.9,492,6,15019,2945,12074,2.4,12.2,15702,3514,12188,2.8,12.7,-683,-0.5,24.4,0,321,322,1547
1996,22,l) Left Censored,14330,26615,735038,732381,1166,4.3,1619,6,86415,21928,64487,3,11.8,81101,20775,60326,2.8,11.1,5314,0.7,22.2,0,517,517,3294
1996,23,a) 0,2782,2801,13294,6794,2775,198.1,0,0,13001,13001,0,191.4,191.4,0,0,0,0,0,13001,191.4,0,0,,,
1996,23,b) 1,2146,2159,10961,11110,10,0.4,538,21.9,2816,47,2769,0.4,25.3,3114,1720,1394,15.5,28,-298,-2.7,50.6,0,426,426,1435
1996,23,c) 2,1689,1709,11207,11223,56,3.1,284,15.5,2594,395,2199,3.5,23.1,2625,1306,1319,11.6,23.4,-31,-0.3,46.2,0,240,240,1196
1996,23,d) 3,1386,1408,10134,10506,38,2.5,251,16.5,1891,169,1722,1.6,18,2635,1610,1025,15.3,25.1,-744,-7.1,36,0,205,205,971
1996,23,e) 4,1168,1220,8789,9016,41,3.2,187,14.4,1348,186,1162,2.1,15,1801,750,1051,8.3,20,-453,-5,30,0,140,140,587
1996,23,f) 5,1131,1192,8690,8676,52,4.2,123,10,1362,208,1154,2.4,15.7,1333,466,867,5.4,15.4,29,0.3,30.8,0,104,104,365
1996,23,g) 6 to 10,5719,5973,55240,56038,213,3.4,626,10.1,6871,1086,5785,1.9,12.3,8466,3429,5037,6.1,15.1,-1595,-2.8,24.6,0,489,489,2199
1996,23,h) 11 to 15,3463,3824,43908,44853,113,2.9,280,7.2,5049,745,4304,1.7,11.3,6939,2835,4104,6.3,15.5,-1890,-4.2,22.6,0,195,195,2393
1996,23,i) 16 to 20,2230,2897,41240,41016,128,4.4,202,6.9,5192,1283,3909,3.1,12.7,4744,1191,3553,2.9,11.6,448,1.1,23.2,0,110,110,540
1996,23,l) Left Censored,5038,8158,221803,224292,374,4.5,551,6.7,18880,5741,13139,2.6,8.4,23857,5629,18228,2.5,10.6,-4977,-2.2,16.8,0,219,219,1216
1996,24,a) 0,8840,8885,49478,24876,8800,198.1,0,0,49205,49205,0,197.8,197.8,0,0,0,0,0,49205,197.8,0,0,,,
1996,24,b) 1,7204,7310,47207,47635,49,0.6,1828,22.1,13971,964,13007,2,29.3,14826,8529,6297,17.9,31.1,-855,-1.8,58.6,0,1432,1432,6546
1996,24,c) 2,5869,5993,46031,47208,188,2.9,1101,17,9771,1751,8020,3.7,20.7,12125,5450,6675,11.5,25.7,-2354,-5,41.4,0,904,904,4436
1996,24,d) 3,5090,5175,47140,48507,189,3.4,855,15.5,7738,1167,6571,2.4,16,10471,4989,5482,10.3,21.6,-2733,-5.6,32,0,671,671,4292
1996,24,e) 4,4349,4567,40872,41586,185,3.8,657,13.7,7583,2279,5304,5.5,18.2,9010,4301,4709,10.3,21.7,-1427,-3.5,36.4,0,495,495,2714
1996,24,f) 5,4128,4321,42840,42970,151,3.3,552,12.2,7470,971,6499,2.3,17.4,7730,3072,4658,7.1,18,-260,-0.6,34.8,0,407,410,2462
1996,24,g) 6 to 10,18210,19329,225740,230667,633,3.2,2044,10.2,33434,8315,25119,3.6,14.5,43287,15136,28151,6.6,18.8,-9853,-4.3,29,0,1421,1422,10851
1996,24,h) 11 to 15,11465,12972,173118,175157,392,2.9,1069,8,22642,3865,18777,2.2,12.9,26719,8953,17766,5.1,15.3,-4077,-2.4,25.8,0,636,636,4541
1996,24,i) 16 to 20,6682,8659,141351,142512,290,3.3,582,6.6,16171,4617,11554,3.2,11.3,18492,4670,13822,3.3,13,-2321,-1.7,22.6,0,333,334,2394
1996,24,l) Left Censored,16733,31446,988984,999682,1474,4.6,2424,7.6,114956,35415,79541,3.5,11.5,136352,41132,95220,4.1,13.6,-21396,-2.1,23,0,714,714,6245
1996,25,a) 0,10628,10667,58152,29393,10590,198.6,0,0,57519,57519,0,195.7,195.7,0,0,0,0,0,57519,195.7,0,0,,,
1996,25,b) 1,8811,8930,66126,63491,66,0.7,2019,20.2,20816,1157,19659,1.8,32.8,15546,8875,6671,14,24.5,5270,8.3,49,0,1569,1570,7263
1996,25,c) 2,7394,7460,60598,60913,193,2.4,1131,14.2,13238,1206,12032,2,21.7,13868,6627,7241,10.9,22.8,-630,-1.1,43.4,0,909,909,5623
1996,25,d) 3,5931,6004,52424,52849,189,3,844,13.3,10601,1201,9400,2.3,20.1,11451,5399,6052,10.2,21.7,-850,-1.6,40.2,0,703,703,4765
1996,25,e) 4,5087,5459,54985,54986,227,4,683,12,10454,1971,8483,3.6,19,10455,5065,5390,9.2,19,-1,0,38,0,557,557,4321
1996,25,f) 5,4597,4793,48171,47083,176,3.5,532,10.7,9804,1833,7971,3.9,20.8,7628,3472,4156,7.4,16.2,2176,4.6,32.4,0,421,421,2839
1996,25,g) 6 to 10,23280,24840,301386,305316,842,3.3,2356,9.2,39320,5832,33488,1.9,12.9,47180,20574,26606,6.7,15.5,-7860,-2.6,25.8,0,1691,1691,13541
1996,25,h) 11 to 15,15979,17963,267528,268913,546,3,1365,7.4,32393,5387,27006,2,12,35163,11907,23256,4.4,13.1,-2770,-1.1,24,0,904,904,7281
1996,25,i) 16 to 20,9431,12101,232086,233076,381,3.1,948,7.7,26428,5741,20687,2.5,11.3,28407,8603,19804,3.7,12.2,-1979,-0.9,22.6,0,450,450,3357
1996,25,l) Left Censored,27942,45516,1582080,1589199,2066,4.5,3333,7.2,173639,48950,124689,3.1,10.9,187877,65061,122816,4.1,11.8,-14238,-0.9,21.8,0,1137,1137,8742
1996,26,a) 0,16163,16245,98672,49798,16089,198.1,0,0,97749,97749,0,196.3,196.3,0,0,0,0,0,97749,196.3,0,0,,,
1996,26,b) 1,13189,13321,102006,99852,82,0.6,2832,19.1,30153,2134,28019,2.1,30.2,25845,11893,13952,11.9,25.9,4308,4.3,51.8,0,2225,2225,9481
1996,26,c) 2,10606,10773,90790,93431,318,2.8,1719,14.9,20120,1689,18431,1.8,21.5,25401,9989,15412,10.7,27.2,-5281,-5.7,43,0,1373,1373,8880
1996,26,d) 3,9074,9241,79806,81778,278,2.9,1268,13,14912,3282,11630,4,18.2,18855,7168,11687,8.8,23.1,-3943,-4.9,36.4,0,1018,1018,5989
1996,26,e) 4,7909,8205,75946,78397,214,2.5,1101,12.7,11205,1125,10080,1.4,14.3,16107,6519,9588,8.3,20.5,-4902,-6.2,28.6,0,877,877,5408
1996,26,f) 5,7512,7838,69957,73162,217,2.6,940,11.5,9551,1221,8330,1.7,13.1,15961,6498,9463,8.9,21.8,-6410,-8.7,26.2,0,721,721,5063
1996,26,g) 6 to 10,31593,34027,394528,402131,1032,2.9,3215,9.2,52238,9347,42891,2.3,13,67444,23350,44094,5.8,16.8,-15206,-3.8,26,0,2394,2394,16823
1996,26,h) 11 to 15,21471,24775,358226,359216,719,2.8,1697,6.7,44595,8638,35957,2.4,12.4,46575,14477,32098,4,13,-1980,-0.6,24.8,0,1137,1137,9496
1996,26,i) 16 to 20,13563,17273,269192,267771,438,2.5,1188,6.7,34869,7035,27834,2.6,13,32027,8622,23405,3.2,12,2842,1,24,0,668,668,4221
1996,26,l) Left Censored,33303,61670,2156422,2171313,2741,4.4,3894,6.3,215130,51408,163722,2.4,9.9,244913,61062,183851,2.8,11.3,-29783,-1.4,19.8,0,1435,1435,11380
1996,27,a) 0,9241,9292,52540,26480,9189,197.8,0,0,52120,52120,0,196.8,196.8,0,0,0,0,0,52120,196.8,0,0,,,
1996,27,b) 1,7359,7443,51480,51008,198,2.4,1562,19.1,15528,4935,10593,9.7,30.4,14584,7316,7268,14.3,28.6,944,1.8,57.2,0,1158,1158,5456
1996,27,c) 2,6218,6305,47763,48676,185,2.7,1020,15.2,9477,1162,8315,2.4,19.5,11303,5612,5691,11.5,23.2,-1826,-3.7,39,0,804,804,4848
1996,27,d) 3,5232,5383,46615,47509,197,3.5,760,13.4,9133,1856,7277,3.9,19.2,10920,5629,5291,11.8,23,-1787,-3.8,38.4,0,614,615,5048
1996,27,e) 4,4580,4786,40223,40717,159,3.2,572,11.5,7072,996,6076,2.4,17.4,8060,3601,4459,8.8,19.8,-988,-2.4,34.8,0,433,433,2694
1996,27,f) 5,4318,4595,46035,46540,185,3.9,523,11,8196,2626,5570,5.6,17.6,9206,2976,6230,6.4,19.8,-1010,-2.2,35.2,0,393,393,2319
1996,27,g) 6 to 10,17001,18214,216189,218595,512,2.7,1683,9,27960,3994,23966,1.8,12.8,32771,11591,21180,5.3,15,-4811,-2.2,25.6,0,1176,1176,8183
1996,27,h) 11 to 15,11830,13534,215265,215732,373,2.7,928,6.7,25296,4946,20350,2.3,11.7,26229,8002,18227,3.7,12.2,-933,-0.5,23.4,0,593,594,4538
1996,27,i) 16 to 20,7883,10042,156400,156488,332,3.3,634,6.2,18239,3609,14630,2.3,11.7,18415,5963,12452,3.8,11.8,-176,-0.1,23.4,0,354,354,2559
1996,27,l) Left Censored,19311,33094,1219111,1219457,1238,3.7,2124,6.3,129036,33821,95215,2.8,10.6,129728,28188,101540,2.3,10.6,-692,0,21.2,0,749,749,6165
1996,28,a) 0,4479,4536,27045,13551,4512,198.9,0,0,26989,26989,0,199.2,199.2,0,0,0,0,0,26989,199.2,0,0,,,
1996,28,b) 1,3459,3507,23996,25558,32,0.8,1014,25.1,6041,761,5280,3,23.6,9165,4421,4744,17.3,35.9,-3124,-12.3,47.2,0,834,834,3742
1996,28,c) 2,2874,2921,28189,29527,98,3.1,632,19.8,5022,1226,3796,4.2,17,7698,4071,3627,13.8,26.1,-2676,-9.1,34,0,513,513,3167
1996,28,d) 3,2376,2433,23239,24179,76,2.9,440,16.8,4141,918,3223,3.8,17.1,6020,3198,2822,13.2,24.9,-1879,-7.8,34.2,0,364,364,2890
1996,28,e) 4,1891,2000,18433,18616,79,3.7,308,14.6,3782,1105,2677,5.9,20.3,4148,1545,2603,8.3,22.3,-366,-2,40.6,0,245,245,1172
1996,28,f) 5,1783,1880,18355,18779,43,2.2,237,11.9,2781,387,2394,2.1,14.8,3629,1612,2017,8.6,19.3,-848,-4.5,29.6,0,187,187,1225
1996,28,g) 6 to 10,7051,7533,86575,88721,279,3.6,844,10.8,11686,3010,8676,3.4,13.2,15978,6682,9296,7.5,18,-4292,-4.8,26.4,0,620,620,4430
1996,28,h) 11 to 15,5740,6295,78230,79366,215,3.3,502,7.8,10126,1780,8346,2.2,12.8,12398,4386,8012,5.5,15.6,-2272,-2.8,25.6,0,347,347,1496
1996,28,i) 16 to 20,3780,4707,72554,70506,151,3.1,370,7.7,12997,3526,9471,5,18.4,8901,2638,6263,3.7,12.6,4096,5.8,25.2,0,208,208,1201
1996,28,l) Left Censored,8864,16137,481228,484132,816,5,1011,6.2,51043,16867,34176,3.5,10.5,56851,16385,40466,3.4,11.7,-5808,-1.2,21,0,390,390,2766
1996,29,a) 0,10529,10601,56153,28212,10506,198.2,0,0,55882,55882,0,198.1,198.1,0,0,0,0,0,55882,198.1,0,0,,,
1996,29,b) 1,8374,8475,55502,56943,63,0.6,2425,24.9,15115,1523,13592,2.7,26.5,17996,10617,7379,18.6,31.6,-2881,-5.1,53,0,1988,1988,9274
1996,29,c) 2,7084,7240,55049,56888,244,3.1,1400,17.9,11166,1703,9463,3,19.6,14844,7099,7745,12.5,26.1,-3678,-6.5,39.2,0,1163,1163,5895
1996,29,d) 3,5697,5839,47139,48975,198,3.2,1018,16.3,8598,1398,7200,2.9,17.6,12270,5759,6511,11.8,25.1,-3672,-7.5,35.2,0,820,820,4815
1996,29,e) 4,4867,5079,50202,50355,174,3.2,731,13.6,8998,1898,7100,3.8,17.9,9303,4107,5196,8.2,18.5,-305,-0.6,35.8,0,565,565,3059
1996,29,f) 5,4560,4864,43864,44525,164,3.2,554,10.9,6270,1141,5129,2.6,14.1,7592,2938,4654,6.6,17.1,-1322,-3,28.2,0,446,446,2375
1996,29,g) 6 to 10,18948,20257,223027,227050,635,3,2051,9.8,31374,6070,25304,2.7,13.8,39420,15845,23575,7,17.4,-8046,-3.6,27.6,0,1487,1487,11717
1996,29,h) 11 to 15,13665,15634,212313,214674,495,3.1,1155,7.2,25411,6199,19212,2.9,11.8,30132,7749,22383,3.6,14,-4721,-2.2,23.6,0,764,764,3917
1996,29,i) 16 to 20,8349,10707,165232,164747,347,3.2,784,7.2,22805,7295,15510,4.4,13.8,21835,5886,15949,3.6,13.3,970,0.5,26.6,0,469,469,2692
1996,29,l) Left Censored,21205,38101,1269135,1265639,1675,4.4,2338,6.1,148399,38788,109611,3.1,11.7,141408,39685,101723,3.1,11.2,6991,0.5,22.4,0,866,866,5061
1996,30,a) 0,2593,2600,11903,5970,2585,198.8,0,0,11866,11866,0,198.8,198.8,0,0,0,0,0,11866,198.8,0,0,,,
1996,30,b) 1,1987,2002,11237,11342,12,0.5,544,23.7,2863,549,2314,4.8,25.2,3072,1670,1402,14.7,27.1,-209,-1.9,50.4,0,423,423,1439
1996,30,c) 2,1530,1548,9463,9617,56,3.3,299,17.8,1916,298,1618,3.1,19.9,2223,1105,1118,11.5,23.1,-307,-3.2,39.8,0,227,228,926
1996,30,d) 3,1269,1286,7614,7942,39,2.8,201,14.6,1298,131,1167,1.6,16.3,1954,1012,942,12.7,24.6,-656,-8.3,32.6,0,154,154,836
1996,30,e) 4,1151,1178,7738,12834,36,2.9,134,10.9,1150,147,1003,1.1,9,11342,514,10828,4,88.4,-10192,-79.4,18,0,103,103,427
1996,30,f) 5,962,1003,7764,7923,31,2.9,129,12.2,1113,227,886,2.9,14,1431,597,834,7.5,18.1,-318,-4.1,28,0,96,96,460
1996,30,g) 6 to 10,3775,3963,35271,35732,133,3.2,419,10.2,4425,762,3663,2.1,12.4,5346,2157,3189,6,15,-921,-2.6,24.8,0,287,287,1473
1996,30,h) 11 to 15,2877,3160,28967,29469,92,2.8,267,8.2,3490,366,3124,1.2,11.8,4493,1591,2902,5.4,15.2,-1003,-3.4,23.6,0,166,166,971
1996,30,i) 16 to 20,2079,2516,29088,29030,78,3,166,6.5,3408,456,2952,1.6,11.7,3292,910,2382,3.1,11.3,116,0.4,22.6,0,113,113,559
1996,30,l) Left Censored,3879,6149,112734,114265,235,3.7,534,8.5,10812,2536,8276,2.2,9.5,13873,4718,9155,4.1,12.1,-3061,-2.6,19,0,181,181,1184
1996,31,a) 0,3103,3113,17808,8952,3073,197.4,0,0,17713,17713,0,197.9,197.9,0,0,0,0,0,17713,197.9,0,0,,,
1996,31,b) 1,2464,2500,17529,17476,20,0.7,582,20.7,4441,550,3891,3.1,25.4,4334,2471,1863,14.1,24.8,107,0.6,49.6,0,490,490,2080
1996,31,c) 2,2102,2147,15233,16349,65,2.8,379,16.4,2669,396,2273,2.4,16.3,4901,2061,2840,12.6,30,-2232,-13.7,32.6,0,319,319,1809
1996,31,d) 3,1840,1876,15091,15171,57,2.9,234,11.9,2476,339,2137,2.2,16.3,2635,1089,1546,7.2,17.4,-159,-1.1,32.6,0,184,184,875
1996,31,e) 4,1603,1643,12328,12726,49,2.8,232,13.4,1966,532,1434,4.2,15.4,2761,1193,1568,9.4,21.7,-795,-6.3,30.8,0,180,180,924
1996,31,f) 5,1426,1489,11332,12191,43,2.8,167,10.7,1938,245,1693,2,15.9,3655,771,2884,6.3,30,-1717,-14.1,31.8,0,127,127,609
1996,31,g) 6 to 10,6062,6573,84654,84671,205,3,608,9,10635,1697,8938,2,12.6,10668,3558,7110,4.2,12.6,-33,0,25.2,0,472,472,2390
1996,31,h) 11 to 15,4891,5530,70160,70344,148,2.6,461,8.1,8237,1568,6669,2.2,11.7,8605,3163,5442,4.5,12.2,-368,-0.5,23.4,0,294,294,1815
1996,31,i) 16 to 20,3322,4188,57272,56780,137,3.2,313,7.3,6921,1757,5164,3.1,12.2,5937,1814,4123,3.2,10.5,984,1.7,21,0,200,200,1130
1996,31,l) Left Censored,8611,13633,382668,378981,502,3.6,867,6.3,40923,11028,29895,2.9,10.8,33549,8828,24721,2.3,8.9,7374,1.9,17.8,0,353,353,1986
1996,32,a) 0,4002,4028,35684,17903,3994,198.3,0,0,35563,35563,0,198.6,198.6,0,0,0,0,0,35563,198.6,0,0,,,
1996,32,b) 1,2951,2986,29518,28959,28,0.8,949,27.2,12772,4066,8706,14,44.1,11654,4962,6692,17.1,40.2,1118,3.9,80.4,0,790,790,4214
1996,32,c) 2,2256,2301,26267,26795,82,3.2,553,21.7,6325,573,5752,2.1,23.6,7381,3766,3615,14.1,27.5,-1056,-3.9,47.2,0,447,447,2806
1996,32,d) 3,1710,1741,20348,20640,79,4.2,328,17.5,4336,736,3600,3.6,21,4919,2439,2480,11.8,23.8,-583,-2.8,42,0,278,278,2074
1996,32,e) 4,1416,1466,17826,17471,65,4.2,233,15,4222,524,3698,3,24.2,3511,1196,2315,6.8,20.1,711,4.1,40.2,0,188,188,995
1996,32,f) 5,1363,1422,17875,17757,66,4.5,193,13,3604,493,3111,2.8,20.3,3368,1649,1719,9.3,19,236,1.3,38,0,144,144,1381
1996,32,g) 6 to 10,5123,5550,81447,82169,279,4.9,602,10.5,14407,3755,10652,4.6,17.5,15851,7562,8289,9.2,19.3,-1444,-1.8,35,0,407,407,4884
1996,32,h) 11 to 15,3118,3724,66537,66134,145,3.8,339,8.9,10364,2527,7837,3.8,15.7,9558,3021,6537,4.6,14.5,806,1.2,29,0,196,196,1621
1996,32,i) 16 to 20,2129,2793,81003,80350,141,5,238,8.4,10760,3640,7120,4.5,13.4,9453,2927,6526,3.6,11.8,1307,1.6,23.6,0,125,125,1743
1996,32,l) Left Censored,3868,7284,327280,324779,687,9.5,635,8.8,43010,14065,28945,4.3,13.2,38007,14024,23983,4.3,11.7,5003,1.5,23.4,0,148,148,1093
1996,33,a) 0,2772,2790,14867,7470,2773,198.8,0,0,14794,14794,0,198,198,0,0,0,0,0,14794,198,0,0,,,
1996,33,b) 1,2124,2135,14386,14431,12,0.5,523,21.7,3862,178,3684,1.2,26.8,3951,2218,1733,15.4,27.4,-89,-0.6,53.6,0,428,428,1952
1996,33,c) 2,1746,1763,12314,12405,52,2.7,319,16.8,2590,229,2361,1.8,20.9,2771,1405,1366,11.3,22.3,-181,-1.4,41.8,0,252,252,1211
1996,33,d) 3,1416,1436,11449,11253,46,3,196,13,2567,216,2351,1.9,22.8,2174,916,1258,8.1,19.3,393,3.5,38.6,0,155,155,794
1996,33,e) 4,1200,1253,10767,10653,53,4,194,14.6,2148,419,1729,3.9,20.2,1919,856,1063,8,18,229,2.2,36,0,132,132,624
1996,33,f) 5,1126,1173,10089,10128,56,4.6,131,10.8,1710,379,1331,3.7,16.9,1788,649,1139,6.4,17.7,-78,-0.8,33.8,0,106,106,484
1996,33,g) 6 to 10,5686,5976,67027,66409,241,3.9,548,8.9,9572,1316,8256,2,14.4,8336,2957,5379,4.5,12.6,1236,1.8,25.2,0,393,394,2110
1996,33,h) 11 to 15,3507,3810,48758,48741,130,3.3,304,7.8,6162,914,5248,1.9,12.6,6127,1636,4491,3.4,12.6,35,0,25.2,0,201,201,1156
1996,33,i) 16 to 20,2021,2578,38549,38606,99,3.8,188,7.2,4633,1012,3621,2.6,12,4746,2132,2614,5.5,12.3,-113,-0.3,24,0,93,93,1067
1996,33,l) Left Censored,4882,8233,250238,249205,434,5.2,580,7,27231,6869,20362,2.8,10.9,25164,7395,17769,3,10.1,2067,0.8,20.2,0,179,179,1463
1996,34,a) 0,16940,17012,86832,43637,16877,198.4,0,0,86390,86390,0,198,198,0,0,0,0,0,86390,198,0,0,,,
1996,34,b) 1,13290,13601,88389,88698,139,0.9,3455,22.4,25327,1831,23496,2.1,28.6,25945,14290,11655,16.1,29.3,-618,-0.7,57.2,0,2667,2667,11490
1996,34,c) 2,10355,10442,74923,76905,294,2.6,1947,17.2,15816,1316,14500,1.7,20.6,19780,9946,9834,12.9,25.7,-3964,-5.1,41.2,0,1531,1531,8102
1996,34,d) 3,9149,9220,71197,73443,302,3.1,1390,14.2,12396,1712,10684,2.3,16.9,16888,7174,9714,9.8,23,-4492,-6.1,33.8,0,1110,1110,5900
1996,34,e) 4,7760,7930,63835,65057,264,3.2,1080,13,10509,1381,9128,2.1,16.2,12953,5594,7359,8.6,19.9,-2444,-3.7,32.4,0,838,838,4521
1996,34,f) 5,7260,7449,60208,60683,277,3.6,942,12.1,10239,1768,8471,2.9,16.9,11189,4533,6656,7.5,18.4,-950,-1.5,33.8,0,730,730,3466
1996,34,g) 6 to 10,32847,34284,366023,372121,1129,3.2,3568,10,48043,8855,39188,2.4,12.9,60238,20587,39651,5.5,16.2,-12195,-3.3,25.8,0,2655,2656,15476
1996,34,h) 11 to 15,21872,23704,309113,314739,687,2.8,1909,7.9,37519,6615,30904,2.1,11.9,48771,15737,33034,5,15.5,-11252,-3.6,23.8,0,1333,1333,6719
1996,34,i) 16 to 20,13596,15613,241478,242973,464,2.9,1133,7.1,29328,5796,23532,2.4,12.1,32318,8584,23734,3.5,13.3,-2990,-1.2,24.2,0,752,752,3832
1996,34,l) Left Censored,34478,55743,1801930,1814217,2332,4.1,4422,7.8,219405,67651,151754,3.7,12.1,243980,76668,167312,4.2,13.4,-24575,-1.3,24.2,0,1684,1684,11875
1996,35,a) 0,3448,3471,19671,9909,3439,198.2,0,0,19525,19525,0,197,197,0,0,0,0,0,19525,197,0,0,,,
1996,35,b) 1,2651,2686,18717,19399,25,0.8,769,24.8,4736,477,4259,2.5,24.4,6100,3533,2567,18.2,31.4,-1364,-7,48.8,0,624,624,3120
1996,35,c) 2,2211,2258,17631,18132,75,3.1,436,17.8,3604,338,3266,1.9,19.9,4606,2325,2281,12.8,25.4,-1002,-5.5,39.8,0,350,350,1883
1996,35,d) 3,1751,1781,14618,14658,68,3.6,296,15.6,3173,473,2700,3.2,21.6,3252,1213,2039,8.3,22.2,-79,-0.6,43.2,0,243,243,1055
1996,35,e) 4,1479,1554,14308,14631,59,3.6,217,13.3,2617,798,1819,5.5,17.9,3263,1471,1792,10.1,22.3,-646,-4.4,35.8,0,170,170,1029
1996,35,f) 5,1466,1585,13525,14395,64,3.9,206,12.4,2103,437,1666,3,14.6,3843,2124,1719,14.8,26.7,-1740,-12.1,29.2,0,154,154,1866
1996,35,g) 6 to 10,5545,5900,67478,68650,228,3.7,600,9.9,9310,1971,7339,2.9,13.6,11653,3718,7935,5.4,17,-2343,-3.4,27.2,0,440,440,2543
1996,35,h) 11 to 15,4080,4629,53669,54471,175,3.7,389,8.2,7464,2064,5400,3.8,13.7,9068,3607,5461,6.6,16.6,-1604,-2.9,27.4,0,265,265,2331
1996,35,i) 16 to 20,2768,3542,47570,48237,182,5.1,285,7.9,6244,1787,4457,3.7,12.9,7578,2137,5441,4.4,15.7,-1334,-2.8,25.8,0,156,158,959
1996,35,l) Left Censored,5186,9212,238035,236083,519,5.6,609,6.6,30097,7132,22965,3,12.7,26193,7249,18944,3.1,11.1,3904,1.6,22.2,0,203,203,1219
1996,36,a) 0,36028,36146,191168,95947,35875,198.5,0,0,190442,190442,0,198.5,198.5,0,0,0,0,0,190442,198.5,0,0,,,
1996,36,b) 1,27729,28590,187022,186279,328,1,7277,22.5,53659,5654,48005,3,28.8,52173,27717,24456,14.9,28,1486,0.8,56,0,5692,5692,23196
1996,36,c) 2,22417,22568,167611,174238,698,2.8,4476,18.3,35063,3740,31323,2.1,20.1,48317,25786,22531,14.8,27.7,-13254,-7.6,40.2,0,3712,3713,22329
1996,36,d) 3,19193,19427,150426,155594,676,3.2,3381,16.3,27299,3925,23374,2.5,17.5,37635,20519,17116,13.2,24.2,-10336,-6.7,35,0,2820,2820,17914
1996,36,e) 4,16548,16972,144231,146161,557,3.1,2574,14.3,26321,4231,22090,2.9,18,30181,13743,16438,9.4,20.6,-3860,-2.6,36,0,2073,2074,11159
1996,36,f) 5,15682,16152,130413,135623,593,3.5,2164,12.8,22010,3722,18288,2.7,16.2,32430,12431,19999,9.2,23.9,-10420,-7.7,32.4,0,1732,1732,9941
1996,36,g) 6 to 10,67875,70575,754259,767921,2132,2.9,7843,10.7,94653,17195,77458,2.2,12.3,121976,49187,72789,6.4,15.9,-27323,-3.6,24.6,0,5947,5947,33684
1996,36,h) 11 to 15,45948,50121,623104,631570,1437,2.8,4330,8.4,73682,13340,60342,2.1,11.7,90614,27670,62944,4.4,14.3,-16932,-2.6,23.4,0,3076,3077,18049
1996,36,i) 16 to 20,26818,32784,519635,526400,1004,3,2619,7.8,59136,13105,46031,2.5,11.2,72666,21955,50711,4.2,13.8,-13530,-2.6,22.4,0,1643,1643,10012
1996,36,l) Left Censored,75047,119189,3820767,3855761,4546,3.7,9246,7.6,404014,118145,285869,3.1,10.5,474003,132500,341503,3.4,12.3,-69989,-1.8,21,0,3965,3965,29214
1996,37,a) 0,14642,14812,87208,43787,14698,198.5,0,0,86843,86843,0,198.3,198.3,0,0,0,0,0,86843,198.3,0,0,,,
1996,37,b) 1,11202,11342,76018,75649,93,0.7,2963,22.9,21554,2451,19103,3.2,28.5,20815,11276,9539,14.9,27.5,739,1,55,0,2368,2368,9384
1996,37,c) 2,9017,9181,72709,76615,295,3,1715,17.3,14289,1629,12660,2.1,18.7,22100,11645,10455,15.2,28.8,-7811,-10.1,37.4,0,1394,1394,10085
1996,37,d) 3,7246,7378,62767,62102,257,3.3,1129,14.4,14550,2211,12339,3.6,23.4,13219,5764,7455,9.3,21.3,1331,2.1,42.6,0,912,912,4841
1996,37,e) 4,6293,6584,65139,66363,221,3.2,845,12.2,10681,1512,9169,2.3,16.1,13129,5352,7777,8.1,19.8,-2448,-3.7,32.2,0,661,661,4508
1996,37,f) 5,5944,6264,59616,59922,233,3.6,713,11,10972,1858,9114,3.1,18.3,11583,4417,7166,7.4,19.3,-611,-1,36.6,0,551,551,2963
1996,37,g) 6 to 10,25115,27238,324027,324836,975,3.5,2594,9.2,45581,9848,35733,3,14,47199,16570,30629,5.1,14.5,-1618,-0.5,28,0,1841,1841,11181
1996,37,h) 11 to 15,18510,21028,278890,281552,674,3.1,1519,7.1,34574,7583,26991,2.7,12.3,39898,15151,24747,5.4,14.2,-5324,-1.9,24.6,0,944,944,7962
1996,37,i) 16 to 20,10189,13263,211101,213851,490,3.6,935,6.9,25269,6455,18814,3,11.8,30769,8816,21953,4.1,14.4,-5500,-2.6,23.6,0,535,535,3870
1996,37,l) Left Censored,24278,49164,1763465,1769638,2451,4.9,3175,6.4,188512,52176,136336,2.9,10.7,200858,55507,145351,3.1,11.4,-12346,-0.7,21.4,0,942,942,7299
1996,38,a) 0,1280,1288,9026,4537,1271,197.4,0,0,8979,8979,0,197.9,197.9,0,0,0,0,0,8979,197.9,0,0,,,
1996,38,b) 1,1002,1002,6564,6695,4,0.4,259,22.7,1496,26,1470,0.4,22.3,1757,799,958,11.9,26.2,-261,-3.9,44.6,0,196,196,666
1996,38,c) 2,962,970,5859,6101,24,2.3,132,12.9,909,63,846,1,14.9,1393,498,895,8.2,22.8,-484,-7.9,29.8,0,107,107,431
1996,38,d) 3,794,798,5817,5914,16,1.9,94,11.2,989,82,907,1.4,16.7,1183,491,692,8.3,20,-194,-3.3,33.4,0,74,74,449
1996,38,e) 4,683,692,5056,5179,20,2.8,77,10.7,626,112,514,2.2,12.1,871,304,567,5.9,16.8,-245,-4.7,24.2,0,62,62,281
1996,38,f) 5,614,637,5669,5521,20,3,73,11,1261,521,740,9.4,22.8,964,448,516,8.1,17.5,297,5.3,35,0,52,52,312
1996,38,g) 6 to 10,2642,2790,26287,26154,71,2.5,231,8,3849,477,3372,1.8,14.7,3582,1101,2481,4.2,13.7,267,1,27.4,0,176,176,938
1996,38,h) 11 to 15,2167,2436,23805,24548,59,2.4,180,7.2,2216,322,1894,1.3,9,3702,1076,2626,4.4,15.1,-1486,-6.1,18,0,128,128,726
1996,38,i) 16 to 20,1526,1795,19917,20163,51,2.8,114,6.2,2117,395,1722,2,10.5,2608,619,1989,3.1,12.9,-491,-2.4,21,0,62,62,267
1996,38,l) Left Censored,3813,5833,124362,125182,206,3.5,359,6.1,12330,2892,9438,2.3,9.8,13969,4281,9688,3.4,11.2,-1639,-1.4,19.6,0,143,143,858
1996,39,a) 0,16843,17006,105116,52882,16859,198.3,0,0,104469,104469,0,197.6,197.6,0,0,0,0,0,104469,197.6,0,0,,,
1996,39,b) 1,13785,13972,100515,98625,107,0.7,3369,21.4,29719,3480,26239,3.5,30.1,25939,13373,12566,13.6,26.3,3780,3.8,52.6,0,2711,2711,11665
1996,39,c) 2,11381,11687,96623,98290,356,2.8,2095,16.6,21650,3256,18394,3.3,22,24983,11685,13298,11.9,25.4,-3333,-3.4,44,0,1719,1719,10129
1996,39,d) 3,9732,9954,90570,93402,292,2.8,1495,14.1,16515,2752,13763,2.9,17.7,22178,9530,12648,10.2,23.7,-5663,-6,35.4,0,1229,1229,7759
1996,39,e) 4,8373,8707,79713,81074,222,2.4,1179,12.8,13356,1645,11711,2,16.5,16078,6625,9453,8.2,19.8,-2722,-3.3,33,0,935,935,5643
1996,39,f) 5,8030,8470,84824,84927,247,2.8,1006,11.4,14505,2051,12454,2.4,17.1,14711,5764,8947,6.8,17.3,-206,-0.2,34.2,0,775,776,4014
1996,39,g) 6 to 10,34532,37683,461712,467227,1150,3,3518,9.1,61968,12014,49954,2.6,13.3,72997,23876,49121,5.1,15.6,-11029,-2.3,26.6,0,2521,2521,16501
1996,39,h) 11 to 15,24316,28211,412376,416547,789,2.7,2038,7.1,46222,9070,37152,2.2,11.1,54564,17742,36822,4.3,13.1,-8342,-2,22.2,0,1279,1279,9252
1996,39,i) 16 to 20,16375,21237,355955,354900,606,2.8,1415,6.5,44722,13685,31037,3.9,12.6,42611,12375,30236,3.5,12,2111,0.6,24,0,783,785,5547
1996,39,l) Left Censored,43968,82638,2786566,2786690,3723,4.5,5452,6.5,314847,90501,224346,3.2,11.3,315095,87332,227763,3.1,11.3,-248,0,22.6,0,1728,1728,12957
1996,40,a) 0,6338,6387,35287,17736,6327,198.1,0,0,35102,35102,0,197.9,197.9,0,0,0,0,0,35102,197.9,0,0,,,
1996,40,b) 1,4798,4858,33811,34144,33,0.6,1460,25.9,9532,928,8604,2.7,27.9,10197,5613,4584,16.4,29.9,-665,-2,55.8,0,1213,1214,4998
1996,40,c) 2,4033,4085,29230,30594,126,2.8,908,20.2,6400,654,5746,2.1,20.9,9128,5332,3796,17.4,29.8,-2728,-8.9,41.8,0,759,759,4774
1996,40,d) 3,3397,3449,27027,27533,126,3.4,591,16,5381,978,4403,3.6,19.5,6392,3054,3338,11.1,23.2,-1011,-3.7,39,0,499,499,2675
1996,40,e) 4,2978,3064,26069,26206,93,2.9,434,13.4,4619,868,3751,3.3,17.6,4893,2233,2660,8.5,18.7,-274,-1.1,35.2,0,357,357,1770
1996,40,f) 5,2732,2836,23563,24186,90,3,358,12.1,3581,592,2989,2.4,14.8,4827,2365,2462,9.8,20,-1246,-5.2,29.6,0,280,280,1968
1996,40,g) 6 to 10,10459,11175,134228,134228,384,3.3,1139,9.9,22040,5897,16143,4.4,16.4,22039,8331,13708,6.2,16.4,1,0,32.8,0,846,846,5254
1996,40,h) 11 to 15,9139,10197,118487,118643,323,3.1,766,7.3,15600,3070,12530,2.6,13.1,15911,4714,11197,4,13.4,-311,-0.3,26.2,0,534,535,2812
1996,40,i) 16 to 20,5379,6775,95310,94399,252,3.6,525,7.6,13636,4942,8694,5.2,14.4,11814,4107,7707,4.4,12.5,1822,1.9,25,0,297,297,1558
1996,40,l) Left Censored,11408,20738,536627,534254,966,4.6,1375,6.6,60628,20140,40488,3.8,11.3,55881,16429,39452,3.1,10.5,4747,0.8,21,0,502,503,2851
1996,41,a) 0,8164,8237,47276,23740,8167,198.3,0,0,47072,47072,0,198.3,198.3,0,0,0,0,0,47072,198.3,0,0,,,
1996,41,b) 1,6405,6460,39160,39380,36,0.5,1758,23.7,10361,598,9763,1.5,26.3,10801,5886,4915,14.9,27.4,-440,-1.1,52.6,0,1359,1359,4419
1996,41,c) 2,5304,5416,35005,36100,209,3.6,1040,17.8,7828,1098,6730,3,21.7,10018,5246,4772,14.5,27.8,-2190,-6.1,43.4,0,843,843,4605
1996,41,d) 3,4116,4182,31298,31039,153,3.4,655,14.7,7432,609,6823,2,23.9,6913,3133,3780,10.1,22.3,519,1.6,44.6,0,519,520,2465
1996,41,e) 4,3606,3759,33547,33976,142,3.6,530,13.4,5521,696,4825,2,16.2,6379,3025,3354,8.9,18.8,-858,-2.6,32.4,0,397,398,2340
1996,41,f) 5,3329,3453,28579,28626,113,3.1,431,11.9,5498,787,4711,2.7,19.2,5591,2582,3009,9,19.5,-93,-0.3,38.4,0,329,329,1765
1996,41,g) 6 to 10,13075,13849,146388,148507,529,3.7,1535,10.7,21727,2874,18853,1.9,14.6,25965,10772,15193,7.3,17.5,-4238,-2.9,29.2,0,1103,1103,7891
1996,41,h) 11 to 15,8758,9972,145393,144970,380,3.7,813,8,20294,5200,15094,3.6,14,19448,5584,13864,3.9,13.4,846,0.6,26.8,0,540,540,3416
1996,41,i) 16 to 20,5998,7476,109974,109810,267,3.5,548,7.2,14370,3695,10675,3.4,13.1,14041,4198,9843,3.8,12.8,329,0.3,25.6,0,316,316,1944
1996,41,l) Left Censored,11394,20821,601879,594792,1243,6,1367,6.5,74564,16054,58510,2.7,12.5,60390,15957,44433,2.7,10.2,14174,2.3,20.4,0,478,478,3655
1996,42,a) 0,17259,17391,108486,54759,17223,198.1,0,0,107455,107455,0,196.2,196.2,0,0,0,0,0,107455,196.2,0,0,,,
1996,42,b) 1,14227,14480,106054,107017,116,0.7,3309,20.4,28015,2709,25306,2.5,26.2,29942,17165,12777,16,28,-1927,-1.8,52.4,0,2622,2622,14526
1996,42,c) 2,11250,11471,101322,106088,303,2.5,1935,15.7,16949,2152,14797,2,16,26481,14944,11537,14.1,25,-9532,-9,32,0,1598,1598,13653
1996,42,d) 3,10052,10218,84382,86738,276,2.6,1430,13.2,16340,2457,13883,2.8,18.8,21052,10242,10810,11.8,24.3,-4712,-5.5,37.6,0,1159,1159,8725
1996,42,e) 4,9387,9808,84442,86212,271,2.6,1238,12,13540,2269,11271,2.6,15.7,17080,6623,10457,7.7,19.8,-3540,-4.1,31.4,0,967,967,5234
1996,42,f) 5,9198,9675,85642,86760,284,2.8,1039,10.3,12890,2021,10869,2.3,14.9,15125,5496,9629,6.3,17.4,-2235,-2.5,29.8,0,845,845,4473
1996,42,g) 6 to 10,41560,44180,473442,481576,1240,2.7,4326,9.5,58940,10374,48566,2.2,12.2,75208,28709,46499,6,15.6,-16268,-3.4,24.4,0,3212,3212,20769
1996,42,h) 11 to 15,28270,31757,443565,444540,889,2.7,2264,7,53353,16648,36705,3.7,12,55303,18380,36923,4.1,12.4,-1950,-0.4,24,0,1516,1516,10463
1996,42,i) 16 to 20,17759,22319,359376,359399,629,2.8,1523,6.7,37841,7771,30070,2.2,10.5,37887,11021,26866,3.1,10.5,-46,0,21,0,949,951,5937
1996,42,l) Left Censored,48905,87502,2839065,2853833,3705,4.2,5861,6.6,288064,79900,208164,2.8,10.1,317600,92927,224673,3.3,11.1,-29536,-1,20.2,0,2237,2237,14513
1996,44,a) 0,1998,2002,10158,5119,1993,199.1,0,0,10079,10079,0,196.9,196.9,0,0,0,0,0,10079,196.9,0,0,,,
1996,44,b) 1,1424,1436,8020,7928,7,0.4,382,23.3,2298,40,2258,0.5,29,2114,1314,800,16.6,26.7,184,2.3,53.4,0,300,300,1068
1996,44,c) 2,1308,1316,13642,13641,36,2.5,249,17.5,2517,108,2409,0.8,18.5,2514,1334,1180,9.8,18.4,3,0.1,36.8,0,205,205,1193
1996,44,d) 3,1101,1107,7266,7628,35,3,177,15,1133,147,986,1.9,14.9,1856,1005,851,13.2,24.3,-723,-9.4,29.8,0,146,146,907
1996,44,e) 4,946,960,7638,7927,29,2.9,124,12.3,1124,146,978,1.8,14.2,1701,625,1076,7.9,21.5,-577,-7.3,28.4,0,102,102,504
1996,44,f) 5,843,861,7518,7651,29,3.2,111,12.3,1143,257,886,3.4,14.9,1409,521,888,6.8,18.4,-266,-3.5,29.8,0,83,83,420
1996,44,g) 6 to 10,4286,4471,42513,43093,149,3.2,465,10,5215,593,4622,1.4,12.1,6374,2250,4124,5.2,14.8,-1159,-2.7,24.2,0,353,353,1560
1996,44,h) 11 to 15,2707,2876,34015,35394,71,2.4,242,8.2,4533,1361,3172,3.8,12.8,7290,2860,4430,8.1,20.6,-2757,-7.8,25.6,0,172,172,1902
1996,44,i) 16 to 20,1775,2013,28397,28394,41,2,155,7.5,3118,718,2400,2.5,11,3112,1016,2096,3.6,11,6,0,22,0,82,82,590
1996,44,l) Left Censored,5346,7423,219070,220983,296,3.9,523,6.9,19756,5613,14143,2.5,8.9,23582,7538,16044,3.4,10.7,-3826,-1.8,17.8,0,219,221,1501
1996,45,a) 0,7294,7343,41264,20702,7294,198.7,0,0,41124,41124,0,198.6,198.6,0,0,0,0,0,41124,198.6,0,0,,,
1996,45,b) 1,5478,5552,43532,42942,66,1,1639,25.6,13437,1726,11711,4,31.3,12256,6892,5364,16,28.5,1181,2.8,57,0,1327,1327,5922
1996,45,c) 2,4344,4442,39392,41273,191,4,876,18.2,7944,1615,6329,3.9,19.2,11705,5725,5980,13.9,28.4,-3761,-9.2,38.4,0,717,717,5110
1996,45,d) 3,3586,3693,31504,31550,171,4.4,626,15.9,6588,1276,5312,4,20.9,6679,3121,3558,9.9,21.2,-91,-0.3,41.8,0,519,519,2804
1996,45,e) 4,3141,3263,35361,35264,165,4.8,476,13.9,7310,3150,4160,8.9,20.7,7116,2572,4544,7.3,20.2,194,0.5,40.4,0,373,373,2068
1996,45,f) 5,2978,3191,28388,28348,132,4,364,11,5135,1341,3794,4.7,18.1,5054,1934,3120,6.8,17.8,81,0.3,35.6,0,293,293,1676
1996,45,g) 6 to 10,11976,13130,159683,160488,446,3.3,1376,10.1,23113,4932,18181,3.1,14.4,24722,9062,15660,5.6,15.4,-1609,-1,28.8,0,970,970,6509
1996,45,h) 11 to 15,8683,9885,119472,120499,335,3.3,752,7.4,15628,3755,11873,3.1,13,17681,5634,12047,4.7,14.7,-2053,-1.7,26,0,494,494,3429
1996,45,i) 16 to 20,4953,6437,98188,97043,300,4.6,437,6.7,14212,4546,9666,4.7,14.6,11922,3208,8714,3.3,12.3,2290,2.3,24.6,0,247,247,1265
1996,45,l) Left Censored,11681,23214,801334,805743,1117,4.8,1502,6.4,81406,23715,57691,2.9,10.1,90225,24404,65821,3,11.2,-8819,-1.1,20.2,0,491,491,3754
1996,46,a) 0,1700,1715,8936,4494,1696,197.8,0,0,8884,8884,0,197.7,197.7,0,0,0,0,0,8884,197.7,0,0,,,
1996,46,b) 1,1251,1267,8035,8007,8,0.6,340,23.5,2158,157,2001,2,27,2102,1056,1046,13.2,26.3,56,0.7,52.6,0,272,272,922
1996,46,c) 2,1154,1171,8033,8393,22,1.7,215,16.9,1170,97,1073,1.2,13.9,1890,870,1020,10.4,22.5,-720,-8.6,27.8,0,168,168,749
1996,46,d) 3,923,936,6694,6839,26,2.6,131,13.2,1000,125,875,1.8,14.6,1290,677,613,9.9,18.9,-290,-4.3,29.2,0,95,95,586
1996,46,e) 4,817,850,6163,6252,15,1.7,114,12.7,927,280,647,4.5,14.8,1105,370,735,5.9,17.7,-178,-2.9,29.6,0,85,85,301
1996,46,f) 5,753,772,5989,6441,26,3.2,95,11.8,657,84,573,1.3,10.2,1560,720,840,11.2,24.2,-903,-14,20.4,0,78,78,606
1996,46,g) 6 to 10,3010,3146,37626,37829,102,3.2,296,9.1,5273,2067,3206,5.5,13.9,5678,1834,3844,4.8,15,-405,-1.1,27.8,0,228,228,1269
1996,46,h) 11 to 15,2293,2574,23090,23832,65,2.5,190,7.2,2270,288,1982,1.2,9.5,3754,1255,2499,5.3,15.8,-1484,-6.3,19,0,121,121,665
1996,46,i) 16 to 20,1552,1848,23373,23854,53,2.8,121,6.4,2265,472,1793,2,9.5,3227,1051,2176,4.4,13.5,-962,-4,19,0,79,79,313
1996,46,l) Left Censored,4040,6039,140780,140844,221,3.6,390,6.4,13130,2984,10146,2.1,9.3,13258,4498,8760,3.2,9.4,-128,-0.1,18.6,0,164,164,942
1996,47,a) 0,9939,10009,64376,32399,9925,198.3,0,0,63954,63954,0,197.4,197.4,0,0,0,0,0,63954,197.4,0,0,,,
1996,47,b) 1,7352,7481,59285,60480,80,0.9,2286,26.3,17307,1480,15827,2.4,28.6,19697,10950,8747,18.1,32.6,-2390,-4,57.2,0,1919,1919,9394
1996,47,c) 2,5999,6108,52171,55468,190,2.8,1279,19.2,11138,2617,8521,4.7,20.1,17731,9835,7896,17.7,32,-6593,-11.9,40.2,0,1052,1052,7754
1996,47,d) 3,5185,5323,46714,57839,186,3.3,864,15.3,9182,1583,7599,2.7,15.9,31432,24821,6611,42.9,54.3,-22250,-38.4,31.8,0,706,706,24041
1996,47,e) 4,4376,4565,44828,46788,160,3.3,647,13.5,7637,1331,6306,2.8,16.3,11556,4955,6601,10.6,24.7,-3919,-8.4,32.6,0,510,510,3940
1996,47,f) 5,3958,4206,45878,47022,140,3.2,528,12,7601,1800,5801,3.8,16.2,9889,5319,4570,11.3,21,-2288,-4.8,32.4,0,417,417,4040
1996,47,g) 6 to 10,16724,18282,234451,237061,715,3.8,1759,9.4,33509,9804,23705,4.1,14.1,38729,12984,25745,5.5,16.3,-5220,-2.2,28.2,0,1326,1327,9053
1996,47,h) 11 to 15,12131,13745,183066,184742,442,3.1,1062,7.6,23003,5863,17140,3.2,12.5,26354,9167,17187,5,14.3,-3351,-1.8,25,0,647,647,5116
1996,47,i) 16 to 20,7337,10057,193548,191328,439,4.3,713,7,28119,8910,19209,4.7,14.7,23679,6538,17141,3.4,12.4,4440,2.3,24.8,0,361,361,2303
1996,47,l) Left Censored,17475,34613,1224215,1230294,1847,5.3,2221,6.4,127477,35424,92053,2.9,10.4,139634,38231,101403,3.1,11.3,-12157,-0.9,20.8,0,738,741,4314
1996,48,a) 0,37659,38104,249519,125416,37798,198.4,0,0,248206,248206,0,197.9,197.9,0,0,0,0,0,248206,197.9,0,0,,,
1996,48,b) 1,27974,28521,240945,241298,234,0.7,8293,25.2,74858,6009,68849,2.5,31,75564,43601,31963,18.1,31.3,-706,-0.3,62,0,6919,6919,36040
1996,48,c) 2,23037,23779,217688,222832,830,3.2,5009,19.3,49708,6198,43510,2.8,22.3,59996,31044,28952,13.9,26.9,-10288,-4.6,44.6,0,4128,4128,26075
1996,48,d) 3,19251,19798,188027,193947,736,3.5,3373,15.9,39504,6413,33091,3.3,20.4,51344,26913,24431,13.9,26.5,-11840,-6.1,40.8,0,2785,2785,23100
1996,48,e) 4,16931,17794,188168,192772,653,3.5,2555,13.6,33706,6905,26801,3.6,17.5,42914,18636,24278,9.7,22.3,-9208,-4.8,35,0,2032,2032,14516
1996,48,f) 5,15492,16483,178488,183128,606,3.5,2156,12.5,30259,5007,25252,2.7,16.5,39539,15240,24299,8.3,21.6,-9280,-5.1,33,0,1665,1665,11976
1996,48,g) 6 to 10,56080,61807,777326,789138,2249,3.5,7036,11,119479,27279,92200,3.5,15.1,143102,51490,91612,6.5,18.1,-23623,-3,30.2,0,4934,4934,33124
1996,48,h) 11 to 15,47231,54693,774918,769783,1850,3.3,4307,7.7,123811,30441,93370,4,16.1,113542,34815,78727,4.5,14.7,10269,1.4,29.4,0,2755,2755,19620
1996,48,i) 16 to 20,21980,29858,474931,472118,1125,3.7,2361,7.7,72262,19220,53042,4.1,15.3,66638,23527,43111,5,14.1,5624,1.2,28.2,0,1224,1225,7699
1996,48,l) Left Censored,45224,106439,3531732,3523454,6194,5.8,8256,7.7,459514,144895,314619,4.1,13,442959,132778,310181,3.8,12.6,16555,0.4,25.2,0,2226,2228,14580
1996,49,a) 0,4886,4934,30625,15364,4889,198.2,0,0,30522,30522,0,198.7,198.7,0,0,0,0,0,30522,198.7,0,0,,,
1996,49,b) 1,3432,3479,34872,33506,22,0.5,1002,25,10767,422,10345,1.3,32.1,8034,4897,3137,14.6,24,2733,8.1,48,0,804,804,4093
1996,49,c) 2,2772,2866,26144,26739,120,3.9,580,18.6,6092,1075,5017,4,22.8,7281,4299,2982,16.1,27.2,-1189,-4.4,45.6,0,451,451,3478
1996,49,d) 3,2107,2153,20798,21113,72,3.1,382,16.5,4059,285,3774,1.3,19.2,4688,1987,2701,9.4,22.2,-629,-3,38.4,0,303,303,1735
1996,49,e) 4,1797,1853,18687,19252,84,4.3,287,14.6,3747,1055,2692,5.5,19.5,4877,2826,2051,14.7,25.3,-1130,-5.8,39,0,214,214,2205
1996,49,f) 5,1598,1664,19296,19188,65,3.8,192,11.1,3800,733,3067,3.8,19.8,3584,1542,2042,8,18.7,216,1.1,37.4,0,161,161,1082
1996,49,g) 6 to 10,5570,6065,99058,97772,227,3.6,630,10,16816,3667,13149,3.8,17.2,14243,5067,9176,5.2,14.6,2573,2.6,29.2,0,450,450,3393
1996,49,h) 11 to 15,3816,4378,74494,74590,166,3.7,388,8.6,9822,1775,8047,2.4,13.2,10013,2665,7348,3.6,13.4,-191,-0.2,26.4,0,276,277,2048
1996,49,i) 16 to 20,2712,3328,59342,58925,161,4.8,231,6.9,7842,1877,5965,3.2,13.3,7008,1915,5093,3.2,11.9,834,1.4,23.8,0,128,128,823
1996,49,l) Left Censored,5485,10373,387258,384631,570,5.5,663,6.4,46760,16640,30120,4.3,12.2,41505,9895,31610,2.6,10.8,5255,1.4,21.6,0,211,211,1162
1996,50,a) 0,1435,1439,7075,3550,1423,197.8,0,0,7051,7051,0,198.6,198.6,0,0,0,0,0,7051,198.6,0,0,,,
1996,50,b) 1,1141,1147,6365,6582,7,0.5,269,20.8,1587,230,1357,3.5,24.1,2020,1003,1017,15.2,30.7,-433,-6.6,48.2,0,210,210,885
1996,50,c) 2,998,1014,5986,6139,29,2.6,184,16.8,1071,103,968,1.7,17.4,1377,745,632,12.1,22.4,-306,-5,34.8,0,146,146,553
1996,50,d) 3,883,890,4855,5196,25,2.6,154,16.1,852,76,776,1.5,16.4,1533,975,558,18.8,29.5,-681,-13.1,32.8,0,130,130,888
1996,50,e) 4,739,757,5303,5505,24,3,93,11.7,761,88,673,1.6,13.8,1165,464,701,8.4,21.2,-404,-7.4,27.6,0,80,80,440
1996,50,f) 5,718,733,5008,5094,28,3.6,96,12.5,869,167,702,3.3,17.1,1040,550,490,10.8,20.4,-171,-3.3,34.2,0,68,68,463
1996,50,g) 6 to 10,3528,3652,29569,30147,96,2.5,399,10.5,3671,687,2984,2.3,12.2,4826,1882,2944,6.2,16,-1155,-3.8,24.4,0,315,315,1606
1996,50,h) 11 to 15,2295,2510,25447,25415,74,2.9,151,5.9,2622,323,2299,1.3,10.3,2557,650,1907,2.6,10.1,65,0.2,20.2,0,111,111,459
1996,50,i) 16 to 20,1264,1504,21580,20965,47,3.1,85,5.6,3335,1041,2294,5,15.9,2104,766,1338,3.7,10,1231,5.9,20,0,54,54,286
1996,50,l) Left Censored,3062,4549,111603,113629,202,4.4,260,5.7,10703,2865,7838,2.5,9.4,14754,7848,6906,6.9,13,-4051,-3.6,18.8,0,100,100,1138
1996,51,a) 0,12152,12221,64676,32492,12109,198.2,0,0,64368,64368,0,198.1,198.1,0,0,0,0,0,64368,198.1,0,0,,,
1996,51,b) 1,9721,9864,67526,67412,87,0.8,2675,23.8,19548,1897,17651,2.8,29,19320,10985,8335,16.3,28.7,228,0.3,57.4,0,2113,2113,9351
1996,51,c) 2,7698,7847,62289,63543,261,3.1,1569,18.4,14654,2283,12371,3.6,23.1,17161,8650,8511,13.6,27,-2507,-3.9,46.2,0,1282,1282,6955
1996,51,d) 3,6767,6878,56306,56527,206,2.8,1086,14.8,11685,1524,10161,2.7,20.7,12127,5610,6517,9.9,21.5,-442,-0.8,41.4,0,870,870,4703
1996,51,e) 4,5790,6052,54965,56182,182,2.9,851,13.3,9559,1729,7830,3.1,17,11993,5084,6909,9,21.3,-2434,-4.3,34,0,634,634,3545
1996,51,f) 5,5347,5568,51505,52342,204,3.5,747,12.8,8446,1531,6915,2.9,16.1,10119,3694,6425,7.1,19.3,-1673,-3.2,32.2,0,526,526,2631
1996,51,g) 6 to 10,23102,24832,278126,282979,844,3.3,2688,10.4,40421,7921,32500,2.8,14.3,50127,17248,32879,6.1,17.7,-9706,-3.4,28.6,0,1889,1889,10939
1996,51,h) 11 to 15,15455,17899,259303,259181,583,3.2,1353,7.4,34734,7686,27048,3,13.4,34490,10218,24272,3.9,13.3,244,0.1,26.6,0,811,811,4861
1996,51,i) 16 to 20,8814,11664,185380,185421,410,3.5,852,7.2,23334,6231,17103,3.4,12.6,23415,6799,16616,3.7,12.6,-81,0,25.2,0,417,417,2355
1996,51,l) Left Censored,20792,43894,1383226,1390978,2380,5.4,3025,6.8,159975,50812,109163,3.7,11.5,175479,51377,124102,3.7,12.6,-15504,-1.1,23,0,802,802,4946
1996,53,a) 0,13540,13611,66155,33322,13454,197.7,0,0,65667,65667,0,197.1,197.1,0,0,0,0,0,65667,197.1,0,0,,,
1996,53,b) 1,9932,10054,62586,64535,83,0.7,3135,26.7,17433,1266,16167,2,27,21331,11908,9423,18.5,33.1,-3898,-6.1,54,0,2428,2428,10270
1996,53,c) 2,8309,8446,54820,57218,366,4,1807,19.6,12106,1818,10288,3.2,21.2,16901,8890,8011,15.5,29.5,-4795,-8.3,42.4,0,1435,1435,7496
1996,53,d) 3,6915,7074,48994,51382,324,4.3,1257,16.7,9203,1551,7652,3,17.9,13978,6080,7898,11.8,27.2,-4775,-9.3,35.8,0,996,996,5309
1996,53,e) 4,6130,6375,52760,53789,250,3.7,989,14.6,9664,1568,8096,2.9,18,11721,4815,6906,9,21.8,-2057,-3.8,36,0,750,750,3784
1996,53,f) 5,5634,5861,50227,51542,252,4.1,766,12.5,8178,1404,6774,2.7,15.9,10808,4322,6486,8.4,21,-2630,-5.1,31.8,0,585,585,3540
1996,53,g) 6 to 10,21137,22679,250052,254290,891,3.8,2677,11.4,35844,6690,29154,2.6,14.1,44320,17047,27273,6.7,17.4,-8476,-3.3,28.2,0,1892,1894,11412
1996,53,h) 11 to 15,14371,16576,234256,236252,597,3.5,1491,8.8,30687,6238,24449,2.6,13,34679,10311,24368,4.4,14.7,-3992,-1.7,26,0,922,923,5581
1996,53,i) 16 to 20,9127,11510,170321,169278,452,3.9,868,7.4,23452,6532,16920,3.9,13.9,21365,5728,15637,3.4,12.6,2087,1.3,25.2,0,479,480,2619
1996,53,l) Left Censored,16983,32233,958837,961055,1996,6.1,2543,7.8,106606,33473,73133,3.5,11.1,111042,28721,82321,3,11.6,-4436,-0.5,22.2,0,725,725,5301
1996,54,a) 0,2757,2791,16218,8201,2770,198.5,0,0,16034,16034,0,195.5,195.5,0,0,0,0,0,16034,195.5,0,0,,,
1996,54,b) 1,2208,2232,14627,14684,12,0.5,675,26,4259,95,4164,0.6,29,4373,2493,1880,17,29.8,-114,-0.8,58,0,545,545,2149
1996,54,c) 2,1763,1788,11674,12191,42,2.2,328,16.9,2211,217,1994,1.8,18.1,3244,1545,1699,12.7,26.6,-1033,-8.5,36.2,0,267,267,1355
1996,54,d) 3,1571,1589,11213,11236,64,3.8,277,16.3,2566,615,1951,5.5,22.8,2611,1223,1388,10.9,23.2,-45,-0.4,45.6,0,217,217,1052
1996,54,e) 4,1392,1449,10382,11132,45,2.9,199,13,1454,199,1255,1.8,13.1,2953,1246,1707,11.2,26.5,-1499,-13.4,26.2,0,147,147,973
1996,54,f) 5,1263,1360,13552,14601,42,2.9,183,12.8,1729,203,1526,1.4,11.8,3826,1852,1974,12.7,26.2,-2097,-14.4,23.6,0,132,132,710
1996,54,g) 6 to 10,5376,5658,59525,59643,190,3.2,582,9.9,7996,1233,6763,2.1,13.4,8232,3245,4987,5.4,13.8,-236,-0.4,26.8,0,427,427,2584
1996,54,h) 11 to 15,4158,4604,56564,58197,152,3.2,304,6.5,5420,1000,4420,1.7,9.3,8685,1716,6969,2.9,14.9,-3265,-5.6,18.6,0,194,194,931
1996,54,i) 16 to 20,2551,3305,44574,44816,93,2.8,222,6.6,4386,867,3519,1.9,9.8,4869,1235,3634,2.8,10.9,-483,-1.1,19.6,0,139,139,564
1996,54,l) Left Censored,7184,12122,281628,284898,549,4.5,755,6.2,30608,10976,19632,3.9,10.7,37148,10315,26833,3.6,13,-6540,-2.3,21.4,0,303,303,1466
1996,55,a) 0,8826,8872,50543,25440,8792,198.2,0,0,50207,50207,0,197.4,197.4,0,0,0,0,0,50207,197.4,0,0,,,
1996,55,b) 1,7140,7230,49036,50093,57,0.7,1684,20.7,12675,1432,11243,2.9,25.3,14788,8623,6165,17.2,29.5,-2113,-4.2,50.6,0,1324,1324,5371
1996,55,c) 2,6044,6144,45322,46813,203,3.1,1028,15.6,8282,1186,7096,2.5,17.7,11263,5489,5774,11.7,24.1,-2981,-6.4,35.4,0,828,828,4794
1996,55,d) 3,5375,5482,42027,43117,192,3.3,773,13.4,7227,1096,6131,2.5,16.8,9406,4711,4695,10.9,21.8,-2179,-5,33.6,0,616,616,3262
1996,55,e) 4,4618,4739,39820,40730,132,2.7,567,11.5,5723,1094,4629,2.7,14.1,7542,2678,4864,6.6,18.5,-1819,-4.4,28.2,0,453,454,2204
1996,55,f) 5,4437,4655,41432,42099,142,2.9,505,10.4,6092,1109,4983,2.6,14.5,7426,3155,4271,7.5,17.6,-1334,-3.1,29,0,361,361,2023
1996,55,g) 6 to 10,18414,19828,240192,241832,625,3.1,1913,9.3,29594,6252,23342,2.6,12.2,32874,11551,21323,4.8,13.6,-3280,-1.4,24.4,0,1378,1378,8050
1996,55,h) 11 to 15,12739,14451,196611,198280,385,2.6,1022,6.9,22300,4510,17790,2.3,11.2,25638,7661,17977,3.9,12.9,-3338,-1.7,22.4,0,653,655,4185
1996,55,i) 16 to 20,8510,10836,167976,168968,342,3.1,727,6.6,16762,3292,13470,1.9,9.9,18745,5338,13407,3.2,11.1,-1983,-1.2,19.8,0,423,423,2579
1996,55,l) Left Censored,22985,38233,1314353,1313827,1404,3.6,2298,5.9,120153,26405,93748,2,9.1,119101,30872,88229,2.3,9.1,1052,0,18.2,0,914,917,6083
1996,56,a) 0,1485,1487,6313,3178,1471,197.8,0,0,6270,,,,197.3,0,0,0,0,0,6270,197.3,0,1,,,
1996,56,b) 1,1078,1086,5727,5670,3,0.2,270,21.9,1571,,,,27.7,1457,780,677,13.8,25.7,114,2,51.4,1,214,214,654
1996,56,c) 2,934,942,5831,6741,34,3.4,176,17.4,1098,142,956,2.1,16.3,2917,898,2019,13.3,43.3,-1819,-27,32.6,0,133,133,754
1996,56,d) 3,746,757,5190,5465,27,3.3,126,15.6,838,125,713,2.3,15.3,1388,613,775,11.2,25.4,-550,-10.1,30.6,0,92,92,474
1996,56,e) 4,615,618,3844,3942,27,4.1,89,13.7,534,67,467,1.7,13.5,730,268,462,6.8,18.5,-196,-5,27,0,63,63,208
1996,56,f) 5,577,586,3547,3763,19,3.1,76,12.4,511,72,439,1.9,13.6,942,381,561,10.1,25,-431,-11.4,27.2,0,54,54,252
1996,56,g) 6 to 10,2098,2203,19535,19948,73,3.2,240,10.5,2343,424,1919,2.1,11.7,3169,1005,2164,5,15.9,-826,-4.2,23.4,0,193,193,814
1996,56,h) 11 to 15,1852,2047,17628,18030,55,2.6,152,7.2,2072,491,1581,2.7,11.5,2876,966,1910,5.4,16,-804,-4.5,23,0,87,87,436
1996,56,i) 16 to 20,1278,1533,17378,17721,44,2.8,126,8,1871,202,1669,1.1,10.6,2556,632,1924,3.6,14.4,-685,-3.8,21.2,0,75,75,365
1996,56,l) Left Censored,2363,3794,66028,67232,146,3.8,258,6.7,6384,1413,4971,2.1,9.5,8792,2090,6702,3.1,13.1,-2408,-3.6,19,0,105,105,387
1997,01,a) 0,7725,7845,45506,22858,7784,198.4,0,0,45297,45297,0,198.2,198.2,0,0,0,0,0,45297,198.2,0,0,,,
1997,01,b) 1,5889,6095,39434,40210,143,2,1842,26.3,11495,1623,9872,4,28.6,13047,8306,4741,20.7,32.4,-1552,-3.8,57.2,0,1510,1510,6408
1997,01,c) 2,4925,5026,36396,38890,182,3.3,1059,19.4,7620,2204,5416,5.7,19.6,12607,7461,5146,19.2,32.4,-4987,-12.8,39.2,0,880,880,6592
1997,01,d) 3,4270,4372,39148,42197,149,3.2,835,17.7,7525,1463,6062,3.5,17.8,13623,8078,5545,19.1,32.3,-6098,-14.5,35.6,0,685,685,7215
1997,01,e) 4,3580,3675,32844,33037,133,3.4,541,13.9,6225,643,5582,1.9,18.8,6610,3012,3598,9.1,20,-385,-1.2,37.6,0,428,428,2138
1997,01,f) 5,3154,3295,36680,35731,102,3,391,11.3,8478,1037,7441,2.9,23.7,6580,2823,3757,7.9,18.4,1898,5.3,36.8,0,304,304,2016
1997,01,g) 6 to 10,12492,13500,168031,171834,513,3.7,1532,10.9,24238,4022,20216,2.3,14.1,31844,13027,18817,7.6,18.5,-7606,-4.4,28.2,0,1132,1132,7025
1997,01,h) 11 to 15,9548,11010,151488,151308,431,3.8,869,7.7,22650,4494,18156,3,15,22290,6775,15515,4.5,14.7,360,0.3,29.4,0,536,536,3753
1997,01,i) 16 to 20,6883,9146,164583,163207,442,4.7,814,8.7,27578,9588,17990,5.9,16.9,24825,7912,16913,4.8,15.2,2753,1.7,30.4,0,370,370,2543
1997,01,l) Left Censored,12678,25484,829853,837737,1509,5.9,1827,7.1,99995,28963,71032,3.5,11.9,115763,31152,84611,3.7,13.8,-15768,-1.9,23.8,0,526,526,4309
1997,02,a) 0,1383,1388,5969,3002,1369,197.3,0,0,5934,5934,0,197.7,197.7,0,0,0,0,0,5934,197.7,0,0,,,
1997,02,b) 1,999,1014,5237,5420,5,0.4,308,26,1533,58,1475,1.1,28.3,1898,1132,766,20.9,35,-365,-6.7,56.6,0,222,222,892
1997,02,c) 2,871,884,5290,5470,27,2.8,175,18.2,1170,127,1043,2.3,21.4,1530,599,931,11,28,-360,-6.6,42.8,0,134,134,482
1997,02,d) 3,722,731,4642,4837,29,3.7,131,16.7,878,85,793,1.8,18.2,1267,584,683,12.1,26.2,-389,-8,36.4,0,103,103,469
1997,02,e) 4,675,686,4052,4166,28,3.9,92,12.8,907,143,764,3.4,21.8,1134,422,712,10.1,27.2,-227,-5.4,43.6,0,70,70,282
1997,02,f) 5,508,542,3647,3820,27,4.7,78,13.6,681,107,574,2.8,17.8,1027,275,752,7.2,26.9,-346,-9.1,35.6,0,54,54,190
1997,02,g) 6 to 10,2267,2377,25002,24453,102,4.1,291,11.8,5561,1529,4032,6.3,22.7,4462,1553,2909,6.4,18.2,1099,4.5,36.4,0,189,189,974
1997,02,h) 11 to 15,1920,2217,21693,21847,101,4.5,180,8,3882,818,3064,3.7,17.8,4190,938,3252,4.3,19.2,-308,-1.4,35.6,0,110,110,576
1997,02,i) 16 to 20,1300,1690,23584,23120,78,4.6,106,6.2,3679,715,2964,3.1,15.9,2750,622,2128,2.7,11.9,929,4,23.8,0,46,46,285
1997,02,l) Left Censored,1742,3255,82984,83245,218,6.7,249,7.6,12265,2697,9568,3.2,14.7,12787,3567,9220,4.3,15.4,-522,-0.7,29.4,0,45,45,279
1997,04,a) 0,9902,10077,62211,31250,9973,197.9,0,0,61922,61922,0,198.2,198.2,0,0,0,0,0,61922,198.2,0,0,,,
1997,04,b) 1,7134,7245,56445,55843,56,0.7,2157,25.7,18168,1821,16347,3.3,32.5,16963,10563,6400,18.9,30.4,1205,2.1,60.8,0,1764,1764,8477
1997,04,c) 2,5960,6120,58236,58506,269,4,1313,19.7,16625,2781,13844,4.8,28.4,17165,9805,7360,16.8,29.3,-540,-0.9,56.8,0,1063,1063,7822
1997,04,d) 3,5089,5321,54181,53031,200,3.5,880,15.5,13831,3541,10290,6.7,26.1,11530,5583,5947,10.5,21.7,2301,4.4,43.4,0,732,732,4877
1997,04,e) 4,3964,4163,41292,42231,191,4.3,690,15.7,8144,1698,6446,4,19.3,10021,4503,5518,10.7,23.7,-1877,-4.4,38.6,0,542,542,3534
1997,04,f) 5,3457,3673,67327,61063,148,3.8,549,14.2,23012,4944,18068,8.1,37.7,10484,4072,6412,6.7,17.2,12528,20.5,34.4,0,406,406,2633
1997,04,g) 6 to 10,14032,15272,202766,204741,775,4.9,1776,11.3,34913,8086,26827,3.9,17.1,38863,15566,23297,7.6,19,-3950,-1.9,34.2,0,1248,1248,10703
1997,04,h) 11 to 15,9903,11806,190628,191384,633,5.3,1095,9.1,30205,7371,22834,3.9,15.8,31717,7554,24163,3.9,16.6,-1512,-0.8,31.6,0,608,608,3897
1997,04,i) 16 to 20,6590,8687,165310,163295,527,6,798,9,30107,8972,21135,5.5,18.4,26076,10173,15903,6.2,16,4031,2.4,32,0,361,361,3721
1997,04,l) Left Censored,8769,20872,756472,747497,2184,10.5,2149,10.3,134249,49731,84518,6.7,18,116300,50637,65663,6.8,15.6,17949,2.4,31.2,0,346,346,1924
1997,05,a) 0,4860,4897,28648,14359,4866,198.7,0,0,28578,28578,0,199,199,0,0,0,0,0,28578,199,0,0,,,
1997,05,b) 1,3641,3732,23899,24899,36,0.8,1189,27.3,6391,358,6033,1.4,25.7,8391,5057,3334,20.3,33.7,-2000,-8,51.4,0,992,992,3774
1997,05,c) 2,3267,3338,24433,25761,106,2.9,722,19.8,4506,742,3764,2.9,17.5,7162,3789,3373,14.7,27.8,-2656,-10.3,35,0,606,606,3285
1997,05,d) 3,2741,2820,20980,21883,85,2.8,474,15.7,3892,850,3042,3.9,17.8,5698,2341,3357,10.7,26,-1806,-8.2,35.6,0,394,394,1951
1997,05,e) 4,2371,2426,18182,18775,95,3.7,368,14.3,3315,624,2691,3.3,17.7,4500,1786,2714,9.5,24,-1185,-6.3,35.4,0,303,303,1428
1997,05,f) 5,1983,2098,18514,19344,84,3.8,295,13.4,2923,840,2083,4.3,15.1,4582,1682,2900,8.7,23.7,-1659,-8.6,30.2,0,213,213,1259
1997,05,g) 6 to 10,7639,8225,82258,85491,312,3.7,919,10.8,12002,2904,9098,3.4,14,18467,8578,9889,10,21.6,-6465,-7.6,28,0,644,644,5128
1997,05,h) 11 to 15,6026,6711,84089,84658,268,3.9,539,7.9,11328,2769,8559,3.3,13.4,12465,3493,8972,4.1,14.7,-1137,-1.3,26.8,0,345,345,2042
1997,05,i) 16 to 20,4823,5853,94796,95857,278,4.7,477,8,12411,2772,9639,2.9,12.9,14534,3223,11311,3.4,15.2,-2123,-2.3,25.8,0,274,274,1649
1997,05,l) Left Censored,8316,15103,511092,505909,908,6,1073,7,63281,15462,47819,3.1,12.5,52915,14280,38635,2.8,10.5,10366,2,21,0,327,327,1806
1997,06,a) 0,60441,61300,388494,195083,60747,198.2,0,0,386823,386823,0,198.3,198.3,0,0,0,0,0,386823,198.3,0,0,,,
1997,06,b) 1,45974,46773,381950,376464,438,0.8,12871,24,122656,12777,109879,3.4,32.6,111684,66573,45111,17.7,29.7,10972,2.9,59.4,0,10105,10105,54857
1997,06,c) 2,37231,38129,340589,352518,1647,4,7782,18.8,91376,10887,80489,3.1,25.9,115234,56526,58708,16,32.7,-23858,-6.8,51.8,0,6203,6203,47781
1997,06,d) 3,30989,31875,321411,329458,1297,3.8,5740,16.8,68154,10897,57257,3.3,20.7,84248,39776,44472,12.1,25.6,-16094,-4.9,41.4,0,4480,4480,31696
1997,06,e) 4,26032,26981,277101,287212,1155,4,4168,14.6,59152,9771,49381,3.4,20.6,79373,31779,47594,11.1,27.6,-20221,-7,41.2,0,3330,3330,24739
1997,06,f) 5,24291,25714,281388,279726,1182,4.4,3757,13.9,60019,9184,50835,3.3,21.5,56694,25293,31401,9,20.3,3325,1.2,40.6,0,2774,2774,19159
1997,06,g) 6 to 10,108002,116587,1421415,1427413,5610,4.6,13917,11.5,259353,50098,209255,3.5,18.2,271348,107663,163685,7.5,19,-11995,-0.8,36.4,0,9618,9618,66339
1997,06,h) 11 to 15,75788,87198,1289436,1284156,4000,4.5,8823,9.8,222319,47647,174672,3.7,17.3,211760,78544,133216,6.1,16.5,10559,0.8,33,0,5021,5022,36578
1997,06,i) 16 to 20,58150,75264,1343323,1331805,3903,5.1,6832,8.9,218473,67531,150942,5.1,16.4,195437,58959,136478,4.4,14.7,23036,1.7,29.4,0,3268,3268,21014
1997,06,l) Left Censored,74505,155397,5294752,5294198,10270,6.5,17180,10.8,788308,216985,571323,4.1,14.9,787199,289279,497920,5.5,14.9,1109,0,29.8,0,3842,3842,40982
1997,08,a) 0,11604,11723,65123,32696,11635,198.5,0,0,64855,64855,0,198.4,198.4,0,0,0,0,0,64855,198.4,0,0,,,
1997,08,b) 1,8502,8637,54641,55901,93,0.9,2554,25.6,15776,1587,14189,2.8,28.2,18295,11581,6714,20.7,32.7,-2519,-4.5,56.4,0,1979,1979,9167
1997,08,c) 2,7262,7453,55913,56676,311,3.8,1549,19.1,14349,2261,12088,4,25.3,15874,9217,6657,16.3,28,-1525,-2.7,50.6,0,1209,1209,6228
1997,08,d) 3,6381,6523,48103,49948,241,3.5,1119,16,10007,2305,7702,4.6,20,13697,6933,6764,13.9,27.4,-3690,-7.4,40,0,869,869,5193
1997,08,e) 4,5110,5233,40744,42029,199,3.6,774,14,7788,1465,6323,3.5,18.5,10358,5167,5191,12.3,24.6,-2570,-6.1,37,0,598,598,4342
1997,08,f) 5,4311,4471,41623,41163,202,4.3,585,12.5,8790,2099,6691,5.1,21.4,7869,3500,4369,8.5,19.1,921,2.3,38.2,0,437,437,2667
1997,08,g) 6 to 10,16218,17489,197374,199350,837,4.6,1945,10.8,36557,10537,26020,5.3,18.3,40508,16392,24116,8.2,20.3,-3951,-2,36.6,0,1337,1337,10983
1997,08,h) 11 to 15,11294,12921,182760,186100,672,5.1,1175,8.9,28995,7181,21814,3.9,15.6,35675,15103,20572,8.1,19.2,-6680,-3.6,31.2,0,673,673,4646
1997,08,i) 16 to 20,8360,10615,180865,180926,636,5.9,941,8.7,30444,10974,19470,6.1,16.8,30565,9668,20897,5.3,16.9,-121,-0.1,33.6,0,430,430,4461
1997,08,l) Left Censored,11809,23324,762049,756322,1870,8,2123,9,118059,38087,79972,5,15.6,106604,35688,70916,4.7,14.1,11455,1.5,28.2,0,432,432,2829
1997,09,a) 0,5558,5620,32144,16109,5579,198.5,0,0,32070,32070,0,199.1,199.1,0,0,0,0,0,32070,199.1,0,0,,,
1997,09,b) 1,4371,4457,39344,35712,50,1,1080,21.5,15737,1815,13922,5.1,44.1,8472,5242,3230,14.7,23.7,7265,20.4,47.4,0,828,828,4501
1997,09,c) 2,4052,4139,30974,30957,136,3,760,17,7997,1279,6718,4.1,25.8,7963,4868,3095,15.7,25.7,34,0.1,51.4,0,604,604,4254
1997,09,d) 3,3468,3515,28704,28911,110,2.9,564,15.1,5466,479,4987,1.7,18.9,5879,2477,3402,8.6,20.3,-413,-1.4,37.8,0,451,451,2112
1997,09,e) 4,3120,3187,26486,27704,103,3.1,424,12.7,4892,521,4371,1.9,17.7,7328,4360,2968,15.7,26.5,-2436,-8.8,35.4,0,335,335,3624
1997,09,f) 5,2744,2846,33688,35023,100,3.4,353,11.9,3618,530,3088,1.5,10.3,6288,2970,3318,8.5,18,-2670,-7.7,20.6,0,260,260,2158
1997,09,g) 6 to 10,13181,13879,149059,149460,534,3.7,1448,10.1,25197,5504,19693,3.7,16.9,25998,10911,15087,7.3,17.4,-801,-0.5,33.8,0,1008,1008,6039
1997,09,h) 11 to 15,9693,10617,123646,123783,433,4,891,8.2,17431,3854,13577,3.1,14.1,17705,6014,11691,4.9,14.3,-274,-0.2,28.2,0,579,579,3405
1997,09,i) 16 to 20,7052,8363,126171,125781,331,3.9,656,7.7,19310,4833,14477,3.8,15.4,18529,4851,13678,3.9,14.7,781,0.7,29.4,0,332,332,1592
1997,09,l) Left Censored,15873,25317,876982,872484,1477,5.8,2136,8.3,115028,31455,83573,3.6,13.2,106031,34525,71506,4,12.2,8997,1,24.4,0,626,626,5120
1997,10,a) 0,1607,1621,9363,4704,1611,198.8,0,0,9319,9319,0,198.1,198.1,0,0,0,0,0,9319,198.1,0,0,,,
1997,10,b) 1,1227,1253,10921,9966,17,1.2,274,19.7,3650,493,3157,4.9,36.6,1740,1056,684,10.6,17.5,1910,19.1,35,0,221,221,851
1997,10,c) 2,1130,1155,8827,8799,48,3.9,190,15.5,1783,247,1536,2.8,20.3,1726,841,885,9.6,19.6,57,0.7,39.2,0,146,146,730
1997,10,d) 3,954,979,7644,7612,37,3.6,133,12.9,1435,168,1267,2.2,18.9,1370,568,802,7.5,18,65,0.9,36,0,114,114,531
1997,10,e) 4,804,814,5959,5931,27,3.1,118,13.7,1111,104,1007,1.8,18.7,1054,489,565,8.2,17.8,57,0.9,35.6,0,94,94,360
1997,10,f) 5,682,708,6299,5888,20,2.7,88,11.9,1702,230,1472,3.9,28.9,879,405,474,6.9,14.9,823,14,29.8,0,64,64,332
1997,10,g) 6 to 10,2819,2938,31201,31060,112,3.7,346,11.3,5641,572,5069,1.8,18.2,5358,2317,3041,7.5,17.3,283,0.9,34.6,0,243,243,1491
1997,10,h) 11 to 15,1893,2092,23994,23956,95,4.4,194,9.1,3895,591,3304,2.5,16.3,3818,1538,2280,6.4,15.9,77,0.4,31.8,0,111,111,875
1997,10,i) 16 to 20,1408,1762,42065,42071,107,6,121,6.8,6242,1801,4441,4.3,14.8,6253,1481,4772,3.5,14.9,-11,-0.1,29.6,0,53,53,401
1997,10,l) Left Censored,3452,5836,191753,190986,528,9,553,9.5,27281,10950,16331,5.7,14.3,25746,10119,15627,5.3,13.5,1535,0.8,27,0,115,115,1838
1997,11,a) 0,1147,1168,7652,3849,1157,198.1,0,0,7606,7606,0,197.6,197.6,0,0,0,0,0,7606,197.6,0,0,,,
1997,11,b) 1,885,891,6481,6590,10,1,225,22.3,1494,154,1340,2.3,22.7,1711,844,867,12.8,26,-217,-3.3,45.4,0,164,164,691
1997,11,c) 2,774,795,7510,7901,31,3.6,144,16.9,1377,102,1275,1.3,17.4,2158,995,1163,12.6,27.3,-781,-9.9,34.8,0,115,115,858
1997,11,d) 3,718,739,6216,6484,21,2.7,99,12.7,952,86,866,1.3,14.7,1487,577,910,8.9,22.9,-535,-8.2,29.4,0,73,73,355
1997,11,e) 4,591,606,6231,6152,20,3.1,79,12.4,1149,107,1042,1.7,18.7,990,367,623,6,16.1,159,2.6,32.2,0,63,63,279
1997,11,f) 5,588,659,11817,11808,28,4.1,90,13,1598,662,936,5.6,13.5,1579,565,1014,4.8,13.4,19,0.1,26.8,0,61,61,381
1997,11,g) 6 to 10,2453,2585,34898,35365,112,4.2,331,12.3,5803,1317,4486,3.7,16.4,6736,2470,4266,7,19,-933,-2.6,32.8,0,189,189,1007
1997,11,h) 11 to 15,2100,2306,32814,32364,84,3.5,217,9.1,5381,1580,3801,4.9,16.6,4481,1674,2807,5.2,13.8,900,2.8,27.6,0,115,115,749
1997,11,i) 16 to 20,1590,1932,61438,61306,73,3.7,174,8.8,5772,1195,4577,1.9,9.4,5507,1471,4036,2.4,9,265,0.4,18,0,78,78,457
1997,11,l) Left Censored,4012,6131,216529,219261,402,6.4,672,10.7,26039,6048,19991,2.8,11.9,31502,12993,18509,5.9,14.4,-5463,-2.5,23.8,0,157,157,1632
1997,12,a) 0,37300,37666,223618,112223,37415,198.7,0,0,222790,222790,0,198.5,198.5,0,0,0,0,0,222790,198.5,0,0,,,
1997,12,b) 1,27941,28361,188934,193177,206,0.6,8879,26.9,59048,4359,54689,2.3,30.6,67534,39060,28474,20.2,35,-8486,-4.4,61.2,0,7272,7272,33539
1997,12,c) 2,23196,23585,164875,173308,832,3.2,5352,20.6,37969,5989,31980,3.5,21.9,54835,32323,22512,18.7,31.6,-16866,-9.7,43.8,0,4426,4426,26700
1997,12,d) 3,20235,20734,167782,169054,744,3.3,3981,17.8,40495,6750,33745,4,24,43038,23571,19467,13.9,25.5,-2543,-1.5,48,0,3221,3221,19894
1997,12,e) 4,17465,18162,159005,164057,808,4.2,3031,15.7,31988,5570,26418,3.4,19.5,42093,23726,18367,14.5,25.7,-10105,-6.2,39,0,2457,2457,19669
1997,12,f) 5,15169,15828,145266,147514,565,3.4,2380,14.2,26987,4265,22722,2.9,18.3,31483,14663,16820,9.9,21.3,-4496,-3,36.6,0,1865,1865,12044
1997,12,g) 6 to 10,58507,63151,718719,731983,2448,3.7,7689,11.7,125244,31985,93259,4.4,17.1,151771,60320,91451,8.2,20.7,-26527,-3.6,34.2,0,5542,5542,38845
1997,12,h) 11 to 15,36647,41917,582085,590678,1963,4.6,4251,9.9,111988,32754,79234,5.5,19,129175,54988,74187,9.3,21.9,-17187,-2.9,38,0,2619,2620,23463
1997,12,i) 16 to 20,23923,31320,484660,485590,1777,5.6,2986,9.3,77519,23692,53827,4.9,16,79378,26576,52802,5.5,16.3,-1859,-0.3,32,0,1481,1481,10352
1997,12,l) Left Censored,32034,79289,2581895,2577126,6548,8.2,7463,9.4,388305,128429,259876,5,15.1,378768,129146,249622,5,14.7,9537,0.4,29.4,0,1636,1636,15571
1997,13,a) 0,16069,16313,92299,46402,16220,198.9,0,0,91795,91795,0,197.8,197.8,0,0,0,0,0,91795,197.8,0,0,,,
1997,13,b) 1,12125,12333,92379,94152,139,1,3785,26.5,28294,2654,25640,2.8,30.1,31840,19508,12332,20.7,33.8,-3546,-3.7,60.2,0,3020,3020,15723
1997,13,c) 2,9868,10182,84222,88298,386,3.5,2154,19.4,19704,3225,16479,3.7,22.3,27855,16443,11412,18.6,31.5,-8151,-9.2,44.6,0,1795,1795,14937
1997,13,d) 3,8485,8749,86312,85894,323,3.5,1489,15.9,20978,2803,18175,3.3,24.4,20141,10601,9540,12.3,23.4,837,1,46.8,0,1178,1178,7864
1997,13,e) 4,7062,7303,69068,70531,336,4.4,1120,14.5,14932,3238,11694,4.6,21.2,17860,9556,8304,13.5,25.3,-2928,-4.1,42.4,0,896,896,7382
1997,13,f) 5,6045,6329,65210,65860,224,3.4,864,13,11659,1863,9796,2.8,17.7,12958,5993,6965,9.1,19.7,-1299,-2,35.4,0,655,655,4597
1997,13,g) 6 to 10,23417,25595,319608,327274,1127,4.3,2902,11,50936,12333,38603,3.8,15.6,66267,22850,43417,7,20.2,-15331,-4.6,31.2,0,2030,2030,14416
1997,13,h) 11 to 15,16788,19161,266506,272743,807,4.1,1685,8.6,43360,12673,30687,4.6,15.9,55834,29121,26713,10.7,20.5,-12474,-4.6,31.8,0,980,980,20587
1997,13,i) 16 to 20,11359,14950,271231,266670,811,5.3,1273,8.4,49127,17385,31742,6.5,18.4,40005,12629,27376,4.7,15,9122,3.4,30,0,592,592,4058
1997,13,l) Left Censored,19859,45243,1673160,1667065,3369,7.4,3816,8.4,253730,79944,173786,4.8,15.2,241540,73472,168068,4.4,14.5,12190,0.7,29,0,844,844,7702
1997,15,a) 0,1884,1891,9817,4921,1879,198.7,0,0,9793,9793,0,199,199,0,0,0,0,0,9793,199,0,0,,,
1997,15,b) 1,1535,1598,12384,12619,27,1.5,398,22,3189,566,2623,4.5,25.3,3659,2132,1527,16.9,29,-470,-3.7,50.6,0,325,325,1880
1997,15,c) 2,1257,1282,11334,11849,50,3.6,241,17.4,1604,180,1424,1.5,13.5,2634,974,1660,8.2,22.2,-1030,-8.7,27,0,195,195,864
1997,15,d) 3,1100,1126,15554,15715,46,3.9,180,15.1,2129,342,1787,2.2,13.5,2450,870,1580,5.5,15.6,-321,-2.1,27,0,150,150,691
1997,15,e) 4,946,992,9096,9110,46,4.4,166,15.7,1492,296,1196,3.2,16.4,1519,639,880,7,16.7,-27,-0.3,32.8,0,131,131,538
1997,15,f) 5,893,935,10338,10918,38,3.9,149,15.1,1073,181,892,1.7,9.8,2233,953,1280,8.7,20.5,-1160,-10.7,19.6,0,113,113,583
1997,15,g) 6 to 10,3972,4371,50504,51675,173,3.8,557,12.2,6624,1012,5612,2,12.8,8965,3682,5283,7.1,17.3,-2341,-4.5,25.6,0,365,365,1940
1997,15,h) 11 to 15,2971,3387,38343,39419,127,3.6,316,9.1,4164,628,3536,1.6,10.6,6316,1933,4383,4.9,16,-2152,-5.4,21.2,0,195,195,1195
1997,15,i) 16 to 20,2588,3484,52048,51504,167,4.7,291,8.2,8042,1589,6453,3.1,15.6,6954,2124,4830,4.1,13.5,1088,2.1,27,0,133,133,824
1997,15,l) Left Censored,4318,7941,211696,213856,360,4.5,635,7.9,22483,6214,16269,2.9,10.5,26802,7357,19445,3.4,12.5,-4319,-2,21,0,158,158,1089
1997,16,a) 0,3339,3383,16155,8123,3344,197.7,0,0,16065,16065,0,197.8,197.8,0,0,0,0,0,16065,197.8,0,0,,,
1997,16,b) 1,2356,2385,14960,15151,24,0.9,752,27,4158,542,3616,3.6,27.4,4540,2783,1757,18.4,30,-382,-2.6,54.8,0,584,584,2263
1997,16,c) 2,1931,1953,11563,12323,65,3,440,20.5,2305,230,2075,1.9,18.7,3825,1969,1856,16,31,-1520,-12.3,37.4,0,360,360,1646
1997,16,d) 3,1714,1750,11739,12231,78,4.2,278,15,2168,303,1865,2.5,17.7,3151,1379,1772,11.3,25.8,-983,-8.1,35.4,0,220,220,1162
1997,16,e) 4,1307,1341,9976,10545,66,4.7,216,15.2,1941,285,1656,2.7,18.4,3078,1923,1155,18.2,29.2,-1137,-10.8,36.8,0,149,149,636
1997,16,f) 5,1222,1251,9299,9470,33,2.5,158,12,1816,161,1655,1.7,19.2,2157,737,1420,7.8,22.8,-341,-3.6,38.4,0,118,118,520
1997,16,g) 6 to 10,4339,4604,44029,45849,168,3.5,554,11.5,6340,1149,5191,2.5,13.8,9979,4505,5474,9.8,21.8,-3639,-8,27.6,0,354,354,1886
1997,16,h) 11 to 15,2995,3409,40527,41737,171,4.9,317,9.1,6062,1764,4298,4.2,14.5,8481,4018,4463,9.6,20.3,-2419,-5.8,29,0,194,194,1330
1997,16,i) 16 to 20,2449,2994,52247,51421,181,6,236,7.8,7713,2384,5329,4.6,15,6061,1775,4286,3.5,11.8,1652,3.2,23.6,0,130,130,866
1997,16,l) Left Censored,3937,6970,178098,177287,420,5.9,624,8.8,24980,6585,18395,3.7,14.1,23357,7249,16108,4.1,13.2,1623,0.9,26.4,0,155,155,962
1997,17,a) 0,20238,20505,121280,60951,20330,198.3,0,0,120658,120658,0,198,198,0,0,0,0,0,120658,198,0,0,,,
1997,17,b) 1,16034,16265,113963,114681,172,0.9,4159,22.6,33592,5451,28141,4.8,29.3,35027,20983,14044,18.3,30.5,-1435,-1.2,58.6,0,3300,3300,17737
1997,17,c) 2,13922,14242,111099,115773,521,3.4,2495,16.3,24210,3355,20855,2.9,20.9,33557,18478,15079,16,29,-9347,-8.1,41.8,0,1969,1969,16633
1997,17,d) 3,12008,12262,109675,110373,392,3,1905,14.6,23888,3928,19960,3.6,21.6,25284,11796,13488,10.7,22.9,-1396,-1.3,43.2,0,1506,1506,10001
1997,17,e) 4,10655,10961,105239,109580,393,3.4,1468,12.7,16466,2576,13890,2.4,15,25149,13591,11558,12.4,23,-8683,-8,30,0,1177,1177,12218
1997,17,f) 5,9450,9896,104457,104552,311,3,1232,11.9,17475,3785,13690,3.6,16.7,17665,6963,10702,6.7,16.9,-190,-0.2,33.4,0,946,946,5633
1997,17,g) 6 to 10,39909,42701,517465,523067,1483,3.4,4479,10.1,77811,18146,59665,3.5,14.9,89015,32612,56403,6.2,17,-11204,-2.1,29.8,0,3101,3101,20080
1997,17,h) 11 to 15,29247,32626,500664,503493,1144,3.4,2788,8.3,68316,14289,54027,2.8,13.6,73973,20670,53303,4.1,14.7,-5657,-1.1,27.2,0,1680,1680,10356
1997,17,i) 16 to 20,21940,27408,461749,459249,1331,4.8,2248,8.1,64761,15631,49130,3.4,14.1,59761,19324,40437,4.2,13,5000,1.1,26,0,1051,1051,7500
1997,17,l) Left Censored,44459,79558,2877999,2877245,4712,5.8,6752,8.4,360722,95102,265620,3.3,12.5,359214,117387,241827,4.1,12.5,1508,0,25,0,1858,1858,12677
1997,18,a) 0,9789,9877,55889,28059,9811,198.7,0,0,55661,55661,0,198.4,198.4,0,0,0,0,0,55661,198.4,0,0,,,
1997,18,b) 1,7662,7835,59015,57344,95,1.1,2122,23.8,19504,1640,17864,2.9,34,16162,9715,6447,16.9,28.2,3342,5.8,56.4,0,1742,1742,7915
1997,18,c) 2,6638,6802,49956,52184,248,3.4,1279,17.4,10452,1694,8758,3.2,20,14907,8487,6420,16.3,28.6,-4455,-8.6,40,0,1038,1038,6983
1997,18,d) 3,5724,5880,50187,51371,197,3.1,974,15.5,9501,1160,8341,2.3,18.5,11868,6154,5714,12,23.1,-2367,-4.6,37,0,789,789,4320
1997,18,e) 4,5004,5166,42286,42927,179,3.3,708,13,7929,2030,5899,4.7,18.5,9211,4036,5175,9.4,21.5,-1282,-3,37,0,581,581,3391
1997,18,f) 5,4443,4776,53504,52528,167,3.3,579,11.6,11863,1978,9885,3.8,22.6,9911,3423,6488,6.5,18.9,1952,3.7,37.8,0,450,450,2562
1997,18,g) 6 to 10,18349,20046,251511,254975,773,3.7,2130,10.3,37474,7533,29941,3,14.7,44402,16975,27427,6.7,17.4,-6928,-2.7,29.4,0,1520,1520,11219
1997,18,h) 11 to 15,13937,15999,217901,218919,685,4.2,1322,8.1,31634,8687,22947,4,14.5,33671,13105,20566,6,15.4,-2037,-0.9,29,0,822,822,5958
1997,18,i) 16 to 20,10063,12986,227207,230967,605,4.6,994,7.5,30373,8698,21675,3.8,13.2,37893,12682,25211,5.5,16.4,-7520,-3.2,26.4,0,514,514,3542
1997,18,l) Left Censored,21220,41103,1425031,1418981,2611,6.3,3196,7.7,175955,46656,129299,3.3,12.4,163855,52919,110936,3.7,11.5,12100,0.9,23,0,833,833,8708
1997,19,a) 0,4857,4952,27202,13644,4914,198.5,0,0,27117,27117,0,198.7,198.7,0,0,0,0,0,27117,198.7,0,0,,,
1997,19,b) 1,3914,3962,24520,24986,37,0.8,926,20.8,6230,613,5617,2.5,24.9,7161,4008,3153,16,28.7,-931,-3.8,49.8,0,724,724,3402
1997,19,c) 2,3427,3507,24017,24975,124,3.3,611,16.2,4499,580,3919,2.3,18,6414,3812,2602,15.3,25.7,-1915,-7.7,36,0,509,509,3181
1997,19,d) 3,3021,3078,22257,22668,92,2.8,476,14.5,4045,772,3273,3.4,17.8,4866,2292,2574,10.1,21.5,-821,-3.7,35.6,0,368,368,1672
1997,19,e) 4,2526,2563,16973,19060,74,2.8,309,11.5,2892,684,2208,3.6,15.2,7066,2183,4883,11.5,37.1,-4174,-21.9,30.4,0,252,252,2000
1997,19,f) 5,2233,2352,24008,23295,80,3.2,330,13.3,5920,915,5005,3.9,25.4,4494,2253,2241,9.7,19.3,1426,6.1,38.6,0,244,244,1748
1997,19,g) 6 to 10,9483,10159,115165,116250,386,3.7,1114,10.6,16593,3467,13126,3,14.3,18763,7990,10773,6.9,16.1,-2170,-1.8,28.6,0,795,795,5303
1997,19,h) 11 to 15,7605,8800,115504,116324,313,3.5,670,7.5,15474,3943,11531,3.4,13.3,17114,5247,11867,4.5,14.7,-1640,-1.4,26.6,0,405,405,2513
1997,19,i) 16 to 20,6648,8715,112499,112266,397,4.5,626,7.1,14400,4212,10188,3.8,12.8,13934,3860,10074,3.4,12.4,466,0.4,24.8,0,321,321,1726
1997,19,l) Left Censored,14321,23913,670843,674094,1091,4.5,1655,6.8,76586,17627,58959,2.6,11.4,83089,26474,56615,3.9,12.3,-6503,-0.9,22.8,0,544,544,5282
1997,20,a) 0,5199,5255,30621,15372,5218,198.6,0,0,30498,30498,0,198.4,198.4,0,0,0,0,0,30498,198.4,0,0,,,
1997,20,b) 1,3933,3983,25352,25975,30,0.7,1138,24.8,7303,1315,5988,5.1,28.1,8549,4749,3800,18.3,32.9,-1246,-4.8,56.2,0,930,930,4223
1997,20,c) 2,3375,3438,25881,26916,106,2.8,639,17.2,5669,926,4743,3.4,21.1,7739,4606,3133,17.1,28.8,-2070,-7.7,42.2,0,509,509,3922
1997,20,d) 3,2886,2943,22552,22936,114,3.6,508,16.2,4704,719,3985,3.1,20.5,5471,2566,2905,11.2,23.9,-767,-3.4,41,0,398,398,1938
1997,20,e) 4,2477,2524,20438,20921,80,3,347,13,3291,426,2865,2,15.7,4257,1886,2371,9,20.3,-966,-4.6,31.4,0,284,284,1486
1997,20,f) 5,2227,2323,19460,20403,87,3.6,315,12.9,2774,577,2197,2.8,13.6,4659,2152,2507,10.5,22.8,-1885,-9.2,27.2,0,238,238,1540
1997,20,g) 6 to 10,8807,9458,107828,108186,367,3.7,1016,10.4,16240,2898,13342,2.7,15,16955,6679,10276,6.2,15.7,-715,-0.7,30,0,706,706,4527
1997,20,h) 11 to 15,7214,8001,90345,90395,311,3.8,698,8.5,13230,3380,9850,3.7,14.6,13329,4380,8949,4.8,14.7,-99,-0.1,29.2,0,446,446,2422
1997,20,i) 16 to 20,5633,7255,106216,105345,385,5.2,560,7.6,16339,4575,11764,4.3,15.5,14597,4342,10255,4.1,13.9,1742,1.6,27.8,0,273,273,1461
1997,20,l) Left Censored,11632,20146,574835,569251,1270,6.3,1568,7.7,74363,22616,51747,4,13.1,63195,17970,45225,3.2,11.1,11168,2,22.2,0,427,427,2975
1997,21,a) 0,6347,6435,37175,18640,6398,198.9,0,0,37070,37070,0,198.9,198.9,0,0,0,0,0,37070,198.9,0,0,,,
1997,21,b) 1,4713,4845,37651,39623,52,0.9,1369,24.7,9768,650,9118,1.6,24.7,13711,7911,5800,20,34.6,-3943,-9.9,49.4,0,1134,1134,6367
1997,21,c) 2,4271,4377,35358,36502,146,3.1,779,16.6,7041,873,6168,2.4,19.3,9328,4666,4662,12.8,25.6,-2287,-6.3,38.6,0,633,633,4087
1997,21,d) 3,3543,3636,31675,32380,117,3,588,15.2,6209,666,5543,2.1,19.2,7618,3852,3766,11.9,23.5,-1409,-4.3,38.4,0,484,484,3105
1997,21,e) 4,3164,3270,30084,30817,122,3.5,470,13.6,5177,903,4274,2.9,16.8,6643,2786,3857,9,21.6,-1466,-4.8,33.6,0,361,361,2109
1997,21,f) 5,2822,2950,26380,26782,92,3,363,11.7,4342,597,3745,2.2,16.2,5145,1853,3292,6.9,19.2,-803,-3,32.4,0,270,270,1335
1997,21,g) 6 to 10,11407,12323,146934,147843,482,3.8,1285,10.1,23170,5535,17635,3.7,15.7,24987,9584,15403,6.5,16.9,-1817,-1.2,31.4,0,938,938,6726
1997,21,h) 11 to 15,8638,9627,132316,134196,329,3.3,860,8.7,16039,2860,13179,2.1,12,19799,6524,13275,4.9,14.8,-3760,-2.8,24,0,513,513,3087
1997,21,i) 16 to 20,6046,7593,137131,137519,331,4.3,614,7.9,20373,5961,14412,4.3,14.8,21148,6112,15036,4.4,15.4,-775,-0.6,29.6,0,311,311,2227
1997,21,l) Left Censored,12694,24330,775197,765610,1561,6.4,1904,7.8,108040,29178,78862,3.8,14.1,88865,29413,59452,3.8,11.6,19175,2.5,23.2,0,521,521,3700
1997,22,a) 0,7187,7280,48306,24252,7220,198.4,0,0,48109,48109,0,198.4,198.4,0,0,0,0,0,48109,198.4,0,0,,,
1997,22,b) 1,5433,5482,44046,44279,29,0.5,1583,25,13199,291,12908,0.7,29.8,13664,8075,5589,18.2,30.9,-465,-1.1,59.6,0,1288,1288,5758
1997,22,c) 2,4625,4699,47969,49201,156,3.1,893,17.5,10541,1157,9384,2.4,21.4,13004,6158,6846,12.5,26.4,-2463,-5,42.8,0,732,732,5306
1997,22,d) 3,4221,4352,41788,43226,134,2.9,701,15.1,7352,737,6615,1.7,17,10227,4587,5640,10.6,23.7,-2875,-6.7,34,0,580,580,3388
1997,22,e) 4,3566,3680,39665,39608,132,3.4,490,12.7,7902,2027,5875,5.1,20,7787,2792,4995,7,19.7,115,0.3,39.4,0,403,403,2250
1997,22,f) 5,3142,3293,32392,33294,117,3.4,439,12.7,5412,1011,4401,3,16.3,7215,2996,4219,9,21.7,-1803,-5.4,32.6,0,328,328,1785
1997,22,g) 6 to 10,11782,12915,166129,169624,433,3.2,1333,10,27784,4750,23034,2.8,16.4,34773,14456,20317,8.5,20.5,-6989,-4.1,32.8,0,903,903,6066
1997,22,h) 11 to 15,10450,11849,149768,150711,393,3.2,925,7.6,21554,3292,18262,2.2,14.3,23439,8071,15368,5.4,15.6,-1885,-1.3,28.6,0,574,574,4065
1997,22,i) 16 to 20,8077,10160,161140,161057,429,4.2,671,6.5,22967,6087,16880,3.8,14.3,22801,6817,15984,4.2,14.2,166,0.1,28.4,0,382,382,3085
1997,22,l) Left Censored,13754,26049,730629,731090,1530,5.8,2091,7.9,99337,26183,73154,3.6,13.6,100259,35264,64995,4.8,13.7,-922,-0.1,27.2,0,573,573,4992
1997,23,a) 0,2726,2751,12009,6035,2726,198.2,0,0,11949,11949,0,198,198,0,0,0,0,0,11949,198,0,0,,,
1997,23,b) 1,2182,2222,13017,12962,19,0.8,539,21.5,3505,385,3120,3,27,3395,1969,1426,15.2,26.2,110,0.8,52.4,0,410,410,1554
1997,23,c) 2,1858,1872,10529,10654,57,2.8,323,16.1,2107,235,1872,2.2,19.8,2356,1185,1171,11.1,22.1,-249,-2.3,39.6,0,256,256,1044
1997,23,d) 3,1474,1495,10653,10845,40,2.5,239,14.9,1998,137,1861,1.3,18.4,2382,1141,1241,10.5,22,-384,-3.6,36.8,0,189,189,1020
1997,23,e) 4,1254,1278,9696,9824,44,3.3,173,12.9,1699,352,1347,3.6,17.3,1954,748,1206,7.6,19.9,-255,-2.6,34.6,0,132,132,516
1997,23,f) 5,1076,1148,8248,8607,64,5.4,142,12,1264,299,965,3.5,14.7,1982,786,1196,9.1,23,-718,-8.3,29.4,0,100,100,471
1997,23,g) 6 to 10,5417,5675,51946,52676,213,3.6,606,10.3,7000,1332,5668,2.5,13.3,8459,3352,5107,6.4,16.1,-1459,-2.8,26.6,0,462,462,2342
1997,23,h) 11 to 15,3736,4163,46543,46714,206,4.9,341,8.1,5857,1791,4066,3.8,12.5,6198,2394,3804,5.1,13.3,-341,-0.8,25,0,206,206,1576
1997,23,i) 16 to 20,2636,3449,50121,49986,206,5.9,269,7.7,7232,2155,5077,4.3,14.5,6961,2186,4775,4.4,13.9,271,0.6,27.8,0,135,135,935
1997,23,l) Left Censored,4854,7968,222607,222309,371,4.6,647,8,25125,5509,19616,2.5,11.3,24529,8773,15756,3.9,11,596,0.3,22,0,186,186,2146
1997,24,a) 0,9214,9310,52220,26225,9253,198.8,0,0,51991,51991,0,198.2,198.2,0,0,0,0,0,51991,198.2,0,0,,,
1997,24,b) 1,6853,7005,48375,48232,92,1.2,1866,23.5,15708,2110,13598,4.4,32.6,15421,9773,5648,20.3,32,287,0.6,64,0,1461,1461,7843
1997,24,c) 2,6117,6227,44186,45284,212,3.1,1235,18.3,10965,1564,9401,3.5,24.2,13161,7587,5574,16.8,29.1,-2196,-4.9,48.4,0,960,960,5440
1997,24,d) 3,5093,5268,45761,45513,196,3.5,873,15.5,10638,1595,9043,3.5,23.4,10142,4943,5199,10.9,22.3,496,1.1,44.6,0,680,680,4201
1997,24,e) 4,4524,4634,46888,46819,175,3.6,676,13.8,8293,852,7441,1.8,17.7,8154,3802,4352,8.1,17.4,139,0.3,34.8,0,528,528,2960
1997,24,f) 5,3892,4149,41304,40928,171,3.9,560,12.9,8038,1528,6510,3.7,19.6,7286,3285,4001,8,17.8,752,1.8,35.6,0,419,419,2420
1997,24,g) 6 to 10,17559,18730,226839,225684,726,3.7,2036,10.5,41147,6237,34910,2.8,18.2,38837,11993,26844,5.3,17.2,2310,1,34.4,0,1443,1443,8267
1997,24,h) 11 to 15,12153,13707,179825,180578,581,4.1,1243,8.9,28149,6472,21677,3.6,15.6,29655,10874,18781,6,16.4,-1506,-0.8,31.2,0,712,712,4959
1997,24,i) 16 to 20,8108,10433,176930,175897,470,4.4,907,8.5,26448,7711,18737,4.4,15,24381,7414,16967,4.2,13.9,2067,1.1,27.8,0,402,402,2513
1997,24,l) Left Censored,16031,30846,1006278,1001351,2020,6.5,2926,9.3,149793,51439,98354,5.1,15,139938,47712,92226,4.8,14,9855,1,28,0,713,713,5239
1997,25,a) 0,11221,11357,63684,31965,11276,198.6,0,0,63439,63439,0,198.5,198.5,0,0,0,0,0,63439,198.5,0,0,,,
1997,25,b) 1,8556,8628,62336,60148,36,0.4,1914,19.8,18705,901,17804,1.5,31.1,14329,7897,6432,13.1,23.8,4376,7.3,47.6,0,1500,1500,6639
1997,25,c) 2,7657,7803,64194,63734,254,3,1269,15.2,15418,1538,13880,2.4,24.2,14498,6879,7619,10.8,22.7,920,1.5,45.4,0,1012,1012,5808
1997,25,d) 3,6619,6730,59745,59477,232,3.3,933,13.2,12161,2513,9648,4.2,20.4,11625,5665,5960,9.5,19.5,536,0.9,39,0,760,760,4955
1997,25,e) 4,5356,5493,51025,51472,161,2.8,672,11.7,10246,1419,8827,2.8,19.9,11139,4937,6202,9.6,21.6,-893,-1.7,39.8,0,546,546,4302
1997,25,f) 5,4654,5030,54407,53936,149,2.9,532,10.2,11076,1394,9682,2.6,20.5,10134,4393,5741,8.1,18.8,942,1.7,37.6,0,392,392,3365
1997,25,g) 6 to 10,22008,23456,303361,300296,860,3.6,2303,9.5,51458,10857,40601,3.6,17.1,45328,19138,26190,6.4,15.1,6130,2,30.2,0,1601,1601,10301
1997,25,h) 11 to 15,16724,18646,282696,280200,747,3.9,1564,8.2,46060,11873,34187,4.2,16.4,41067,17517,23550,6.3,14.7,4993,1.7,29.4,0,907,907,8562
1997,25,i) 16 to 20,11658,14945,284531,284086,760,5,1064,7,38686,12021,26665,4.2,13.6,37795,8657,29138,3,13.3,891,0.3,26.6,0,530,530,3683
1997,25,l) Left Censored,26872,45021,1580383,1580892,2538,5.6,3470,7.6,199466,64660,134806,4.1,12.6,200485,61092,139393,3.9,12.7,-1019,-0.1,25.2,0,1050,1050,11847
1997,26,a) 0,16315,16593,102018,51348,16457,198.4,0,0,101341,101341,0,197.4,197.4,0,0,0,0,0,101341,197.4,0,0,,,
1997,26,b) 1,12884,13028,105217,109506,102,0.7,3005,20.6,28615,4455,24160,4.1,26.1,37192,12466,24726,11.4,34,-8577,-7.9,52.2,0,2332,2332,10554
1997,26,c) 2,11280,11473,90293,94549,336,2.7,2054,16.6,18846,1976,16870,2.1,19.9,27357,12140,15217,12.8,28.9,-8511,-9,39.8,0,1653,1653,10622
1997,26,d) 3,9383,9600,87504,89592,278,2.7,1401,13.8,16203,1658,14545,1.9,18.1,20378,8799,11579,9.8,22.7,-4175,-4.6,36.2,0,1064,1064,5851
1997,26,e) 4,8132,8332,73761,76424,256,2.9,1118,12.7,11051,1706,9345,2.2,14.5,16377,6654,9723,8.7,21.4,-5326,-6.9,29,0,873,873,5633
1997,26,f) 5,7120,7457,74495,74908,215,2.7,940,12,13344,1796,11548,2.4,17.8,14170,6449,7721,8.6,18.9,-826,-1.1,35.6,0,733,733,5326
1997,26,g) 6 to 10,31083,33478,386426,389208,1161,3.3,3461,10,60090,11352,48738,2.9,15.4,65654,26292,39362,6.8,16.9,-5564,-1.5,30.8,0,2442,2442,15667
1997,26,h) 11 to 15,21967,25305,364307,366371,941,3.6,2145,8.3,54273,15001,39272,4.1,14.8,58400,20139,38261,5.5,15.9,-4127,-1.1,29.6,0,1274,1274,8270
1997,26,i) 16 to 20,16328,20652,336350,335949,822,3.9,1644,7.8,49366,13696,35670,4.1,14.7,48563,14002,34561,4.2,14.5,803,0.2,29,0,796,796,6238
1997,26,l) Left Censored,31865,60118,2168324,2155774,2912,4.8,4950,8.1,286191,64661,221530,3,13.3,261092,85589,175503,4,12.1,25099,1.2,24.2,0,1375,1375,11951
1997,27,a) 0,9497,9577,50421,25329,9495,198.3,0,0,50184,50184,0,198.1,198.1,0,0,0,0,0,50184,198.1,0,0,,,
1997,27,b) 1,7299,7386,49346,50394,74,0.9,1805,21.7,14050,1695,12355,3.4,27.9,16145,10662,5483,21.2,32,-2095,-4.1,55.8,0,1368,1368,8664
1997,27,c) 2,6173,6277,45031,47611,186,2.7,1240,18.2,9885,848,9037,1.8,20.8,15044,8634,6410,18.1,31.6,-5159,-10.8,41.6,0,1006,1006,6551
1997,27,d) 3,5538,5705,47111,47174,219,3.6,805,13.4,10433,2448,7985,5.2,22.1,10559,6109,4450,12.9,22.4,-126,-0.3,44.2,0,628,628,4947
1997,27,e) 4,4708,4931,44820,46005,194,3.8,625,12.1,8411,1748,6663,3.8,18.3,10781,4810,5971,10.5,23.4,-2370,-5.1,36.6,0,467,467,2914
1997,27,f) 5,4183,4400,39526,39775,137,3,495,10.8,6685,735,5950,1.8,16.8,7183,2904,4279,7.3,18.1,-498,-1.3,33.6,0,340,340,1933
1997,27,g) 6 to 10,17125,18527,214507,214595,748,3.9,1707,9,35259,6109,29150,2.8,16.4,35435,13039,22396,6.1,16.5,-176,-0.1,32.8,0,1168,1168,7829
1997,27,h) 11 to 15,12181,14003,209406,209661,522,3.6,1105,7.7,28494,6052,22442,2.9,13.6,29003,10269,18734,4.9,13.8,-509,-0.2,27.2,0,640,640,4336
1997,27,i) 16 to 20,9442,12091,207994,207147,598,4.9,927,7.6,30683,8623,22060,4.2,14.8,28989,8919,20070,4.3,14,1694,0.8,28,0,429,429,3225
1997,27,l) Left Censored,18496,32420,1237145,1232456,1750,5.3,2560,7.8,150983,40541,110442,3.3,12.3,141605,48806,92799,4,11.5,9378,0.8,23,0,708,708,7426
1997,28,a) 0,4486,4525,25438,12774,4483,198.1,0,0,25329,25329,0,198.3,198.3,0,0,0,0,0,25329,198.3,0,0,,,
1997,28,b) 1,3383,3481,24752,25426,53,1.3,1020,25.4,6802,1122,5680,4.4,26.8,8149,4612,3537,18.1,32,-1347,-5.2,53.6,0,827,827,3343
1997,28,c) 2,2922,2983,23241,23387,116,3.6,606,18.7,5372,984,4388,4.2,23,5664,3276,2388,14,24.2,-292,-1.2,46,0,507,507,2749
1997,28,d) 3,2520,2598,27778,27933,113,4.1,432,15.6,5426,1282,4144,4.6,19.4,5735,2497,3238,8.9,20.5,-309,-1.1,38.8,0,354,354,1779
1997,28,e) 4,2156,2237,21412,22373,88,3.8,280,12,3212,704,2508,3.1,14.4,5134,1562,3572,7,22.9,-1922,-8.5,28.8,0,220,220,1356
1997,28,f) 5,1698,1818,16855,17612,82,4.3,268,14,2686,850,1836,4.8,15.3,4200,1692,2508,9.6,23.8,-1514,-8.5,30.6,0,193,193,1233
1997,28,g) 6 to 10,7036,7560,92367,92279,284,3.6,847,10.8,16621,1878,14743,2,18,16445,4996,11449,5.4,17.8,176,0.2,35.6,0,623,623,3424
1997,28,h) 11 to 15,5730,6314,72421,72377,250,3.9,472,7.4,11617,2227,9390,3.1,16.1,11529,3635,7894,5,15.9,88,0.2,31.8,0,320,320,1885
1997,28,i) 16 to 20,4455,5527,93420,92773,241,4.3,463,8.2,13624,3522,10102,3.8,14.7,12331,4341,7990,4.7,13.3,1293,1.4,26.6,0,269,269,1756
1997,28,l) Left Censored,8434,15908,485043,484728,877,5.5,1235,7.7,60589,15102,45487,3.1,12.5,59958,17200,42758,3.5,12.4,631,0.1,24.8,0,417,417,2886
1997,29,a) 0,10359,10446,54774,27462,10382,198.8,0,0,54625,54625,0,198.9,198.9,0,0,0,0,0,54625,198.9,0,0,,,
1997,29,b) 1,7994,8148,55990,55774,100,1.1,2351,25.1,17560,3345,14215,6,31.5,17128,9535,7593,17.1,30.7,432,0.8,61.4,0,1891,1891,7977
1997,29,c) 2,6880,7014,49106,51004,221,2.9,1559,20.2,10815,1428,9387,2.8,21.2,14611,8214,6397,16.1,28.6,-3796,-7.4,42.4,0,1273,1273,7129
1997,29,d) 3,6086,6292,53241,53987,229,3.4,1136,16.8,11202,2833,8369,5.2,20.7,12694,6229,6465,11.5,23.5,-1492,-2.8,41.4,0,924,924,5049
1997,29,e) 4,5016,5218,43410,45171,201,3.6,815,14.7,7250,934,6316,2.1,16.1,10771,5294,5477,11.7,23.8,-3521,-7.7,32.2,0,656,656,4570
1997,29,f) 5,4380,4589,48533,49326,169,3.5,630,13.1,8029,1079,6950,2.2,16.3,9616,4398,5218,8.9,19.5,-1587,-3.2,32.6,0,497,497,3019
1997,29,g) 6 to 10,18477,19900,218224,220641,724,3.5,2232,10.8,33783,5775,28008,2.6,15.3,38617,14135,24482,6.4,17.5,-4834,-2.2,30.6,0,1600,1600,9701
1997,29,h) 11 to 15,13963,15735,222932,220550,566,3.5,1329,8.2,33539,6573,26966,3,15.2,28774,9609,19165,4.4,13,4765,2.2,26,0,843,843,5300
1997,29,i) 16 to 20,10064,12924,219485,216923,573,4.3,1113,8.4,33348,12322,21026,5.7,15.4,28224,8796,19428,4.1,13,5124,2.4,26,0,542,542,3246
1997,29,l) Left Censored,20322,37413,1275244,1269426,1909,5,2966,7.8,161899,38354,123545,3,12.8,150263,48352,101911,3.8,11.8,11636,1,23.6,0,896,896,10010
1997,30,a) 0,2556,2568,11135,5613,2542,198,0,0,11045,11045,0,196.8,196.8,0,0,0,0,0,11045,196.8,0,0,,,
1997,30,b) 1,1989,2008,10574,11181,13,0.6,548,23.8,2441,107,2334,1,21.8,3655,1856,1799,16.6,32.7,-1214,-10.9,43.6,0,420,420,1561
1997,30,c) 2,1706,1723,9593,10238,47,2.5,311,16.7,1726,207,1519,2,16.9,3015,1725,1290,16.8,29.4,-1289,-12.5,33.8,0,236,236,1501
1997,30,d) 3,1362,1388,8598,8905,69,4.7,222,15.1,1459,291,1168,3.3,16.4,2073,833,1240,9.4,23.3,-614,-6.9,32.8,0,186,186,736
1997,30,e) 4,1147,1173,7131,7428,45,3.7,155,12.6,1115,188,927,2.5,15,1709,663,1046,8.9,23,-594,-8,30,0,126,126,560
1997,30,f) 5,1047,1062,6869,7132,35,3.1,126,11.3,896,141,755,2,12.6,1422,570,852,8,19.9,-526,-7.3,25.2,0,102,102,495
1997,30,g) 6 to 10,3728,3923,33215,34224,152,3.7,440,10.8,4475,801,3674,2.3,13.1,6493,2449,4044,7.2,19,-2018,-5.9,26.2,0,317,317,1723
1997,30,h) 11 to 15,2970,3292,30600,30809,158,4.7,267,8,4288,1166,3122,3.8,13.9,4706,1463,3243,4.7,15.3,-418,-1.4,27.8,0,169,169,879
1997,30,i) 16 to 20,2425,2920,34420,34307,123,4.1,225,7.6,4822,880,3942,2.6,14.1,4595,1175,3420,3.4,13.4,227,0.7,26.8,0,140,140,617
1997,30,l) Left Censored,3711,6003,114156,114498,296,4.9,487,8,14852,3213,11639,2.8,13,15536,5882,9654,5.1,13.6,-684,-0.6,26,0,153,153,1100
1997,31,a) 0,3218,3251,15336,7706,3218,198,0,0,15260,15260,0,198,198,0,0,0,0,0,15260,198,0,0,,,
1997,31,b) 1,2444,2474,16807,16898,25,0.9,612,21.9,4440,501,3939,3,26.3,4622,2827,1795,16.7,27.4,-182,-1.1,52.6,0,470,470,2526
1997,31,c) 2,2075,2121,15104,16094,69,3,413,18,2733,456,2277,2.8,17,4713,2741,1972,17,29.3,-1980,-12.3,34,0,323,323,2140
1997,31,d) 3,1846,1900,13639,14605,75,3.7,286,14.3,2711,688,2023,4.7,18.6,4643,2537,2106,17.4,31.8,-1932,-13.2,37.2,0,223,223,2308
1997,31,e) 4,1654,1700,13088,13447,56,3.1,219,12.3,2427,567,1860,4.2,18,3145,1597,1548,11.9,23.4,-718,-5.4,36,0,178,178,985
1997,31,f) 5,1475,1522,11776,12017,52,3.3,173,10.9,2106,742,1364,6.2,17.5,2587,923,1664,7.7,21.5,-481,-4,35,0,136,136,831
1997,31,g) 6 to 10,5969,6486,76917,77817,256,3.8,658,9.8,15780,7614,8166,9.8,20.3,17579,3999,13580,5.1,22.6,-1799,-2.3,40.6,0,469,469,2848
1997,31,h) 11 to 15,4892,5462,71606,72433,201,3.6,417,7.5,9104,1516,7588,2.1,12.6,10757,4105,6652,5.7,14.9,-1653,-2.3,25.2,0,272,272,1878
1997,31,i) 16 to 20,3985,5044,73050,73270,224,4.4,347,6.8,9142,2614,6528,3.6,12.5,9582,2406,7176,3.3,13.1,-440,-0.6,25,0,197,197,1208
1997,31,l) Left Censored,8313,13293,382202,382816,558,4.1,1000,7.4,42555,11550,31005,3,11.1,43783,11663,32120,3,11.4,-1228,-0.3,22.2,0,288,288,1564
1997,32,a) 0,4415,4440,30923,15510,4407,198.5,0,0,30827,30827,0,198.8,198.8,0,0,0,0,0,30827,198.8,0,0,,,
1997,32,b) 1,2945,2994,38730,35840,39,1.1,987,28.2,14100,369,13731,1,39.3,8320,5025,3295,14,23.2,5780,16.1,46.4,0,810,810,4264
1997,32,c) 2,2451,2501,29000,28575,99,3.6,540,19.8,9838,2936,6902,10.3,34.4,8988,3907,5081,13.7,31.5,850,2.9,63,0,442,442,3103
1997,32,d) 3,1944,2005,24667,25232,109,5.1,389,18.1,4873,1547,3326,6.1,19.3,6003,2836,3167,11.2,23.8,-1130,-4.5,38.6,0,325,325,2356
1997,32,e) 4,1509,1550,21218,20788,68,4.1,250,15.2,4900,447,4453,2.2,23.6,4039,1776,2263,8.5,19.4,861,4.2,38.8,0,200,200,1618
1997,32,f) 5,1275,1325,15838,16611,62,4.5,202,14.5,2664,521,2143,3.1,16,4209,1413,2796,8.5,25.3,-1545,-9.3,32,0,152,152,969
1997,32,g) 6 to 10,5251,5739,83573,83199,345,5.9,641,10.9,15576,4376,11200,5.3,18.7,14828,4602,10226,5.5,17.8,748,0.9,35.6,0,443,443,3150
1997,32,h) 11 to 15,3242,3864,72408,72363,245,6.2,378,9.6,12216,3245,8971,4.5,16.9,12126,2773,9353,3.8,16.8,90,0.1,33.6,0,176,176,816
1997,32,i) 16 to 20,2631,3472,96395,94273,281,8.1,303,8.7,14043,5840,8203,6.2,14.9,9798,2406,7392,2.6,10.4,4245,4.5,20.8,0,138,138,836
1997,32,l) Left Censored,3841,7620,337288,334959,1003,13.3,802,10.7,50163,19500,30663,5.8,15,45505,14676,30829,4.4,13.6,4658,1.4,27.2,0,133,133,1027
1997,33,a) 0,2767,2790,14150,7092,2774,198.9,0,0,14116,14116,0,199,199,0,0,0,0,0,14116,199,0,0,,,
1997,33,b) 1,2191,2228,15849,15407,13,0.5,540,21.5,4463,124,4339,0.8,29,3578,2274,1304,14.8,23.2,885,5.8,46.4,0,444,444,2085
1997,33,c) 2,1831,1843,12603,13107,50,2.5,311,15.7,2530,198,2332,1.5,19.3,3538,2069,1469,15.8,27,-1008,-7.7,38.6,0,254,254,1823
1997,33,d) 3,1561,1586,11689,11931,51,3,223,13.3,1916,135,1781,1.1,16.1,2399,1092,1307,9.2,20.1,-483,-4,32.2,0,180,180,956
1997,33,e) 4,1277,1295,10701,10927,44,3.2,164,12.1,2012,257,1755,2.4,18.4,2464,886,1578,8.1,22.5,-452,-4.1,36.8,0,125,125,752
1997,33,f) 5,1113,1179,11344,11370,53,4.3,136,11.1,2088,357,1731,3.1,18.4,2139,897,1242,7.9,18.8,-51,-0.4,36.8,0,107,107,702
1997,33,g) 6 to 10,5294,5538,55203,55633,183,3.2,604,10.5,8382,1320,7062,2.4,15.1,9241,3608,5633,6.5,16.6,-859,-1.5,30.2,0,430,430,2576
1997,33,h) 11 to 15,3801,4167,55380,57519,188,4.4,382,9,7589,1946,5643,3.4,13.2,11866,2970,8896,5.2,20.6,-4277,-7.4,26.4,0,248,248,1250
1997,33,i) 16 to 20,2406,3038,47675,47257,131,4.2,264,8.5,6420,1436,4984,3,13.6,5583,1537,4046,3.3,11.8,837,1.8,23.6,0,135,135,781
1997,33,l) Left Censored,4756,8156,254948,254115,484,5.9,686,8.3,30227,8060,22167,3.2,11.9,28561,9841,18720,3.9,11.2,1666,0.7,22.4,0,150,150,838
1997,34,a) 0,17653,17826,88033,44211,17688,198.5,0,0,87645,87645,0,198.2,198.2,0,0,0,0,0,87645,198.2,0,0,,,
1997,34,b) 1,13339,13479,90503,87551,78,0.5,3327,21.8,31751,4619,27132,5.3,36.3,25847,14210,11637,16.2,29.5,5904,6.8,59,0,2606,2606,11703
1997,34,c) 2,11412,11780,87834,87525,462,3.6,2153,17,22712,3619,19093,4.1,25.9,22094,11811,10283,13.5,25.2,618,0.7,50.4,0,1672,1672,9293
1997,34,d) 3,9156,9254,67038,68396,314,3.2,1461,14.8,14660,1948,12712,2.8,21.4,17375,9410,7965,13.8,25.4,-2715,-4,42.8,0,1149,1149,7479
1997,34,e) 4,8187,8283,65768,68003,278,3.2,1175,13.4,12674,1236,11438,1.8,18.6,17144,8604,8540,12.7,25.2,-4470,-6.6,37.2,0,942,942,7381
1997,34,f) 5,6948,7153,60677,62419,246,3.3,993,13.2,10563,1167,9396,1.9,16.9,14047,6986,7061,11.2,22.5,-3484,-5.6,33.8,0,767,767,5570
1997,34,g) 6 to 10,31861,33275,344199,343990,1220,3.5,3527,10.2,55963,8553,47410,2.5,16.3,55544,20663,34881,6,16.1,419,0.2,32.2,0,2497,2497,13711
1997,34,h) 11 to 15,22452,24420,321409,322107,846,3.4,2269,9,48842,11525,37317,3.6,15.2,50237,18428,31809,5.7,15.6,-1395,-0.4,30.4,0,1476,1476,9450
1997,34,i) 16 to 20,16368,18654,298280,298160,653,3.4,1600,8.4,42226,10566,31660,3.5,14.2,41985,12880,29105,4.3,14.1,241,0.1,28.2,0,894,894,5196
1997,34,l) Left Censored,32878,54122,1835266,1829545,3410,6.2,5232,9.5,276033,81442,194591,4.5,15.1,264592,97452,167140,5.3,14.5,11441,0.6,29,0,1565,1565,10876
1997,35,a) 0,3364,3394,18962,9536,3365,198.3,0,0,18852,18852,0,197.7,197.7,0,0,0,0,0,18852,197.7,0,0,,,
1997,35,b) 1,2531,2562,17796,18246,16,0.5,831,27.6,4824,259,4565,1.4,26.4,5723,3198,2525,17.5,31.4,-899,-5,52.8,0,671,671,2675
1997,35,c) 2,2223,2270,17279,18016,75,3,489,19.7,3661,403,3258,2.2,20.3,5134,2442,2692,13.6,28.5,-1473,-8.2,40.6,0,385,385,2039
1997,35,d) 3,1923,2004,16873,16851,95,4.5,340,15.9,3840,801,3039,4.8,22.8,3795,1758,2037,10.4,22.5,45,0.3,45,0,267,267,1441
1997,35,e) 4,1544,1591,13867,14387,60,3.6,248,14.7,2514,374,2140,2.6,17.5,3554,1183,2371,8.2,24.7,-1040,-7.2,35,0,190,190,892
1997,35,f) 5,1321,1404,13869,14157,56,3.8,208,14.1,2292,499,1793,3.5,16.2,2868,1241,1627,8.8,20.3,-576,-4.1,32.4,0,158,158,937
1997,35,g) 6 to 10,5501,5933,68837,69544,235,3.8,725,11.7,10573,1874,8699,2.7,15.2,11986,4528,7458,6.5,17.2,-1413,-2,30.4,0,528,528,3000
1997,35,h) 11 to 15,4102,4683,53878,54474,224,4.7,403,8.4,7826,2062,5764,3.8,14.4,9018,2950,6068,5.4,16.6,-1192,-2.2,28.8,0,254,254,1643
1997,35,i) 16 to 20,3301,4139,56436,56179,198,4.7,355,8.4,9678,3158,6520,5.6,17.2,9164,2410,6754,4.3,16.3,514,0.9,32.6,0,173,173,798
1997,35,l) Left Censored,4960,9221,235000,237602,736,7.9,832,9,31077,9601,21476,4,13.1,36281,10385,25896,4.4,15.3,-5204,-2.2,26.2,0,211,211,1558
1997,36,a) 0,37288,37606,195702,98184,37328,198.5,0,0,195036,195036,0,198.6,198.6,0,0,0,0,0,195036,198.6,0,0,,,
1997,36,b) 1,28144,28385,187356,188476,162,0.5,7367,22.8,53591,3304,50287,1.8,28.4,55830,33746,22084,17.9,29.6,-2239,-1.2,56.8,0,5904,5904,28218
1997,36,c) 2,23480,24328,171208,176804,858,3.2,4956,18.7,36906,4325,32581,2.4,20.9,48097,24078,24019,13.6,27.2,-11191,-6.3,41.8,0,3889,3889,19533
1997,36,d) 3,19480,19668,152812,158454,593,2.8,3381,16,30729,3115,27614,2,19.4,42013,22545,19468,14.2,26.5,-11284,-7.1,38.8,0,2819,2819,16193
1997,36,e) 4,16955,17243,144927,147409,502,2.7,2626,14.3,27655,4458,23197,3,18.8,32619,15700,16919,10.7,22.1,-4964,-3.3,37.6,0,2131,2131,12533
1997,36,f) 5,14811,15200,133606,137868,479,3,2144,13.4,20850,2664,18186,1.9,15.1,29373,12462,16911,9,21.3,-8523,-6.2,30.2,0,1699,1699,10117
1997,36,g) 6 to 10,65880,68705,753450,760515,2195,3.1,7645,10.7,111956,21152,90804,2.8,14.7,126087,47179,78908,6.2,16.6,-14131,-1.9,29.4,0,5669,5669,29721
1997,36,h) 11 to 15,47364,51474,600696,605694,1623,3.1,4562,8.6,81763,15020,66743,2.5,13.5,91758,31826,59932,5.3,15.1,-9995,-1.6,27,0,3143,3143,20419
1997,36,i) 16 to 20,32374,39355,649243,652516,1333,3.3,3195,7.9,83664,19645,64019,3,12.8,90209,26500,63709,4.1,13.8,-6545,-1,25.6,0,1877,1877,13452
1997,36,l) Left Censored,71260,115421,3815680,3825729,5983,5.1,10233,8.7,488707,118815,369892,3.1,12.8,508804,179759,329045,4.7,13.3,-20097,-0.5,25.6,0,3641,3641,27552
1997,37,a) 0,15745,15958,88148,44280,15840,198.5,0,0,87736,87736,0,198.1,198.1,0,0,0,0,0,87736,198.1,0,0,,,
1997,37,b) 1,11368,11671,85335,85584,161,1.2,2993,22.6,23859,2225,21634,2.6,27.9,24357,13716,10641,16,28.5,-498,-0.6,55.8,0,2371,2371,11745
1997,37,c) 2,9554,9737,68347,69962,361,3.4,1844,17.5,16080,2805,13275,4,23,19310,11580,7730,16.6,27.6,-3230,-4.6,46,0,1506,1506,9011
1997,37,d) 3,7913,8124,66554,67801,292,3.4,1298,15,12800,1636,11164,2.4,18.9,15294,7902,7392,11.7,22.6,-2494,-3.7,37.8,0,1036,1036,6840
1997,37,e) 4,6460,6639,62052,62806,239,3.4,942,13.5,12457,3694,8763,5.9,19.8,13965,6538,7427,10.4,22.2,-1508,-2.4,39.6,0,782,782,5734
1997,37,f) 5,5705,6099,64556,64602,261,4.1,756,11.9,11848,2421,9427,3.7,18.3,11939,5349,6590,8.3,18.5,-91,-0.2,36.6,0,551,551,4018
1997,37,g) 6 to 10,24735,26918,322110,321104,1175,4.2,2700,9.8,53600,9363,44237,2.9,16.7,51588,19810,31778,6.2,16.1,2012,0.6,32.2,0,1909,1909,12251
1997,37,h) 11 to 15,19451,22052,272173,273556,864,3.9,1604,7.1,37679,7790,29889,2.8,13.8,40445,12898,27547,4.7,14.8,-2766,-1,27.6,0,978,978,6165
1997,37,i) 16 to 20,12272,16135,284130,280123,813,5,1214,7.4,43932,11599,32333,4.1,15.7,35917,10683,25234,3.8,12.8,8015,2.9,25.6,0,574,574,3801
1997,37,l) Left Censored,23403,49879,1786662,1781934,4068,8.2,3729,7.5,224271,73747,150524,4.1,12.6,214815,67878,146937,3.8,12.1,9456,0.5,24.2,0,884,884,6641
1997,38,a) 0,1207,1214,5982,3001,1202,198,0,0,5962,5962,0,198.7,198.7,0,0,0,0,0,5962,198.7,0,0,,,
1997,38,b) 1,993,1008,12270,10578,12,1,266,23.2,5526,588,4938,5.6,52.2,2141,1302,839,12.3,20.2,3385,32,40.4,0,200,200,1080
1997,38,c) 2,801,805,6012,6306,23,2.6,208,23.1,1342,141,1201,2.2,21.3,1930,1320,610,20.9,30.6,-588,-9.3,42.6,0,173,173,1205
1997,38,d) 3,823,829,4590,5094,18,2,139,15.6,665,61,604,1.2,13.1,1672,1029,643,20.2,32.8,-1007,-19.7,26.2,0,114,114,871
1997,38,e) 4,697,700,5103,5384,18,2.4,99,13.3,714,95,619,1.8,13.3,1276,618,658,11.5,23.7,-562,-10.4,26.6,0,84,84,583
1997,38,f) 5,611,627,4379,4666,23,3.5,84,12.8,662,106,556,2.3,14.2,1235,744,491,15.9,26.5,-573,-12.3,28.4,0,63,63,566
1997,38,g) 6 to 10,2526,2653,26330,26623,90,3.3,298,10.8,4061,654,3407,2.5,15.3,4646,2141,2505,8,17.5,-585,-2.2,30.6,0,198,198,1114
1997,38,h) 11 to 15,2132,2418,23321,23554,83,3.4,198,8,3066,476,2590,2,13,3532,1284,2248,5.5,15,-466,-2,26,0,114,114,647
1997,38,i) 16 to 20,1845,2196,27885,26759,73,3.3,143,6.4,5257,1430,3827,5.3,19.6,3005,768,2237,2.9,11.2,2252,8.4,22.4,0,82,82,381
1997,38,l) Left Censored,3655,5643,126769,125566,232,4,421,7.3,15289,4136,11153,3.3,12.2,12883,4397,8486,3.5,10.3,2406,1.9,20.6,0,133,133,1289
1997,39,a) 0,16962,17224,109828,55089,17103,198.6,0,0,109479,109479,0,198.7,198.7,0,0,0,0,0,109479,198.7,0,0,,,
1997,39,b) 1,13140,13436,104672,104549,155,1,3437,22.6,32669,6505,26164,6.2,31.2,32422,16519,15903,15.8,31,247,0.2,62,0,2739,2739,13682
1997,39,c) 2,11826,12064,92133,95264,374,2.9,2188,16.8,19910,2262,17648,2.4,20.9,26171,13667,12504,14.3,27.5,-6261,-6.6,41.8,0,1785,1785,11486
1997,39,d) 3,10014,10379,87811,90574,365,3.3,1579,14.3,16377,2105,14272,2.3,18.1,21903,10439,11464,11.5,24.2,-5526,-6.1,36.2,0,1259,1259,7583
1997,39,e) 4,8698,9062,81844,85272,349,3.7,1216,12.8,14308,2839,11469,3.3,16.8,21164,10361,10803,12.2,24.8,-6856,-8,33.6,0,965,965,7191
1997,39,f) 5,7663,8007,76011,77486,256,3.1,927,11.1,11887,1929,9958,2.5,15.3,14836,6114,8722,7.9,19.1,-2949,-3.8,30.6,0,728,728,4891
1997,39,g) 6 to 10,33685,36964,448164,451959,1444,3.8,3809,10,71244,16888,54356,3.7,15.8,78834,28711,50123,6.4,17.4,-7590,-1.6,31.6,0,2705,2705,18630
1997,39,h) 11 to 15,24688,28656,412556,413877,1179,4,2505,8.5,59175,13980,45195,3.4,14.3,61817,22444,39373,5.4,14.9,-2642,-0.6,28.6,0,1612,1612,10994
1997,39,i) 16 to 20,19609,25255,434635,435727,1207,4.7,2224,8.6,67325,21802,45523,5,15.5,69508,20518,48990,4.7,16,-2183,-0.5,31,0,992,992,7482
1997,39,l) Left Censored,42284,81007,2803398,2803494,4551,5.5,6560,8,350404,106484,243920,3.8,12.5,350596,109633,240963,3.9,12.5,-192,0,25,0,1640,1640,13709
1997,40,a) 0,6666,6812,40307,20261,6753,198.3,0,0,40093,40093,0,197.9,197.9,0,0,0,0,0,40093,197.9,0,0,,,
1997,40,b) 1,4757,4827,31720,33276,41,0.7,1477,26.4,8849,587,8262,1.8,26.6,11960,8096,3864,24.3,35.9,-3111,-9.3,53.2,0,1236,1236,7101
1997,40,c) 2,3943,4010,29749,31471,128,2.9,917,20.7,6220,761,5459,2.4,19.8,9663,5497,4166,17.5,30.7,-3443,-10.9,39.6,0,768,768,4940
1997,40,d) 3,3526,3583,27095,27619,122,3.2,600,15.7,5602,565,5037,2,20.3,6650,3280,3370,11.9,24.1,-1048,-3.8,40.6,0,482,482,2807
1997,40,e) 4,2979,3065,25163,25956,102,3.1,481,14.8,4705,522,4183,2,18.1,6291,2492,3799,9.6,24.2,-1586,-6.1,36.2,0,385,385,2181
1997,40,f) 5,2661,2743,23166,24224,72,2.5,379,13.1,3484,232,3252,1,14.4,5599,2893,2706,11.9,23.1,-2115,-8.7,28.8,0,282,282,2304
1997,40,g) 6 to 10,10309,11082,132027,133074,454,3.9,1296,11.3,23078,6116,16962,4.6,17.3,25171,8441,16730,6.3,18.9,-2093,-1.6,34.6,0,916,916,5647
1997,40,h) 11 to 15,9018,10099,115916,116654,377,3.6,853,8.2,16913,3414,13499,2.9,14.5,18388,5566,12822,4.8,15.8,-1475,-1.3,29,0,539,539,3414
1997,40,i) 16 to 20,6544,8141,117600,119616,364,4.4,711,8.5,14995,4004,10991,3.3,12.5,19027,5442,13585,4.5,15.9,-4032,-3.4,25,0,370,370,2736
1997,40,l) Left Censored,10933,20631,553072,545408,1403,6.8,1621,7.8,80357,23158,57199,4.2,14.7,65028,18063,46965,3.3,11.9,15329,2.8,23.8,0,472,472,2807
1997,41,a) 0,8025,8102,40227,20175,8050,198.7,0,0,40104,40104,0,198.8,198.8,0,0,0,0,0,40104,198.8,0,0,,,
1997,41,b) 1,6217,6342,51128,50311,67,0.9,1811,24.9,13252,1379,11873,2.7,26.3,11617,6607,5010,13.1,23.1,1635,3.2,46.2,0,1422,1422,5499
1997,41,c) 2,5391,5470,36091,37300,202,3.4,1114,18.7,7511,1253,6258,3.4,20.1,9928,5470,4458,14.7,26.6,-2417,-6.5,40.2,0,862,862,4205
1997,41,d) 3,4609,4777,35093,35350,197,3.9,836,16.4,7242,1273,5969,3.6,20.5,7755,3422,4333,9.7,21.9,-513,-1.4,41,0,647,647,2722
1997,41,e) 4,3693,3772,29489,30257,145,3.6,541,13.6,5104,737,4367,2.4,16.9,6639,2601,4038,8.6,21.9,-1535,-5,33.8,0,410,410,1841
1997,41,f) 5,3249,3419,32064,32835,159,4.4,475,13.2,5521,883,4638,2.7,16.8,7062,3709,3353,11.3,21.5,-1541,-4.7,33.6,0,358,358,2212
1997,41,g) 6 to 10,13054,13890,141788,142159,608,4.2,1530,10.6,25128,5466,19662,3.8,17.7,25869,9319,16550,6.6,18.2,-741,-0.5,35.4,0,1034,1034,6194
1997,41,h) 11 to 15,8919,10309,150462,149154,505,4.8,883,8.4,24599,6302,18297,4.2,16.5,21982,6854,15128,4.6,14.7,2617,1.8,29.4,0,564,564,3827
1997,41,i) 16 to 20,7236,8968,139203,137326,451,5,703,7.7,22385,5571,16814,4.1,16.3,18631,5966,12665,4.3,13.6,3754,2.7,27.2,0,382,382,3091
1997,41,l) Left Censored,11031,20519,619664,612130,1356,6.5,1805,8.7,96367,26761,69606,4.4,15.7,81299,28205,53094,4.6,13.3,15068,2.4,26.6,0,450,450,3673
1997,42,a) 0,17917,18229,105190,52817,18089,198.5,0,0,104747,104747,0,198.3,198.3,0,0,0,0,0,104747,198.3,0,0,,,
1997,42,b) 1,13844,14139,105151,103996,182,1.2,3178,20.2,30149,3483,26666,3.3,29,27839,15896,11943,15.3,26.8,2310,2.2,53.6,0,2513,2513,13812
1997,42,c) 2,12302,12662,95814,99639,412,3,2062,15.2,20577,2677,17900,2.7,20.7,28228,17065,11163,17.1,28.3,-7651,-7.6,41.4,0,1653,1653,13709
1997,42,d) 3,10019,10293,87391,93433,324,3,1457,13.4,15950,1715,14235,1.8,17.1,28034,18664,9370,20,30,-12084,-12.9,34.2,0,1162,1162,17185
1997,42,e) 4,9029,9306,82456,83000,330,3.4,1209,12.4,15500,2299,13201,2.8,18.7,16587,7315,9272,8.8,20,-1087,-1.3,37.4,0,985,985,6311
1997,42,f) 5,8498,8928,83500,84855,281,3,1117,11.9,13398,2261,11137,2.7,15.8,16108,7101,9007,8.4,19,-2710,-3.2,31.6,0,830,830,4508
1997,42,g) 6 to 10,40153,42861,448255,454314,1453,3.3,4258,9.6,66916,11596,55320,2.6,14.7,79034,30390,48644,6.7,17.4,-12118,-2.7,29.4,0,3099,3099,20231
1997,42,h) 11 to 15,29580,33202,465975,468024,1145,3.4,2598,7.7,61410,13625,47785,2.9,13.1,65507,23351,42156,5,14,-4097,-0.9,26.2,0,1648,1648,10912
1997,42,i) 16 to 20,21340,26671,449384,445770,1148,4.2,2148,7.9,68257,18703,49554,4.2,15.3,61029,20675,40354,4.6,13.7,7228,1.6,27.4,0,1055,1055,8355
1997,42,l) Left Censored,46736,86046,2845900,2846299,4955,5.7,6912,7.9,344600,96867,247733,3.4,12.1,345398,106651,238747,3.7,12.1,-798,0,24.2,0,2145,2145,15700
1997,44,a) 0,1947,1961,9992,5005,1951,199,0,0,9975,9975,0,199.3,199.3,0,0,0,0,0,9975,199.3,0,0,,,
1997,44,b) 1,1551,1563,10691,10369,11,0.6,418,23.4,2966,519,2447,5,28.6,2321,1460,861,14.1,22.4,645,6.2,44.8,0,347,347,1299
1997,44,c) 2,1246,1258,8364,8143,41,3.1,207,15.4,2184,383,1801,4.7,26.8,1742,981,761,12,21.4,442,5.4,42.8,0,171,171,909
1997,44,d) 3,1149,1160,12557,13067,33,2.7,180,14.5,1801,175,1626,1.3,13.8,2821,740,2081,5.7,21.6,-1020,-7.8,27.6,0,151,151,628
1997,44,e) 4,1001,1008,6747,6864,25,2.4,114,10.8,997,112,885,1.6,14.5,1230,520,710,7.6,17.9,-233,-3.4,29,0,87,87,439
1997,44,f) 5,850,867,7161,7270,20,2.2,110,12.1,1055,144,911,2,14.5,1273,489,784,6.7,17.5,-218,-3,29,0,92,92,453
1997,44,g) 6 to 10,4077,4245,43283,43352,128,2.9,436,9.9,7021,863,6158,2,16.2,7158,3084,4074,7.1,16.5,-137,-0.3,32.4,0,336,336,1916
1997,44,h) 11 to 15,2853,3013,36183,35691,99,3.2,239,7.7,5604,1587,4017,4.4,15.7,4620,1961,2659,5.5,12.9,984,2.8,25.8,0,165,165,1111
1997,44,i) 16 to 20,2151,2435,33609,33936,94,3.8,181,7.3,4187,847,3340,2.5,12.3,4841,1666,3175,4.9,14.3,-654,-2,24.6,0,105,105,893
1997,44,l) Left Censored,5166,7248,220269,220039,336,4.6,563,7.6,24923,7410,17513,3.4,11.3,24463,6985,17478,3.2,11.1,460,0.2,22.2,0,209,209,1294
1997,45,a) 0,7495,7575,45003,22624,7515,198.4,0,0,44758,44758,0,197.8,197.8,0,0,0,0,0,44758,197.8,0,0,,,
1997,45,b) 1,5515,5619,41332,40760,92,1.4,1663,25.7,13505,1420,12085,3.5,33.1,12361,8006,4355,19.6,30.3,1144,2.8,60.6,0,1367,1367,6906
1997,45,c) 2,4633,4741,39615,40962,219,4.3,971,18.9,10050,1476,8574,3.6,24.5,12743,7494,5249,18.3,31.1,-2693,-6.6,49,0,772,772,6705
1997,45,d) 3,3835,3958,37550,38341,160,3.8,639,15.2,7820,2197,5623,5.7,20.4,9402,4528,4874,11.8,24.5,-1582,-4.1,40.8,0,488,488,3225
1997,45,e) 4,3162,3303,32403,32256,128,3.7,497,14.2,6556,1131,5425,3.5,20.3,6261,2773,3488,8.6,19.4,295,0.9,38.8,0,384,384,2223
1997,45,f) 5,2850,2999,36848,36063,109,3.5,376,12,8371,1219,7152,3.4,23.2,6800,3613,3187,10,18.9,1571,4.3,37.8,0,285,285,2357
1997,45,g) 6 to 10,11859,13079,159787,160401,608,4.5,1415,10.5,26171,5215,20956,3.3,16.3,27399,9835,17564,6.1,17.1,-1228,-0.8,32.6,0,970,970,6795
1997,45,h) 11 to 15,9065,10322,122319,122203,444,4.2,844,8,18840,5044,13796,4.1,15.4,18607,6099,12508,5,15.2,233,0.2,30.4,0,516,516,3238
1997,45,i) 16 to 20,5946,7805,119734,120340,421,5.3,611,7.7,16748,5032,11716,4.2,13.9,17959,5382,12577,4.5,14.9,-1211,-1,27.8,0,309,309,2191
1997,45,l) Left Censored,11298,23189,802704,804514,1483,6.4,1768,7.6,93892,30305,63587,3.8,11.7,97511,30005,67506,3.7,12.1,-3619,-0.4,23.4,0,438,438,2712
1997,46,a) 0,1653,1670,8721,4372,1659,198.7,0,0,8698,8698,0,198.9,198.9,0,0,0,0,0,8698,198.9,0,0,,,
1997,46,b) 1,1295,1320,8339,8650,15,1,373,24.5,2320,285,2035,3.3,26.8,2942,1849,1093,21.4,34,-622,-7.2,53.6,0,293,293,1286
1997,46,c) 2,1073,1094,6941,7286,36,3.1,190,16.2,1235,259,976,3.6,17,1924,1049,875,14.4,26.4,-689,-9.4,34,0,152,152,837
1997,46,d) 3,1010,1024,7469,7714,36,3.3,176,16.1,1178,125,1053,1.6,15.3,1668,890,778,11.5,21.6,-490,-6.3,30.6,0,130,130,523
1997,46,e) 4,839,858,5918,6319,38,4.2,115,12.8,894,191,703,3,14.1,1696,548,1148,8.7,26.8,-802,-12.7,28.2,0,89,89,454
1997,46,f) 5,720,753,5555,5822,30,3.8,108,13.5,766,79,687,1.4,13.2,1299,680,619,11.7,22.3,-533,-9.1,26.4,0,87,87,610
1997,46,g) 6 to 10,3014,3158,33290,33439,112,3.4,337,10.3,5191,1242,3949,3.7,15.5,5489,2034,3455,6.1,16.4,-298,-0.9,31,0,235,235,1456
1997,46,h) 11 to 15,2282,2591,30433,29622,115,4.4,211,8,5339,1316,4023,4.4,18,3717,1265,2452,4.3,12.5,1622,5.5,25,0,131,131,623
1997,46,i) 16 to 20,1831,2150,27982,28157,81,3.7,178,8.1,3524,740,2784,2.6,12.5,3873,944,2929,3.4,13.8,-349,-1.3,25,0,88,88,422
1997,46,l) Left Censored,3861,5949,141486,141086,334,5.6,446,7.4,15861,5418,10443,3.8,11.2,15060,5279,9781,3.7,10.7,801,0.5,21.4,0,151,151,680
1997,47,a) 0,9732,9905,62375,31282,9823,198.3,0,0,62186,62186,0,198.8,198.8,0,0,0,0,0,62186,198.8,0,0,,,
1997,47,b) 1,7456,7598,65098,64847,94,1.1,2329,26.5,21601,2811,18790,4.3,33.3,21099,12445,8654,19.2,32.5,502,0.8,65,0,1942,1942,10693
1997,47,c) 2,6088,6232,53811,54782,210,3.1,1357,19.9,13285,1538,11747,2.8,24.3,15227,8864,6363,16.2,27.8,-1942,-3.5,48.6,0,1120,1120,7844
1997,47,d) 3,5134,5284,46150,47216,192,3.4,987,17.4,9028,1284,7744,2.7,19.1,11159,6043,5116,12.8,23.6,-2131,-4.5,38.2,0,801,801,5038
1997,47,e) 4,4611,4803,43602,44427,204,4,708,14,8425,1197,7228,2.7,19,10074,4049,6025,9.1,22.7,-1649,-3.7,38,0,560,560,3179
1997,47,f) 5,3943,4152,42066,42787,150,3.4,537,12.3,7179,982,6197,2.3,16.8,8620,3490,5130,8.2,20.1,-1441,-3.3,33.6,0,418,418,2653
1997,47,g) 6 to 10,16279,17864,223048,227221,717,3.9,1940,10.5,32688,7202,25486,3.2,14.4,41034,16525,24509,7.3,18.1,-8346,-3.7,28.8,0,1371,1371,12434
1997,47,h) 11 to 15,12674,14396,194856,193454,638,4.3,1189,8.1,31995,7778,24217,4,16.5,29190,11674,17516,6,15.1,2805,1.4,30.2,0,735,735,5310
1997,47,i) 16 to 20,8811,12044,230893,230146,655,5.4,866,7.1,36268,11230,25038,4.9,15.8,34774,7753,27021,3.4,15.1,1494,0.7,30.2,0,400,400,2362
1997,47,l) Left Censored,16893,34641,1245539,1243040,2428,7,2777,8,167129,53907,113222,4.3,13.4,162131,46249,115882,3.7,13,4998,0.4,26,0,694,694,5230
1997,48,a) 0,37049,37633,249950,125507,37344,198.5,0,0,248886,248886,0,198.3,198.3,0,0,0,0,0,248886,198.3,0,0,,,
1997,48,b) 1,28296,28969,245823,243294,331,1,8684,25.9,79885,13074,66811,5.4,32.8,74826,44844,29982,18.4,30.8,5059,2,61.6,0,7058,7058,37102
1997,48,c) 2,23145,23916,214623,222457,892,3.4,5161,19.7,52211,7754,44457,3.5,23.5,67878,39557,28321,17.8,30.5,-15667,-7,47,0,4261,4261,34334
1997,48,d) 3,19689,20573,205260,207491,802,3.6,3812,17.2,49640,8770,40870,4.2,23.9,54101,29311,24790,14.1,26.1,-4461,-2.2,47.8,0,3061,3061,24406
1997,48,e) 4,16986,17746,176713,185620,683,3.6,2701,14.4,37516,5472,32044,2.9,20.2,55329,26070,29259,14,29.8,-17813,-9.6,40.4,0,2160,2160,18659
1997,48,f) 5,15101,16106,187014,191495,609,3.6,2288,13.5,36118,5802,30316,3,18.9,45079,20312,24767,10.6,23.5,-8961,-4.6,37.8,0,1769,1769,16242
1997,48,g) 6 to 10,56379,62304,797077,801001,2819,4.4,7275,11.3,147513,32034,115479,4,18.4,155362,60623,94739,7.6,19.4,-7849,-1,36.8,0,5044,5044,38797
1997,48,h) 11 to 15,43581,51131,719981,720032,2391,4.6,4613,8.8,117855,34414,83441,4.8,16.4,117957,45298,72659,6.3,16.4,-102,0,32.8,0,2762,2762,21419
1997,48,i) 16 to 20,31346,41380,662284,661192,2335,5.5,3687,8.8,106993,34629,72364,5.2,16.2,104809,34390,70419,5.2,15.9,2184,0.3,31.8,0,1806,1806,14128
1997,48,l) Left Censored,43273,105502,3636999,3606029,7807,7.3,9697,9.1,573793,176671,397122,4.9,15.9,511852,168882,342970,4.7,14.2,61941,1.7,28.4,0,2120,2120,16433
1997,49,a) 0,4995,5062,31573,15891,5026,198.6,0,0,31364,31364,0,197.4,197.4,0,0,0,0,0,31364,197.4,0,0,,,
1997,49,b) 1,3718,3790,35232,35938,37,0.8,1095,25.1,10912,677,10235,1.9,30.4,12324,8562,3762,23.8,34.3,-1412,-3.9,60.8,0,876,876,4074
1997,49,c) 2,2862,2934,30548,30398,105,3.3,625,19.5,7778,1136,6642,3.7,25.6,7477,4304,3173,14.2,24.6,301,1,49.2,0,488,488,3388
1997,49,d) 3,2390,2469,24213,24829,99,3.7,450,16.9,5248,872,4376,3.5,21.1,6479,2921,3558,11.8,26.1,-1231,-5,42.2,0,345,345,2301
1997,49,e) 4,1843,1922,19415,20158,88,4.3,319,15.6,3543,713,2830,3.5,17.6,5029,2561,2468,12.7,24.9,-1486,-7.3,35.2,0,248,248,1962
1997,49,f) 5,1647,1716,16483,16978,70,3.9,207,11.6,2983,711,2272,4.2,17.6,3973,1379,2594,8.1,23.4,-990,-5.8,35.2,0,160,160,1134
1997,49,g) 6 to 10,5758,6241,98568,97848,255,4,659,10.2,18613,3903,14710,4,19,17173,6720,10453,6.9,17.6,1440,1.4,35.2,0,454,454,4696
1997,49,h) 11 to 15,3794,4365,73613,74238,203,4.5,398,8.9,10927,2275,8652,3.1,14.7,12177,3706,8471,5,16.4,-1250,-1.7,29.4,0,232,232,1931
1997,49,i) 16 to 20,3285,4034,75614,75899,218,5.3,341,8.3,11204,3098,8106,4.1,14.8,11774,3404,8370,4.5,15.5,-570,-0.7,29.6,0,175,175,1338
1997,49,l) Left Censored,5345,10496,408573,401398,834,7.9,888,8.4,64033,25333,38700,6.3,16,49683,19978,29705,5,12.4,14350,3.6,24.8,0,197,197,1384
1997,50,a) 0,1519,1532,6229,3136,1511,197.3,0,0,6187,6187,0,197.3,197.3,0,0,0,0,0,6187,197.3,0,0,,,
1997,50,b) 1,1132,1139,6714,6764,5,0.4,277,21.5,1830,24,1806,0.4,27.1,1929,1198,731,17.7,28.5,-99,-1.4,54.2,0,228,228,1085
1997,50,c) 2,977,987,5746,5971,30,2.8,182,17.1,1038,192,846,3.2,17.4,1488,633,855,10.6,24.9,-450,-7.5,34.8,0,140,140,504
1997,50,d) 3,881,905,5647,5945,28,2.9,137,14.2,885,159,726,2.7,14.9,1480,628,852,10.6,24.9,-595,-10,29.8,0,109,109,505
1997,50,e) 4,792,802,4541,4698,21,2.5,105,12.4,702,61,641,1.3,14.9,1015,441,574,9.4,21.6,-313,-6.7,29.8,0,85,85,255
1997,50,f) 5,670,684,5151,5226,16,2.2,87,12.1,794,34,760,0.7,15.2,943,470,473,9,18,-149,-2.8,30.4,0,68,68,390
1997,50,g) 6 to 10,3370,3492,27244,27703,111,3.1,327,9.1,3457,462,2995,1.7,12.5,4375,1528,2847,5.5,15.8,-918,-3.3,25,0,250,250,1242
1997,50,h) 11 to 15,2447,2658,31080,29122,118,4.3,229,8.4,7645,5099,2546,17.5,26.3,3729,1414,2315,4.9,12.8,3916,13.5,25.6,0,148,148,613
1997,50,i) 16 to 20,1540,1849,25974,26110,66,3.5,136,7.2,3020,905,2115,3.5,11.6,3292,807,2485,3.1,12.6,-272,-1,23.2,0,74,74,295
1997,50,l) Left Censored,2954,4464,110820,111357,211,4.7,327,7.2,10815,3060,7755,2.7,9.7,11888,4467,7421,4,10.7,-1073,-1,19.4,0,116,116,1100
1997,51,a) 0,12577,12714,69712,34968,12630,198.7,0,0,69489,69489,0,198.7,198.7,0,0,0,0,0,69489,198.7,0,0,,,
1997,51,b) 1,9337,9480,66751,64829,108,1,2612,24.1,21978,4355,17623,6.7,33.9,18134,10579,7555,16.3,28,3844,5.9,56,0,2064,2064,8642
1997,51,c) 2,8293,8525,63158,64776,354,3.9,1621,17.7,14714,2092,12622,3.2,22.7,17950,9857,8093,15.2,27.7,-3236,-5,45.4,0,1300,1300,8443
1997,51,d) 3,6863,7061,60446,61365,278,3.7,1028,13.8,13748,2736,11012,4.5,22.4,15585,8094,7491,13.2,25.4,-1837,-3,44.8,0,800,800,6431
1997,51,e) 4,6088,6267,54477,54954,254,3.9,854,13,10157,1900,8257,3.5,18.5,11110,4531,6579,8.2,20.2,-953,-1.7,37,0,687,687,3844
1997,51,f) 5,5331,5608,55211,54797,212,3.6,643,11,10238,1297,8941,2.4,18.7,9409,3874,5535,7.1,17.2,829,1.5,34.4,0,463,463,2664
1997,51,g) 6 to 10,22486,24145,276879,273684,1033,4.1,2557,10.3,50027,14471,35556,5.3,18.3,43637,16131,27506,5.9,15.9,6390,2.4,31.8,0,1746,1746,9717
1997,51,h) 11 to 15,16365,18974,270903,266472,811,4.2,1572,8.1,46444,10379,36065,3.9,17.4,37581,12029,25552,4.5,14.1,8863,3.3,28.2,0,908,908,5551
1997,51,i) 16 to 20,10742,14108,249309,246896,730,5.1,1167,8.1,40252,9346,30906,3.8,16.3,35426,10300,25126,4.2,14.3,4826,2,28.6,0,536,536,2941
1997,51,l) Left Censored,19991,43577,1410380,1398580,3076,7,3654,8.3,200833,62474,138359,4.5,14.4,177235,58566,118669,4.2,12.7,23598,1.7,25.4,0,780,780,7507
1997,53,a) 0,13440,13586,68624,34519,13455,198.1,0,0,68210,68210,0,197.6,197.6,0,0,0,0,0,68210,197.6,0,0,,,
1997,53,b) 1,10077,10220,63914,64543,99,0.8,3179,26.7,19260,2015,17245,3.1,29.8,20518,12590,7928,19.5,31.8,-1258,-2,59.6,0,2474,2474,10235
1997,53,c) 2,8394,8611,59105,60337,393,4.2,1763,18.9,13692,2287,11405,3.8,22.7,16156,8436,7720,14,26.8,-2464,-4.1,45.4,0,1392,1392,7243
1997,53,d) 3,7257,7441,54017,54782,337,4.2,1314,16.5,11699,1761,9938,3.2,21.4,13228,6265,6963,11.4,24.1,-1529,-2.7,42.8,0,1001,1001,4957
1997,53,e) 4,6146,6389,47006,47795,295,4.4,982,14.6,9497,1920,7577,4,19.9,11074,4981,6093,10.4,23.2,-1577,-3.3,39.8,0,763,763,4017
1997,53,f) 5,5505,5774,52542,52438,268,4.4,848,14,10748,1607,9141,3.1,20.5,10540,4359,6181,8.3,20.1,208,0.4,40.2,0,611,611,3382
1997,53,g) 6 to 10,21045,22499,241552,246298,1028,4.4,2809,12,42957,8849,34108,3.6,17.4,52449,22121,30328,9,21.3,-9492,-3.9,34.8,0,1924,1924,13279
1997,53,h) 11 to 15,14716,16907,234317,234014,799,4.6,1637,9.4,35631,6505,29126,2.8,15.2,35025,11650,23375,5,15,606,0.2,30,0,952,952,5746
1997,53,i) 16 to 20,10961,13909,216344,215582,691,4.9,1215,8.6,35709,8948,26761,4.2,16.6,34185,12060,22125,5.6,15.9,1524,0.7,31.8,0,574,574,5580
1997,53,l) Left Censored,16442,31865,962608,965857,2472,7.7,3156,9.8,148791,48213,100578,5,15.4,155290,72170,83120,7.5,16.1,-6499,-0.7,30.8,0,655,656,5340
1997,54,a) 0,2797,2810,13907,6981,2782,198,0,0,13852,13852,0,198.4,198.4,0,0,0,0,0,13852,198.4,0,0,,,
1997,54,b) 1,2081,2118,15010,15088,19,0.8,618,25.3,4021,477,3544,3.2,26.7,4176,2358,1818,15.6,27.7,-155,-1,53.4,0,505,505,1996
1997,54,c) 2,1877,1905,12966,13713,61,3,377,18.2,2740,343,2397,2.5,20,4234,1964,2270,14.3,30.9,-1494,-10.9,40,0,307,307,1520
1997,54,d) 3,1527,1554,10281,10847,46,2.8,271,16.3,1737,228,1509,2.1,16,2869,1214,1655,11.2,26.4,-1132,-10.4,32,0,213,213,856
1997,54,e) 4,1385,1410,10899,11016,47,3.1,222,14.8,2243,374,1869,3.4,20.4,2476,1369,1107,12.4,22.5,-233,-2.1,40.8,0,180,180,1273
1997,54,f) 5,1244,1309,10207,10167,46,3.3,172,12.5,1992,363,1629,3.6,19.6,1912,843,1069,8.3,18.8,80,0.8,37.6,0,129,129,658
1997,54,g) 6 to 10,5276,5572,57419,58296,207,3.6,542,9.4,7526,1421,6105,2.4,12.9,9280,3334,5946,5.7,15.9,-1754,-3,25.8,0,414,414,2727
1997,54,h) 11 to 15,4247,4754,58066,58344,170,3.5,378,7.8,7656,2397,5259,4.1,13.1,8212,2683,5529,4.6,14.1,-556,-1,26.2,0,232,232,1434
1997,54,i) 16 to 20,3078,3954,55485,55115,199,5,264,6.6,7887,2261,5626,4.1,14.3,7146,2263,4883,4.1,13,741,1.3,26,0,134,134,1003
1997,54,l) Left Censored,6904,12018,286206,285545,690,5.7,892,7.4,35824,9931,25893,3.5,12.5,34503,8101,26402,2.8,12.1,1321,0.4,24.2,0,266,266,1295
1997,55,a) 0,8895,8968,48778,24475,8912,198.8,0,0,48606,48606,0,198.6,198.6,0,0,0,0,0,48606,198.6,0,0,,,
1997,55,b) 1,7070,7151,50859,50166,72,0.9,1641,20.5,15461,4817,10644,9.6,30.8,14075,8175,5900,16.3,28.1,1386,2.7,56.2,0,1298,1298,6378
1997,55,c) 2,6154,6308,45294,46345,217,3.2,1054,15.6,8629,1393,7236,3,18.6,10730,4885,5845,10.5,23.2,-2101,-4.6,37.2,0,844,844,4299
1997,55,d) 3,5443,5560,40783,42489,192,3.3,734,12.6,6685,1009,5676,2.4,15.7,10096,4779,5317,11.2,23.8,-3411,-8.1,31.4,0,588,588,4095
1997,55,e) 4,4865,4987,41580,41731,163,3.1,628,12,7867,2486,5381,6,18.9,8169,3130,5039,7.5,19.6,-302,-0.7,37.8,0,486,486,2471
1997,55,f) 5,4199,4355,37214,38015,123,2.7,480,10.6,5494,889,4605,2.3,14.5,7096,3044,4052,8,18.7,-1602,-4.2,29,0,366,366,2140
1997,55,g) 6 to 10,18251,19739,218901,222078,752,3.7,1926,9.5,30977,6194,24783,2.8,13.9,37331,13466,23865,6.1,16.8,-6354,-2.9,27.8,0,1365,1365,8450
1997,55,h) 11 to 15,13103,14849,212487,210789,544,3.6,1160,7.7,30829,8986,21843,4.3,14.6,27433,8281,19152,3.9,13,3396,1.6,26,0,736,736,4240
1997,55,i) 16 to 20,10186,13060,208357,209712,646,4.9,982,7.4,26435,7751,18684,3.7,12.6,29145,9024,20121,4.3,13.9,-2710,-1.3,25.2,0,490,490,2522
1997,55,l) Left Censored,22084,37574,1331555,1326356,1845,4.9,2711,7.1,148811,38289,110522,2.9,11.2,138413,42710,95703,3.2,10.4,10398,0.8,20.8,0,851,851,5846
1997,56,a) 0,1400,1410,6205,3114,1396,198,0,0,6183,6183,0,198.6,198.6,0,0,0,0,0,6183,198.6,0,0,,,
1997,56,b) 1,1147,1156,5680,5977,15,1.1,313,23.7,1316,71,1245,1.2,22,1909,1083,826,18.1,31.9,-593,-9.9,44,0,235,235,904
1997,56,c) 2,923,933,5376,5500,24,2.4,168,16.7,1115,132,983,2.4,20.3,1363,627,736,11.4,24.8,-248,-4.5,40.6,0,134,134,514
1997,56,d) 3,826,836,5513,5626,32,3.6,134,15.1,994,83,911,1.5,17.7,1219,637,582,11.3,21.7,-225,-4,35.4,0,105,105,525
1997,56,e) 4,684,696,4889,5084,25,3.4,85,11.7,697,108,589,2.1,13.7,1087,418,669,8.2,21.4,-390,-7.7,27.4,0,57,57,330
1997,56,f) 5,552,556,3558,3692,18,3.1,76,12.9,590,53,537,1.4,16,858,419,439,11.3,23.2,-268,-7.2,32,0,58,58,334
1997,56,g) 6 to 10,2071,2203,19423,19702,84,3.6,272,11.8,3018,348,2670,1.8,15.3,3576,1387,2189,7,18.2,-558,-2.9,30.6,0,200,200,988
1997,56,h) 11 to 15,1770,1964,17127,17174,74,3.7,161,8,2636,505,2131,2.9,15.3,2730,789,1941,4.6,15.9,-94,-0.6,30.6,0,96,96,420
1997,56,i) 16 to 20,1539,1816,20800,20781,81,4.4,165,8.9,3184,924,2260,4.4,15.3,3145,930,2215,4.5,15.1,39,0.2,30.2,0,89,89,522
1997,56,l) Left Censored,2261,3520,64923,65342,175,4.8,447,12.2,9164,2333,6831,3.6,14,10002,3825,6177,5.9,15.3,-838,-1.3,28,0,78,78,423
1998,01,a) 0,7477,7516,49450,24801,7464,198.6,0,0,49298,49298,0,198.8,198.8,0,0,0,0,0,49298,198.8,0,0,,,
1998,01,b) 1,5784,5898,43485,44253,11,0.2,1837,26.7,12817,681,12136,1.5,29,14352,8668,5684,19.6,32.4,-1535,-3.4,58,0,1522,1522,7118
1998,01,c) 2,4903,5105,35672,37214,178,3.2,1100,19.7,7444,1364,6080,3.7,20,10528,5387,5141,14.5,28.3,-3084,-8.3,40,0,901,901,4576
1998,01,d) 3,4217,4338,34397,35150,138,2.9,794,17,6838,1225,5613,3.5,19.5,8343,4124,4219,11.7,23.7,-1505,-4.2,39,0,661,661,3342
1998,01,e) 4,3738,3840,39107,38932,128,3.1,661,16.1,9193,667,8526,1.7,23.6,8843,4001,4842,10.3,22.7,350,0.9,45.4,0,537,537,3073
1998,01,f) 5,3219,3318,31192,31990,96,2.7,440,12.6,4589,508,4081,1.6,14.3,6185,2318,3867,7.2,19.3,-1596,-5,28.6,0,361,361,1760
1998,01,g) 6 to 10,12248,13174,156461,157433,403,2.9,1458,10.6,25846,5827,20019,3.7,16.4,27789,10481,17308,6.7,17.7,-1943,-1.3,32.8,0,1121,1121,8161
1998,01,h) 11 to 15,9851,11336,167533,170989,278,2.4,933,8,17176,2738,14438,1.6,10,24087,7887,16200,4.6,14.1,-6911,-4.1,20,0,593,593,3644
1998,01,i) 16 to 20,6259,7785,139421,141483,212,2.7,598,7.5,16622,3774,12848,2.7,11.7,20746,7316,13430,5.2,14.7,-4124,-3,23.4,0,349,349,2229
1998,01,j) 21 to 25,1507,2556,49127,53940,101,3.8,284,10.7,7903,1637,6266,3,14.7,17528,13280,4248,24.6,32.5,-9625,-17.8,29.4,0,71,71,602
1998,01,l) Left Censored,12012,24921,818659,818766,1421,5.7,1764,7,90554,22202,68352,2.7,11.1,90768,29539,61229,3.6,11.1,-214,0,22.2,0,556,556,4452
1998,02,a) 0,1408,1410,7774,3901,1392,197.4,0,0,7747,7747,0,198.6,198.6,0,0,0,0,0,7747,198.6,0,0,,,
1998,02,b) 1,1026,1032,5720,5798,3,0.2,321,26.6,1567,,,,27,1722,914,808,15.8,29.7,-155,-2.7,54,1,228,228,649
1998,02,c) 2,857,870,4772,4947,39,4.1,171,18.2,979,,,,19.8,1329,599,730,12.1,26.9,-350,-7.1,39.6,1,132,132,463
1998,02,d) 3,745,758,4449,4843,29,3.5,143,17.4,718,64,654,1.3,14.8,1506,659,847,13.6,31.1,-788,-16.3,29.6,0,116,116,614
1998,02,e) 4,637,646,4433,4520,21,3.1,100,14.5,866,92,774,2,19.2,1040,406,634,9,23,-174,-3.8,38.4,0,78,78,348
1998,02,f) 5,605,617,3987,4012,19,2.9,87,13.4,895,87,808,2.2,22.3,945,431,514,10.7,23.6,-50,-1.3,44.6,0,66,66,374
1998,02,g) 6 to 10,2172,2276,20049,20486,89,3.8,274,11.5,3020,360,2660,1.8,14.7,3894,1309,2585,6.4,19,-874,-4.3,29.4,0,196,196,951
1998,02,h) 11 to 15,1899,2158,25311,25524,68,3,220,9.8,3380,577,2803,2.3,13.2,3806,1369,2437,5.4,14.9,-426,-1.7,26.4,0,105,105,552
1998,02,i) 16 to 20,1283,1540,19043,18735,71,4.6,91,5.9,3225,1348,1877,7.2,17.2,2609,695,1914,3.7,13.9,616,3.3,27.8,0,49,49,398
1998,02,j) 21 to 25,279,463,7997,8111,23,5,26,5.6,1188,345,843,4.3,14.6,1415,213,1202,2.6,17.4,-227,-2.8,29.2,0,8,8,51
1998,02,l) Left Censored,1670,3242,87495,85656,234,7.2,242,7.4,13480,3664,9816,4.3,15.7,9802,2841,6961,3.3,11.4,3678,4.3,22.8,0,55,55,217
1998,04,a) 0,9584,9654,68635,34437,9577,198.4,0,0,68396,68396,0,198.6,198.6,0,0,0,0,0,68396,198.6,0,0,,,
1998,04,b) 1,7370,7553,62803,61976,33,0.4,2386,27.1,19985,805,19180,1.3,32.2,18330,11228,7102,18.1,29.6,1655,2.6,59.2,0,1941,1941,9351
1998,04,c) 2,5996,6113,55085,55370,197,2.9,1296,19.4,14276,867,13409,1.6,25.8,14846,8579,6267,15.5,26.8,-570,-1,51.6,0,1048,1048,7486
1998,04,d) 3,5103,5268,54422,55524,223,3.9,999,17.6,12549,2001,10548,3.6,22.6,14752,6399,8353,11.5,26.6,-2203,-4,45.2,0,809,809,5515
1998,04,e) 4,4425,4621,46080,50027,139,2.8,806,16.2,7282,1085,6197,2.2,14.6,15176,5729,9447,11.5,30.3,-7894,-15.7,29.2,0,611,611,4656
1998,04,f) 5,3549,3730,39509,40361,144,3.7,556,14.1,7309,1348,5961,3.3,18.1,9013,3865,5148,9.6,22.3,-1704,-4.2,36.2,0,428,428,2748
1998,04,g) 6 to 10,13621,14635,216685,218438,506,3.3,1797,11.7,40200,10190,30010,4.7,18.4,43705,15091,28614,6.9,20,-3505,-1.6,36.8,0,1286,1286,9708
1998,04,h) 11 to 15,10080,12110,196684,196466,534,4.3,1118,9,29329,8535,20794,4.3,14.9,28894,12097,16797,6.2,14.7,435,0.2,29.4,0,692,692,7008
1998,04,i) 16 to 20,6590,8056,141167,145463,259,3.1,678,8.2,22624,5217,17407,3.6,15.6,31215,18384,12831,12.6,21.5,-8591,-5.9,31.2,0,340,340,14516
1998,04,j) 21 to 25,1170,2230,68302,65936,148,6.6,187,8.3,12856,4014,8842,6.1,19.5,8124,2325,5799,3.5,12.3,4732,7.2,24.6,0,63,63,829
1998,04,l) Left Censored,8363,20860,778267,767134,1567,7.5,1590,7.6,109476,31365,78111,4.1,14.3,87210,29826,57384,3.9,11.4,22266,2.9,22.8,0,324,324,3748
1998,05,a) 0,4673,4741,29740,14924,4705,198.5,0,0,29633,29633,0,198.6,198.6,0,0,0,0,0,29633,198.6,0,0,,,
1998,05,b) 1,3601,3633,25386,26758,0,0,1185,27.8,5943,0,5943,0,22.2,8687,5248,3439,19.6,32.5,-2744,-10.3,44.4,0,998,998,4709
1998,05,c) 2,3000,3099,22398,23216,90,2.6,697,20.4,4645,583,4062,2.5,20,6281,3532,2749,15.2,27.1,-1636,-7.1,40,0,573,573,2667
1998,05,d) 3,2779,2852,23097,23677,93,3,555,17.9,4377,449,3928,1.9,18.5,5537,2915,2622,12.3,23.4,-1160,-4.9,37,0,455,455,2540
1998,05,e) 4,2418,2501,19882,20311,69,2.6,376,14.1,3347,342,3005,1.7,16.5,4204,1881,2323,9.3,20.7,-857,-4.2,33,0,305,305,1531
1998,05,f) 5,2081,2134,17026,17444,49,2.2,323,14.2,2836,222,2614,1.3,16.3,3671,1576,2095,9,21,-835,-4.7,32.6,0,265,265,1190
1998,05,g) 6 to 10,7480,7936,76603,77699,230,2.8,929,11.2,11023,2173,8850,2.8,14.2,13214,5433,7781,7,17,-2191,-2.8,28.4,0,694,694,3848
1998,05,h) 11 to 15,6106,6850,87742,88028,202,2.9,607,8.6,10862,1926,8936,2.2,12.3,11434,4038,7396,4.6,13,-572,-0.7,24.6,0,419,419,2539
1998,05,i) 16 to 20,4436,5172,82225,82877,143,2.7,432,8.1,10122,1490,8632,1.8,12.2,11425,3587,7838,4.3,13.8,-1303,-1.6,24.4,0,275,275,1818
1998,05,j) 21 to 25,958,1455,33709,33756,60,4,115,7.8,3469,605,2864,1.8,10.3,3562,738,2824,2.2,10.6,-93,-0.3,20.6,0,53,53,191
1998,05,l) Left Censored,7869,14933,514745,513641,856,5.7,1109,7.4,60420,20980,39440,4.1,11.8,58211,22116,36095,4.3,11.3,2209,0.5,22.6,0,372,372,2570
1998,06,a) 0,60833,61294,427598,214602,60821,198.5,0,0,425992,425992,0,198.5,198.5,0,0,0,0,0,425992,198.5,0,0,,,
1998,06,b) 1,45692,46582,393630,390420,129,0.2,13669,25.3,117863,6001,111862,1.5,30.2,111442,66481,44961,17,28.5,6421,1.7,57,0,10886,10886,54872
1998,06,c) 2,38709,39561,350716,359770,1429,3.3,8286,19.2,83823,10445,73378,2.9,23.3,101930,55529,46401,15.4,28.3,-18107,-5,46.6,0,6619,6619,45145
1998,06,d) 3,32296,33365,332315,335205,1374,3.8,5949,16.6,73649,10047,63602,3,22,79428,39870,39558,11.9,23.7,-5779,-1.7,44,0,4670,4670,30478
1998,06,e) 4,27562,28486,310342,315001,1073,3.6,4362,14.5,59749,8007,51742,2.5,19,69066,30960,38106,9.8,21.9,-9317,-2.9,38,0,3412,3412,25040
1998,06,f) 5,23453,24406,273039,274854,895,3.5,3486,13.6,55354,6808,48546,2.5,20.1,58983,27369,31614,10,21.5,-3629,-1.4,40.2,0,2666,2666,19889
1998,06,g) 6 to 10,103816,111586,1348603,1351848,4469,3.9,12918,11.1,245014,37142,207872,2.7,18.1,251503,97037,154466,7.2,18.6,-6489,-0.5,36.2,0,9329,9329,67054
1998,06,h) 11 to 15,77878,89241,1390212,1392105,3585,3.9,7986,8.7,200031,35077,164954,2.5,14.4,203817,75970,127847,5.5,14.6,-3786,-0.2,28.8,0,5042,5042,34538
1998,06,i) 16 to 20,56274,67530,1178904,1165749,2097,3,5437,7.8,172076,27992,144084,2.4,14.8,145765,45682,100083,3.9,12.5,26311,2.3,25,0,3267,3267,21262
1998,06,j) 21 to 25,10653,18973,464422,452556,986,5.1,1453,7.6,78223,22405,55818,5,17.3,54491,16982,37509,3.8,12,23732,5.3,24,0,546,546,3351
1998,06,l) Left Censored,70481,152748,5343592,5300680,10261,6.7,12824,8.3,745043,238310,506733,4.5,14.1,659219,222094,437125,4.2,12.4,85824,1.7,24.8,0,3411,3411,30162
1998,08,a) 0,11690,11743,63303,31748,11672,198.8,0,0,63110,63110,0,198.8,198.8,0,0,0,0,0,63110,198.8,0,0,,,
1998,08,b) 1,8761,8895,64337,62718,46,0.4,2677,26,20875,1546,19329,2.5,33.3,17637,10655,6982,17,28.1,3238,5.2,56.2,0,2113,2113,8855
1998,08,c) 2,7172,7311,50761,52572,269,3.4,1556,19.5,10986,1125,9861,2.1,20.9,14607,8623,5984,16.4,27.8,-3621,-6.9,41.8,0,1236,1236,7021
1998,08,d) 3,6290,6462,50939,53379,245,3.5,1190,17.1,11276,2170,9106,4.1,21.1,16156,8316,7840,15.6,30.3,-4880,-9.2,42.2,0,925,925,6506
1998,08,e) 4,5617,5773,47270,47935,180,2.9,918,14.9,9683,1917,7766,4,20.2,11013,5376,5637,11.2,23,-1330,-2.8,40.4,0,703,703,4530
1998,08,f) 5,4624,4758,40573,40740,149,3,629,12.6,8064,1545,6519,3.8,19.8,8397,3982,4415,9.8,20.6,-333,-0.8,39.6,0,465,465,2711
1998,08,g) 6 to 10,16392,17512,195879,196587,630,3.5,1922,10.6,32024,6102,25922,3.1,16.3,33439,13302,20137,6.8,17,-1415,-0.7,32.6,0,1347,1347,8637
1998,08,h) 11 to 15,11429,13361,201083,199599,654,4.8,1155,8.5,32597,10103,22494,5.1,16.3,29628,9565,20063,4.8,14.8,2969,1.5,29.6,0,719,719,4936
1998,08,i) 16 to 20,8203,9723,156300,156596,368,3.7,747,7.5,21557,5115,16442,3.3,13.8,22148,7340,14808,4.7,14.1,-591,-0.3,27.6,0,449,449,2796
1998,08,j) 21 to 25,1498,2665,62788,60465,159,6,167,6.3,12102,3313,8789,5.5,20,7455,2115,5340,3.5,12.3,4647,7.7,24.6,0,64,64,436
1998,08,l) Left Censored,11289,23271,782798,770387,1739,7.5,1750,7.5,113931,34127,79804,4.4,14.8,89108,26718,62390,3.5,11.6,24823,3.2,23.2,0,426,426,2946
1998,09,a) 0,5723,5763,38104,19104,5719,198.5,0,0,38000,38000,0,198.9,198.9,0,0,0,0,0,38000,198.9,0,0,,,
1998,09,b) 1,4331,4394,30177,30245,13,0.3,1142,22.8,8666,537,8129,1.8,28.7,8801,4983,3818,16.5,29.1,-135,-0.4,57.4,0,895,895,3696
1998,09,c) 2,3805,3905,36085,37313,137,3.3,677,16.2,6490,895,5595,2.4,17.4,8946,4383,4563,11.7,24,-2456,-6.6,34.8,0,550,550,3956
1998,09,d) 3,3566,3664,29263,30749,112,2.9,579,14.8,5820,628,5192,2,18.9,8792,4751,4041,15.5,28.6,-2972,-9.7,37.8,0,469,469,4071
1998,09,e) 4,3094,3147,26877,27720,107,3.2,463,13.9,5137,523,4614,1.9,18.5,6822,3223,3599,11.6,24.6,-1685,-6.1,37,0,373,373,2595
1998,09,f) 5,2785,2845,23425,24529,89,3,405,13.5,4344,981,3363,4,17.7,6552,3648,2904,14.9,26.7,-2208,-9,35.4,0,323,323,2805
1998,09,g) 6 to 10,12348,12930,142052,142882,425,3.2,1369,10.2,21166,4794,16372,3.4,14.8,22825,7474,15351,5.2,16,-1659,-1.2,29.6,0,985,985,5205
1998,09,h) 11 to 15,10133,11050,137857,136762,326,2.9,888,7.8,20961,6891,14070,5,15.3,18771,6868,11903,5,13.7,2190,1.6,27.4,0,629,629,4371
1998,09,i) 16 to 20,6680,7626,102304,102356,191,2.4,571,7.3,13922,3947,9975,3.9,13.6,14026,3843,10183,3.8,13.7,-104,-0.1,27.2,0,376,376,2193
1998,09,j) 21 to 25,1438,2083,44488,44727,108,5.1,140,6.7,7257,1691,5566,3.8,16.2,7735,1215,6520,2.7,17.3,-478,-1.1,32.4,0,73,73,244
1998,09,l) Left Censored,15131,24542,875044,878976,1200,4.8,2022,8.1,99605,30903,68702,3.5,11.3,107468,32113,75355,3.7,12.2,-7863,-0.9,22.6,0,615,615,3833
1998,10,a) 0,1739,1746,10963,5496,1736,198.9,0,0,10934,10934,0,198.9,198.9,0,0,0,0,0,10934,198.9,0,0,,,
1998,10,b) 1,1276,1290,7842,8138,4,0.3,306,21.1,1662,31,1631,0.4,20.4,2253,1056,1197,13,27.7,-591,-7.3,40.8,0,245,245,862
1998,10,c) 2,1056,1085,9513,10217,30,2.6,192,16.4,1563,223,1340,2.2,15.3,2971,1368,1603,13.4,29.1,-1408,-13.8,30.6,0,161,161,1270
1998,10,d) 3,999,1016,7808,8132,30,2.8,148,13.8,1136,92,1044,1.1,14,1783,1098,685,13.5,21.9,-647,-7.9,28,0,119,119,942
1998,10,e) 4,820,847,7832,7710,18,2,142,15.6,1710,83,1627,1.1,22.2,1466,778,688,10.1,19,244,3.2,38,0,116,116,730
1998,10,f) 5,726,736,6069,6021,25,3.2,98,12.6,1421,172,1249,2.9,23.6,1324,712,612,11.8,22,97,1.6,44,0,78,78,610
1998,10,g) 6 to 10,2759,2860,28635,29432,95,3.2,335,11.2,4190,803,3387,2.7,14.2,5783,2365,3418,8,19.6,-1593,-5.4,28.4,0,239,239,1158
1998,10,h) 11 to 15,1958,2167,26821,26942,77,3.4,208,9.3,3706,936,2770,3.5,13.8,3947,1347,2600,5,14.6,-241,-0.8,27.6,0,135,135,720
1998,10,i) 16 to 20,1307,1497,21574,21833,42,2.7,107,7,2964,1120,1844,5.1,13.6,3482,766,2716,3.5,15.9,-518,-2.3,27.2,0,46,46,366
1998,10,j) 21 to 25,347,547,28238,26348,32,5.8,30,5.5,5451,1035,4416,3.9,20.7,1670,655,1015,2.5,6.3,3781,14.4,12.6,0,8,8,20
1998,10,l) Left Censored,3303,5721,190820,191669,377,6.5,498,8.6,25874,8827,17047,4.6,13.5,27571,7315,20256,3.8,14.4,-1697,-0.9,27,0,100,100,1360
1998,11,a) 0,1075,1078,8506,4264,1070,198.5,0,0,8484,8484,0,199,199,0,0,0,0,0,8484,199,0,0,,,
1998,11,b) 1,927,944,9823,9302,2,0.2,199,18.9,2468,,,,26.5,1426,798,628,8.6,15.3,1042,11.2,30.6,1,154,154,659
1998,11,c) 2,773,782,6123,6241,35,4.2,140,16.7,1153,,,,18.5,1388,720,668,11.5,22.2,-235,-3.7,37,1,100,100,637
1998,11,d) 3,690,712,7397,7407,23,3.1,99,13.2,1588,598,990,8.1,21.4,1608,659,949,8.9,21.7,-20,-0.3,42.8,0,75,75,575
1998,11,e) 4,635,653,5822,6005,15,2.2,97,14,894,38,856,0.6,14.9,1260,661,599,11,21,-366,-6.1,29.8,0,75,75,413
1998,11,f) 5,533,546,5926,6123,12,2.1,71,12.3,1026,171,855,2.8,16.8,1419,858,561,14,23.2,-393,-6.4,33.6,0,57,57,815
1998,11,g) 6 to 10,2420,2605,40457,40624,104,3.9,267,9.9,5200,1300,3900,3.2,12.8,5533,2192,3341,5.4,13.6,-333,-0.8,25.6,0,175,175,1374
1998,11,h) 11 to 15,2008,2195,31943,31896,67,3,198,8.8,4585,904,3681,2.8,14.4,4491,1461,3030,4.6,14.1,94,0.3,28.2,0,125,125,825
1998,11,i) 16 to 20,1485,1705,36924,36589,66,3.8,133,7.6,4531,734,3797,2,12.4,3860,1161,2699,3.2,10.5,671,1.9,21,0,64,64,376
1998,11,j) 21 to 25,380,576,36197,35017,20,3.4,30,5.2,5279,494,4785,1.4,15.1,2918,838,2080,2.4,8.3,2361,6.8,16.6,0,9,9,175
1998,11,l) Left Censored,3840,5993,211557,213151,368,6.1,518,8.5,23327,6276,17051,2.9,10.9,26514,6343,20171,3,12.4,-3187,-1.5,21.8,0,135,135,901
1998,12,a) 0,36977,37137,212544,106608,36883,198.6,0,0,211873,211873,0,198.7,198.7,0,0,0,0,0,211873,198.7,0,0,,,
1998,12,b) 1,27488,27888,223604,221738,74,0.2,9187,28,66336,1703,64633,0.8,29.9,62604,39872,22732,18,28.2,3732,1.7,56.4,0,7567,7567,33540
1998,12,c) 2,22897,23365,175071,181017,750,2.9,5511,21.3,39686,3855,35831,2.1,21.9,51577,28380,23197,15.7,28.5,-11891,-6.6,43.8,0,4500,4500,23517
1998,12,d) 3,19861,20281,158645,161217,701,3.2,3903,17.8,34965,5323,29642,3.3,21.7,40108,21708,18400,13.5,24.9,-5143,-3.2,43.4,0,3203,3203,18304
1998,12,e) 4,17674,18106,160964,162947,562,2.9,3098,16,34328,5651,28677,3.5,21.1,38294,21244,17050,13,23.5,-3966,-2.4,42.2,0,2456,2456,17168
1998,12,f) 5,15485,16193,152017,154741,500,2.9,2415,14.1,28254,4015,24239,2.6,18.3,33702,17791,15911,11.5,21.8,-5448,-3.5,36.6,0,1908,1908,13701
1998,12,g) 6 to 10,58192,62230,690828,696324,1879,2.9,7354,11.3,128553,22946,105607,3.3,18.5,139545,61612,77933,8.8,20,-10992,-1.5,37,0,5458,5458,40151
1998,12,h) 11 to 15,37636,43131,656370,644808,1295,2.9,4092,9.2,118812,32190,86622,5,18.4,95688,39219,56469,6.1,14.8,23124,3.6,29.6,0,2614,2614,22184
1998,12,i) 16 to 20,23530,28052,429292,432440,794,2.7,2617,9,54534,11253,43281,2.6,12.6,60829,22010,38819,5.1,14.1,-6295,-1.5,25.2,0,1523,1523,10217
1998,12,j) 21 to 25,4337,8343,158031,158965,419,4.9,683,8.1,27497,9162,18335,5.8,17.3,29364,11040,18324,6.9,18.5,-1867,-1.2,34.6,0,253,253,1997
1998,12,l) Left Censored,30246,77737,2614847,2599385,5927,7.6,7342,9.4,370804,119229,251575,4.6,14.3,339880,112431,227449,4.3,13.1,30924,1.2,26.2,0,1508,1508,12893
1998,13,a) 0,16486,16555,107469,53967,16432,198.5,0,0,107004,107004,0,198.3,198.3,0,0,0,0,0,107004,198.3,0,0,,,
1998,13,b) 1,12053,12312,89643,90782,38,0.3,3734,26.1,27411,1977,25434,2.2,30.2,29688,18385,11303,20.3,32.7,-2277,-2.5,60.4,0,3010,3010,15880
1998,13,c) 2,10053,10319,83147,86531,391,3.5,2313,20.4,18123,2514,15609,2.9,20.9,24890,14110,10780,16.3,28.8,-6767,-7.9,41.8,0,1838,1838,12258
1998,13,d) 3,8533,8825,78596,80078,287,3,1565,16.5,17294,1780,15514,2.2,21.6,20257,10880,9377,13.6,25.3,-2963,-3.7,43.2,0,1249,1249,8418
1998,13,e) 4,7513,7735,76202,79106,224,2.7,1173,14.3,13749,1733,12016,2.2,17.4,19556,8066,11490,10.2,24.7,-5807,-7.3,34.8,0,898,898,6170
1998,13,f) 5,6362,6647,69155,68576,254,3.6,898,12.9,15397,4201,11196,6.1,22.5,14238,6319,7919,9.2,20.8,1159,1.7,41.6,0,688,688,4850
1998,13,g) 6 to 10,23139,25039,300388,304767,868,3.3,2945,11.3,52317,12853,39464,4.2,17.2,61074,28466,32608,9.3,20,-8757,-2.8,34.4,0,2102,2102,18515
1998,13,h) 11 to 15,17193,19564,296469,296310,641,3.2,1776,8.8,41792,7724,34068,2.6,14.1,41475,15811,25664,5.3,14,317,0.1,28,0,1116,1116,7966
1998,13,i) 16 to 20,10705,13331,231919,232877,433,3.2,1058,7.8,34937,11912,23025,5.1,15,36853,12805,24048,5.5,15.8,-1916,-0.8,30,0,621,621,5452
1998,13,j) 21 to 25,2381,4290,96792,97490,261,6,335,7.7,15768,5353,10415,5.5,16.2,17163,6619,10544,6.8,17.6,-1395,-1.4,32.4,0,105,105,567
1998,13,l) Left Censored,18846,44779,1683607,1677538,3442,7.7,3720,8.3,233346,70746,162600,4.2,13.9,221208,73104,148104,4.4,13.2,12138,0.7,26.4,0,822,822,6909
1998,15,a) 0,1857,1876,12894,6476,1854,197.7,0,0,12837,12837,0,198.2,198.2,0,0,0,0,0,12837,198.2,0,0,,,
1998,15,b) 1,1431,1438,9970,9855,6,0.4,428,25.7,2879,,,,29.2,2648,1561,1087,15.8,26.9,231,2.3,53.8,1,340,340,1329
1998,15,c) 2,1290,1353,10621,11490,24,1.6,262,17.8,1818,,,,15.8,3555,2237,1318,19.5,30.9,-1737,-15.1,31.6,1,222,222,2118
1998,15,d) 3,1082,1107,10062,10683,41,3.4,206,17.2,2136,311,1825,2.9,20,3378,2366,1012,22.1,31.6,-1242,-11.6,40,0,166,166,771
1998,15,e) 4,954,980,13961,14749,26,2.5,168,16,1070,152,918,1,7.3,2646,1278,1368,8.7,17.9,-1576,-10.6,14.6,0,136,136,801
1998,15,f) 5,882,930,8971,8777,40,4.2,107,11.1,1923,254,1669,2.9,21.9,1535,597,938,6.8,17.5,388,4.4,35,0,89,89,504
1998,15,g) 6 to 10,3831,4189,45118,46561,149,3.4,479,11,5450,1469,3981,3.2,11.7,8336,3554,4782,7.6,17.9,-2886,-6.2,23.4,0,354,354,1724
1998,15,h) 11 to 15,2923,3400,44332,45312,105,3,287,8.2,4622,1148,3474,2.5,10.2,6582,2394,4188,5.3,14.5,-1960,-4.3,20.4,0,200,200,1076
1998,15,i) 16 to 20,2453,2957,37477,39386,59,1.9,243,8,2702,339,2363,0.9,6.9,6519,2147,4372,5.5,16.6,-3817,-9.7,13.8,0,129,129,456
1998,15,j) 21 to 25,506,912,15192,15547,24,2.6,62,6.7,1352,194,1158,1.2,8.7,2062,739,1323,4.8,13.3,-710,-4.6,17.4,0,21,21,86
1998,15,l) Left Censored,4159,7662,205384,208647,363,4.7,622,8,19807,5245,14562,2.5,9.5,26333,7768,18565,3.7,12.6,-6526,-3.1,19,0,140,140,664
1998,16,a) 0,3124,3147,18950,9556,3104,197.3,0,0,18789,18789,0,196.6,196.6,0,0,0,0,0,18789,196.6,0,0,,,
1998,16,b) 1,2488,2534,17568,17027,4,0.1,818,27.6,6211,,,,36.5,5129,3151,1978,18.5,30.1,1082,6.4,60.2,1,619,619,2457
1998,16,c) 2,2000,2034,14277,14561,74,3.3,413,18.7,3058,,,,21,3626,1877,1749,12.9,24.9,-568,-3.9,42,1,341,341,1647
1998,16,d) 3,1661,1683,10578,11045,60,3.3,317,17.4,2011,291,1720,2.6,18.2,2944,1475,1469,13.4,26.7,-933,-8.5,36.4,0,238,238,1189
1998,16,e) 4,1499,1537,11379,11557,55,3.3,257,15.6,2301,176,2125,1.5,19.9,2656,1223,1433,10.6,23,-355,-3.1,39.8,0,194,194,996
1998,16,f) 5,1197,1247,9494,9680,59,4.6,158,12.2,1533,276,1257,2.9,15.8,1904,631,1273,6.5,19.7,-371,-3.9,31.6,0,118,118,538
1998,16,g) 6 to 10,4442,4673,41277,42546,181,3.7,558,11.5,6226,1297,4929,3,14.6,8764,3297,5467,7.7,20.6,-2538,-6,29.2,0,377,377,1991
1998,16,h) 11 to 15,3074,3463,45378,44113,151,4.3,309,8.7,8962,4512,4450,10.2,20.3,6431,2400,4031,5.4,14.6,2531,5.7,29.2,0,188,188,1204
1998,16,i) 16 to 20,2243,2627,43047,42005,77,2.8,217,8,6806,1399,5407,3.3,16.2,4722,1619,3103,3.9,11.2,2084,5,22.4,0,128,128,830
1998,16,j) 21 to 25,488,752,17023,16864,30,3.9,52,6.8,2033,478,1555,2.8,12.1,1714,459,1255,2.7,10.2,319,1.9,20.4,0,20,20,94
1998,16,l) Left Censored,3792,6939,180178,179862,419,6,439,6.3,21212,5994,15218,3.3,11.8,20580,4620,15960,2.6,11.4,632,0.4,22.8,0,158,158,855
1998,17,a) 0,20086,20219,132810,66674,20065,198.5,0,0,132272,132272,0,198.4,198.4,0,0,0,0,0,132272,198.4,0,0,,,
1998,17,b) 1,15923,16233,117339,118853,69,0.4,4027,21.9,30673,2278,28395,1.9,25.8,33700,18648,15052,15.7,28.4,-3027,-2.6,51.6,0,3158,3158,15080
1998,17,c) 2,13826,14060,114467,113795,386,2.5,2477,16.4,28272,2499,25773,2.2,24.8,26927,13733,13194,12.1,23.7,1345,1.1,47.4,0,1991,1991,11748
1998,17,d) 3,12379,12736,107962,109634,409,3,1868,13.9,20438,3294,17144,3,18.6,23782,10599,13183,9.7,21.7,-3344,-3.1,37.2,0,1456,1456,8673
1998,17,e) 4,10870,11113,102244,105174,329,2.8,1422,12.2,17584,2126,15458,2,16.7,23443,11070,12373,10.5,22.3,-5859,-5.6,33.4,0,1112,1112,9816
1998,17,f) 5,9658,9972,95475,100018,307,2.9,1268,12.1,15917,2277,13640,2.3,15.9,25003,9155,15848,9.2,25,-9086,-9.1,31.8,0,963,963,6331
1998,17,g) 6 to 10,39058,41359,488984,492827,1160,2.7,4169,9.7,75885,10544,65341,2.1,15.4,83570,35785,47785,7.3,17,-7685,-1.6,30.8,0,3016,3016,23474
1998,17,h) 11 to 15,29826,33499,531843,534351,964,2.8,2552,7.4,65867,12862,53005,2.4,12.3,70882,19637,51245,3.7,13.3,-5015,-1,24.6,0,1715,1715,11869
1998,17,i) 16 to 20,20847,24103,401505,398054,540,2.2,1746,7.1,54464,6997,47467,1.8,13.7,47562,14400,33162,3.6,11.9,6902,1.8,23.8,0,1075,1075,7587
1998,17,j) 21 to 25,4626,7642,168823,167252,367,4.8,474,6.2,21830,6154,15676,3.7,13.1,18688,5408,13280,3.2,11.2,3142,1.9,22.4,0,189,189,1089
1998,17,l) Left Censored,42243,78179,2894666,2881793,4106,5.2,5418,6.9,335963,84264,251699,2.9,11.7,310216,89065,221151,3.1,10.8,25747,0.9,21.6,0,1809,1809,14988
1998,18,a) 0,9728,9826,69864,35160,9748,198.4,0,0,69409,69409,0,197.4,197.4,0,0,0,0,0,69409,197.4,0,0,,,
1998,18,b) 1,7563,7671,56626,55396,41,0.5,2066,23.6,17069,1884,15185,3.4,30.8,14608,8263,6345,14.9,26.4,2461,4.4,52.8,0,1703,1703,6740
1998,18,c) 2,6450,6652,57160,58218,187,2.6,1336,18.4,11081,1503,9578,2.6,19,13197,6722,6475,11.5,22.7,-2116,-3.7,38,0,1115,1115,5544
1998,18,d) 3,5811,5975,46758,48115,160,2.5,952,14.9,7875,733,7142,1.5,16.4,10588,4645,5943,9.7,22,-2713,-5.6,32.8,0,760,760,3810
1998,18,e) 4,5096,5249,45621,47071,145,2.6,752,13.5,8186,2064,6122,4.4,17.4,11086,4506,6580,9.6,23.6,-2900,-6.2,34.8,0,603,603,3480
1998,18,f) 5,4536,4698,40470,41320,97,2,565,11.4,6814,604,6210,1.5,16.5,8514,3854,4660,9.3,20.6,-1700,-4.1,33,0,445,445,2717
1998,18,g) 6 to 10,18110,19608,238704,242964,485,2.4,1945,9.6,34654,5034,29620,2.1,14.3,43173,17384,25789,7.2,17.8,-8519,-3.5,28.6,0,1429,1429,11240
1998,18,h) 11 to 15,14268,16551,240880,241319,448,2.6,1254,7.4,33345,6454,26891,2.7,13.8,34222,13444,20778,5.6,14.2,-877,-0.4,27.6,0,844,844,6402
1998,18,i) 16 to 20,9314,10881,175020,176103,246,2.2,767,6.9,21520,4797,16723,2.7,12.2,23686,6408,17278,3.6,13.5,-2166,-1.3,24.4,0,467,467,3264
1998,18,j) 21 to 25,2133,3789,94546,94690,134,3.5,320,8.2,12288,2264,10024,2.4,13,12576,4935,7641,5.2,13.3,-288,-0.3,26,0,96,96,775
1998,18,l) Left Censored,20275,40569,1428055,1422533,2137,5.2,2622,6.4,150574,42683,107891,3,10.6,139530,40757,98773,2.9,9.8,11044,0.8,19.6,0,809,809,7239
1998,19,a) 0,4868,4903,33011,16547,4864,198.4,0,0,32928,32928,0,199,199,0,0,0,0,0,32928,199,0,0,,,
1998,19,b) 1,3772,3888,27472,27433,22,0.5,1025,23.2,7724,1224,6500,4.5,28.2,7646,4868,2778,17.7,27.9,78,0.3,55.8,0,804,804,3751
1998,19,c) 2,3346,3401,24255,24390,86,2.3,609,16.6,4463,492,3971,2,18.3,4733,2302,2431,9.4,19.4,-270,-1.1,36.6,0,467,467,1869
1998,19,d) 3,3052,3143,23448,23523,87,2.6,410,12.4,3962,464,3498,2,16.8,4111,1876,2235,8,17.5,-149,-0.7,33.6,0,319,319,1492
1998,19,e) 4,2739,2800,21420,21816,86,2.9,352,12,3301,501,2800,2.3,15.1,4093,1532,2561,7,18.8,-792,-3.7,30.2,0,279,279,1255
1998,19,f) 5,2276,2314,15855,16262,57,2.3,293,12,2271,280,1991,1.7,14,3085,1179,1906,7.3,19,-814,-5,28,0,232,232,950
1998,19,g) 6 to 10,9293,9839,99676,102007,266,2.6,968,9.5,12497,1956,10541,1.9,12.3,17159,6288,10871,6.2,16.8,-4662,-4.5,24.6,0,696,696,4216
1998,19,h) 11 to 15,7577,8852,132186,131797,282,3.1,678,7.5,15727,2626,13101,2,11.9,14949,5483,9466,4.2,11.3,778,0.6,22.6,0,458,458,2920
1998,19,i) 16 to 20,6073,7321,89617,89710,142,1.9,475,6.3,11279,1306,9973,1.5,12.6,11464,4768,6696,5.3,12.8,-185,-0.2,25.2,0,294,294,1651
1998,19,j) 21 to 25,1445,2448,40196,39810,91,3.7,141,5.7,4397,740,3657,1.9,11,3624,1190,2434,3,9.1,773,1.9,18.2,0,51,51,131
1998,19,l) Left Censored,13694,23485,686814,679289,979,4.1,1393,5.9,74243,15583,58660,2.3,10.9,59193,14347,44846,2.1,8.7,15050,2.2,17.4,0,542,542,3907
1998,20,a) 0,5072,5105,33663,16876,5072,198.7,0,0,33574,33574,0,198.9,198.9,0,0,0,0,0,33574,198.9,0,0,,,
1998,20,b) 1,3934,4009,29785,29450,23,0.5,1160,25,8366,498,7868,1.7,28.4,7695,4722,2973,16,26.1,671,2.3,52.2,0,932,932,3958
1998,20,c) 2,3362,3414,23193,24128,100,2.7,635,17.2,4893,771,4122,3.2,20.3,6763,3163,3600,13.1,28,-1870,-7.7,40.6,0,539,539,2693
1998,20,d) 3,2960,3022,23644,24844,99,3.1,511,15.8,4155,339,3816,1.4,16.7,6554,3784,2770,15.2,26.4,-2399,-9.7,33.4,0,405,405,3167
1998,20,e) 4,2527,2582,21395,21887,84,3,429,15.5,3666,647,3019,3,16.7,4649,2206,2443,10.1,21.2,-983,-4.5,33.4,0,338,338,1621
1998,20,f) 5,2228,2283,19682,20005,78,3.2,305,12.7,3497,823,2674,4.1,17.5,4142,1819,2323,9.1,20.7,-645,-3.2,35,0,231,231,1509
1998,20,g) 6 to 10,8717,9316,95895,97279,289,3,1005,10.4,15240,2804,12436,2.9,15.7,18007,8837,9170,9.1,18.5,-2767,-2.8,31.4,0,736,736,4259
1998,20,h) 11 to 15,7150,7904,99611,101069,232,2.9,677,8.3,12107,2287,9820,2.3,12,15023,5710,9313,5.6,14.9,-2916,-2.9,24,0,459,459,3052
1998,20,i) 16 to 20,5297,6153,79512,79839,147,2.3,440,7,10477,2411,8066,3,13.1,11131,3677,7454,4.6,13.9,-654,-0.8,26.2,0,267,267,1378
1998,20,j) 21 to 25,1219,2083,35320,34787,118,5.6,152,7.2,5227,2127,3100,6.1,15,4160,1328,2832,3.8,12,1067,3,24,0,50,50,269
1998,20,l) Left Censored,11151,20008,595361,589986,1116,5.5,1295,6.4,73280,18976,54304,3.2,12.4,62530,21516,41014,3.6,10.6,10750,1.8,21.2,0,434,434,4387
1998,21,a) 0,6382,6439,45329,22711,6403,198.9,0,0,45237,45237,0,199.2,199.2,0,0,0,0,0,45237,199.2,0,0,,,
1998,21,b) 1,4846,4946,35173,36007,22,0.4,1421,25,9285,329,8956,0.9,25.8,10952,6316,4636,17.5,30.4,-1667,-4.6,51.6,0,1179,1179,5538
1998,21,c) 2,4003,4133,35569,36354,124,2.8,812,18.1,7082,1010,6072,2.8,19.5,8651,4096,4555,11.3,23.8,-1569,-4.3,39,0,670,670,3481
1998,21,d) 3,3720,3842,33083,34008,103,2.5,625,15.2,5702,677,5025,2,16.8,7552,3932,3620,11.6,22.2,-1850,-5.4,33.6,0,512,512,3079
1998,21,e) 4,3141,3235,28784,29953,85,2.5,461,13.4,4571,715,3856,2.4,15.3,6909,3561,3348,11.9,23.1,-2338,-7.8,30.6,0,374,374,3022
1998,21,f) 5,2874,2986,28047,28453,89,2.8,356,11.4,4411,586,3825,2.1,15.5,5223,1837,3386,6.5,18.4,-812,-2.9,31,0,295,295,1566
1998,21,g) 6 to 10,11273,12110,129555,131259,341,2.7,1230,9.8,18964,3347,15617,2.5,14.4,22372,8190,14182,6.2,17,-3408,-2.6,28.8,0,927,927,6298
1998,21,h) 11 to 15,8861,9912,143234,144866,320,3.2,771,7.6,16150,4664,11486,3.2,11.1,19414,5900,13514,4.1,13.4,-3264,-2.3,22.2,0,501,501,2997
1998,21,i) 16 to 20,5645,6562,115393,116751,185,2.8,491,7.3,14259,2411,11848,2.1,12.2,16974,4638,12336,4,14.5,-2715,-2.3,24.4,0,309,309,2164
1998,21,j) 21 to 25,1288,2264,51661,50905,137,6,158,6.9,7594,2068,5526,4.1,14.9,6082,2446,3636,4.8,11.9,1512,3,23.8,0,67,67,414
1998,21,l) Left Censored,12124,23956,776165,773536,1401,5.8,1699,7,95209,31762,63447,4.1,12.3,89950,25535,64415,3.3,11.6,5259,0.7,23.2,0,477,477,2679
1998,22,a) 0,7139,7224,54394,27492,7180,198.8,0,0,53804,53804,0,195.7,195.7,0,0,0,0,0,53804,195.7,0,0,,,
1998,22,b) 1,5469,5558,48291,47893,14,0.2,1593,24.8,14459,1184,13275,2.5,30.2,13663,8323,5340,17.4,28.5,796,1.7,57,0,1303,1303,7250
1998,22,c) 2,4593,4659,41014,42366,151,3,937,18.5,9530,1649,7881,3.9,22.5,12233,7567,4666,17.9,28.9,-2703,-6.4,45,0,772,772,5244
1998,22,d) 3,4070,4149,46270,47086,120,2.7,646,14.6,9397,1150,8247,2.4,20,11029,4586,6443,9.7,23.4,-1632,-3.4,40,0,531,531,3722
1998,22,e) 4,3738,3874,38300,40234,73,1.8,551,13.4,6637,577,6060,1.4,16.5,10504,4647,5857,11.5,26.1,-3867,-9.6,33,0,443,443,4012
1998,22,f) 5,3224,3335,37266,38114,79,2.3,432,12.3,6508,491,6017,1.3,17.1,8204,4037,4167,10.6,21.5,-1696,-4.4,34.2,0,340,340,3458
1998,22,g) 6 to 10,11816,12683,152151,154416,371,2.8,1405,10.6,23587,4527,19060,2.9,15.3,28117,10920,17197,7.1,18.2,-4530,-2.9,30.6,0,1022,1022,7934
1998,22,h) 11 to 15,9980,11302,157470,157897,300,2.6,884,7.6,20660,2450,18210,1.6,13.1,21514,7792,13722,4.9,13.6,-854,-0.5,26.2,0,544,544,3979
1998,22,i) 16 to 20,7960,9506,150550,151902,221,2.3,651,6.7,19669,3701,15968,2.4,12.9,22372,6233,16139,4.1,14.7,-2703,-1.8,25.8,0,400,400,2721
1998,22,j) 21 to 25,1514,2490,41168,41241,86,3.4,170,6.7,5727,1098,4629,2.7,13.9,5872,2366,3506,5.7,14.2,-145,-0.3,27.8,0,71,71,541
1998,22,l) Left Censored,13099,25664,745361,738846,1411,5.5,1753,6.8,96970,25127,71843,3.4,13.1,83940,24979,58961,3.4,11.4,13030,1.7,22.8,0,510,510,4109
1998,23,a) 0,2904,2927,14981,7522,2902,198.3,0,0,14918,14918,0,198.3,198.3,0,0,0,0,0,14918,198.3,0,0,,,
1998,23,b) 1,2148,2173,11265,11538,0,0,545,22.1,2645,0,2645,0,22.9,3190,2005,1185,17.4,27.6,-545,-4.7,45.8,0,431,431,1752
1998,23,c) 2,1877,1920,13124,13030,51,2.5,325,15.7,3054,811,2243,6.2,23.4,2866,1583,1283,12.1,22,188,1.4,44,0,273,273,1403
1998,23,d) 3,1650,1663,9899,10137,50,2.8,244,13.8,1759,162,1597,1.6,17.4,2234,1254,980,12.4,22,-475,-4.6,34.8,0,196,196,1128
1998,23,e) 4,1323,1346,10247,10449,40,2.8,193,13.6,1648,161,1487,1.5,15.8,2051,791,1260,7.6,19.6,-403,-3.8,31.6,0,154,154,675
1998,23,f) 5,1143,1167,9065,9319,32,2.6,130,10.6,1374,190,1184,2,14.7,1882,818,1064,8.8,20.2,-508,-5.5,29.4,0,103,103,728
1998,23,g) 6 to 10,5033,5267,44720,44787,137,2.5,550,10,6844,1451,5393,3.2,15.3,6977,2878,4099,6.4,15.6,-133,-0.3,30.6,0,421,421,2324
1998,23,h) 11 to 15,4010,4436,47601,48203,133,2.9,346,7.6,5435,812,4623,1.7,11.3,6639,3051,3588,6.3,13.8,-1204,-2.5,22.6,0,246,246,1816
1998,23,i) 16 to 20,2464,2856,45222,44541,82,2.8,227,7.7,5442,556,4886,1.2,12.2,4080,1230,2850,2.8,9.2,1362,3,18.4,0,138,138,754
1998,23,j) 21 to 25,547,1118,18743,17860,124,11.4,71,6.5,3355,1062,2293,5.9,18.8,1588,652,936,3.7,8.9,1767,9.9,17.8,0,26,26,118
1998,23,l) Left Censored,4655,7805,224692,224947,380,4.8,550,7,20213,5214,14999,2.3,9,20722,5959,14763,2.6,9.2,-509,-0.2,18,0,192,192,1132
1998,24,a) 0,8891,8943,64421,32296,8877,198.5,0,0,64251,64251,0,198.9,198.9,0,0,0,0,0,64251,198.9,0,0,,,
1998,24,b) 1,7119,7227,53779,52825,17,0.2,1957,23.7,15423,611,14812,1.2,29.2,13514,8004,5510,15.2,25.6,1909,3.6,51.2,0,1537,1537,6799
1998,24,c) 2,5877,5982,44938,46972,180,2.8,1116,17.2,9756,1178,8578,2.5,20.8,13823,7410,6413,15.8,29.4,-4067,-8.6,41.6,0,876,876,6259
1998,24,d) 3,5383,5462,42619,43245,189,3.2,889,15.2,9138,1130,8008,2.6,21.1,10390,5357,5033,12.4,24,-1252,-2.9,42.2,0,682,682,4249
1998,24,e) 4,4546,4705,43124,44071,162,3.3,692,13.9,9171,960,8211,2.2,20.8,11065,5651,5414,12.8,25.1,-1894,-4.3,41.6,0,545,545,4445
1998,24,f) 5,4119,4250,43800,45637,139,3.1,540,12.1,6321,850,5471,1.9,13.9,9997,3832,6165,8.4,21.9,-3676,-8,27.8,0,439,439,2648
1998,24,g) 6 to 10,16885,17971,204785,207899,517,2.8,1924,10.3,33107,5525,27582,2.7,15.9,39334,13293,26041,6.4,18.9,-6227,-3,31.8,0,1405,1405,9421
1998,24,h) 11 to 15,12597,14224,196048,199133,443,3,1241,8.5,25657,5228,20429,2.6,12.9,31826,12269,19557,6.2,16,-6169,-3.1,25.8,0,777,777,6322
1998,24,i) 16 to 20,7629,8977,144780,143841,232,2.5,709,7.7,22071,5172,16899,3.6,15.3,20193,6823,13370,4.7,14,1878,1.3,28,0,416,416,3170
1998,24,j) 21 to 25,1730,3005,67634,67863,106,3.5,206,6.7,9397,2678,6719,3.9,13.8,9855,3028,6827,4.5,14.5,-458,-0.7,27.6,0,73,73,880
1998,24,l) Left Censored,15226,30200,1015800,1014573,1936,6.3,2645,8.7,122841,39919,82922,3.9,12.1,120387,43927,76460,4.3,11.9,2454,0.2,23.8,0,654,654,6572
1998,25,a) 0,11105,11151,72519,36354,11079,198.7,0,0,72330,72330,0,199,199,0,0,0,0,0,72330,199,0,0,,,
1998,25,b) 1,8852,8991,66375,64645,30,0.3,2213,21.7,21910,2020,19890,3.1,33.9,18449,10621,7828,16.4,28.5,3461,5.4,57,0,1690,1690,7934
1998,25,c) 2,7392,7483,59472,60089,164,2,1263,15.7,14263,1111,13152,1.8,23.7,15496,7448,8048,12.4,25.8,-1233,-2.1,47.4,0,1024,1024,6569
1998,25,d) 3,6745,6945,61048,62765,210,2.8,1039,14.1,12205,1496,10709,2.4,19.4,15638,5805,9833,9.2,24.9,-3433,-5.5,38.8,0,832,832,4992
1998,25,e) 4,5950,6064,56000,57621,170,2.7,806,12.6,10246,1015,9231,1.8,17.8,13488,4757,8731,8.3,23.4,-3242,-5.6,35.6,0,656,656,4028
1998,25,f) 5,4913,5045,47779,49131,125,2.4,532,10.1,7572,709,6863,1.4,15.4,10275,3805,6470,7.7,20.9,-2703,-5.5,30.8,0,425,425,3097
1998,25,g) 6 to 10,20722,22130,273111,277381,606,2.6,2084,9.1,38745,5451,33294,2,14,47285,16336,30949,5.9,17,-8540,-3,28,0,1514,1514,11560
1998,25,h) 11 to 15,17588,19504,300241,300271,619,3.1,1483,7.4,42497,8438,34059,2.8,14.2,42557,13862,28695,4.6,14.2,-60,0,28.4,0,1010,1010,6904
1998,25,i) 16 to 20,11224,13447,237861,235768,355,2.6,832,6.1,35748,8978,26770,3.8,15.2,31561,8447,23114,3.6,13.4,4187,1.8,26.8,0,544,544,4452
1998,25,j) 21 to 25,2393,3982,115842,115115,175,4.3,307,7.6,12453,2510,9943,2.2,10.8,10998,2676,8322,2.3,9.6,1455,1.2,19.2,0,122,122,592
1998,25,l) Left Censored,25644,43813,1576523,1576356,2098,4.7,3217,7.2,180035,44745,135290,2.8,11.4,179700,53442,126258,3.4,11.4,335,0,22.8,0,1063,1063,8723
1998,26,a) 0,15454,15585,110313,55378,15466,198.5,0,0,109870,109870,0,198.4,198.4,0,0,0,0,0,109870,198.4,0,0,,,
1998,26,b) 1,12655,12934,105631,104072,44,0.3,3358,22.8,29879,1448,28431,1.4,28.7,26760,14867,11893,14.3,25.7,3119,3,51.4,0,2600,2600,10949
1998,26,c) 2,10997,11147,93852,98943,296,2.5,2074,17.2,18339,1312,17027,1.3,18.5,28521,13891,14630,14,28.8,-10182,-10.3,37,0,1671,1671,12082
1998,26,d) 3,9916,10113,85334,87946,284,2.6,1605,14.9,15081,1184,13897,1.3,17.1,20304,10189,10115,11.6,23.1,-5223,-6,34.2,0,1259,1259,8165
1998,26,e) 4,8427,8607,80578,83607,237,2.6,1192,13.1,14692,1936,12756,2.3,17.6,20750,7224,13526,8.6,24.8,-6058,-7.2,35.2,0,925,925,5507
1998,26,f) 5,7294,7527,69599,71301,204,2.6,989,12.5,12152,2407,9745,3.4,17,15556,7533,8023,10.6,21.8,-3404,-4.8,34,0,768,768,5377
1998,26,g) 6 to 10,30003,32090,358098,362064,869,2.6,3251,9.8,52245,7381,44864,2,14.4,60177,22838,37339,6.3,16.6,-7932,-2.2,28.8,0,2431,2431,16157
1998,26,h) 11 to 15,22948,26416,388068,388965,778,2.9,2082,7.7,55593,17344,38249,4.5,14.3,57387,16490,40897,4.2,14.8,-1794,-0.5,28.6,0,1424,1424,10283
1998,26,i) 16 to 20,15326,18258,297976,298569,469,2.5,1262,6.8,36664,5702,30962,1.9,12.3,37849,11324,26525,3.8,12.7,-1185,-0.4,24.6,0,770,770,6147
1998,26,j) 21 to 25,3322,5404,114333,113240,197,3.6,437,7.9,16927,4134,12793,3.7,14.9,14741,5229,9512,4.6,13,2186,1.9,26,0,149,149,962
1998,26,l) Left Censored,30313,58900,2175285,2166046,2984,5,4027,6.8,239962,64139,175823,3,11.1,221483,64051,157432,3,10.2,18479,0.9,20.4,0,1260,1260,10184
1998,27,a) 0,9485,9561,63158,31686,9505,198.8,0,0,62944,62944,0,198.6,198.6,0,0,0,0,0,62944,198.6,0,0,,,
1998,27,b) 1,7570,7671,49105,50228,31,0.4,1834,21.2,13321,868,12453,1.7,26.5,15566,10155,5411,20.2,31,-2245,-4.5,53,0,1354,1354,7270
1998,27,c) 2,6323,6428,46969,48385,168,2.4,1071,15.5,9216,952,8264,2,19,12047,6934,5113,14.3,24.9,-2831,-5.9,38,0,843,843,6023
1998,27,d) 3,5516,5622,43364,44004,157,2.6,786,13.2,8443,765,7678,1.7,19.2,9722,5093,4629,11.6,22.1,-1279,-2.9,38.4,0,613,613,4379
1998,27,e) 4,5029,5148,44040,44681,136,2.5,633,11.7,6840,673,6167,1.5,15.3,8121,3922,4199,8.8,18.2,-1281,-2.9,30.6,0,485,485,3256
1998,27,f) 5,4323,4589,43490,44032,185,3.9,510,10.7,7904,1789,6115,4.1,18,8987,4133,4854,9.4,20.4,-1083,-2.4,36,0,367,367,2063
1998,27,g) 6 to 10,17144,18272,193732,194629,530,2.8,1684,8.9,28027,3744,24283,1.9,14.4,29820,10340,19480,5.3,15.3,-1793,-0.9,28.8,0,1228,1228,7351
1998,27,h) 11 to 15,12601,14668,231918,231388,488,3.3,1089,7.3,30731,7967,22764,3.4,13.3,29671,9120,20551,3.9,12.8,1060,0.5,25.6,0,671,671,4581
1998,27,i) 16 to 20,8670,10321,174750,172165,283,2.7,707,6.7,26562,4326,22236,2.5,15.4,21391,6422,14969,3.7,12.4,5171,3,24.8,0,433,433,3269
1998,27,j) 21 to 25,2062,3282,72164,71653,97,2.9,202,6.1,8995,1341,7654,1.9,12.6,7973,2167,5806,3,11.1,1022,1.5,22.2,0,79,79,551
1998,27,l) Left Censored,17750,31913,1275099,1257272,1346,4.2,1905,5.9,162340,36492,125848,2.9,12.9,126685,32708,93977,2.6,10.1,35655,2.8,20.2,0,655,655,8838
1998,28,a) 0,4394,4432,28206,14168,4388,198,0,0,28077,28077,0,198.2,198.2,0,0,0,0,0,28077,198.2,0,0,,,
1998,28,b) 1,3344,3394,23794,24648,19,0.5,1082,27.3,6038,302,5736,1.2,24.5,7746,4747,2999,19.3,31.4,-1708,-6.9,49,0,883,883,4170
1998,28,c) 2,2781,2855,22324,23440,93,2.9,700,22.1,5085,312,4773,1.3,21.7,7316,4771,2545,20.4,31.2,-2231,-9.5,43.4,0,561,561,3901
1998,28,d) 3,2522,2584,20955,21641,73,2.6,454,16.3,3733,304,3429,1.4,17.2,5104,2674,2430,12.4,23.6,-1371,-6.4,34.4,0,373,373,2141
1998,28,e) 4,2236,2311,27632,27384,67,2.7,335,13.7,4838,399,4439,1.5,17.7,4342,1716,2626,6.3,15.9,496,1.8,31.8,0,277,277,1461
1998,28,f) 5,1912,2001,17599,18135,50,2.4,279,13.2,3332,531,2801,2.9,18.4,4404,1989,2415,11,24.3,-1072,-5.9,36.8,0,227,227,1283
1998,28,g) 6 to 10,6877,7354,78282,78366,207,2.7,813,10.6,13297,2990,10307,3.8,17,13466,5283,8183,6.7,17.2,-169,-0.2,34,0,631,631,3990
1998,28,h) 11 to 15,5744,6352,88671,88918,186,2.9,512,7.8,10194,1396,8798,1.6,11.5,10687,3899,6788,4.4,12,-493,-0.5,23,0,334,334,2493
1998,28,i) 16 to 20,4074,4932,83020,82908,158,3.1,384,7.6,10752,2519,8233,3,13,10529,3750,6779,4.5,12.7,223,0.3,25.4,0,242,242,1855
1998,28,j) 21 to 25,960,1436,33049,32973,64,4.4,102,7,4028,1104,2924,3.3,12.2,3875,1575,2300,4.8,11.8,153,0.4,23.6,0,56,56,207
1998,28,l) Left Censored,8058,15668,482581,480950,869,5.5,999,6.3,50597,12904,37693,2.7,10.5,47334,13191,34143,2.7,9.8,3263,0.7,19.6,0,338,338,1949
1998,29,a) 0,10206,10286,71362,35787,10207,198.5,0,0,71151,71151,0,198.8,198.8,0,0,0,0,0,71151,198.8,0,0,,,
1998,29,b) 1,7895,7998,54227,55172,41,0.4,2327,25.2,14942,1333,13609,2.4,27.1,16832,10083,6749,18.3,30.5,-1890,-3.4,54.2,0,1867,1867,7636
1998,29,c) 2,6623,6767,52032,54345,195,2.6,1487,20,9265,1130,8135,2.1,17,13891,7717,6174,14.2,25.6,-4626,-8.6,34,0,1210,1210,6598
1998,29,d) 3,5993,6128,45392,46979,189,2.9,1045,15.9,7840,950,6890,2,16.7,11014,5092,5922,10.8,23.4,-3174,-6.7,33.4,0,861,861,4336
1998,29,e) 4,5442,5648,48740,50502,197,3.3,817,13.7,7708,1001,6707,2,15.3,11232,4164,7068,8.2,22.2,-3524,-6.9,30.6,0,631,631,3268
1998,29,f) 5,4521,4738,40246,41724,151,3,635,12.7,6274,771,5503,1.8,15,9229,3816,5413,9.1,22.1,-2955,-7.1,30,0,515,515,3033
1998,29,g) 6 to 10,17884,19171,206948,211661,600,3,2129,10.7,28951,4498,24453,2.1,13.7,38376,14797,23579,7,18.1,-9425,-4.4,27.4,0,1579,1579,10149
1998,29,h) 11 to 15,14396,16144,228559,233158,472,2.8,1304,7.9,25436,5543,19893,2.4,10.9,34634,10976,23658,4.7,14.9,-9198,-4,21.8,0,894,894,6136
1998,29,i) 16 to 20,9364,11150,174817,174882,252,2.2,791,6.9,20733,3566,17167,2,11.9,20863,5933,14930,3.4,11.9,-130,0,23.8,0,507,507,2676
1998,29,j) 21 to 25,2107,3609,75706,76653,139,3.8,241,6.6,7030,1557,5473,2,9.2,8923,1797,7126,2.3,11.6,-1893,-2.4,18.4,0,84,84,269
1998,29,l) Left Censored,19426,36857,1275236,1274828,1970,5.3,2527,6.8,138854,41106,97748,3.2,10.9,138038,36046,101992,2.8,10.8,816,0.1,21.6,0,749,749,5217
1998,30,a) 0,2628,2637,13037,6548,2616,198.4,0,0,12978,12978,0,198.2,198.2,0,0,0,0,0,12978,198.2,0,0,,,
1998,30,b) 1,1923,1936,10475,10731,2,0.1,588,26.1,2478,,,,23.1,2990,1754,1236,16.3,27.9,-512,-4.8,46.2,1,458,458,1493
1998,30,c) 2,1732,1753,9584,10050,60,3.2,301,16,1752,,,,17.4,2684,1215,1469,12.1,26.7,-932,-9.3,34.8,1,236,236,889
1998,30,d) 3,1496,1513,8802,9163,58,3.6,253,15.7,1484,265,1219,2.9,16.2,2205,1094,1111,11.9,24.1,-721,-7.9,32.4,0,206,206,935
1998,30,e) 4,1207,1233,8387,8463,35,2.7,178,13.6,1573,119,1454,1.4,18.6,1725,689,1036,8.1,20.4,-152,-1.8,37.2,0,145,145,556
1998,30,f) 5,1039,1065,6889,6998,42,3.8,141,12.6,1078,122,956,1.7,15.4,1296,500,796,7.1,18.5,-218,-3.1,30.8,0,109,109,398
1998,30,g) 6 to 10,3794,3960,31264,31769,150,3.6,475,11.5,4647,1054,3593,3.3,14.6,5656,2366,3290,7.4,17.8,-1009,-3.2,29.2,0,353,353,1491
1998,30,h) 11 to 15,2944,3301,33445,33690,150,4.4,325,9.6,4662,732,3930,2.2,13.8,5152,1999,3153,5.9,15.3,-490,-1.5,27.6,0,209,209,1037
1998,30,i) 16 to 20,2247,2546,27840,28180,61,2.3,200,7.6,3028,359,2669,1.3,10.7,3707,1137,2570,4,13.2,-679,-2.5,21.4,0,122,122,620
1998,30,j) 21 to 25,490,715,10115,10265,23,3.1,55,7.5,1289,273,1016,2.7,12.6,1588,455,1133,4.4,15.5,-299,-2.9,25.2,0,24,24,100
1998,30,l) Left Censored,3548,5888,112950,113273,309,5.2,398,6.7,12570,4300,8270,3.8,11.1,13215,5644,7571,5,11.7,-645,-0.6,22.2,0,147,147,906
1998,31,a) 0,3138,3161,21477,10765,3135,198.4,0,0,21424,21424,0,199,199,0,0,0,0,0,21424,199,0,0,,,
1998,31,b) 1,2487,2549,15383,15303,37,1.3,693,23.9,4269,822,3447,5.4,27.9,4109,2497,1612,16.3,26.9,160,1,53.8,0,553,553,2108
1998,31,c) 2,2075,2106,14485,15519,58,2.5,396,17.3,2282,150,2132,1,14.7,4350,2060,2290,13.3,28,-2068,-13.3,29.4,0,319,319,1825
1998,31,d) 3,1828,1872,13602,14296,59,3,292,14.7,2236,599,1637,4.2,15.6,3624,1737,1887,12.2,25.3,-1388,-9.7,31.2,0,236,236,1242
1998,31,e) 4,1653,1709,12925,13247,44,2.4,222,12.3,2148,274,1874,2.1,16.2,2791,1479,1312,11.2,21.1,-643,-4.9,32.4,0,182,182,1326
1998,31,f) 5,1489,1531,11772,12432,32,2,194,12,1679,111,1568,0.9,13.5,2998,1457,1541,11.7,24.1,-1319,-10.6,27,0,152,152,945
1998,31,g) 6 to 10,5897,6368,71941,70333,182,2.8,616,9.3,12855,1439,11416,2,18.3,9638,3659,5979,5.2,13.7,3217,4.6,27.4,0,441,441,2317
1998,31,h) 11 to 15,4860,5445,75498,76653,176,3.1,455,8.1,9703,2900,6803,3.8,12.7,12012,4940,7072,6.4,15.7,-2309,-3,25.4,0,298,298,1699
1998,31,i) 16 to 20,3662,4272,58343,57949,90,2.1,278,6.4,7410,714,6696,1.2,12.8,6621,2274,4347,3.9,11.4,789,1.4,22.8,0,163,163,738
1998,31,j) 21 to 25,866,1393,26777,26865,43,3,107,7.5,2893,579,2314,2.2,10.8,3068,1093,1975,4.1,11.4,-175,-0.6,21.6,0,40,40,162
1998,31,l) Left Censored,7979,13078,382983,382897,557,4.2,767,5.8,36028,8493,27535,2.2,9.4,35855,9956,25899,2.6,9.4,173,0,18.8,0,308,308,1820
1998,32,a) 0,4660,4698,37896,19035,4660,198.4,0,0,37723,37723,0,198.2,198.2,0,0,0,0,0,37723,198.2,0,0,,,
1998,32,b) 1,3303,3332,30055,30233,11,0.3,1045,26.9,9407,369,9038,1.2,31.1,9763,4994,4769,16.5,32.3,-356,-1.2,62.2,0,860,860,3870
1998,32,c) 2,2434,2488,35109,36893,95,3.5,571,20.8,4958,1022,3936,2.8,13.4,8525,4378,4147,11.9,23.1,-3567,-9.7,26.8,0,456,456,2682
1998,32,d) 3,2108,2166,27523,28058,94,4,422,18.1,4922,1279,3643,4.6,17.5,5992,2867,3125,10.2,21.4,-1070,-3.9,35,0,337,337,2396
1998,32,e) 4,1715,1777,23186,23481,65,3.4,280,14.8,4325,635,3690,2.7,18.4,4915,1661,3254,7.1,20.9,-590,-2.5,36.8,0,216,216,1301
1998,32,f) 5,1347,1391,21470,21302,46,3.1,202,13.8,3761,297,3464,1.4,17.7,3424,1428,1996,6.7,16.1,337,1.6,32.2,0,147,147,1097
1998,32,g) 6 to 10,5142,5563,78201,80165,208,3.6,668,11.5,12486,2046,10440,2.6,15.6,16413,5863,10550,7.3,20.5,-3927,-4.9,31.2,0,477,477,3573
1998,32,h) 11 to 15,3354,4067,70173,72282,195,4.7,361,8.7,10528,2984,7544,4.1,14.6,14745,4509,10236,6.2,20.4,-4217,-5.8,29.2,0,217,217,1425
1998,32,i) 16 to 20,2499,3046,83150,83860,131,4.2,251,8.1,7411,1042,6369,1.2,8.8,8831,1964,6867,2.3,10.5,-1420,-1.7,17.6,0,142,142,832
1998,32,j) 21 to 25,524,977,33246,32673,86,8.9,54,5.6,4639,966,3673,3,14.2,3493,477,3016,1.5,10.7,1146,3.5,21.4,0,23,23,241
1998,32,l) Left Censored,3709,7788,339863,336043,800,10.4,636,8.3,43348,13708,29640,4.1,12.9,35707,9270,26437,2.8,10.6,7641,2.3,21.2,0,139,139,2165
1998,33,a) 0,2665,2676,15114,7576,2658,198.7,0,0,15076,15076,0,199,199,0,0,0,0,0,15076,199,0,0,,,
1998,33,b) 1,2173,2197,13372,13535,2,0.1,547,21.9,3556,,,,26.3,3882,2436,1446,18,28.7,-326,-2.4,52.6,1,436,436,2135
1998,33,c) 2,1908,1944,15342,15205,45,2.2,308,14.8,3314,,,,21.8,3040,1313,1727,8.6,20,274,1.8,40,1,251,251,1176
1998,33,d) 3,1646,1659,12449,12502,46,2.6,220,12.6,2355,151,2204,1.2,18.8,2461,990,1471,7.9,19.7,-106,-0.9,37.6,0,177,177,851
1998,33,e) 4,1447,1472,11085,11410,44,2.9,156,10.2,1838,135,1703,1.2,16.1,2488,849,1639,7.4,21.8,-650,-5.7,32.2,0,131,131,726
1998,33,f) 5,1169,1187,10855,10784,36,2.9,135,10.9,1793,129,1664,1.2,16.6,1650,586,1064,5.4,15.3,143,1.3,30.6,0,114,114,504
1998,33,g) 6 to 10,4979,5258,54470,55085,154,2.8,488,9,7225,940,6285,1.7,13.1,8454,3234,5220,5.9,15.3,-1229,-2.2,26.2,0,367,367,2404
1998,33,h) 11 to 15,4130,4483,61309,61212,149,3.2,386,8.4,7715,1422,6293,2.3,12.6,7521,2435,5086,4,12.3,194,0.3,24.6,0,280,280,1668
1998,33,i) 16 to 20,2254,2561,35323,35438,76,2.9,191,7.3,4151,896,3255,2.5,11.7,4380,1309,3071,3.7,12.4,-229,-0.7,23.4,0,132,132,609
1998,33,j) 21 to 25,529,923,23607,21811,58,6.3,60,6.5,5778,2589,3189,11.9,26.5,2185,392,1793,1.8,10,3593,16.5,20,0,20,20,111
1998,33,l) Left Censored,4587,7897,254554,253697,430,5.4,666,8.3,29549,5899,23650,2.3,11.6,27834,11173,16661,4.4,11,1715,0.6,22,0,147,147,2918
1998,34,a) 0,17429,17507,101777,51055,17392,198.7,0,0,101445,101445,0,198.7,198.7,0,0,0,0,0,101445,198.7,0,0,,,
1998,34,b) 1,13890,14046,95911,93326,32,0.2,3479,21.8,29235,1986,27249,2.1,31.3,24064,13228,10836,14.2,25.8,5171,5.5,51.6,0,2717,2717,10701
1998,34,c) 2,11388,11541,82078,84965,325,2.6,2170,17.3,18881,2346,16535,2.8,22.2,24655,12243,12412,14.4,29,-5774,-6.8,44.4,0,1736,1736,10132
1998,34,d) 3,10100,10481,77975,80785,397,3.6,1584,14.3,16602,2189,14413,2.7,20.6,22221,8737,13484,10.8,27.5,-5619,-6.9,41.2,0,1247,1247,7435
1998,34,e) 4,8237,8358,66963,66863,274,3.1,1169,13.3,13838,1500,12338,2.2,20.7,13637,6116,7521,9.1,20.4,201,0.3,40.8,0,932,932,4912
1998,34,f) 5,7397,7506,68013,66654,215,2.7,982,12.4,16133,3641,12492,5.5,24.2,13415,5142,8273,7.7,20.1,2718,4.1,40.2,0,772,772,4012
1998,34,g) 6 to 10,30389,31492,312873,318922,949,2.9,3328,10.2,48197,7647,40550,2.4,15.1,60294,21543,38751,6.8,18.9,-12097,-3.8,30.2,0,2473,2473,15050
1998,34,h) 11 to 15,23393,25458,339971,342111,827,3.2,2132,8.2,45851,7305,38546,2.1,13.4,50131,15050,35081,4.4,14.7,-4280,-1.3,26.8,0,1454,1454,8993
1998,34,i) 16 to 20,15480,17061,255744,258147,422,2.4,1344,7.7,32746,7483,25263,2.9,12.7,37552,11948,25604,4.6,14.5,-4806,-1.8,25.4,0,927,927,6719
1998,34,j) 21 to 25,3363,4519,108142,107237,176,3.8,342,7.4,17949,4226,13723,3.9,16.7,16139,7248,8891,6.8,15,1810,1.7,30,0,159,159,2500
1998,34,l) Left Censored,31151,52646,1817659,1823091,2766,5.2,4321,8.1,226553,65362,161191,3.6,12.4,237417,83591,153826,4.6,13,-10864,-0.6,24.8,0,1541,1541,11173
1998,35,a) 0,3270,3297,21274,10690,3263,197.9,0,0,21169,21169,0,198,198,0,0,0,0,0,21169,198,0,0,,,
1998,35,b) 1,2500,2530,16879,17841,10,0.3,790,26.6,3953,120,3833,0.7,22.2,5877,3532,2345,19.8,32.9,-1924,-10.7,44.4,0,603,603,2979
1998,35,c) 2,2089,2123,15300,16521,67,2.9,491,21,2885,274,2611,1.7,17.5,5327,3108,2219,18.8,32.2,-2442,-14.7,35,0,403,403,2663
1998,35,d) 3,1926,1979,16124,16616,76,3.6,351,16.5,3615,1435,2180,8.6,21.8,4598,2270,2328,13.7,27.7,-983,-5.9,43.6,0,271,271,1713
1998,35,e) 4,1704,1784,14105,14635,62,3.3,280,14.8,2513,401,2112,2.7,17.2,3572,1828,1744,12.5,24.4,-1059,-7.2,34.4,0,215,215,1341
1998,35,f) 5,1384,1429,13082,13536,50,3.3,215,14.2,2183,233,1950,1.7,16.1,3091,1650,1441,12.2,22.8,-908,-6.7,32.2,0,163,163,1279
1998,35,g) 6 to 10,5385,5779,56050,58211,216,3.6,696,11.5,7605,1429,6176,2.5,13.1,11927,4450,7477,7.6,20.5,-4322,-7.4,26.2,0,470,470,2925
1998,35,h) 11 to 15,4161,4775,67239,66711,191,3.9,405,8.3,10507,3659,6848,5.5,15.8,9451,3266,6185,4.9,14.2,1056,1.6,28.4,0,260,260,1518
1998,35,i) 16 to 20,3070,3544,45911,45887,108,3,283,7.8,6610,1492,5118,3.3,14.4,6561,2405,4156,5.2,14.3,49,0.1,28.6,0,171,171,812
1998,35,j) 21 to 25,662,1163,20092,19650,66,5.7,67,5.7,2776,836,1940,4.3,14.1,1892,604,1288,3.1,9.6,884,4.5,19.2,0,24,24,83
1998,35,l) Left Censored,4766,9046,233713,234774,529,5.8,682,7.5,27560,7697,19863,3.3,11.7,29682,10055,19627,4.3,12.6,-2122,-0.9,23.4,0,183,183,1572
1998,36,a) 0,36699,36875,236699,118779,36614,198.6,0,0,235840,235840,0,198.6,198.6,0,0,0,0,0,235840,198.6,0,0,,,
1998,36,b) 1,29297,29638,202596,199603,64,0.2,7498,22.3,62450,2504,59946,1.3,31.3,56463,31201,25262,15.6,28.3,5987,3,56.6,0,5960,5960,26633
1998,36,c) 2,23952,24210,173650,179792,681,2.6,4698,17.9,40151,3787,36364,2.1,22.3,52435,25254,27181,14,29.2,-12284,-6.9,44.6,0,3875,3875,22353
1998,36,d) 3,20622,21498,161945,166132,879,3.8,3667,16,33869,5766,28103,3.5,20.4,42243,19697,22546,11.9,25.4,-8374,-5,40.8,0,2835,2835,16046
1998,36,e) 4,17220,17425,148716,153088,486,2.6,2693,14.5,27935,3997,23938,2.6,18.2,36678,15373,21305,10,24,-8743,-5.8,36.4,0,2172,2172,12011
1998,36,f) 5,15183,15499,141037,143955,425,2.6,2154,13.2,25843,2782,23061,1.9,18,31680,12668,19012,8.8,22,-5837,-4,36,0,1773,1773,10093
1998,36,g) 6 to 10,63412,65656,640265,646104,1866,2.7,6964,10.2,99467,11298,88169,1.7,15.4,111145,41209,69936,6.4,17.2,-11678,-1.8,30.8,0,5329,5329,30449
1998,36,h) 11 to 15,48846,53026,691791,698970,1431,2.6,4416,8.1,83464,10956,72508,1.6,11.9,97822,30406,67416,4.4,14,-14358,-2.1,23.8,0,3187,3187,19883
1998,36,i) 16 to 20,31356,35814,537788,540318,818,2.2,2560,7,67115,11315,55800,2.1,12.4,72174,22081,50093,4.1,13.4,-5059,-1,24.8,0,1746,1746,11864
1998,36,j) 21 to 25,6319,9847,240448,238941,312,3.1,698,6.9,32903,7083,25820,3,13.8,29889,6750,23139,2.8,12.5,3014,1.3,25,0,338,338,1871
1998,36,l) Left Censored,67445,112136,3789059,3795976,5095,4.5,8326,7.3,458401,107159,351242,2.8,12.1,472234,143037,329197,3.8,12.4,-13833,-0.3,24.2,0,3373,3373,22830
1998,37,a) 0,15378,15505,101524,50887,15410,198.8,0,0,101275,101275,0,199,199,0,0,0,0,0,101275,199,0,0,,,
1998,37,b) 1,12030,12223,95767,90548,79,0.6,3544,25.2,34992,6895,28097,7.6,38.6,24553,14679,9874,16.2,27.1,10439,11.5,54.2,0,2845,2845,11902
1998,37,c) 2,9681,9987,78992,80957,305,2.8,1909,17.6,16559,2970,13589,3.7,20.5,20489,10077,10412,12.4,25.3,-3930,-4.8,41,0,1545,1545,8384
1998,37,d) 3,8420,8615,63999,65936,283,3.1,1365,14.9,11599,1581,10018,2.4,17.6,15472,7449,8023,11.3,23.5,-3873,-5.9,35.2,0,1087,1087,5916
1998,37,e) 4,7011,7257,65795,66830,226,2.9,1091,14.2,11273,1953,9320,2.9,16.9,13343,6310,7033,9.4,20,-2070,-3.1,33.8,0,870,870,5048
1998,37,f) 5,5825,6066,60511,61457,202,3.2,784,12.3,11015,2404,8611,3.9,17.9,12906,4915,7991,8,21,-1891,-3.1,35.8,0,641,641,3950
1998,37,g) 6 to 10,23989,25828,299790,304867,792,2.9,2777,10.3,45335,8895,36440,2.9,14.9,55489,25651,29838,8.4,18.2,-10154,-3.3,29.8,0,1985,1985,16467
1998,37,h) 11 to 15,20172,23017,306549,308026,736,3.1,1792,7.6,39774,6554,33220,2.1,12.9,42728,15686,27042,5.1,13.9,-2954,-1,25.8,0,1088,1088,6904
1998,37,i) 16 to 20,11678,14215,232508,233215,472,3.3,933,6.5,27962,7245,20717,3.1,12,29376,10507,18869,4.5,12.6,-1414,-0.6,24,0,588,591,3823
1998,37,j) 21 to 25,2537,4394,98969,97146,195,4.4,322,7.2,13918,3853,10065,4,14.3,10271,3441,6830,3.5,10.6,3647,3.7,21.2,0,104,104,548
1998,37,l) Left Censored,22325,48842,1778774,1780608,3344,6.8,4356,8.8,196868,58366,138502,3.3,11.1,200536,70774,129762,4,11.3,-3668,-0.2,22.2,0,922,922,6941
1998,38,a) 0,1195,1199,7942,3986,1192,198.8,0,0,7913,7913,0,198.5,198.5,0,0,0,0,0,7913,198.5,0,0,,,
1998,38,b) 1,959,984,6742,9247,13,1.2,228,20.7,1922,,,,20.8,6931,654,6277,7.1,75,-5009,-54.2,41.6,1,169,169,487
1998,38,c) 2,847,862,5400,6059,28,3,166,17.7,798,,,,13.2,2116,1341,775,22.1,34.9,-1318,-21.7,26.4,1,132,132,1254
1998,38,d) 3,700,704,5067,5525,28,3.7,123,16.3,595,96,499,1.7,10.8,1510,735,775,13.3,27.3,-915,-16.5,21.6,0,97,97,660
1998,38,e) 4,721,727,4300,4513,20,2.6,121,15.6,624,95,529,2.1,13.8,1050,593,457,13.1,23.3,-426,-9.5,27.6,0,106,106,566
1998,38,f) 5,637,640,5153,5115,12,1.8,71,10.6,913,33,880,0.6,17.8,837,408,429,8,16.4,76,1.4,32.8,0,58,58,357
1998,38,g) 6 to 10,2470,2604,24377,24477,91,3.4,251,9.3,3572,416,3156,1.7,14.6,3772,1561,2211,6.4,15.4,-200,-0.8,29.2,0,189,189,900
1998,38,h) 11 to 15,2170,2428,25300,25441,86,3.5,189,7.6,3311,683,2628,2.7,13,3592,1214,2378,4.8,14.1,-281,-1.1,26,0,112,112,522
1998,38,i) 16 to 20,1703,1912,22320,22520,40,2,141,7.2,2477,353,2124,1.6,11,2877,948,1929,4.2,12.8,-400,-1.8,22,0,87,87,451
1998,38,j) 21 to 25,385,546,8949,8864,20,3.6,35,6.3,1383,476,907,5.4,15.6,1212,332,880,3.7,13.7,171,1.9,27.4,0,14,14,92
1998,38,l) Left Censored,3512,5489,128578,127476,197,3.5,348,6.3,14525,3224,11301,2.5,11.4,12320,5054,7266,4,9.7,2205,1.7,19.4,0,124,124,1642
1998,39,a) 0,16495,16689,118358,59404,16576,198.6,0,0,117908,117908,0,198.5,198.5,0,0,0,0,0,117908,198.5,0,0,,,
1998,39,b) 1,13168,13467,109196,108098,69,0.4,3575,23.3,30429,2615,27814,2.4,28.1,28232,16422,11810,15.2,26.1,2197,2,52.2,0,2810,2810,13029
1998,39,c) 2,11252,11520,92464,96186,317,2.5,2116,17,18559,1727,16832,1.8,19.3,26003,14115,11888,14.7,27,-7444,-7.7,38.6,0,1717,1717,10712
1998,39,d) 3,10379,10615,84690,87989,239,2.1,1601,14.1,14693,1222,13471,1.4,16.7,21291,10667,10624,12.1,24.2,-6598,-7.5,33.4,0,1303,1303,9306
1998,39,e) 4,8999,9362,83483,85460,247,2.5,1239,12.6,14441,2054,12387,2.4,16.9,18395,8282,10113,9.7,21.5,-3954,-4.6,33.8,0,962,962,6449
1998,39,f) 5,7933,8321,80677,81325,230,2.6,966,11.1,14210,2282,11928,2.8,17.5,15505,6500,9005,8,19.1,-1295,-1.6,35,0,760,760,4675
1998,39,g) 6 to 10,32412,35064,404917,409835,956,2.6,3426,9.4,57600,9568,48032,2.3,14.1,67435,25850,41585,6.3,16.5,-9835,-2.4,28.2,0,2523,2523,16871
1998,39,h) 11 to 15,25660,29689,444989,445672,811,2.7,2263,7.4,55254,10418,44836,2.3,12.4,56619,19241,37378,4.3,12.7,-1365,-0.3,24.8,0,1435,1435,9554
1998,39,i) 16 to 20,18293,21890,338106,337399,565,2.5,1443,6.5,44678,8776,35902,2.6,13.2,43263,12271,30992,3.6,12.8,1415,0.4,25.6,0,893,894,5995
1998,39,j) 21 to 25,4091,7151,168600,166421,348,4.8,547,7.5,26037,6985,19052,4.2,15.6,21678,7254,14424,4.4,13,4359,2.6,26,0,183,183,1351
1998,39,l) Left Censored,40366,79413,2822374,2819220,3700,4.6,5339,6.7,325283,72867,252416,2.6,11.5,318975,105025,213950,3.7,11.3,6308,0.2,22.6,0,1613,1613,18284
1998,40,a) 0,6362,6427,42027,21072,6391,198.9,0,0,41911,41911,0,198.9,198.9,0,0,0,0,0,41911,198.9,0,0,,,
1998,40,b) 1,5017,5175,37364,38525,27,0.5,1554,25.9,9785,692,9093,1.8,25.4,12107,6517,5590,16.9,31.4,-2322,-6,50.8,0,1274,1274,5562
1998,40,c) 2,3935,4014,28497,30032,98,2.2,874,19.8,5802,661,5141,2.2,19.3,8872,4533,4339,15.1,29.5,-3070,-10.2,38.6,0,731,731,3438
1998,40,d) 3,3377,3445,27330,28657,110,3,655,17.6,4991,625,4366,2.2,17.4,7644,3902,3742,13.6,26.7,-2653,-9.3,34.8,0,534,534,3286
1998,40,e) 4,3077,3139,23532,25166,97,2.9,511,15.2,3540,369,3171,1.5,14.1,6808,3557,3251,14.1,27.1,-3268,-13,28.2,0,406,406,2698
1998,40,f) 5,2672,2779,25004,25054,94,3.2,386,13.2,4786,644,4142,2.6,19.1,4886,2322,2564,9.3,19.5,-100,-0.4,38.2,0,302,302,1710
1998,40,g) 6 to 10,10275,10844,110408,112539,306,2.7,1243,11,16697,1748,14949,1.6,14.8,20959,9837,11122,8.7,18.6,-4262,-3.8,29.6,0,916,916,6969
1998,40,h) 11 to 15,8607,9631,129042,128513,298,3,818,8.3,17620,2667,14953,2.1,13.7,16562,6752,9810,5.3,12.9,1058,0.8,25.8,0,522,522,3441
1998,40,i) 16 to 20,6542,7612,109799,109884,263,3.4,569,7.3,13626,3505,10121,3.2,12.4,13795,3792,10003,3.5,12.6,-169,-0.2,24.8,0,332,334,1653
1998,40,j) 21 to 25,1239,2069,37066,36399,78,3.7,165,7.8,5735,1041,4694,2.9,15.8,4401,1826,2575,5,12.1,1334,3.7,24.2,0,61,61,235
1998,40,l) Left Censored,10452,20312,569661,561247,1077,5.3,1367,6.7,73268,19908,53360,3.5,13.1,56439,18518,37921,3.3,10.1,16829,3,20.2,0,423,423,2911
1998,41,a) 0,7891,7943,44191,22157,7876,198.3,0,0,44069,44069,0,198.9,198.9,0,0,0,0,0,44069,198.9,0,0,,,
1998,41,b) 1,6050,6134,38840,39188,13,0.2,1853,26,10122,707,9415,1.8,25.8,10818,6993,3825,17.8,27.6,-696,-1.8,51.6,0,1416,1416,5026
1998,41,c) 2,5252,5383,45849,47979,172,2.9,1096,18.7,7043,842,6201,1.8,14.7,11302,5461,5841,11.4,23.6,-4259,-8.9,29.4,0,876,876,4655
1998,41,d) 3,4769,4856,34590,35356,185,3.6,781,15.1,6626,1168,5458,3.3,18.7,8157,3548,4609,10,23.1,-1531,-4.4,37.4,0,593,593,2937
1998,41,e) 4,4121,4300,33668,34430,158,3.5,619,13.6,5694,649,5045,1.9,16.5,7218,3088,4130,9,21,-1524,-4.5,33,0,462,462,2149
1998,41,f) 5,3342,3451,28080,28889,113,3.1,445,12.3,5317,1044,4273,3.6,18.4,6935,3874,3061,13.4,24,-1618,-5.6,36.8,0,342,342,3502
1998,41,g) 6 to 10,12857,13621,136426,139070,434,3.1,1504,10.6,21114,3066,18048,2.2,15.2,26402,9977,16425,7.2,19,-5288,-3.8,30.4,0,1079,1079,7070
1998,41,h) 11 to 15,9158,10488,149359,151322,378,3.5,955,8.9,19975,5230,14745,3.5,13.2,23900,7972,15928,5.3,15.8,-3925,-2.6,26.4,0,592,592,4339
1998,41,i) 16 to 20,6804,7953,109205,110216,232,2.9,583,7.2,12871,2499,10372,2.3,11.7,14892,4255,10637,3.9,13.5,-2021,-1.8,23.4,0,373,373,2293
1998,41,j) 21 to 25,1427,2319,52223,52414,97,4.1,147,6.3,6477,1950,4527,3.7,12.4,6858,1796,5062,3.4,13.1,-381,-0.7,24.8,0,63,63,352
1998,41,l) Left Censored,10525,19973,619182,621382,1148,5.7,1655,8.2,75933,20111,55822,3.2,12.2,80333,26472,53861,4.3,12.9,-4400,-0.7,24.4,0,441,441,3910
1998,42,a) 0,17609,17779,119981,60187,17669,198.8,0,0,119589,119589,0,198.7,198.7,0,0,0,0,0,119589,198.7,0,0,,,
1998,42,b) 1,14298,14644,107409,105982,82,0.5,3408,20.7,30431,1890,28541,1.8,28.7,27577,16002,11575,15.1,26,2854,2.7,52,0,2692,2692,13571
1998,42,c) 2,11996,12333,103533,106158,347,2.6,2065,15.6,21446,2353,19093,2.2,20.2,26696,14661,12035,13.8,25.1,-5250,-4.9,40.4,0,1664,1664,11813
1998,42,d) 3,10949,11251,88090,89719,323,2.7,1614,13.5,15845,1564,14281,1.7,17.7,19103,7982,11121,8.9,21.3,-3258,-3.6,35.4,0,1276,1276,6388
1998,42,e) 4,9053,9327,80777,82460,218,2.2,1143,11.7,13029,1200,11829,1.5,15.8,16395,6943,9452,8.4,19.9,-3366,-4.1,31.6,0,939,939,6109
1998,42,f) 5,8193,8494,81180,81690,227,2.6,1011,11.4,12525,1215,11310,1.5,15.3,13545,5299,8246,6.5,16.6,-1020,-1.3,30.6,0,797,797,4205
1998,42,g) 6 to 10,38076,40377,406741,412233,993,2.4,3971,9.5,59530,10487,49043,2.5,14.4,70513,27841,42672,6.8,17.1,-10983,-2.7,28.8,0,2905,2905,20191
1998,42,h) 11 to 15,31069,34846,477594,477343,1055,3,2454,6.9,57808,11438,46370,2.4,12.1,57306,19427,37879,4.1,12,502,0.1,24,0,1707,1707,11002
1998,42,i) 16 to 20,20024,23381,366148,367954,565,2.4,1673,7,42537,8025,34512,2.2,11.6,46149,13892,32257,3.8,12.5,-3612,-0.9,23.2,0,1041,1041,6938
1998,42,j) 21 to 25,4504,7336,181024,179807,340,4.6,471,6.4,24348,6994,17354,3.9,13.5,21914,5287,16627,2.9,12.2,2434,1.3,24.4,0,186,186,1414
1998,42,l) Left Censored,44486,84242,2844329,2849479,4068,4.8,5893,6.9,305510,78130,227380,2.7,10.7,315811,98049,217762,3.4,11.1,-10301,-0.4,21.4,0,1944,1944,15073
1998,44,a) 0,1981,2005,12260,6149,1989,198.4,0,0,12223,12223,0,198.8,198.8,0,0,0,0,0,12223,198.8,0,0,,,
1998,44,b) 1,1540,1557,10934,10930,3,0.2,382,21.7,2708,224,2484,2,24.8,2700,1378,1322,12.6,24.7,8,0.1,49.4,0,302,302,1099
1998,44,c) 2,1324,1336,8873,9771,38,2.6,261,18,1940,294,1646,3,19.9,3736,1306,2430,13.4,38.2,-1796,-18.3,39.8,0,221,221,1156
1998,44,d) 3,1101,1113,8018,8176,29,2.4,170,14.3,1370,63,1307,0.8,16.8,1686,696,990,8.5,20.6,-316,-3.8,33.6,0,132,132,610
1998,44,e) 4,1012,1023,11737,12120,22,2,155,14.2,1461,165,1296,1.4,12.1,2226,844,1382,7,18.4,-765,-6.3,24.2,0,119,119,471
1998,44,f) 5,910,917,6228,6448,23,2.4,107,11.1,876,70,806,1.1,13.6,1315,572,743,8.9,20.4,-439,-6.8,27.2,0,88,88,517
1998,44,g) 6 to 10,3862,4003,41184,41067,96,2.3,388,9.4,6041,716,5325,1.7,14.7,5807,1664,4143,4.1,14.1,234,0.6,28.2,0,294,294,1232
1998,44,h) 11 to 15,3062,3258,37453,37609,96,2.9,231,6.9,4730,791,3939,2.1,12.6,5041,1171,3870,3.1,13.4,-311,-0.8,25.2,0,167,167,785
1998,44,i) 16 to 20,1933,2126,28817,28867,51,2.3,146,6.7,3456,684,2772,2.4,12,3555,1304,2251,4.5,12.3,-99,-0.3,24,0,102,102,392
1998,44,j) 21 to 25,492,636,12530,12321,17,2.6,42,6.5,1520,173,1347,1.4,12.3,1101,220,881,1.8,8.9,419,3.4,17.8,0,26,26,123
1998,44,l) Left Censored,4953,6942,222018,221155,249,3.5,531,7.5,23463,5918,17545,2.7,10.6,21737,6858,14879,3.1,9.8,1726,0.8,19.6,0,198,198,1809
1998,45,a) 0,7561,7589,49149,24646,7546,198.9,0,0,49006,49006,0,198.8,198.8,0,0,0,0,0,49006,198.8,0,0,,,
1998,45,b) 1,5600,5683,43903,43966,11,0.2,1750,26.4,11971,,,,27.2,12096,6952,5144,15.8,27.5,-125,-0.3,54.4,1,1432,1432,5942
1998,45,c) 2,4631,4730,43720,42251,139,2.7,985,19.1,14337,,,,33.9,11399,5512,5887,13,27,2938,6.9,54,1,810,810,4565
1998,45,d) 3,4046,4152,36202,37765,130,2.9,682,15.3,6113,809,5304,2.1,16.2,9238,4537,4701,12,24.5,-3125,-8.3,32.4,0,535,535,3103
1998,45,e) 4,3414,3549,34381,35787,119,3.2,525,14,6429,1055,5374,2.9,18,9240,4727,4513,13.2,25.8,-2811,-7.8,36,0,420,420,2707
1998,45,f) 5,2872,3020,29326,30672,109,3.5,406,12.9,4489,842,3647,2.7,14.6,7180,2734,4446,8.9,23.4,-2691,-8.8,29.2,0,334,334,2255
1998,45,g) 6 to 10,11517,12596,139536,143751,433,3.3,1371,10.5,20985,4637,16348,3.2,14.6,29415,11041,18374,7.7,20.5,-8430,-5.9,29.2,0,1000,1000,6171
1998,45,h) 11 to 15,9433,10897,152185,152589,346,3.1,832,7.5,20000,3398,16602,2.2,13.1,20808,7774,13034,5.1,13.6,-808,-0.5,26.2,0,537,537,3839
1998,45,i) 16 to 20,5593,6847,101680,102790,197,2.8,564,8,12162,1792,10370,1.7,11.8,14382,5420,8962,5.3,14,-2220,-2.2,23.6,0,332,332,1749
1998,45,j) 21 to 25,1226,2193,39655,37679,113,5.1,124,5.6,8023,2165,5858,5.7,21.3,4071,1099,2972,2.9,10.8,3952,10.5,21.6,0,44,44,153
1998,45,l) Left Censored,10900,22817,819489,811157,1411,6.2,1669,7.3,100314,29329,70985,3.6,12.4,83650,30131,53519,3.7,10.3,16664,2.1,20.6,0,407,407,4024
1998,46,a) 0,1672,1687,9185,4602,1674,198.5,0,0,9167,9167,0,199.2,199.2,0,0,0,0,0,9167,199.2,0,0,,,
1998,46,b) 1,1270,1290,7932,8312,1,0.1,359,24.2,1591,,,,19.1,2351,1360,991,16.4,28.3,-760,-9.2,38.2,1,294,294,1008
1998,46,c) 2,1081,1111,6935,7515,37,3.1,226,18.7,1265,,,,16.8,2424,1644,780,21.9,32.3,-1159,-15.5,33.6,1,175,175,1345
1998,46,d) 3,942,962,6521,6732,33,3.2,157,15.3,1050,124,926,1.8,15.6,1471,631,840,9.4,21.9,-421,-6.3,31.2,0,126,126,550
1998,46,e) 4,898,911,7084,7169,27,2.8,127,13.1,1041,177,864,2.5,14.5,1210,460,750,6.4,16.9,-169,-2.4,29,0,96,96,370
1998,46,f) 5,754,770,5312,5594,19,2.3,103,12.7,850,52,798,0.9,15.2,1413,721,692,12.9,25.3,-563,-10.1,30.4,0,84,84,588
1998,46,g) 6 to 10,2950,3102,27522,27720,99,3.1,360,11.1,3781,589,3192,2.1,13.6,4176,1860,2316,6.7,15.1,-395,-1.5,27.2,0,262,262,1237
1998,46,h) 11 to 15,2327,2587,38382,37286,86,3.2,203,7.7,6477,1143,5334,3.1,17.4,4284,1358,2926,3.6,11.5,2193,5.9,23,0,132,132,508
1998,46,i) 16 to 20,1670,1890,24214,24267,37,1.9,123,6.3,2833,353,2480,1.5,11.7,2939,811,2128,3.3,12.1,-106,-0.4,23.4,0,84,84,440
1998,46,j) 21 to 25,393,550,8227,8191,21,3.7,48,8.5,939,231,708,2.8,11.5,867,330,537,4,10.6,72,0.9,21.2,0,17,17,61
1998,46,l) Left Censored,3700,5813,144690,143238,234,4,360,6.1,14558,2949,11609,2.1,10.2,11653,3570,8083,2.5,8.1,2905,2.1,16.2,0,151,151,983
1998,47,a) 0,9528,9625,71353,35786,9554,198.5,0,0,71134,71134,0,198.8,198.8,0,0,0,0,0,71134,198.8,0,0,,,
1998,47,b) 1,7147,7329,58490,59914,35,0.4,2414,28.1,16880,1930,14950,3.2,28.2,19728,11281,8447,18.8,32.9,-2848,-4.7,56.4,0,2028,2028,9558
1998,47,c) 2,6196,6339,58198,61389,209,3,1413,20.3,11670,1961,9709,3.2,19,18051,10915,7136,17.8,29.4,-6381,-10.4,38,0,1168,1168,9533
1998,47,d) 3,5214,5359,48080,50430,185,3.2,974,16.9,9065,1783,7282,3.5,18,13764,6736,7028,13.4,27.3,-4699,-9.3,36,0,782,782,5766
1998,47,e) 4,4554,4694,42585,43949,147,3,699,14,6679,912,5767,2.1,15.2,9407,4236,5171,9.6,21.4,-2728,-6.2,30.4,0,559,559,3534
1998,47,f) 5,4101,4311,40653,42239,137,3,628,13.8,7162,1390,5772,3.3,17,10334,4270,6064,10.1,24.5,-3172,-7.5,34,0,500,500,3263
1998,47,g) 6 to 10,15683,16938,199304,200867,490,2.8,1921,10.9,30304,5514,24790,2.7,15.1,33429,12903,20526,6.4,16.6,-3125,-1.5,30.2,0,1411,1411,8263
1998,47,h) 11 to 15,13163,15170,223273,225015,465,3,1142,7.4,26908,7004,19904,3.1,12,30391,8634,21757,3.8,13.5,-3483,-1.5,24,0,730,730,4758
1998,47,i) 16 to 20,8109,9751,162038,161625,331,3.3,698,7,22212,4623,17589,2.9,13.7,21386,5850,15536,3.6,13.2,826,0.5,26.4,0,405,406,2873
1998,47,j) 21 to 25,1945,4135,108349,106059,308,7.5,279,6.8,18914,8169,10745,7.7,17.8,14334,5513,8821,5.2,13.5,4580,4.3,27,0,95,95,811
1998,47,l) Left Censored,15989,34166,1263461,1253467,2121,6.2,2493,7.3,153555,44442,109113,3.5,12.3,133567,40901,92666,3.3,10.7,19988,1.6,21.4,0,733,733,6087
1998,48,a) 0,36392,36679,271423,136410,36411,198.5,0,0,270027,270027,0,198,198,0,0,0,0,0,270027,198,0,0,,,
1998,48,b) 1,27890,28571,250363,248216,154,0.5,8551,25.8,75870,4421,71449,1.8,30.6,71575,44315,27260,17.9,28.8,4295,1.8,57.6,0,6991,6991,37249
1998,48,c) 2,23413,24157,226963,234872,803,3,5412,20.4,57540,8396,49144,3.6,24.5,73357,42312,31045,18,31.2,-15817,-6.7,49,0,4474,4474,35292
1998,48,d) 3,20009,20706,194695,202020,688,3.1,3717,16.7,38422,5686,32736,2.8,19,53072,25535,27537,12.6,26.3,-14650,-7.3,38,0,2936,2936,21100
1998,48,e) 4,17449,18274,195123,196443,647,3.3,2750,14.2,43411,6005,37406,3.1,22.1,46051,20996,25055,10.7,23.4,-2640,-1.3,44.2,0,2208,2208,16725
1998,48,f) 5,15113,15907,167864,172169,527,3.1,2352,14,34600,3846,30754,2.2,20.1,43209,21832,21377,12.7,25.1,-8609,-5,40.2,0,1835,1835,18250
1998,48,g) 6 to 10,56937,62437,806579,806771,2176,3.4,7042,10.8,143640,27158,116482,3.4,17.8,144024,56561,87463,7,17.9,-384,-0.1,35.6,0,5060,5060,35023
1998,48,h) 11 to 15,42504,50207,763976,762769,1759,3.4,4268,8.3,111515,22994,88521,3,14.6,109101,35453,73648,4.6,14.3,2414,0.3,28.6,0,2696,2696,18596
1998,48,i) 16 to 20,31513,38424,613397,611396,1251,3.2,2996,7.6,90264,15656,74608,2.6,14.8,86262,29337,56925,4.8,14.1,4002,0.7,28.2,0,1686,1690,14239
1998,48,j) 21 to 25,5558,10412,215122,212884,572,5.4,911,8.6,36508,10640,25868,5,17.1,32032,10379,21653,4.9,15,4476,2.1,30,0,243,243,1726
1998,48,l) Left Censored,41122,104914,3690249,3661380,7936,7.5,8299,7.9,529445,172616,356829,4.7,14.5,471708,141434,330274,3.9,12.9,57737,1.6,25.8,0,1862,1862,19125
1998,49,a) 0,4934,4971,34832,17456,4939,198.7,0,0,34753,34753,0,199.1,199.1,0,0,0,0,0,34753,199.1,0,0,,,
1998,49,b) 1,3688,3749,29741,30368,11,0.3,1201,27.3,9770,,,,32.2,11023,6511,4512,21.4,36.3,-1253,-4.1,64.4,1,948,948,5181
1998,49,c) 2,3090,3167,39894,37442,89,2.6,687,19.8,13160,,,,35.1,8255,4392,3863,11.7,22,4905,13.1,44,1,557,557,3827
1998,49,d) 3,2438,2501,26242,27145,82,3,477,17.6,6067,467,5600,1.7,22.4,7872,3598,4274,13.3,29,-1805,-6.6,44.8,0,374,374,2618
1998,49,e) 4,2094,2181,22315,23198,77,3.3,362,15.6,4239,749,3490,3.2,18.3,6004,2970,3034,12.8,25.9,-1765,-7.6,36.6,0,282,282,2607
1998,49,f) 5,1655,1740,18684,19060,59,3.2,236,12.9,3178,451,2727,2.4,16.7,3929,1672,2257,8.8,20.6,-751,-3.9,33.4,0,186,186,1273
1998,49,g) 6 to 10,5933,6411,93331,95598,211,3.2,717,10.7,14257,2125,12132,2.2,14.9,18791,6625,12166,6.9,19.7,-4534,-4.8,29.8,0,493,493,3717
1998,49,h) 11 to 15,3811,4435,76750,77769,197,4.3,401,8.8,10049,1964,8085,2.5,12.9,12087,4062,8025,5.2,15.5,-2038,-2.6,25.8,0,223,223,1737
1998,49,i) 16 to 20,3038,3507,64963,65579,103,2.9,276,7.7,7575,878,6697,1.3,11.6,8807,2702,6105,4.1,13.4,-1232,-1.8,23.2,0,157,157,1389
1998,49,j) 21 to 25,721,1136,21729,21763,68,6,69,6.1,3067,1208,1859,5.6,14.1,3135,622,2513,2.9,14.4,-68,-0.3,28.2,0,25,25,136
1998,49,l) Left Censored,5139,10411,409029,409633,724,6.9,750,7.2,55777,19867,35910,4.8,13.6,56984,11835,45149,2.9,13.9,-1207,-0.3,27.2,0,190,190,1111
1998,50,a) 0,1440,1453,7250,3639,1443,198.6,0,0,7222,7222,0,198.5,198.5,0,0,0,0,0,7222,198.5,0,0,,,
1998,50,b) 1,1178,1190,5378,5690,2,0.1,306,22.5,1546,,,,27.2,2170,1231,939,21.6,38.1,-624,-10.9,54.4,1,237,237,733
1998,50,c) 2,976,984,6213,6520,21,2,176,16.6,1152,,,,17.7,1765,867,898,13.3,27.1,-613,-9.4,35.4,1,146,146,634
1998,50,d) 3,861,871,5826,6197,28,3,143,15.4,771,100,671,1.6,12.4,1515,763,752,12.3,24.4,-744,-12,24.8,0,124,124,638
1998,50,e) 4,815,840,5187,5376,29,3.3,94,10.8,742,134,608,2.5,13.8,1120,453,667,8.4,20.8,-378,-7,27.6,0,72,72,350
1998,50,f) 5,746,766,4770,4802,25,3.2,71,9,684,161,523,3.4,14.2,747,280,467,5.8,15.6,-63,-1.4,28.4,0,58,58,195
1998,50,g) 6 to 10,3147,3250,26239,26406,73,2.1,359,10.6,3745,213,3532,0.8,14.2,4078,1391,2687,5.3,15.4,-333,-1.2,28.4,0,281,281,1127
1998,50,h) 11 to 15,2535,2750,31895,32218,67,2.4,234,8.3,3304,307,2997,1,10.3,3950,1312,2638,4.1,12.3,-646,-2,20.6,0,171,171,961
1998,50,i) 16 to 20,1472,1661,19839,19423,45,2.6,117,6.9,2741,807,1934,4.2,14.1,1908,642,1266,3.3,9.8,833,4.3,19.6,0,78,78,324
1998,50,j) 21 to 25,321,473,10334,10483,16,3.3,29,6.1,793,92,701,0.9,7.6,1091,264,827,2.5,10.4,-298,-2.8,15.2,0,13,13,65
1998,50,l) Left Censored,2827,4253,113937,112584,163,3.7,358,8.2,12321,2840,9481,2.5,10.9,9615,3470,6145,3.1,8.5,2706,2.4,17,0,106,106,651
1998,51,a) 0,12496,12594,77414,38948,12506,198.6,0,0,76932,76932,0,197.5,197.5,0,0,0,0,0,76932,197.5,0,0,,,
1998,51,b) 1,9607,9763,68807,69372,46,0.4,2782,24.8,19186,2458,16728,3.5,27.7,20315,11987,8328,17.3,29.3,-1129,-1.6,55.4,0,2216,2216,10241
1998,51,c) 2,8036,8211,59802,63272,260,2.9,1514,17.1,12581,1268,11313,2,19.9,19520,8849,10671,14,30.9,-6939,-11,39.8,0,1180,1180,7083
1998,51,d) 3,7316,7544,59874,61433,235,2.9,1177,14.7,11537,1289,10248,2.1,18.8,14654,7415,7239,12.1,23.9,-3117,-5.1,37.6,0,927,927,6015
1998,51,e) 4,6151,6348,58796,59261,195,2.9,898,13.4,11100,1097,10003,1.9,18.7,12029,5078,6951,8.6,20.3,-929,-1.6,37.4,0,696,696,4104
1998,51,f) 5,5490,5694,49041,51452,178,3,736,12.3,7652,1239,6413,2.4,14.9,12474,5623,6851,10.9,24.2,-4822,-9.3,29.8,0,569,569,4779
1998,51,g) 6 to 10,22073,23541,259900,262007,698,2.9,2338,9.6,37558,6003,31555,2.3,14.3,41771,15026,26745,5.7,15.9,-4213,-1.6,28.6,0,1704,1704,10324
1998,51,h) 11 to 15,16912,19485,282597,283608,612,3.1,1629,8.1,39483,8107,31376,2.9,13.9,41504,14147,27357,5,14.6,-2021,-0.7,27.8,0,993,993,5845
1998,51,i) 16 to 20,10194,12394,226045,226994,375,3,948,7.5,30353,6159,24194,2.7,13.4,32251,10497,21754,4.6,14.2,-1898,-0.8,26.8,0,513,513,5072
1998,51,j) 21 to 25,2250,3972,78498,78636,150,3.7,249,6.2,11286,3203,8083,4.1,14.4,11561,2691,8870,3.4,14.7,-275,-0.3,28.8,0,93,93,422
1998,51,l) Left Censored,19091,43428,1420632,1414118,3283,7.5,3374,7.8,176094,59599,116495,4.2,12.5,163066,58723,104343,4.2,11.5,13028,1,23,0,765,765,5743
1998,53,a) 0,13467,13660,76429,38369,13525,198,0,0,76121,76121,0,198.4,198.4,0,0,0,0,0,76121,198.4,0,0,,,
1998,53,b) 1,10052,10195,65799,66341,22,0.2,3167,26.6,18842,939,17903,1.4,28.4,19925,11260,8665,17,30,-1083,-1.6,56.8,0,2425,2425,9257
1998,53,c) 2,8504,8668,59984,62140,328,3.5,1832,19.4,13038,1294,11744,2.1,21,17350,9071,8279,14.6,27.9,-4312,-6.9,42,0,1448,1448,7483
1998,53,d) 3,7297,7501,56792,57283,312,3.9,1358,16.9,12018,1121,10897,2,21,13000,6529,6471,11.4,22.7,-982,-1.7,42,0,1045,1045,5386
1998,53,e) 4,6430,6629,55375,54547,294,4.2,1081,15.4,14538,2959,11579,5.4,26.7,12882,5213,7669,9.6,23.6,1656,3.1,47.2,0,838,838,4002
1998,53,f) 5,5551,5809,44341,45512,236,3.9,808,13.2,7629,969,6660,2.1,16.8,9971,3931,6040,8.6,21.9,-2342,-5.1,33.6,0,619,619,3242
1998,53,g) 6 to 10,21222,22540,230722,232259,861,3.7,2566,11,37942,5692,32250,2.5,16.3,41015,15809,25206,6.8,17.7,-3073,-1.4,32.6,0,1822,1822,11099
1998,53,h) 11 to 15,15023,17214,242640,244371,666,3.8,1541,8.7,32244,7803,24441,3.2,13.2,35706,13198,22508,5.4,14.6,-3462,-1.4,26.4,0,934,934,6620
1998,53,i) 16 to 20,10414,12413,190597,190491,406,3.2,921,7.3,25231,4373,20858,2.3,13.2,25018,6622,18396,3.5,13.1,213,0.1,26.2,0,554,554,3677
1998,53,j) 21 to 25,2189,3645,74597,73941,187,5.1,253,6.9,11060,2566,8494,3.5,15,9748,3175,6573,4.3,13.2,1312,1.8,26.4,0,99,99,741
1998,53,l) Left Censored,15679,31395,977315,970489,1836,5.8,2286,7.2,122226,28864,93362,3,12.6,108574,33318,75256,3.4,11.2,13652,1.4,22.4,0,676,676,4537
1998,54,a) 0,2624,2642,15852,7975,2617,198.1,0,0,15754,15754,0,197.5,197.5,0,0,0,0,0,15754,197.5,0,0,,,
1998,54,b) 1,2113,2126,13519,13575,3,0.1,633,25.7,3696,188,3508,1.4,27.2,3808,2036,1772,15,28.1,-112,-0.9,54.4,0,517,517,1673
1998,54,c) 2,1733,1773,11930,13071,49,2.5,384,19.7,2165,279,1886,2.1,16.6,4446,2559,1887,19.6,34,-2281,-17.4,33.2,0,314,314,2124
1998,54,d) 3,1645,1672,11836,12147,57,3.2,279,15.6,2407,407,2000,3.4,19.8,3029,1395,1634,11.5,24.9,-622,-5.1,39.6,0,221,221,1190
1998,54,e) 4,1364,1399,9742,10000,53,3.6,205,13.9,1628,307,1321,3.1,16.3,2144,902,1242,9,21.4,-516,-5.1,32.6,0,164,164,746
1998,54,f) 5,1253,1279,10204,10605,34,2.5,165,12.3,1549,268,1281,2.5,14.6,2351,898,1453,8.5,22.2,-802,-7.6,29.2,0,134,134,804
1998,54,g) 6 to 10,5178,5454,49059,50196,156,2.8,537,9.5,6351,832,5519,1.7,12.7,8625,3128,5497,6.2,17.2,-2274,-4.5,25.4,0,395,395,2126
1998,54,h) 11 to 15,4232,4711,58560,59548,125,2.6,360,7.4,5731,971,4760,1.6,9.6,7706,2200,5506,3.7,12.9,-1975,-3.3,19.2,0,239,239,1431
1998,54,i) 16 to 20,2909,3413,43990,44301,88,2.5,214,6.2,4569,883,3686,2,10.3,5191,1151,4040,2.6,11.7,-622,-1.4,20.6,0,138,138,723
1998,54,j) 21 to 25,707,1221,22372,22022,36,2.9,66,5.3,2884,776,2108,3.5,13.1,2184,429,1755,1.9,9.9,700,3.2,19.8,0,37,37,124
1998,54,l) Left Censored,6646,11852,290835,291280,567,4.7,729,6.1,34120,10331,23789,3.5,11.7,35011,9818,25193,3.4,12,-891,-0.3,23.4,0,251,251,1558
1998,55,a) 0,8756,8859,62689,31410,8800,198.7,0,0,62559,62559,0,199.2,199.2,0,0,0,0,0,62559,199.2,0,0,,,
1998,55,b) 1,7051,7134,49740,49028,28,0.3,1749,21.7,14006,1368,12638,2.8,28.6,12582,6664,5918,13.6,25.7,1424,2.9,51.4,0,1392,1392,5627
1998,55,c) 2,6116,6194,45827,47444,140,2.1,1005,15.1,8962,1073,7889,2.3,18.9,12196,6875,5321,14.5,25.7,-3234,-6.8,37.8,0,809,809,5977
1998,55,d) 3,5427,5577,42959,44001,137,2.3,838,14.1,6533,723,5810,1.6,14.8,8617,3874,4743,8.8,19.6,-2084,-4.8,29.6,0,665,665,3273
1998,55,e) 4,4889,5010,39421,40147,105,2,636,12,5809,580,5229,1.4,14.5,7260,3070,4190,7.6,18.1,-1451,-3.6,29,0,513,513,2631
1998,55,f) 5,4454,4590,41000,41695,128,2.7,507,10.6,5962,871,5091,2.1,14.3,7351,2596,4755,6.2,17.6,-1389,-3.3,28.6,0,390,390,2031
1998,55,g) 6 to 10,17671,18787,190656,192656,472,2.4,1676,8.6,25678,4038,21640,2.1,13.3,29678,12258,17420,6.4,15.4,-4000,-2.1,26.6,0,1233,1233,6680
1998,55,h) 11 to 15,13910,15843,241466,242015,373,2.3,1048,6.5,28267,3594,24673,1.5,11.7,29365,8610,20755,3.6,12.1,-1098,-0.4,23.4,0,706,706,4415
1998,55,i) 16 to 20,9368,11058,169560,170833,255,2.3,777,6.9,17556,3731,13825,2.2,10.3,20102,6382,13720,3.7,11.8,-2546,-1.5,20.6,0,489,489,3230
1998,55,j) 21 to 25,2168,3761,69292,69795,168,4.4,263,6.9,9036,2465,6571,3.5,12.9,10042,3133,6909,4.5,14.4,-1006,-1.5,25.8,0,116,116,855
1998,55,l) Left Censored,21093,36681,1340187,1334967,1585,4.3,2379,6.4,134320,27172,107148,2,10.1,123881,35039,88842,2.6,9.3,10439,0.8,18.6,0,870,870,7778
1998,56,a) 0,1425,1435,7403,3710,1423,198.3,0,0,7386,7386,0,199.1,199.1,0,0,0,0,0,7386,199.1,0,0,,,
1998,56,b) 1,1082,1094,5501,5746,4,0.3,290,23.2,1427,,,,24.8,1916,1205,711,21,33.3,-489,-8.5,49.6,1,217,217,754
1998,56,c) 2,959,968,4947,5261,32,3,215,20.3,931,,,,17.7,1559,808,751,15.4,29.6,-628,-11.9,35.4,1,170,170,648
1998,56,d) 3,819,830,4916,5125,26,3,125,14.2,890,190,700,3.7,17.4,1307,538,769,10.5,25.5,-417,-8.1,34.8,0,92,92,379
1998,56,e) 4,748,758,5182,5309,24,3,102,12.8,814,60,754,1.1,15.3,1068,456,612,8.6,20.1,-254,-4.8,30.6,0,75,75,305
1998,56,f) 5,616,649,4901,4893,43,6.4,88,13.1,1015,371,644,7.6,20.7,998,437,561,8.9,20.4,17,0.3,40.8,0,69,69,366
1998,56,g) 6 to 10,2124,2212,17089,17409,83,3.6,238,10.4,2457,356,2101,2,14.1,3097,1058,2039,6.1,17.8,-640,-3.7,28.2,0,162,162,753
1998,56,h) 11 to 15,1664,1877,19728,19897,68,3.5,175,9.1,2480,581,1899,2.9,12.5,2818,1056,1762,5.3,14.2,-338,-1.7,25,0,107,107,616
1998,56,i) 16 to 20,1508,1690,16431,16618,47,2.7,119,6.9,1998,243,1755,1.5,12,2372,729,1643,4.4,14.3,-374,-2.3,24,0,78,78,438
1998,56,j) 21 to 25,291,427,7072,7066,15,3.5,28,6.5,1469,655,814,9.3,20.8,1457,647,810,9.2,20.6,12,0.2,41.2,0,18,18,582
1998,56,l) Left Censored,2169,3465,63471,64208,173,5,237,6.8,7611,2107,5504,3.3,11.9,9084,3858,5226,6,14.1,-1473,-2.2,23.8,0,87,87,990
1999,01,a) 0,7120,7171,49375,24919,7123,198.7,0,0,48913,48913,0,196.3,196.3,0,0,0,0,0,48913,196.3,0,0,,,
1999,01,b) 1,5739,5861,49491,49102,112,1.7,1659,24.8,14897,2706,12191,5.5,30.3,14118,7726,6392,15.7,28.8,779,1.5,57.6,0,1347,1347,5862
1999,01,c) 2,4799,4915,39875,41408,146,2.7,1095,20.3,8633,1111,7522,2.7,20.8,11699,6667,5032,16.1,28.3,-3066,-7.5,41.6,0,872,872,5153
1999,01,d) 3,4210,4387,33317,34163,145,3.1,835,17.6,5703,856,4847,2.5,16.7,7395,3991,3404,11.7,21.6,-1692,-4.9,33.4,0,639,639,3187
1999,01,e) 4,3719,3834,32150,33079,121,3,595,14.6,5720,478,5242,1.4,17.3,7578,3519,4059,10.6,22.9,-1858,-5.6,34.6,0,454,454,2589
1999,01,f) 5,3350,3447,33476,34521,103,2.8,494,13.6,5430,634,4796,1.8,15.7,7520,3986,3534,11.5,21.8,-2090,-6.1,31.4,0,381,381,3485
1999,01,g) 6 to 10,12161,13005,145659,149880,352,2.6,1519,11.2,21137,2816,18321,1.9,14.1,29578,11145,18433,7.4,19.7,-8441,-5.6,28.2,0,1129,1129,8219
1999,01,h) 11 to 15,9961,11432,185323,186207,326,2.8,936,8,19942,4420,15522,2.4,10.7,21710,7594,14116,4.1,11.7,-1768,-1,21.4,0,618,618,4468
1999,01,i) 16 to 20,6034,7199,129196,130522,234,3.2,540,7.3,16110,4210,11900,3.2,12.3,18761,4436,14325,3.4,14.4,-2651,-2.1,24.6,0,370,370,2510
1999,01,j) 21 to 25,2584,4334,82502,81028,207,4.7,267,6.1,14628,7504,7124,9.3,18.1,11679,2232,9447,2.8,14.4,2949,3.7,28.8,0,129,129,694
1999,01,l) Left Censored,11557,24784,827153,828051,1398,5.6,1605,6.4,99214,34295,64919,4.1,12,101009,33043,67966,4,12.2,-1795,-0.2,24,0,460,460,3612
1999,02,a) 0,1262,1265,5807,2922,1256,198.6,0,0,5771,5771,0,197.5,197.5,0,0,0,0,0,5771,197.5,0,0,,,
1999,02,b) 1,1069,1090,7884,7805,18,1.4,318,25.4,2084,274,1810,3.5,26.7,1926,966,960,12.4,24.7,158,2,49.4,0,230,230,748
1999,02,c) 2,856,863,5243,5446,25,2.6,180,19,1184,103,1081,1.9,21.7,1589,903,686,16.6,29.2,-405,-7.5,43.4,0,128,128,588
1999,02,d) 3,747,758,4517,4636,29,3.6,138,17,954,235,719,5.1,20.6,1191,626,565,13.5,25.7,-237,-5.1,41.2,0,99,99,443
1999,02,e) 4,658,671,4372,4404,19,2.7,104,14.5,804,40,764,0.9,18.3,867,346,521,7.9,19.7,-63,-1.4,36.6,0,73,73,250
1999,02,f) 5,571,581,4252,4356,22,3.6,85,13.8,901,258,643,5.9,20.7,1108,459,649,10.5,25.4,-207,-4.7,41.4,0,54,54,300
1999,02,g) 6 to 10,2218,2301,17673,18038,85,3.5,278,11.6,2595,305,2290,1.7,14.4,3324,1020,2304,5.7,18.4,-729,-4,28.8,0,193,193,652
1999,02,h) 11 to 15,1827,2101,26418,27049,66,3.1,157,7.3,2822,337,2485,1.2,10.4,4083,1087,2996,4,15.1,-1261,-4.7,20.8,0,111,111,659
1999,02,i) 16 to 20,1278,1512,17657,17700,46,3,111,7.2,2080,235,1845,1.3,11.8,2165,545,1620,3.1,12.2,-85,-0.4,23.6,0,76,76,328
1999,02,j) 21 to 25,503,771,11998,12060,40,5.1,50,6.4,1630,333,1297,2.8,13.5,1753,497,1256,4.1,14.5,-123,-1,27,0,24,24,210
1999,02,l) Left Censored,1630,3204,86587,87913,152,4.7,193,6,8286,1593,6693,1.8,9.4,10937,2821,8116,3.2,12.4,-2651,-3,18.8,0,42,42,299
1999,04,a) 0,9655,9743,77147,38694,9643,197.9,0,0,76906,76906,0,198.8,198.8,0,0,0,0,0,76906,198.8,0,0,,,
1999,04,b) 1,7359,7564,71464,69759,173,2,2124,24.7,24022,3729,20293,5.3,34.4,20612,11215,9397,16.1,29.5,3410,4.9,59,0,1703,1703,9606
1999,04,c) 2,6142,6306,56360,58867,210,3,1394,20.2,13731,1659,12072,2.8,23.3,18744,10407,8337,17.7,31.8,-5013,-8.5,46.6,0,1105,1105,8610
1999,04,d) 3,5202,5338,48754,51606,204,3.6,961,16.8,10590,1871,8719,3.6,20.5,16294,8248,8046,16,31.6,-5704,-11.1,41,0,745,745,6492
1999,04,e) 4,4552,4751,53531,54558,192,3.8,730,14.6,10598,1446,9152,2.7,19.4,12652,5855,6797,10.7,23.2,-2054,-3.8,38.8,0,557,557,4780
1999,04,f) 5,3998,4181,47115,46639,178,4.1,600,13.7,10891,1849,9042,4,23.4,9938,5270,4668,11.3,21.3,953,2.1,42.6,0,446,446,3479
1999,04,g) 6 to 10,13506,14569,202259,208953,533,3.5,1824,12,32765,5972,26793,2.9,15.7,46152,17167,28985,8.2,22.1,-13387,-6.4,31.4,0,1311,1311,11677
1999,04,h) 11 to 15,10155,12053,195316,194679,556,4.5,1117,9.1,29040,6325,22715,3.2,14.9,27765,11369,16396,5.8,14.3,1275,0.6,28.6,0,684,684,6186
1999,04,i) 16 to 20,6598,8304,156098,154982,300,3.5,747,8.8,23995,6540,17455,4.2,15.5,21763,7964,13799,5.1,14,2232,1.5,28,0,371,371,2717
1999,04,j) 21 to 25,2127,3500,94154,92970,197,5.6,230,6.5,13784,3961,9823,4.3,14.8,11416,2309,9107,2.5,12.3,2368,2.5,24.6,0,86,86,571
1999,04,l) Left Censored,8023,20961,800020,793202,1877,9,1821,8.7,112404,38315,74089,4.8,14.2,98767,34037,64730,4.3,12.5,13637,1.7,25,0,297,297,2237
1999,05,a) 0,4592,4632,26366,13242,4596,198.4,0,0,26248,26248,0,198.2,198.2,0,0,0,0,0,26248,198.2,0,0,,,
1999,05,b) 1,3553,3678,29541,29492,64,1.5,1065,25.3,9058,1603,7455,5.4,30.7,8959,4647,4312,15.8,30.4,99,0.3,60.8,0,895,895,4089
1999,05,c) 2,2968,2996,23099,23914,85,2.6,682,20.6,4531,347,4184,1.5,18.9,6161,3663,2498,15.3,25.8,-1630,-6.9,37.8,0,563,563,2550
1999,05,d) 3,2540,2639,21590,21976,76,2.6,526,18.3,4239,684,3555,3.1,19.3,5011,2702,2309,12.3,22.8,-772,-3.5,38.6,0,426,426,2142
1999,05,e) 4,2439,2512,21359,22222,60,2.2,397,14.8,3112,278,2834,1.3,14,4838,2502,2336,11.3,21.8,-1726,-7.8,28,0,301,301,1957
1999,05,f) 5,2164,2239,18602,19213,56,2.4,310,13.1,3070,330,2740,1.7,16,4292,2349,1943,12.2,22.3,-1222,-6.3,32,0,239,239,1883
1999,05,g) 6 to 10,7673,8103,77452,77984,259,3.1,938,11.1,12004,2795,9209,3.6,15.4,13068,5290,7778,6.8,16.8,-1064,-1.4,30.8,0,683,683,3498
1999,05,h) 11 to 15,5971,6706,90578,90456,183,2.7,554,8,12154,2486,9668,2.7,13.4,11910,4980,6930,5.5,13.2,244,0.2,26.4,0,381,381,3251
1999,05,i) 16 to 20,4190,4931,73061,75304,142,2.8,425,8.4,8177,1515,6662,2,10.9,12662,4294,8368,5.7,16.8,-4485,-5.9,21.8,0,286,286,1999
1999,05,j) 21 to 25,1740,2367,55237,54700,70,2.9,175,7.2,6062,899,5163,1.6,11.1,4988,1834,3154,3.4,9.1,1074,2,18.2,0,92,92,551
1999,05,l) Left Censored,7516,14754,512460,514105,893,6,1090,7.3,57384,15610,41774,3,11.2,60673,20225,40448,3.9,11.8,-3289,-0.6,22.4,0,314,314,1851
1999,06,a) 0,60531,61061,407079,204584,60524,198.2,0,0,404990,404990,0,198,198,0,0,0,0,0,404990,198,0,0,,,
1999,06,b) 1,47211,48545,452867,436418,1016,1.9,12725,23.2,151291,40818,110473,9.4,34.7,118393,61696,56697,14.1,27.1,32898,7.6,54.2,0,9782,9782,49516
1999,06,c) 2,38685,39503,383719,385086,1263,2.9,8050,18.7,103051,8147,94904,2.1,26.8,105784,60571,45213,15.7,27.5,-2733,-0.7,53.6,0,6286,6286,49327
1999,06,d) 3,33651,34412,329583,336434,1202,3.3,6137,16.6,67517,7395,60122,2.2,20.1,81219,41667,39552,12.4,24.1,-13702,-4,40.2,0,4707,4707,33140
1999,06,e) 4,28769,29858,325328,327895,1174,3.7,4644,14.7,64347,9489,54858,2.9,19.6,69480,32621,36859,9.9,21.2,-5133,-1.6,39.2,0,3474,3474,25249
1999,06,f) 5,24787,25746,305129,307044,997,3.7,3665,13.5,57490,9716,47774,3.2,18.7,61320,28429,32891,9.3,20,-3830,-1.3,37.4,0,2779,2779,21670
1999,06,g) 6 to 10,100358,107448,1302843,1326521,4198,3.8,12494,11.2,213160,33110,180050,2.5,16.1,260515,101788,158727,7.7,19.6,-47355,-3.5,32.2,0,8919,8919,68875
1999,06,h) 11 to 15,79419,91172,1443689,1440870,3640,3.9,8258,8.8,218581,51234,167347,3.6,15.2,212942,72460,140482,5,14.8,5639,0.4,29.6,0,5256,5256,37506
1999,06,i) 16 to 20,55329,66493,1208628,1205705,2171,3.2,5016,7.4,159902,38182,121720,3.2,13.3,154056,45437,108619,3.8,12.8,5846,0.5,25.6,0,3004,3004,19982
1999,06,j) 21 to 25,19320,30142,644743,651109,1370,4.5,2285,7.5,86139,23476,62663,3.6,13.2,98870,31439,67431,4.8,15.2,-12731,-2,26.4,0,1004,1004,7668
1999,06,l) Left Censored,66855,149428,5330678,5367156,10068,6.7,13575,9,710124,225491,484633,4.2,13.2,783079,280470,502609,5.2,14.6,-72955,-1.4,26.4,0,3268,3268,27948
1999,08,a) 0,11432,11524,68167,34179,11457,198.8,0,0,67977,67977,0,198.9,198.9,0,0,0,0,0,67977,198.9,0,0,,,
1999,08,b) 1,9109,9253,63445,62850,124,1.2,2467,23.5,18976,2411,16565,3.8,30.2,17786,10034,7752,16,28.3,1190,1.9,56.6,0,1907,1907,8509
1999,08,c) 2,7373,7491,58273,60756,244,3,1573,19.2,12711,1305,11406,2.1,20.9,17677,10672,7005,17.6,29.1,-4966,-8.2,41.8,0,1252,1252,8673
1999,08,d) 3,6271,6413,49764,50104,231,3.4,1111,16.2,9917,1400,8517,2.8,19.8,10597,5344,5253,10.7,21.2,-680,-1.4,39.6,0,861,861,4063
1999,08,e) 4,5606,5785,50119,50589,204,3.3,881,14.4,8845,1769,7076,3.5,17.5,9784,4399,5385,8.7,19.3,-939,-1.8,35,0,667,667,3405
1999,08,f) 5,5076,5234,45981,46601,212,3.9,726,13.2,8655,2039,6616,4.4,18.6,9894,4499,5395,9.7,21.2,-1239,-2.6,37.2,0,531,531,2823
1999,08,g) 6 to 10,16946,17990,197478,199313,636,3.4,1976,10.6,31763,6376,25387,3.2,15.9,35433,14448,20985,7.2,17.8,-3670,-1.9,31.8,0,1386,1386,9395
1999,08,h) 11 to 15,11565,13182,198743,198000,472,3.5,1210,8.9,30214,7205,23009,3.6,15.3,28728,10652,18076,5.4,14.5,1486,0.8,29,0,770,770,5667
1999,08,i) 16 to 20,7985,9834,180558,178848,458,4.6,887,8.8,31160,9213,21947,5.2,17.4,27740,12033,15707,6.7,15.5,3420,1.9,31,0,426,426,2852
1999,08,j) 21 to 25,2798,4320,95091,94655,189,4.3,345,7.8,14093,2753,11340,2.9,14.9,13221,5565,7656,5.9,14,872,0.9,28,0,135,135,642
1999,08,l) Left Censored,10811,23396,781779,779519,1885,8.1,1790,7.7,113469,40746,72723,5.2,14.6,108948,38223,70725,4.9,14,4521,0.6,28,0,414,414,5081
1999,09,a) 0,5288,5304,32635,16355,5276,198.9,0,0,32561,32561,0,199.1,199.1,0,0,0,0,0,32561,199.1,0,0,,,
1999,09,b) 1,4579,4691,38372,37823,99,1.9,1089,20.8,11104,2660,8444,7,29.4,10006,4481,5525,11.8,26.5,1098,2.9,53,0,857,857,3713
1999,09,c) 2,3739,3789,28466,29027,108,2.6,675,16.5,5685,655,5030,2.3,19.6,6806,3557,3249,12.3,23.4,-1121,-3.8,39.2,0,535,535,2889
1999,09,d) 3,3365,3461,34241,35092,91,2.5,527,14.3,5127,571,4556,1.6,14.6,6828,3178,3650,9.1,19.5,-1701,-4.9,29.2,0,410,410,2355
1999,09,e) 4,3215,3316,28349,28383,97,2.8,447,12.8,5609,1057,4552,3.7,19.8,5677,2782,2895,9.8,20,-68,-0.2,39.6,0,354,354,2236
1999,09,f) 5,2811,2868,25748,26167,80,2.7,350,11.6,4735,1245,3490,4.8,18.1,5573,2815,2758,10.8,21.3,-838,-3.2,36.2,0,266,266,2102
1999,09,g) 6 to 10,11719,12174,129249,130299,305,2.4,1226,9.7,16931,2552,14379,2,13,19030,8306,10724,6.4,14.6,-2099,-1.6,26,0,913,913,5837
1999,09,h) 11 to 15,10479,11526,143269,144764,363,3.1,958,8.1,16781,4049,12732,2.8,11.6,19771,7551,12220,5.2,13.7,-2990,-2.1,23.2,0,634,634,3631
1999,09,i) 16 to 20,6569,7564,111141,109936,312,4.1,553,7.2,15449,4915,10534,4.5,14.1,13039,4420,8619,4,11.9,2410,2.2,23.8,0,359,359,1990
1999,09,j) 21 to 25,2511,3401,63731,63051,134,3.9,242,7,9636,2114,7522,3.4,15.3,8275,2488,5787,3.9,13.1,1361,2.2,26.2,0,132,132,991
1999,09,l) Left Censored,14434,24020,883198,881071,1195,4.9,1747,7.2,106035,27650,78385,3.1,12,101780,33589,68191,3.8,11.6,4255,0.4,23.2,0,598,598,5092
1999,10,a) 0,1735,1737,9516,4777,1722,198.3,0,0,9479,9479,0,198.4,198.4,0,0,0,0,0,9479,198.4,0,0,,,
1999,10,b) 1,1416,1436,9155,9550,19,1.2,301,18.9,2134,305,1829,3.2,22.3,2924,1684,1240,17.6,30.6,-790,-8.3,44.6,0,227,227,1494
1999,10,c) 2,1091,1107,7699,7713,31,2.6,201,16.8,1743,180,1563,2.3,22.6,1771,1026,745,13.3,23,-28,-0.4,45.2,0,154,154,839
1999,10,d) 3,932,959,8370,8915,21,2.1,143,14,1203,76,1127,0.9,13.5,2293,1276,1017,14.3,25.7,-1090,-12.2,27,0,107,107,836
1999,10,e) 4,884,903,7648,7769,18,1.9,124,12.9,1449,81,1368,1,18.7,1691,702,989,9,21.8,-242,-3.1,37.4,0,92,92,541
1999,10,f) 5,761,785,7225,7337,26,3.2,91,11.2,1320,174,1146,2.4,18,1544,608,936,8.3,21,-224,-3,36,0,68,68,386
1999,10,g) 6 to 10,2817,2912,27624,28112,80,2.7,303,10,4323,1075,3248,3.8,15.4,5299,1665,3634,5.9,18.8,-976,-3.4,30.8,0,224,224,1381
1999,10,h) 11 to 15,2025,2214,28338,29025,100,4.4,206,9.1,3546,817,2729,2.8,12.2,4919,1872,3047,6.4,16.9,-1373,-4.7,24.4,0,128,128,945
1999,10,i) 16 to 20,1262,1463,23213,22815,52,3.5,111,7.4,3257,967,2290,4.2,14.3,2461,1044,1417,4.6,10.8,796,3.5,21.6,0,62,62,263
1999,10,j) 21 to 25,564,801,29002,30053,44,5.5,53,6.6,2481,877,1604,2.9,8.3,4582,750,3832,2.5,15.2,-2101,-6.9,16.6,0,22,22,152
1999,10,l) Left Censored,3172,5616,190184,191002,377,6.6,520,9.2,23030,8302,14728,4.3,12.1,24665,7979,16686,4.2,12.9,-1635,-0.8,24.2,0,98,98,689
1999,11,a) 0,1030,1036,8819,4425,1029,198.6,0,0,8789,8789,0,198.6,198.6,0,0,0,0,0,8789,198.6,0,0,,,
1999,11,b) 1,879,888,8797,8683,27,2.7,199,20.2,2263,316,1947,3.6,26.1,2034,746,1288,8.6,23.4,229,2.7,46.8,0,150,150,605
1999,11,c) 2,804,821,7579,7921,21,2.4,142,16.1,1151,102,1049,1.3,14.5,1835,1160,675,14.6,23.2,-684,-8.7,29,0,103,103,727
1999,11,d) 3,682,691,6397,6224,27,3.7,112,15.2,1337,106,1231,1.7,21.5,991,451,540,7.2,15.9,346,5.6,31.8,0,86,86,353
1999,11,e) 4,621,640,7402,7354,23,3.4,92,13.7,1422,362,1060,4.9,19.3,1326,569,757,7.7,18,96,1.3,36,0,66,66,389
1999,11,f) 5,581,598,6139,5978,14,2.2,66,10.6,1160,83,1077,1.4,19.4,838,320,518,5.4,14,322,5.4,28,0,47,47,122
1999,11,g) 6 to 10,2338,2461,34096,34623,79,3.1,246,9.7,5106,1043,4063,3,14.7,6159,3586,2573,10.4,17.8,-1053,-3.1,29.4,0,175,175,1478
1999,11,h) 11 to 15,1979,2177,36443,37319,79,3.6,171,7.7,3783,767,3016,2.1,10.1,5534,1614,3920,4.3,14.8,-1751,-4.7,20.2,0,105,105,669
1999,11,i) 16 to 20,1501,1714,32593,33287,70,4,143,8.2,2929,721,2208,2.2,8.8,4318,2028,2290,6.1,13,-1389,-4.2,17.6,0,63,63,916
1999,11,j) 21 to 25,635,899,44255,44464,28,3,67,7.3,3928,576,3352,1.3,8.8,4345,768,3577,1.7,9.8,-417,-1,17.6,0,17,17,61
1999,11,l) Left Censored,3679,5907,215016,213922,407,6.8,520,8.7,27688,8985,18703,4.2,12.9,25501,8876,16625,4.1,11.9,2187,1,23.8,0,121,121,1033
1999,12,a) 0,37045,37421,203101,102010,37133,198.5,0,0,202183,202183,0,198.2,198.2,0,0,0,0,0,202183,198.2,0,0,,,
1999,12,b) 1,27951,28423,201236,203498,379,1.2,8465,25.8,62444,10355,52089,5.1,30.7,66968,39259,27709,19.3,32.9,-4524,-2.2,61.4,0,6707,6707,32113
1999,12,c) 2,22555,22959,197656,211667,723,2.8,5476,21.6,42021,3857,38164,1.8,19.9,70042,40812,29230,19.3,33.1,-28021,-13.2,39.8,0,4428,4428,27298
1999,12,d) 3,19536,19971,162158,167336,658,3,4005,18.5,40464,9742,30722,5.8,24.2,50819,25460,25359,15.2,30.4,-10355,-6.2,48.4,0,3183,3183,20325
1999,12,e) 4,17323,17761,153904,155057,631,3.3,3097,16.3,35943,4701,31242,3,23.2,38248,19777,18471,12.8,24.7,-2305,-1.5,46.4,0,2436,2436,13776
1999,12,f) 5,15683,16237,163089,161807,560,3.3,2433,14.2,37141,5703,31438,3.5,23,34576,15335,19241,9.5,21.4,2565,1.6,42.8,0,1874,1874,11572
1999,12,g) 6 to 10,57932,61676,676409,680674,1897,2.9,7610,11.8,135011,18136,116875,2.7,19.8,143541,67355,76186,9.9,21.1,-8530,-1.3,39.6,0,5614,5614,40814
1999,12,h) 11 to 15,38747,44498,743612,728002,1510,3.3,4403,9.6,159418,31710,127708,4.4,21.9,128198,44075,84123,6.1,17.6,31220,4.3,35.2,0,2849,2849,23099
1999,12,i) 16 to 20,23323,27821,444932,449392,901,3.1,2558,8.9,60168,15079,45089,3.4,13.4,69088,23930,45158,5.3,15.4,-8920,-2,26.8,0,1542,1542,11241
1999,12,j) 21 to 25,7853,13078,239113,238666,643,4.8,1095,8.2,38287,9577,28710,4,16,37394,13600,23794,5.7,15.7,893,0.3,31.4,0,441,441,2975
1999,12,l) Left Censored,28553,77355,2673392,2648163,6189,8,6518,8.4,399560,130797,268763,4.9,15.1,349102,140042,209060,5.3,13.2,50458,1.9,26.4,0,1430,1430,11888
1999,13,a) 0,16185,16279,120949,60742,16118,198,0,0,120414,120414,0,198.2,198.2,0,0,0,0,0,120414,198.2,0,0,,,
1999,13,b) 1,12722,12948,107940,106768,219,1.5,3578,24.3,33748,6604,27144,6.2,31.6,31403,16389,15014,15.4,29.4,2345,2.2,58.8,0,2853,2853,13646
1999,13,c) 2,10220,10464,86142,87493,351,3.1,2160,19,21786,3097,18689,3.5,24.9,24487,13755,10732,15.7,28,-2701,-3.1,49.8,0,1689,1689,11151
1999,13,d) 3,8714,8941,76371,78141,328,3.4,1683,17.5,15219,1626,13593,2.1,19.5,18758,9906,8852,12.7,24,-3539,-4.5,39,0,1272,1272,7423
1999,13,e) 4,7557,7886,79854,79163,251,3,1184,14.2,17431,1876,15555,2.4,22,16048,7541,8507,9.5,20.3,1383,1.7,40.6,0,883,883,5687
1999,13,f) 5,6704,6930,71020,73250,207,2.8,1011,13.8,11782,1551,10231,2.1,16.1,16241,8277,7964,11.3,22.2,-4459,-6.1,32.2,0,774,774,6647
1999,13,g) 6 to 10,23361,25099,308575,309127,812,3.1,2959,11.3,55000,14364,40636,4.6,17.8,56104,25399,30705,8.2,18.1,-1104,-0.3,35.6,0,2162,2162,17697
1999,13,h) 11 to 15,17495,20155,315934,318353,723,3.5,1757,8.5,44593,11381,33212,3.6,14,49431,18634,30797,5.9,15.5,-4838,-1.5,28,0,1103,1103,9579
1999,13,i) 16 to 20,10579,13147,231313,229161,461,3.4,994,7.4,33133,8356,24777,3.6,14.5,28829,8723,20106,3.8,12.6,4304,1.9,25.2,0,582,582,3561
1999,13,j) 21 to 25,4121,6541,153713,149121,338,5.1,569,8.6,30403,7450,22953,5,20.4,21219,8699,12520,5.8,14.2,9184,6.2,28.4,0,207,207,1385
1999,13,l) Left Censored,17968,44358,1743235,1722249,3060,6.9,3419,7.7,248951,71794,177157,4.2,14.5,206979,72276,134703,4.2,12,41972,2.5,24,0,706,706,6973
1999,15,a) 0,1691,1710,11189,5609,1700,198.8,0,0,11161,11161,0,199,199,0,0,0,0,0,11161,199,0,0,,,
1999,15,b) 1,1455,1484,14324,13523,22,1.3,371,22.1,4429,615,3814,4.5,32.8,2827,1470,1357,10.9,20.9,1602,11.9,41.8,0,299,299,1227
1999,15,c) 2,1225,1235,9363,9642,43,3.2,237,17.7,1517,211,1306,2.2,15.7,2075,890,1185,9.2,21.5,-558,-5.8,31.4,0,196,196,705
1999,15,d) 3,1130,1183,9630,10062,33,2.6,195,15.4,1642,106,1536,1.1,16.3,2506,1502,1004,14.9,24.9,-864,-8.6,32.6,0,149,149,814
1999,15,e) 4,956,980,9351,9715,22,2.1,144,13.8,1510,157,1353,1.6,15.5,2238,1322,916,13.6,23,-728,-7.5,31,0,111,111,639
1999,15,f) 5,846,874,12920,13438,23,2.5,130,14,2932,1936,996,14.4,21.8,3967,682,3285,5.1,29.5,-1035,-7.7,43.6,0,103,103,453
1999,15,g) 6 to 10,3641,3920,40389,42023,112,2.7,477,11.6,4849,636,4213,1.5,11.5,8117,3801,4316,9,19.3,-3268,-7.8,23,0,363,363,3156
1999,15,h) 11 to 15,2915,3462,45939,46798,102,2.9,304,8.5,4739,849,3890,1.8,10.1,6457,2563,3894,5.5,13.8,-1718,-3.7,20.2,0,188,188,1506
1999,15,i) 16 to 20,2449,2946,35869,36019,92,3.1,184,6.1,3847,732,3115,2,10.7,4147,1861,2286,5.2,11.5,-300,-0.8,21.4,0,111,111,888
1999,15,j) 21 to 25,893,1343,22298,22877,36,2.6,70,5.1,1470,324,1146,1.4,6.4,2627,487,2140,2.1,11.5,-1157,-5.1,12.8,0,33,33,89
1999,15,l) Left Censored,3989,7446,203210,204227,357,4.7,585,7.7,20788,7899,12889,3.9,10.2,22821,6609,16212,3.2,11.2,-2033,-1,20.4,0,145,145,777
1999,16,a) 0,3093,3103,16465,8278,3072,198,0,0,16375,16375,0,197.8,197.8,0,0,0,0,0,16375,197.8,0,0,,,
1999,16,b) 1,2375,2430,19678,18629,46,1.7,690,24.8,6709,850,5859,4.6,36,4611,2423,2188,13,24.8,2098,11.2,49.6,0,526,526,1909
1999,16,c) 2,2086,2130,13958,15597,66,2.8,443,19,2636,296,2340,1.9,16.9,5914,4081,1833,26.2,37.9,-3278,-21,33.8,0,333,333,1894
1999,16,d) 3,1730,1778,12736,13465,59,3.1,306,16.1,2574,823,1751,6.1,19.1,4031,2477,1554,18.4,29.9,-1457,-10.8,38.2,0,214,214,1538
1999,16,e) 4,1494,1518,10101,10326,62,3.9,229,14.3,1965,220,1745,2.1,19,2415,1070,1345,10.4,23.4,-450,-4.4,38,0,179,179,787
1999,16,f) 5,1376,1416,11180,11269,59,4,182,12.3,2114,579,1535,5.1,18.8,2292,1001,1291,8.9,20.3,-178,-1.5,37.6,0,133,133,642
1999,16,g) 6 to 10,4580,4830,41110,41783,178,3.6,527,10.5,6167,836,5331,2,14.8,7512,2937,4575,7,18,-1345,-3.2,29.6,0,385,385,2158
1999,16,h) 11 to 15,3111,3490,47420,47790,145,4.1,304,8.5,6133,1119,5014,2.3,12.8,6872,2820,4052,5.9,14.4,-739,-1.6,25.6,0,208,208,2091
1999,16,i) 16 to 20,2160,2617,45536,45242,88,3.3,225,8.4,5767,2058,3709,4.5,12.7,5179,1918,3261,4.2,11.4,588,1.3,22.8,0,131,131,975
1999,16,j) 21 to 25,892,1256,22948,22964,49,3.9,72,5.7,2041,394,1647,1.7,8.9,2072,496,1576,2.2,9,-31,-0.1,17.8,0,34,34,187
1999,16,l) Left Censored,3691,7043,187465,186356,538,7.7,370,5.3,20780,6693,14087,3.6,11.2,18561,4847,13714,2.6,10,2219,1.2,20,0,112,112,712
1999,17,a) 0,19382,19541,126749,63816,19403,198.6,0,0,125866,125866,0,197.2,197.2,0,0,0,0,0,125866,197.2,0,0,,,
1999,17,b) 1,15950,16302,137216,133736,289,1.6,3884,21.3,41786,7319,34467,5.5,31.2,34825,17270,17555,12.9,26,6961,5.2,52,0,2937,2937,13953
1999,17,c) 2,13801,14285,112725,114840,368,2.4,2478,16.1,26052,2300,23752,2,22.7,30281,15289,14992,13.3,26.4,-4229,-3.7,45.4,0,1871,1871,10651
1999,17,d) 3,12251,12410,102537,104217,303,2.3,1924,14.6,18759,1335,17424,1.3,18,22118,10842,11276,10.4,21.2,-3359,-3.2,36,0,1427,1427,7626
1999,17,e) 4,11158,11527,104348,105922,366,3,1538,12.7,17407,1639,15768,1.5,16.4,20554,8563,11991,8.1,19.4,-3147,-3,32.8,0,1151,1151,6762
1999,17,f) 5,9845,10089,98161,100075,256,2.4,1278,12.1,16425,1869,14556,1.9,16.4,20253,8370,11883,8.4,20.2,-3828,-3.8,32.8,0,966,966,5808
1999,17,g) 6 to 10,38788,41063,470060,473443,1154,2.7,4162,9.8,68013,10136,57877,2.1,14.4,74780,29302,45478,6.2,15.8,-6767,-1.4,28.8,0,3003,3003,18946
1999,17,h) 11 to 15,30264,34026,539366,540038,951,2.7,2668,7.6,65759,12032,53727,2.2,12.2,67103,25347,41756,4.7,12.4,-1344,-0.2,24.4,0,1709,1709,11891
1999,17,i) 16 to 20,20326,23531,423390,423737,566,2.3,1669,6.9,49104,11449,37655,2.7,11.6,49797,14516,35281,3.4,11.8,-693,-0.2,23.2,0,1039,1039,6550
1999,17,j) 21 to 25,7975,11792,245243,244729,456,3.8,805,6.7,29102,7240,21862,3,11.9,28073,8314,19759,3.4,11.5,1029,0.4,23,0,394,394,3085
1999,17,l) Left Censored,40276,76516,2907502,2906114,3835,5,5445,7.1,330190,93380,236810,3.2,11.4,327414,100662,226752,3.5,11.3,2776,0.1,22.6,0,1696,1696,13292
1999,18,a) 0,9071,9154,59741,30010,9096,198.7,0,0,59462,59462,0,198.1,198.1,0,0,0,0,0,59462,198.1,0,0,,,
1999,18,b) 1,7592,7915,70084,70508,176,2,2073,23.3,19865,4131,15734,5.9,28.2,20712,10706,10006,15.2,29.4,-847,-1.2,56.4,0,1663,1663,9200
1999,18,c) 2,6410,6579,49980,52526,158,2.2,1294,18.1,10137,1636,8501,3.1,19.3,15228,9128,6100,17.4,29,-5091,-9.7,38.6,0,1032,1032,7467
1999,18,d) 3,5665,5847,55109,55954,142,2.3,959,15.3,9552,963,8589,1.7,17.1,11241,5846,5395,10.4,20.1,-1689,-3,34.2,0,748,748,4423
1999,18,e) 4,5121,5308,46394,47915,150,2.7,821,14.5,7174,924,6250,1.9,15,10216,5473,4743,11.4,21.3,-3042,-6.3,30,0,642,642,4404
1999,18,f) 5,4590,4757,43592,44387,153,3.1,640,12.8,6798,997,5801,2.2,15.3,8387,3465,4922,7.8,18.9,-1589,-3.6,30.6,0,489,489,2482
1999,18,g) 6 to 10,18095,19629,225437,227301,549,2.7,2055,10.1,34523,5701,28822,2.5,15.2,38250,15159,23091,6.7,16.8,-3727,-1.6,30.4,0,1516,1516,10231
1999,18,h) 11 to 15,14170,16481,251071,253271,448,2.7,1222,7.2,28325,4618,23707,1.8,11.2,32725,9747,22978,3.8,12.9,-4400,-1.7,22.4,0,802,802,5275
1999,18,i) 16 to 20,9216,10775,178595,179757,267,2.4,716,6.5,18811,3291,15520,1.8,10.5,21135,6235,14900,3.5,11.8,-2324,-1.3,21,0,477,477,3266
1999,18,j) 21 to 25,3740,5737,130020,129441,221,3.8,399,6.8,16497,3694,12803,2.9,12.7,15339,5153,10186,4,11.9,1158,0.8,23.8,0,176,176,1177
1999,18,l) Left Censored,19451,39953,1442919,1440212,1907,4.7,2349,5.8,154143,36812,117331,2.6,10.7,148729,39170,109559,2.7,10.3,5414,0.4,20.6,0,709,709,6285
1999,19,a) 0,4482,4515,30956,15509,4485,198.7,0,0,30894,30894,0,199.2,199.2,0,0,0,0,0,30894,199.2,0,0,,,
1999,19,b) 1,3787,3889,30486,31083,84,1.9,1011,23,7610,1941,5669,6.2,24.5,8803,3777,5026,12.2,28.3,-1193,-3.8,49,0,808,808,3176
1999,19,c) 2,3230,3327,25051,25912,100,2.8,639,17.8,5291,743,4548,2.9,20.4,7013,3953,3060,15.3,27.1,-1722,-6.7,40.8,0,492,492,2575
1999,19,d) 3,2955,3018,23763,23954,101,3.1,472,14.7,4122,708,3414,3,17.2,4503,2240,2263,9.4,18.8,-381,-1.6,34.4,0,365,365,1831
1999,19,e) 4,2761,2857,22985,23250,74,2.5,370,12.3,3787,550,3237,2.4,16.3,4317,1843,2474,7.9,18.6,-530,-2.3,32.6,0,288,288,1438
1999,19,f) 5,2487,2546,21909,22170,52,1.9,297,11.1,3061,379,2682,1.7,13.8,3583,1519,2064,6.9,16.2,-522,-2.4,27.6,0,224,224,962
1999,19,g) 6 to 10,9303,9842,88866,90966,276,2.7,964,9.5,12706,2795,9911,3.1,14,16905,8442,8463,9.3,18.6,-4199,-4.6,28,0,719,719,4766
1999,19,h) 11 to 15,7641,8710,134693,135099,222,2.5,601,6.8,13582,2012,11570,1.5,10.1,14393,4951,9442,3.7,10.7,-811,-0.6,20.2,0,396,396,2283
1999,19,i) 16 to 20,5620,6911,89712,91061,186,2.6,503,7.1,9945,2414,7531,2.7,10.9,12642,5076,7566,5.6,13.9,-2697,-3,21.8,0,317,317,1466
1999,19,j) 21 to 25,2520,3877,58313,58468,109,2.8,239,6.1,6408,1656,4752,2.8,11,6717,1853,4864,3.2,11.5,-309,-0.5,22,0,128,128,760
1999,19,l) Left Censored,13162,23140,701308,697659,1022,4.4,1298,5.6,75502,19088,56414,2.7,10.8,68204,16293,51911,2.3,9.8,7298,1,19.6,0,494,494,3273
1999,20,a) 0,4826,4842,30144,15117,4810,198.7,0,0,30054,30054,0,198.8,198.8,0,0,0,0,0,30054,198.8,0,0,,,
1999,20,b) 1,3987,4086,35347,33932,87,1.9,1029,22.4,12381,3648,8733,10.8,36.5,9551,4022,5529,11.9,28.1,2830,8.4,56.2,0,805,805,3385
1999,20,c) 2,3285,3356,28521,29002,88,2.4,716,19.5,6409,663,5746,2.3,22.1,7370,4338,3032,15,25.4,-961,-3.3,44.2,0,559,559,3539
1999,20,d) 3,2961,3006,22312,22635,76,2.4,474,14.8,4131,522,3609,2.3,18.3,4777,2604,2173,11.5,21.1,-646,-2.8,36.6,0,378,378,1754
1999,20,e) 4,2624,2698,22110,22686,93,3.3,426,14.9,3757,806,2951,3.6,16.6,4908,2035,2873,9,21.6,-1151,-5,33.2,0,352,352,1727
1999,20,f) 5,2260,2341,21254,21412,88,3.6,326,13.2,5032,2265,2767,10.6,23.5,5347,2330,3017,10.9,25,-315,-1.5,47,0,264,264,2090
1999,20,g) 6 to 10,8697,9233,94706,96231,291,3,1022,10.7,14473,2335,12138,2.4,15,17523,8838,8685,9.2,18.2,-3050,-3.2,30,0,752,752,6984
1999,20,h) 11 to 15,7060,7836,104448,104448,230,2.9,654,8.1,13480,3274,10206,3.1,12.9,13480,5052,8428,4.8,12.9,0,0,25.8,0,454,454,2593
1999,20,i) 16 to 20,5211,6080,81498,81620,173,2.8,434,7,10800,2280,8520,2.8,13.2,11043,4352,6691,5.3,13.5,-243,-0.3,26.4,0,249,249,1717
1999,20,j) 21 to 25,2063,3125,50317,50595,98,3.1,234,7.3,7099,2050,5049,4.1,14,7655,2391,5264,4.7,15.1,-556,-1.1,28,0,76,76,286
1999,20,l) Left Censored,10717,19650,603765,601038,996,5,1344,6.8,71572,20507,51065,3.4,11.9,66118,23893,42225,4,11,5454,0.9,22,0,396,396,2858
1999,21,a) 0,5960,6016,41494,20889,5971,198.5,0,0,41210,41210,0,197.3,197.3,0,0,0,0,0,41210,197.3,0,0,,,
1999,21,b) 1,4962,5095,41278,42358,96,1.7,1364,23.7,11619,1523,10096,3.6,27.4,13779,7398,6381,17.5,32.5,-2160,-5.1,54.8,0,1117,1117,5968
1999,21,c) 2,4074,4168,31985,33100,99,2.2,850,18.7,6255,402,5853,1.2,18.9,8484,4476,4008,13.5,25.6,-2229,-6.7,37.8,0,694,694,3627
1999,21,d) 3,3472,3578,32696,33938,92,2.4,629,16.3,5177,475,4702,1.4,15.3,7660,4191,3469,12.3,22.6,-2483,-7.3,30.6,0,503,503,3613
1999,21,e) 4,3306,3439,30930,31859,108,3,511,14,4161,503,3658,1.6,13.1,6019,2596,3423,8.1,18.9,-1858,-5.8,26.2,0,409,409,2032
1999,21,f) 5,2829,2921,26580,27452,77,2.5,378,12.3,3565,505,3060,1.8,13,5309,2319,2990,8.4,19.3,-1744,-6.3,26,0,296,296,1703
1999,21,g) 6 to 10,11199,12008,125907,128397,358,2.9,1302,10.4,18628,3724,14904,2.9,14.5,23607,9667,13940,7.5,18.4,-4979,-3.9,29,0,956,956,5353
1999,21,h) 11 to 15,9025,10156,153783,155493,321,3.1,832,8,19269,3644,15625,2.3,12.4,22689,8114,14575,5.2,14.6,-3420,-2.2,24.8,0,536,536,3098
1999,21,i) 16 to 20,5533,6384,108231,109189,182,2.8,446,6.8,13090,3807,9283,3.5,12,15006,5362,9644,4.9,13.7,-1916,-1.7,24,0,280,280,1522
1999,21,j) 21 to 25,2255,3534,77351,75579,158,4.4,234,6.5,11734,4893,6841,6.5,15.5,8189,2871,5318,3.8,10.8,3545,4.7,21.6,0,113,113,694
1999,21,l) Left Censored,11603,23698,774649,777020,1295,5.4,1509,6.3,83998,24631,59367,3.2,10.8,88740,22039,66701,2.8,11.4,-4742,-0.6,21.6,0,452,452,3685
1999,22,a) 0,6539,6585,46790,23466,6539,198.6,0,0,46649,46649,0,198.8,198.8,0,0,0,0,0,46649,198.8,0,0,,,
1999,22,b) 1,5489,5705,50484,51771,141,2.2,1562,24.1,15125,2975,12150,5.7,29.2,17699,9200,8499,17.8,34.2,-2574,-5,58.4,0,1242,1242,7707
1999,22,c) 2,4612,4695,43447,45616,141,2.8,976,19,8528,832,7696,1.8,18.7,12865,7232,5633,15.9,28.2,-4337,-9.5,37.4,0,770,770,4912
1999,22,d) 3,3987,4055,37034,38796,102,2.3,700,16.1,6219,877,5342,2.3,16,9743,4352,5391,11.2,25.1,-3524,-9.1,32,0,584,584,3675
1999,22,e) 4,3585,3664,38514,41987,95,2.4,563,14.4,5591,494,5097,1.2,13.3,12537,7513,5024,17.9,29.9,-6946,-16.6,26.6,0,443,443,6503
1999,22,f) 5,3361,3492,35109,36892,89,2.4,473,12.8,5819,1023,4796,2.8,15.8,9384,5162,4222,14,25.4,-3565,-9.6,31.6,0,368,368,3538
1999,22,g) 6 to 10,12121,12885,152057,155506,346,2.6,1317,9.8,22563,3728,18835,2.4,14.5,29461,10433,19028,6.7,18.9,-6898,-4.4,29,0,939,939,6294
1999,22,h) 11 to 15,9639,11001,162623,165540,341,3,840,7.5,19415,4903,14512,3,11.7,25249,10423,14826,6.3,15.3,-5834,-3.6,23.4,0,532,532,5531
1999,22,i) 16 to 20,7905,9477,148872,150629,266,2.7,702,7.2,17859,4884,12975,3.2,11.9,21373,7093,14280,4.7,14.2,-3514,-2.3,23.8,0,427,427,3032
1999,22,j) 21 to 25,2695,3920,67372,67661,169,4.3,269,6.8,8875,1772,7103,2.6,13.1,9452,3495,5957,5.2,14,-577,-0.9,26.2,0,136,136,1296
1999,22,l) Left Censored,12601,25463,765423,766678,1279,5,1630,6.4,87722,20560,67162,2.7,11.4,90231,25697,64534,3.4,11.8,-2509,-0.4,22.8,0,474,474,3347
1999,23,a) 0,2790,2797,14708,7379,2770,198.1,0,0,14658,14658,0,198.6,198.6,0,0,0,0,0,14658,198.6,0,0,,,
1999,23,b) 1,2328,2392,15080,14898,44,1.7,535,20.1,4185,805,3380,5.4,28.1,3821,1819,2002,12.2,25.6,364,2.5,51.2,0,410,410,1586
1999,23,c) 2,1864,1888,10510,10721,56,2.8,318,15.7,1975,279,1696,2.6,18.4,2396,1321,1075,12.3,22.3,-421,-3.9,36.8,0,248,248,1061
1999,23,d) 3,1644,1684,12495,12814,52,2.9,289,16,2103,197,1906,1.5,16.4,2740,1514,1226,11.8,21.4,-637,-5,32.8,0,210,210,999
1999,23,e) 4,1491,1502,9823,9919,44,2.8,208,13.1,1772,110,1662,1.1,17.9,1963,1055,908,10.6,19.8,-191,-1.9,35.8,0,163,163,856
1999,23,f) 5,1237,1256,9209,9570,46,3.5,132,10.2,1375,153,1222,1.6,14.4,2096,1033,1063,10.8,21.9,-721,-7.5,28.8,0,106,106,858
1999,23,g) 6 to 10,4841,5057,42785,42996,148,2.8,483,9.2,6247,817,5430,1.9,14.5,6669,3093,3576,7.2,15.5,-422,-1,29,0,346,346,2004
1999,23,h) 11 to 15,4232,4622,52427,52189,154,3.3,363,7.7,7037,1095,5942,2.1,13.5,6560,2062,4498,4,12.6,477,0.9,25.2,0,252,252,1484
1999,23,i) 16 to 20,2415,2797,43544,44000,74,2.6,189,6.6,4313,445,3868,1,9.8,5225,1213,4012,2.8,11.9,-912,-2.1,19.6,0,124,124,879
1999,23,j) 21 to 25,958,1613,26799,26445,71,4.3,147,8.9,4414,1110,3304,4.2,16.7,3706,1248,2458,4.7,14,708,2.7,28,0,58,58,401
1999,23,l) Left Censored,4525,7772,228346,227368,414,5.3,489,6.3,23600,6914,16686,3,10.4,21644,5127,16517,2.3,9.5,1956,0.9,19,0,170,170,1289
1999,24,a) 0,8599,8643,53688,26954,8594,198.9,0,0,53468,53468,0,198.4,198.4,0,0,0,0,0,53468,198.4,0,0,,,
1999,24,b) 1,7021,7172,60248,61084,135,1.7,1771,22,17887,2670,15217,4.4,29.3,19558,11664,7894,19.1,32,-1671,-2.7,58.6,0,1333,1333,8689
1999,24,c) 2,6094,6211,48364,50207,195,2.9,1164,17.3,10005,1338,8667,2.7,19.9,13691,7579,6112,15.1,27.3,-3686,-7.4,39.8,0,905,905,5075
1999,24,d) 3,5151,5228,42071,43559,145,2.6,849,15.2,7914,780,7134,1.8,18.2,10890,6028,4862,13.8,25,-2976,-6.8,36.4,0,640,640,4620
1999,24,e) 4,4817,4920,42198,42449,167,3.2,718,13.8,7906,1381,6525,3.3,18.6,8408,4156,4252,9.8,19.8,-502,-1.2,37.2,0,559,559,3458
1999,24,f) 5,4094,4242,39991,41117,134,3,581,13,6911,1074,5837,2.6,16.8,9163,3937,5226,9.6,22.3,-2252,-5.5,33.6,0,422,422,3041
1999,24,g) 6 to 10,16607,17661,204257,204842,518,2.8,1789,9.8,32766,5753,27013,2.8,16,33937,12802,21135,6.2,16.6,-1171,-0.6,32,0,1264,1264,7780
1999,24,h) 11 to 15,13002,14587,204368,207463,445,3,1200,8,25891,6078,19813,2.9,12.5,32081,11485,20596,5.5,15.5,-6190,-3,25,0,736,736,5409
1999,24,i) 16 to 20,7719,9076,144991,146644,290,3.1,663,7.2,21053,5692,15361,3.9,14.4,24358,12541,11817,8.6,16.6,-3305,-2.2,28.8,0,386,386,7896
1999,24,j) 21 to 25,2945,4540,99276,97475,195,4.3,289,6.3,16376,4439,11937,4.6,16.8,12773,4191,8582,4.3,13.1,3603,3.7,26.2,0,123,123,1591
1999,24,l) Left Censored,14525,29553,1011779,1015281,1683,5.6,2390,8,129064,42141,86923,4.2,12.7,136069,46578,89491,4.6,13.4,-7005,-0.7,25.4,0,580,580,6870
1999,25,a) 0,10641,10698,67310,33743,10619,198.5,0,0,67134,67134,0,199,199,0,0,0,0,0,67134,199,0,0,,,
1999,25,b) 1,8948,9120,74175,72473,178,1.8,2036,20.1,24528,6245,18283,8.6,33.8,21123,10476,10647,14.5,29.1,3405,4.7,58.2,0,1551,1551,8481
1999,25,c) 2,7613,7733,65478,64768,231,2.8,1424,17.1,17119,1638,15481,2.5,26.4,15698,8160,7538,12.6,24.2,1421,2.2,48.4,0,1085,1085,6598
1999,25,d) 3,6478,6555,53862,55902,159,2.3,1046,14.9,9830,650,9180,1.2,17.6,13910,7530,6380,13.5,24.9,-4080,-7.3,35.2,0,813,813,5577
1999,25,e) 4,6097,6344,61150,61731,195,2.9,789,11.9,11386,2510,8876,4.1,18.4,12547,4172,8375,6.8,20.3,-1161,-1.9,36.8,0,596,596,3425
1999,25,f) 5,5450,5556,53462,54392,133,2.3,617,10.6,8616,1129,7487,2.1,15.8,10475,4667,5808,8.6,19.3,-1859,-3.5,31.6,0,476,476,3651
1999,25,g) 6 to 10,19885,21093,239327,240976,516,2.4,2019,9.2,35158,5654,29504,2.3,14.6,38455,13971,24484,5.8,16,-3297,-1.4,29.2,0,1494,1494,9728
1999,25,h) 11 to 15,18126,20006,320283,323810,583,2.8,1618,7.9,35612,8008,27604,2.5,11,42665,16569,26096,5.1,13.2,-7053,-2.2,22,0,1027,1027,7814
1999,25,i) 16 to 20,11194,13304,260523,261408,367,2.7,1019,7.5,36079,9370,26709,3.6,13.8,37848,13484,24364,5.2,14.5,-1769,-0.7,27.6,0,596,596,4445
1999,25,j) 21 to 25,4214,6344,151342,152071,228,3.5,426,6.6,14754,3768,10986,2.5,9.7,16212,5077,11135,3.3,10.7,-1458,-1,19.4,0,188,188,1303
1999,25,l) Left Censored,24526,42844,1591890,1583184,1956,4.5,2975,6.9,209825,63674,146151,4,13.3,192413,57614,134799,3.6,12.2,17412,1.1,24.4,0,998,998,9590
1999,26,a) 0,14565,14677,100364,50412,14547,198.2,0,0,99904,99904,0,198.2,198.2,0,0,0,0,0,99904,198.2,0,0,,,
1999,26,b) 1,12285,12621,109144,108640,240,1.7,2961,21,28094,5471,22623,5,25.9,27086,12664,14422,11.7,24.9,1008,1,49.8,0,2248,2248,9801
1999,26,c) 2,10914,11384,98825,102644,302,2.5,2011,16.4,19218,1905,17313,1.9,18.7,26856,13941,12915,13.6,26.2,-7638,-7.5,37.4,0,1564,1564,11537
1999,26,d) 3,9673,9807,88995,91271,259,2.5,1577,15.1,15388,1325,14063,1.5,16.9,19939,10891,9048,11.9,21.8,-4551,-4.9,33.8,0,1205,1205,8619
1999,26,e) 4,8943,9127,82416,83418,243,2.5,1196,12.4,15136,1773,13363,2.1,18.1,17139,7851,9288,9.4,20.5,-2003,-2.4,36.2,0,917,917,6406
1999,26,f) 5,7629,7860,78694,79645,249,3,984,12,14098,4688,9410,5.9,17.7,16000,6856,9144,8.6,20.1,-1902,-2.4,35.4,0,767,767,5651
1999,26,g) 6 to 10,29611,31556,340764,346713,868,2.7,3252,9.9,47175,7688,39487,2.2,13.6,59073,23077,35996,6.7,17,-11898,-3.4,27.2,0,2390,2390,16843
1999,26,h) 11 to 15,23169,26634,395162,403077,748,2.7,2162,7.9,50112,8547,41565,2.1,12.4,65944,19541,46403,4.8,16.4,-15832,-4,24.8,0,1455,1455,11627
1999,26,i) 16 to 20,15023,18022,300371,302773,478,2.6,1209,6.6,33464,7873,25591,2.6,11.1,38268,10582,27686,3.5,12.6,-4804,-1.5,22.2,0,729,729,5203
1999,26,j) 21 to 25,5866,8554,166648,167470,284,3.3,585,6.7,21910,4662,17248,2.8,13.1,23553,6452,17101,3.9,14.1,-1643,-1,26.2,0,289,289,2071
1999,26,l) Left Censored,28905,57853,2183872,2180410,2797,4.8,3793,6.5,263097,82354,180743,3.8,12.1,256172,72341,183831,3.3,11.7,6925,0.4,23.4,0,1235,1235,10904
1999,27,a) 0,9040,9130,56892,28523,9055,198.4,0,0,56738,56738,0,198.9,198.9,0,0,0,0,0,56738,198.9,0,0,,,
1999,27,b) 1,7683,7903,65992,64361,174,2,1717,19.7,19246,3895,15351,6.1,29.9,15983,7950,8033,12.4,24.8,3263,5.1,49.6,0,1256,1256,5935
1999,27,c) 2,6578,6720,50890,49975,228,3.2,1127,15.7,13424,5237,8187,10.5,26.9,11593,7028,4565,14.1,23.2,1831,3.7,46.4,0,832,832,5167
1999,27,d) 3,5667,5759,46162,47471,153,2.5,790,13,7949,780,7169,1.6,16.7,10567,5860,4707,12.3,22.3,-2618,-5.6,33.4,0,588,588,3889
1999,27,e) 4,5008,5116,43714,43481,141,2.6,628,11.7,7698,626,7072,1.4,17.7,7232,3526,3706,8.1,16.6,466,1.1,33.2,0,475,475,2957
1999,27,f) 5,4603,4744,43949,43990,158,3.2,570,11.5,7275,1313,5962,3,16.5,7357,3126,4231,7.1,16.7,-82,-0.2,33,0,397,397,2018
1999,27,g) 6 to 10,17256,18485,198054,199264,493,2.6,1748,9.1,27594,3876,23718,1.9,13.8,30014,11212,18802,5.6,15.1,-2420,-1.3,27.6,0,1226,1226,7327
1999,27,h) 11 to 15,12954,14836,223453,226388,394,2.6,1154,7.6,25020,4624,20396,2,11.1,30890,11290,19600,5,13.6,-5870,-2.5,22.2,0,729,729,5387
1999,27,i) 16 to 20,8341,9933,184220,183126,273,2.7,785,7.7,24292,4401,19891,2.4,13.3,22103,8198,13905,4.5,12.1,2189,1.2,24.2,0,413,413,3086
1999,27,j) 21 to 25,3577,5263,109020,108060,166,3.1,318,6,13586,3516,10070,3.3,12.6,11665,3475,8190,3.2,10.8,1921,1.8,21.6,0,141,141,679
1999,27,l) Left Censored,17091,31686,1290694,1287165,1678,5.3,1918,6,147707,48978,98729,3.8,11.5,140649,44947,95702,3.5,10.9,7058,0.6,21.8,0,569,569,5850
1999,28,a) 0,4361,4404,25485,12800,4381,199,0,0,25370,25370,0,198.2,198.2,0,0,0,0,0,25370,198.2,0,0,,,
1999,28,b) 1,3318,3401,27515,27690,52,1.3,1031,26.3,8095,1616,6479,5.8,29.2,8444,4730,3714,17.1,30.5,-349,-1.3,58.4,0,847,847,3933
1999,28,c) 2,2783,2843,20907,22213,93,3,632,20.3,3889,594,3295,2.7,17.5,6500,3638,2862,16.4,29.3,-2611,-11.8,35,0,521,521,3100
1999,28,d) 3,2398,2463,20622,21529,86,3.2,477,18,3336,519,2817,2.4,15.5,5149,2765,2384,12.8,23.9,-1813,-8.4,31,0,366,366,2148
1999,28,e) 4,2209,2298,20589,20873,72,2.9,366,15,3784,885,2899,4.2,18.1,4351,1692,2659,8.1,20.8,-567,-2.7,36.2,0,297,297,1351
1999,28,f) 5,2002,2061,24809,25989,54,2.5,294,13.5,3726,302,3424,1.2,14.3,6086,2479,3607,9.5,23.4,-2360,-9.1,28.6,0,235,235,1351
1999,28,g) 6 to 10,6928,7366,78065,78515,214,2.8,899,11.7,12571,1667,10904,2.1,16,13470,5412,8058,6.9,17.2,-899,-1.2,32,0,681,681,4108
1999,28,h) 11 to 15,5690,6349,89867,91412,207,3.2,547,8.4,10228,1796,8432,2,11.2,13317,6222,7095,6.8,14.6,-3089,-3.4,22.4,0,348,348,3105
1999,28,i) 16 to 20,4004,4747,91698,88539,117,2.4,344,7.1,16862,2192,14670,2.5,19,10544,2758,7786,3.1,11.9,6318,7.1,23.8,0,232,232,1204
1999,28,j) 21 to 25,1610,2335,48793,47496,146,6.2,163,7,7103,3425,3678,7.2,15,4509,1701,2808,3.6,9.5,2594,5.5,19,0,80,80,534
1999,28,l) Left Censored,7714,15459,492362,495364,744,4.8,985,6.3,49470,12773,36697,2.6,10,55474,17728,37746,3.6,11.2,-6004,-1.2,20,0,341,341,2873
1999,29,a) 0,9856,9926,60968,30576,9847,198.4,0,0,60784,60784,0,198.8,198.8,0,0,0,0,0,60784,198.8,0,0,,,
1999,29,b) 1,7906,8114,68773,69528,163,1.8,2190,23.8,19705,6211,13494,8.9,28.3,21217,9326,11891,13.4,30.5,-1512,-2.2,56.6,0,1723,1723,7563
1999,29,c) 2,6664,6754,48467,51033,190,2.6,1394,18.9,10045,1139,8906,2.2,19.7,15176,6530,8646,12.8,29.7,-5131,-10,39.4,0,1088,1088,5203
1999,29,d) 3,5752,5878,49228,50620,160,2.5,1017,16.1,8069,636,7433,1.3,15.9,10853,5500,5353,10.9,21.4,-2784,-5.5,31.8,0,810,810,4087
1999,29,e) 4,5316,5458,44081,44647,144,2.5,816,14.1,7570,473,7097,1.1,17,8701,3918,4783,8.8,19.5,-1131,-2.5,34,0,675,675,3276
1999,29,f) 5,4849,5038,46339,47088,153,2.9,745,14,7471,1352,6119,2.9,15.9,8968,4433,4535,9.4,19,-1497,-3.1,31.8,0,601,601,3411
1999,29,g) 6 to 10,17727,19001,195276,198525,558,2.8,2139,10.8,27394,4155,23239,2.1,13.8,33891,13132,20759,6.6,17.1,-6497,-3.3,27.6,0,1591,1591,9114
1999,29,h) 11 to 15,14536,16233,232740,232218,541,3.3,1300,7.8,31788,8671,23117,3.7,13.7,30743,8786,21957,3.8,13.2,1045,0.5,26.4,0,882,882,4749
1999,29,i) 16 to 20,9148,11065,201434,199947,278,2.5,825,7.3,24003,6049,17954,3,12,21029,6869,14160,3.4,10.5,2974,1.5,21,0,512,512,3021
1999,29,j) 21 to 25,3637,5511,107676,108185,210,3.7,386,6.9,11614,2212,9402,2,10.7,12631,3346,9285,3.1,11.7,-1017,-1,21.4,0,179,179,1294
1999,29,l) Left Censored,18545,36381,1277472,1274862,1969,5.4,2460,6.7,151718,40646,111072,3.2,11.9,146498,52298,94200,4.1,11.5,5220,0.4,23,0,760,760,4565
1999,30,a) 0,2366,2375,11016,5529,2354,198.2,0,0,10974,10974,0,198.5,198.5,0,0,0,0,0,10974,198.5,0,0,,,
1999,30,b) 1,2047,2089,13874,13395,40,1.7,544,23,4049,1189,2860,8.9,30.2,3091,1592,1499,11.9,23.1,958,7.1,46.2,0,423,423,1220
1999,30,c) 2,1655,1663,9801,10073,45,2.5,295,16.4,1979,171,1808,1.7,19.6,2522,1308,1214,13,25,-543,-5.4,39.2,0,230,230,928
1999,30,d) 3,1509,1532,9439,9500,45,2.7,258,15.7,1753,315,1438,3.3,18.5,1875,938,937,9.9,19.7,-122,-1.2,37,0,198,198,760
1999,30,e) 4,1327,1344,8500,8649,38,2.7,207,14.5,1375,186,1189,2.2,15.9,1673,810,863,9.4,19.3,-298,-3.4,31.8,0,154,154,593
1999,30,f) 5,1091,1113,8304,8353,38,3.2,162,13.8,1579,492,1087,5.9,18.9,1677,880,797,10.5,20.1,-98,-1.2,37.8,0,114,114,616
1999,30,g) 6 to 10,3838,3991,30429,31199,118,2.8,472,11.3,4189,414,3775,1.3,13.4,5729,2595,3134,8.3,18.4,-1540,-5,26.8,0,334,334,1863
1999,30,h) 11 to 15,2944,3253,34356,34432,112,3.4,252,7.6,4018,741,3277,2.2,11.7,4169,1322,2847,3.8,12.1,-151,-0.4,23.4,0,173,173,810
1999,30,i) 16 to 20,2187,2525,28115,28405,69,2.7,193,7.5,2925,545,2380,1.9,10.3,3504,1121,2383,3.9,12.3,-579,-2,20.6,0,118,118,555
1999,30,j) 21 to 25,859,1135,13443,13498,42,3.6,81,7,1493,212,1281,1.6,11.1,1602,512,1090,3.8,11.9,-109,-0.8,22.2,0,45,45,233
1999,30,l) Left Censored,3423,5841,116765,115586,303,5.2,368,6.3,14525,3682,10843,3.2,12.6,12167,3826,8341,3.3,10.5,2358,2.1,21,0,135,135,759
1999,31,a) 0,2982,2994,16321,8199,2971,198.5,0,0,16245,16245,0,198.1,198.1,0,0,0,0,0,16245,198.1,0,0,,,
1999,31,b) 1,2529,2590,26377,26129,50,1.7,579,20.1,5883,780,5103,3,22.5,5386,2396,2990,9.2,20.6,497,1.9,41.2,0,435,435,1946
1999,31,c) 2,2147,2208,13468,14337,49,2.1,378,15.9,2370,190,2180,1.3,16.5,4107,2450,1657,17.1,28.6,-1737,-12.1,33,0,301,301,1725
1999,31,d) 3,1812,1844,13549,13963,54,2.7,312,15.8,2377,296,2081,2.1,17,3205,1686,1519,12.1,23,-828,-6,34,0,243,243,1396
1999,31,e) 4,1649,1689,13333,13435,48,2.7,227,12.8,2176,249,1927,1.9,16.2,2380,1021,1359,7.6,17.7,-204,-1.5,32.4,0,170,170,773
1999,31,f) 5,1506,1556,12780,12793,42,2.6,196,12,2230,294,1936,2.3,17.4,2255,1124,1131,8.8,17.6,-25,-0.2,34.8,0,149,149,925
1999,31,g) 6 to 10,5867,6283,64822,67678,165,2.5,623,9.6,10380,3450,6930,5.1,15.3,16091,7522,8569,11.1,23.8,-5711,-8.5,30.6,0,437,437,6118
1999,31,h) 11 to 15,4798,5318,76754,75841,128,2.3,444,8.1,9912,2125,7787,2.8,13.1,8085,3001,5084,4,10.7,1827,2.4,21.4,0,295,295,1394
1999,31,i) 16 to 20,3518,4146,58685,58106,125,2.9,322,7.6,8012,1476,6536,2.5,13.8,6854,3066,3788,5.3,11.8,1158,2,23.6,0,188,188,971
1999,31,j) 21 to 25,1522,2246,41295,41121,92,4.1,131,5.8,4898,1325,3573,3.2,11.9,4550,1566,2984,3.8,11.1,348,0.8,22.2,0,74,74,390
1999,31,l) Left Censored,7689,12822,390903,389599,461,3.6,755,5.8,41421,10012,31409,2.6,10.6,38813,12562,26251,3.2,10,2608,0.6,20,0,300,300,4105
1999,32,a) 0,4748,4773,36279,18188,4743,198.7,0,0,36182,36182,0,198.9,198.9,0,0,0,0,0,36182,198.9,0,0,,,
1999,32,b) 1,3577,3667,36774,36672,80,1.9,1036,24.8,11693,2000,9693,5.5,31.9,11488,6335,5153,17.3,31.3,205,0.6,62.6,0,815,815,5031
1999,32,c) 2,2783,2817,29968,29963,95,3.1,598,19.5,7165,991,6174,3.3,23.9,7154,3807,3347,12.7,23.9,11,0,47.8,0,488,488,3260
1999,32,d) 3,2102,2160,34157,34244,85,3.7,399,17.2,4961,374,4587,1.1,14.5,5134,2535,2599,7.4,15,-173,-0.5,29,0,326,326,2137
1999,32,e) 4,1885,1963,26064,26878,83,4,292,14.1,3918,658,3260,2.4,14.6,5545,2313,3232,8.6,20.6,-1627,-6,29.2,0,219,219,1786
1999,32,f) 5,1539,1597,23306,23271,67,4,261,15.5,5143,1103,4040,4.7,22.1,5072,2304,2768,9.9,21.8,71,0.3,43.6,0,202,202,1762
1999,32,g) 6 to 10,5225,5634,78200,77773,237,4.1,685,11.7,14448,2664,11784,3.4,18.6,13593,5553,8040,7.1,17.5,855,1.1,35,0,502,502,3857
1999,32,h) 11 to 15,3440,4217,70997,71519,288,6.7,403,9.4,12608,4097,8511,5.7,17.6,13652,3999,9653,5.6,19.1,-1044,-1.5,35.2,0,243,243,2237
1999,32,i) 16 to 20,2423,3020,86700,83345,116,3.7,261,8.4,16011,1484,14527,1.8,19.2,9300,1832,7468,2.2,11.2,6711,8,22.4,0,138,138,895
1999,32,j) 21 to 25,917,1488,66235,65888,108,7.2,123,8.2,8366,3327,5039,5,12.7,7671,2418,5253,3.7,11.6,695,1.1,23.2,0,45,45,220
1999,32,l) Left Censored,3603,8162,351577,344777,1019,12.8,643,8.1,51476,22334,29142,6.5,14.9,37876,11693,26183,3.4,11,13600,3.9,22,0,110,110,1513
1999,33,a) 0,2471,2489,12842,6446,2467,198.2,0,0,12792,12792,0,198.4,198.4,0,0,0,0,0,12792,198.4,0,0,,,
1999,33,b) 1,2121,2151,15326,15188,31,1.3,528,21.9,3819,594,3225,3.9,25.1,3543,1982,1561,13,23.3,276,1.8,46.6,0,414,414,1612
1999,33,c) 2,1895,1911,12372,12617,53,2.6,320,15.6,2353,277,2076,2.2,18.6,2843,1380,1463,10.9,22.5,-490,-3.9,37.2,0,248,248,1033
1999,33,d) 3,1680,1708,14965,15012,49,2.7,267,14.6,2324,142,2182,0.9,15.5,2418,1088,1330,7.2,16.1,-94,-0.6,31,0,219,219,930
1999,33,e) 4,1490,1508,11816,12114,36,2.3,193,12.2,1811,252,1559,2.1,14.9,2406,873,1533,7.2,19.9,-595,-5,29.8,0,152,152,697
1999,33,f) 5,1327,1348,11197,11086,29,2.1,147,10.4,1972,233,1739,2.1,17.8,1750,763,987,6.9,15.8,222,2,31.6,0,114,114,584
1999,33,g) 6 to 10,4746,5006,52620,53503,118,2.3,489,9.4,6127,706,5421,1.3,11.5,7892,2707,5185,5.1,14.8,-1765,-3.3,23,0,351,351,1889
1999,33,h) 11 to 15,4371,4719,63928,63679,139,2.9,365,7.6,8059,1278,6781,2,12.7,7560,2594,4966,4.1,11.9,499,0.8,23.8,0,240,240,1440
1999,33,i) 16 to 20,2279,2565,40993,41158,64,2.4,160,6.1,4340,752,3588,1.8,10.5,4669,974,3695,2.4,11.3,-329,-0.8,21,0,104,104,453
1999,33,j) 21 to 25,895,1345,29236,29716,27,2,98,7.1,2960,397,2563,1.3,10,3919,1404,2515,4.7,13.2,-959,-3.2,20,0,38,38,154
1999,33,l) Left Censored,4478,8025,255916,253752,535,6.7,437,5.5,27282,9194,18088,3.6,10.8,22953,5877,17076,2.3,9,4329,1.8,18,0,140,140,1962
1999,34,a) 0,16404,16485,98359,49507,16348,198.3,0,0,97704,97704,0,197.4,197.4,0,0,0,0,0,97704,197.4,0,0,,,
1999,34,b) 1,13952,14146,110045,109621,163,1,3282,20.7,29811,4403,25408,4,27.2,28962,13202,15760,12,26.4,849,0.8,52.8,0,2489,2489,10795
1999,34,c) 2,11915,12072,87268,88297,341,2.6,2234,17.1,20794,2052,18742,2.3,23.6,22851,12977,9874,14.7,25.9,-2057,-2.3,47.2,0,1741,1741,10263
1999,34,d) 3,10080,10215,77707,79611,310,2.9,1607,14.8,14477,2264,12213,2.8,18.2,18285,8780,9505,11,23,-3808,-4.8,36.4,0,1252,1252,6506
1999,34,e) 4,8965,9387,76152,77384,346,3.5,1407,14.2,14613,2542,12071,3.3,18.9,17076,7956,9120,10.3,22.1,-2463,-3.2,37.8,0,1012,1012,5776
1999,34,f) 5,7486,7617,65955,66214,230,2.9,954,11.9,10895,1201,9694,1.8,16.5,11412,4811,6601,7.3,17.2,-517,-0.7,33,0,737,737,3601
1999,34,g) 6 to 10,29410,30361,293811,297843,827,2.6,3290,10.4,44204,6089,38115,2,14.8,52267,20475,31792,6.9,17.5,-8063,-2.7,29.6,0,2490,2490,14285
1999,34,h) 11 to 15,24034,26250,362652,361427,895,3.3,2306,8.5,52956,10829,42127,3,14.7,50506,19059,31447,5.3,14,2450,0.7,28,0,1612,1612,11824
1999,34,i) 16 to 20,15421,17159,256160,256074,492,2.8,1272,7.2,35880,9952,25928,3.9,14,35707,11030,24677,4.3,13.9,173,0.1,27.8,0,854,854,5839
1999,34,j) 21 to 25,5767,7245,161837,164552,212,2.9,558,7.5,17393,4078,13315,2.5,10.6,22822,6667,16155,4.1,13.9,-5429,-3.3,21.2,0,305,305,1583
1999,34,l) Left Censored,29527,51101,1816840,1816353,2405,4.6,3935,7.6,222639,73730,148909,4.1,12.3,221666,66101,155565,3.6,12.2,973,0.1,24.4,0,1413,1413,11504
1999,35,a) 0,3058,3075,20012,10081,3040,197.7,0,0,19862,19862,0,197,197,0,0,0,0,0,19862,197,0,0,,,
1999,35,b) 1,2458,2511,19061,19761,35,1.2,758,26.1,4484,445,4039,2.3,22.7,5883,3140,2743,15.9,29.8,-1399,-7.1,45.4,0,585,585,2272
1999,35,c) 2,2104,2130,15766,16310,81,3.5,472,20.3,3071,323,2748,2,18.8,4158,2348,1810,14.4,25.5,-1087,-6.7,37.6,0,345,345,1806
1999,35,d) 3,1802,1839,14302,14841,66,3.3,357,18,2305,350,1955,2.4,15.5,3382,1605,1777,10.8,22.8,-1077,-7.3,31,0,282,282,1352
1999,35,e) 4,1687,1737,14251,15223,52,2.8,290,15.6,2143,299,1844,2,14.1,4086,1596,2490,10.5,26.8,-1943,-12.7,28.2,0,225,225,1244
1999,35,f) 5,1546,1632,13356,13759,68,4,218,12.8,2121,481,1640,3.5,15.4,2926,998,1928,7.3,21.3,-805,-5.9,30.8,0,163,163,697
1999,35,g) 6 to 10,5397,5779,52720,55035,202,3.3,730,12.1,7588,1341,6247,2.4,13.8,12217,4773,7444,8.7,22.2,-4629,-8.4,27.6,0,512,512,3476
1999,35,h) 11 to 15,4000,4527,68341,69037,177,3.8,476,10.2,7620,1271,6349,1.8,11,9011,3349,5662,4.9,13.1,-1391,-2.1,22,0,289,289,1617
1999,35,i) 16 to 20,3062,3633,49523,49918,122,3.3,295,7.9,6562,1697,4865,3.4,13.1,7351,2234,5117,4.5,14.7,-789,-1.6,26.2,0,173,173,1250
1999,35,j) 21 to 25,1164,1735,28663,27786,62,3.5,98,5.6,4823,1844,2979,6.6,17.4,3069,657,2412,2.4,11,1754,6.4,22,0,41,41,183
1999,35,l) Left Censored,4570,9169,239739,239826,730,8,596,6.5,31280,12169,19111,5.1,13,31454,8982,22472,3.7,13.1,-174,-0.1,26,0,186,186,1162
1999,36,a) 0,34542,34656,203050,101891,34405,198.6,0,0,202319,202319,0,198.6,198.6,0,0,0,0,0,202319,198.6,0,0,,,
1999,36,b) 1,29217,29724,237872,238453,382,1.1,7071,21.2,62268,11265,51003,4.7,26.1,63429,32081,31348,13.5,26.6,-1161,-0.5,52.2,0,5501,5501,25860
1999,36,c) 2,24853,25200,185707,191036,674,2.5,4949,18.1,37927,4641,33286,2.4,19.9,48585,27478,21107,14.4,25.4,-10658,-5.5,39.8,0,3977,3977,22616
1999,36,d) 3,20844,21074,161461,165897,574,2.5,3631,16,29336,3837,25499,2.3,17.7,38208,19998,18210,12.1,23,-8872,-5.3,35.4,0,2918,2918,15436
1999,36,e) 4,18307,19389,157615,159442,811,4,2923,14.3,29346,4448,24898,2.8,18.4,33000,15929,17071,10,20.7,-3654,-2.3,36.8,0,2255,2255,12713
1999,36,f) 5,15485,15781,144144,147290,465,2.8,2127,12.8,26296,3022,23274,2.1,17.9,32588,13396,19192,9.1,22.1,-6292,-4.2,35.8,0,1716,1716,10106
1999,36,g) 6 to 10,61702,63907,615170,622131,1640,2.5,6697,10.1,89584,13032,76552,2.1,14.4,103506,45409,58097,7.3,16.6,-13922,-2.2,28.8,0,5152,5152,32120
1999,36,h) 11 to 15,49732,53792,712639,721850,1439,2.6,4540,8.2,77324,13049,64275,1.8,10.7,95745,32970,62775,4.6,13.3,-18421,-2.6,21.4,0,3121,3121,18922
1999,36,i) 16 to 20,31373,35746,554027,552670,949,2.6,2610,7.1,70561,16412,54149,3,12.8,67847,24880,42967,4.5,12.3,2714,0.5,24.6,0,1749,1749,11773
1999,36,j) 21 to 25,11337,15846,326798,334453,546,3.4,1173,7.3,36119,9615,26504,2.9,10.8,51429,16566,34863,5,15.4,-15310,-4.6,21.6,0,557,557,3478
1999,36,l) Left Censored,63846,109923,3778121,3787377,5380,4.8,7611,6.9,420096,116188,303908,3.1,11.1,438610,128168,310442,3.4,11.6,-18514,-0.5,22.2,0,3214,3214,26939
1999,37,a) 0,15292,15392,97057,48657,15291,198.7,0,0,96801,96801,0,198.9,198.9,0,0,0,0,0,96801,198.9,0,0,,,
1999,37,b) 1,12059,12392,102571,102361,245,1.8,3171,22.7,29701,6129,23572,6,29,29281,15845,13436,15.5,28.6,420,0.4,57.2,0,2502,2502,13220
1999,37,c) 2,10152,10323,78991,85718,285,2.5,2103,18.7,16917,1776,15141,2.1,19.7,30371,21378,8993,24.9,35.4,-13454,-15.7,39.4,0,1634,1634,19019
1999,37,d) 3,8537,8849,75350,75604,311,3.3,1409,15,15243,1757,13486,2.3,20.2,15750,8166,7584,10.8,20.8,-507,-0.6,40.4,0,1119,1119,5969
1999,37,e) 4,7499,7729,62472,63336,230,2.8,1120,13.7,11151,1130,10021,1.8,17.6,12879,6621,6258,10.5,20.3,-1728,-2.7,35.2,0,871,871,5452
1999,37,f) 5,6291,6552,61582,62247,204,3,885,12.8,10645,1722,8923,2.8,17.1,11974,5241,6733,8.4,19.2,-1329,-2.1,34.2,0,691,691,3598
1999,37,g) 6 to 10,23640,25301,294370,293268,726,2.8,2645,10.1,53809,16622,37187,5.7,18.3,51605,19730,31875,6.7,17.6,2204,0.7,35.2,0,1899,1899,12635
1999,37,h) 11 to 15,20501,23538,340293,339210,801,3.3,1791,7.4,45569,12571,32998,3.7,13.4,43403,15109,28294,4.5,12.8,2166,0.6,25.6,0,1168,1168,9514
1999,37,i) 16 to 20,11561,14002,234558,233684,398,2.8,966,6.8,29640,7144,22496,3.1,12.7,27891,9485,18406,4.1,11.9,1749,0.8,23.8,0,584,584,3587
1999,37,j) 21 to 25,4514,7006,141462,140484,358,5.1,488,6.9,20310,7709,12601,5.5,14.5,18353,5814,12539,4.1,13.1,1957,1.4,26.2,0,242,242,1661
1999,37,l) Left Censored,21367,48313,1789786,1790716,2924,6,3493,7.2,221896,58615,163281,3.3,12.4,223758,71879,151879,4,12.5,-1862,-0.1,24.8,0,835,835,7191
1999,38,a) 0,1045,1048,7588,3801,1038,198.1,0,0,7574,7574,0,199.3,199.3,0,0,0,0,0,7574,199.3,0,0,,,
1999,38,b) 1,972,999,8609,8433,26,2.4,217,19.7,2968,1723,1245,20.4,35.2,2616,858,1758,10.2,31,352,4.2,62,0,166,166,732
1999,38,c) 2,834,841,5513,6118,18,2,150,16.5,755,89,666,1.5,12.3,1964,1111,853,18.2,32.1,-1209,-19.8,24.6,0,101,101,536
1999,38,d) 3,747,760,5163,5287,23,2.8,120,14.8,937,58,879,1.1,17.7,1184,538,646,10.2,22.4,-247,-4.7,35.4,0,101,101,465
1999,38,e) 4,619,622,4689,4879,17,2.6,105,15.8,745,238,507,4.9,15.3,1124,642,482,13.2,23,-379,-7.7,30.6,0,79,79,542
1999,38,f) 5,646,652,5189,5270,14,2,89,12.9,691,82,609,1.6,13.1,853,314,539,6,16.2,-162,-3.1,26.2,0,63,63,270
1999,38,g) 6 to 10,2510,2636,22388,23248,78,2.9,227,8.4,3285,672,2613,2.9,14.1,5004,1432,3572,6.2,21.5,-1719,-7.4,28.2,0,164,164,863
1999,38,h) 11 to 15,2136,2335,24080,24767,60,2.5,175,7.3,2539,549,1990,2.2,10.3,3912,1538,2374,6.2,15.8,-1373,-5.5,20.6,0,129,129,565
1999,38,i) 16 to 20,1657,1928,22203,22636,44,2.2,126,6.4,2051,452,1599,2,9.1,2916,811,2105,3.6,12.9,-865,-3.8,18.2,0,73,73,385
1999,38,j) 21 to 25,655,850,12935,13017,20,2.3,57,6.6,1235,202,1033,1.6,9.5,1398,290,1108,2.2,10.7,-163,-1.2,19,0,28,28,153
1999,38,l) Left Censored,3404,5418,128697,128983,198,3.6,264,4.8,10601,1811,8790,1.4,8.2,11173,3054,8119,2.4,8.7,-572,-0.5,16.4,0,108,108,561
1999,39,a) 0,15457,15589,115125,57698,15481,198.6,0,0,114855,114855,0,199.1,199.1,0,0,0,0,0,114855,199.1,0,0,,,
1999,39,b) 1,13136,13620,117128,117090,314,2.1,3187,21,33723,8023,25700,6.9,28.8,33647,15373,18274,13.1,28.7,76,0.1,57.4,0,2492,2492,12687
1999,39,c) 2,11335,11728,103325,105492,352,2.8,2105,16.7,21026,2653,18373,2.5,19.9,25360,14118,11242,13.4,24,-4334,-4.1,39.8,0,1614,1614,10691
1999,39,d) 3,9930,10189,88976,90302,278,2.6,1586,14.6,17607,1540,16067,1.7,19.5,20258,9077,11181,10.1,22.4,-2651,-2.9,39,0,1228,1228,6401
1999,39,e) 4,9390,9652,82316,83314,251,2.5,1196,11.8,14654,2033,12621,2.4,17.6,16649,7587,9062,9.1,20,-1995,-2.4,35.2,0,928,928,5558
1999,39,f) 5,8148,8521,81972,82604,248,2.8,1064,11.9,14113,2319,11794,2.8,17.1,15377,7009,8368,8.5,18.6,-1264,-1.5,34.2,0,798,798,5376
1999,39,g) 6 to 10,32087,34593,379655,385672,904,2.5,3394,9.5,50926,8110,42816,2.1,13.2,62959,24810,38149,6.4,16.3,-12033,-3.1,26.4,0,2428,2428,16949
1999,39,h) 11 to 15,26207,30253,469796,469931,854,2.8,2224,7.2,57987,11345,46642,2.4,12.3,58256,18037,40219,3.8,12.4,-269,-0.1,24.6,0,1442,1442,9610
1999,39,i) 16 to 20,17425,20871,342804,344499,478,2.2,1413,6.6,40792,9887,30905,2.9,11.8,44181,14299,29882,4.2,12.8,-3389,-1,23.6,0,903,903,7711
1999,39,j) 21 to 25,7195,11029,226699,227723,362,3.2,746,6.6,26429,6147,20282,2.7,11.6,28477,10030,18447,4.4,12.5,-2048,-0.9,23.2,0,363,363,2761
1999,39,l) Left Censored,38607,78263,2802304,2818588,3789,4.8,4973,6.3,301317,80649,220668,2.9,10.7,333886,100899,232987,3.6,11.8,-32569,-1.1,21.4,0,1552,1552,11245
1999,40,a) 0,6054,6094,36815,18476,6051,198.6,0,0,36678,36678,0,198.5,198.5,0,0,0,0,0,36678,198.5,0,0,,,
1999,40,b) 1,4824,4968,37841,39199,100,1.8,1443,25.3,10343,1812,8531,4.6,26.4,13059,7012,6047,17.9,33.3,-2716,-6.9,52.8,0,1163,1163,5641
1999,40,c) 2,4150,4318,35720,36228,144,3,967,20.4,8406,1953,6453,5.4,23.2,9421,5255,4166,14.5,26,-1015,-2.8,46.4,0,752,752,3970
1999,40,d) 3,3431,3505,25909,27090,101,2.7,596,15.9,4758,643,4115,2.4,17.6,7119,3215,3904,11.9,26.3,-2361,-8.7,35.2,0,481,481,2666
1999,40,e) 4,2968,3041,26051,26555,109,3.4,508,15.7,5076,828,4248,3.1,19.1,6084,3033,3051,11.4,22.9,-1008,-3.8,38.2,0,385,385,2309
1999,40,f) 5,2760,2853,22128,22826,127,4.2,414,13.8,4253,966,3287,4.2,18.6,5648,3138,2510,13.7,24.7,-1395,-6.1,37.2,0,322,322,2578
1999,40,g) 6 to 10,10276,10869,110699,112420,324,2.9,1275,11.2,17104,2548,14556,2.3,15.2,20546,8336,12210,7.4,18.3,-3442,-3.1,30.4,0,935,935,5772
1999,40,h) 11 to 15,8249,9241,132700,133444,312,3.3,798,8.4,18494,4724,13770,3.5,13.9,19982,6081,13901,4.6,15,-1488,-1.1,27.8,0,536,536,3282
1999,40,i) 16 to 20,6544,7690,113564,114148,217,2.8,545,6.9,14744,3810,10934,3.3,12.9,15911,3927,11984,3.4,13.9,-1167,-1,25.8,0,351,351,1901
1999,40,j) 21 to 25,2206,3116,53721,54207,83,2.6,291,9,7720,1331,6389,2.5,14.2,8692,3271,5421,6,16,-972,-1.8,28.4,0,102,102,935
1999,40,l) Left Censored,9976,19982,560154,566100,1192,5.9,1467,7.3,66510,20242,46268,3.6,11.7,78402,26929,51473,4.8,13.8,-11892,-2.1,23.4,0,420,420,3661
1999,41,a) 0,7545,7594,38819,19496,7537,198.5,0,0,38647,38647,0,198.2,198.2,0,0,0,0,0,38647,198.2,0,0,,,
1999,41,b) 1,6060,6214,41610,42570,121,1.7,1725,24.4,11642,3142,8500,7.4,27.3,13561,6638,6923,15.6,31.9,-1919,-4.6,54.6,0,1308,1308,5343
1999,41,c) 2,5100,5185,35113,36481,175,3.1,1073,19,6700,791,5909,2.2,18.4,9435,5317,4118,14.6,25.9,-2735,-7.5,36.8,0,841,841,4352
1999,41,d) 3,4551,4691,45295,45628,162,3.2,829,16.5,7452,1554,5898,3.4,16.3,8118,4173,3945,9.1,17.8,-666,-1.5,32.6,0,630,630,3350
1999,41,e) 4,4254,4346,31955,33254,153,3.3,655,14.2,5725,970,4755,2.9,17.2,8322,3315,5007,10,25,-2597,-7.8,34.4,0,497,497,2733
1999,41,f) 5,3689,3878,31040,32281,134,3.3,549,13.4,4907,975,3932,3,15.2,7389,3644,3745,11.3,22.9,-2482,-7.7,30.4,0,407,407,3006
1999,41,g) 6 to 10,12846,13572,131757,134712,417,2.9,1575,11.1,19268,2896,16372,2.1,14.3,25177,10953,14224,8.1,18.7,-5909,-4.4,28.6,0,1143,1143,6475
1999,41,h) 11 to 15,9318,10517,140190,142422,369,3.4,969,9,19071,3477,15594,2.4,13.4,23535,9288,14247,6.5,16.5,-4464,-3.1,26.8,0,634,634,3492
1999,41,i) 16 to 20,6568,7907,121122,122021,251,3.1,621,7.7,14847,3818,11029,3.1,12.2,16644,5576,11068,4.6,13.6,-1797,-1.4,24.4,0,356,356,2403
1999,41,j) 21 to 25,2525,3666,70738,70810,168,4.5,258,6.9,9481,3179,6302,4.5,13.4,9624,3337,6287,4.7,13.6,-143,-0.2,26.8,0,114,114,608
1999,41,l) Left Censored,10034,19782,623367,621398,1229,6.2,1384,7,78788,22844,55944,3.7,12.7,74850,26796,48054,4.3,12,3938,0.7,24,0,407,407,4012
1999,42,a) 0,17013,17135,115170,57832,17005,198.5,0,0,114676,114676,0,198.3,198.3,0,0,0,0,0,114676,198.3,0,0,,,
1999,42,b) 1,14263,14738,125833,124364,379,2.3,3214,19.8,35428,9600,25828,7.7,28.5,32490,15361,17129,12.4,26.1,2938,2.4,52.2,0,2440,2440,12245
1999,42,c) 2,12374,12735,102727,103431,322,2.4,2184,16,22104,2848,19256,2.8,21.4,23511,12470,11041,12.1,22.7,-1407,-1.3,42.8,0,1674,1674,9797
1999,42,d) 3,10576,10902,95593,97724,294,2.5,1670,14.4,16385,1938,14447,2,16.8,20647,10874,9773,11.1,21.1,-4262,-4.3,33.6,0,1270,1270,7858
1999,42,e) 4,9915,10260,86467,87514,285,2.6,1299,12,15164,2396,12768,2.7,17.3,17257,7223,10034,8.3,19.7,-2093,-2.4,34.6,0,993,993,5623
1999,42,f) 5,8248,8530,77956,78741,219,2.5,979,11,12893,1967,10926,2.5,16.4,14462,6989,7473,8.9,18.4,-1569,-2,32.8,0,791,791,5831
1999,42,g) 6 to 10,36459,38613,386554,393132,1005,2.5,3678,9.2,51943,8139,43804,2.1,13.2,65098,27423,37675,7,16.6,-13155,-3.4,26.4,0,2740,2740,18756
1999,42,h) 11 to 15,31850,36006,485773,488999,1157,3.1,2768,7.5,56312,12664,43648,2.6,11.5,62764,21726,41038,4.4,12.8,-6452,-1.3,23,0,1849,1849,12031
1999,42,i) 16 to 20,19486,22547,358857,359282,530,2.3,1586,6.9,43370,8220,35150,2.3,12.1,44220,15586,28634,4.3,12.3,-850,-0.2,24.2,0,1024,1024,7319
1999,42,j) 21 to 25,7784,11425,230304,237273,336,2.9,758,6.5,25714,4931,20783,2.1,10.8,39652,9352,30300,3.9,16.7,-13938,-5.9,21.6,0,393,393,3220
1999,42,l) Left Censored,42345,82060,2845497,2856155,3516,4.2,5769,6.9,293449,73059,220390,2.6,10.3,314766,88756,226010,3.1,11,-21317,-0.7,20.6,0,1981,1981,14972
1999,44,a) 0,1797,1804,9038,4528,1792,198.7,0,0,9020,9020,0,199.2,199.2,0,0,0,0,0,9020,199.2,0,0,,,
1999,44,b) 1,1564,1604,10997,11290,23,1.3,400,22.2,3062,936,2126,8.3,27.1,3648,1246,2402,11,32.3,-586,-5.2,54.2,0,311,311,1039
1999,44,c) 2,1319,1340,10844,10772,39,2.7,245,16.9,2139,180,1959,1.7,19.9,1994,924,1070,8.6,18.5,145,1.4,37,0,192,192,776
1999,44,d) 3,1122,1131,8593,8674,19,1.5,220,17.9,1646,108,1538,1.2,19,1807,969,838,11.2,20.8,-161,-1.8,38,0,176,176,699
1999,44,e) 4,996,1005,7640,7821,28,2.6,133,12.6,1305,219,1086,2.8,16.7,1666,831,835,10.6,21.3,-361,-4.6,33.4,0,93,93,472
1999,44,f) 5,919,931,12130,11887,31,3.2,126,12.9,1631,220,1411,1.9,13.7,1145,458,687,3.9,9.6,486,4.1,19.2,0,103,103,378
1999,44,g) 6 to 10,3713,3837,37592,37350,85,2.1,363,9.1,5981,829,5152,2.2,16,5497,2336,3161,6.3,14.7,484,1.3,29.4,0,265,265,1105
1999,44,h) 11 to 15,3204,3420,39356,39902,104,3,283,8.1,4149,699,3450,1.8,10.4,5240,1884,3356,4.7,13.1,-1091,-2.7,20.8,0,204,204,1458
1999,44,i) 16 to 20,1902,2100,30412,30500,54,2.5,163,7.6,4241,836,3405,2.7,13.9,4417,1400,3017,4.6,14.5,-176,-0.6,27.8,0,115,115,628
1999,44,j) 21 to 25,807,985,18261,17981,31,3.1,64,6.4,2132,516,1616,2.9,11.9,1571,318,1253,1.8,8.7,561,3.2,17.4,0,44,44,124
1999,44,l) Left Censored,4735,6834,218248,220544,320,4.6,427,6.2,21308,5367,15941,2.4,9.7,25901,7816,18085,3.5,11.7,-4593,-2,19.4,0,221,221,1827
1999,45,a) 0,7521,7585,47849,23987,7538,198.8,0,0,47725,47725,0,199,199,0,0,0,0,0,47725,199,0,0,,,
1999,45,b) 1,5871,5959,55066,52096,100,1.5,1632,24.1,20970,6550,14420,12.6,40.3,15029,7034,7995,13.5,28.8,5941,11.5,57.6,0,1315,1315,5646
1999,45,c) 2,4752,4833,44162,43761,152,2.9,991,18.9,11924,4270,7654,9.8,27.2,11122,6248,4874,14.3,25.4,802,1.8,50.8,0,781,781,5142
1999,45,d) 3,4081,4169,42386,42863,140,3.1,680,15.3,6991,682,6309,1.6,16.3,7945,3887,4058,9.1,18.5,-954,-2.2,32.6,0,536,536,2989
1999,45,e) 4,3573,3657,35352,35786,120,3.1,605,15.5,7313,864,6449,2.4,20.4,8180,4822,3358,13.5,22.9,-867,-2.5,40.8,0,462,462,3482
1999,45,f) 5,3069,3212,35506,34839,107,3.2,431,12.8,6920,983,5937,2.8,19.9,5586,2307,3279,6.6,16,1334,3.9,32,0,315,315,1540
1999,45,g) 6 to 10,11415,12405,134516,135333,393,3.1,1342,10.4,19969,3063,16906,2.3,14.8,21603,9440,12163,7,16,-1634,-1.2,29.6,0,952,952,5838
1999,45,h) 11 to 15,9692,11288,166210,167733,400,3.5,878,7.6,20918,4772,16146,2.8,12.5,23964,7973,15991,4.8,14.3,-3046,-1.8,25,0,549,549,3647
1999,45,i) 16 to 20,5525,6645,104437,103099,238,3.5,470,7,14716,4177,10539,4.1,14.3,12040,3561,8479,3.5,11.7,2676,2.6,23.4,0,274,274,1718
1999,45,j) 21 to 25,2167,3498,52702,53941,218,6.2,284,8,7176,2114,5062,3.9,13.3,9653,3722,5931,6.9,17.9,-2477,-4.6,26.6,0,102,102,769
1999,45,l) Left Censored,10485,22644,820155,823780,1386,6.1,1568,6.9,86602,22837,63765,2.8,10.5,93852,21895,71957,2.7,11.4,-7250,-0.9,21,0,429,429,3417
1999,46,a) 0,1583,1590,8817,4426,1571,197.6,0,0,8783,8783,0,198.4,198.4,0,0,0,0,0,8783,198.4,0,0,,,
1999,46,b) 1,1311,1341,9173,9120,28,1.9,352,23.3,2225,451,1774,4.9,24.4,2118,1193,925,13.1,23.2,107,1.2,46.4,0,280,280,1001
1999,46,c) 2,1076,1086,7427,7644,24,2,208,17.5,1363,220,1143,2.9,17.8,1796,974,822,12.7,23.5,-433,-5.7,35.6,0,159,159,704
1999,46,d) 3,957,980,6694,6656,33,3.2,154,14.7,1386,246,1140,3.7,20.8,1309,578,731,8.7,19.7,77,1.1,39.4,0,101,101,439
1999,46,e) 4,847,870,6354,6427,15,1.6,105,11.5,820,147,673,2.3,12.8,966,367,599,5.7,15,-146,-2.2,25.6,0,81,81,302
1999,46,f) 5,819,833,6943,7036,20,2.3,104,11.9,910,69,841,1,12.9,1095,395,700,5.6,15.6,-185,-2.7,25.8,0,86,86,310
1999,46,g) 6 to 10,2958,3107,26862,27219,113,3.5,337,10.5,3452,778,2674,2.9,12.7,4166,1493,2673,5.5,15.3,-714,-2.6,25.4,0,239,239,984
1999,46,h) 11 to 15,2369,2585,38052,38469,64,2.4,192,7.3,3155,341,2814,0.9,8.2,3989,1429,2560,3.7,10.4,-834,-2.2,16.4,0,139,139,924
1999,46,i) 16 to 20,1564,1810,22588,22974,51,2.7,156,8.4,2793,926,1867,4,12.2,3564,1668,1896,7.3,15.5,-771,-3.3,24.4,0,101,101,887
1999,46,j) 21 to 25,699,934,14316,13915,62,6.6,66,7.1,2099,956,1143,6.9,15.1,1297,300,997,2.2,9.3,802,5.8,18.6,0,39,39,200
1999,46,l) Left Censored,3552,5723,144778,145207,227,3.9,337,5.8,14109,4117,9992,2.8,9.7,14966,4629,10337,3.2,10.3,-857,-0.6,19.4,0,141,141,627
1999,47,a) 0,8975,9122,66877,33567,9046,198.3,0,0,66620,66620,0,198.5,198.5,0,0,0,0,0,66620,198.5,0,0,,,
1999,47,b) 1,7249,7509,71224,70254,162,1.9,2162,25.2,21884,5359,16525,7.6,31.1,19943,10765,9178,15.3,28.4,1941,2.7,56.8,0,1776,1776,8752
1999,47,c) 2,5777,5943,51688,54469,159,2.4,1485,22.4,11516,1249,10267,2.3,21.1,17078,11084,5994,20.3,31.4,-5562,-10.3,42.2,0,1170,1170,8160
1999,47,d) 3,5329,5453,53462,54590,158,2.7,1018,17.3,8901,1188,7713,2.2,16.3,11156,5617,5539,10.3,20.4,-2255,-4.1,32.6,0,818,818,4377
1999,47,e) 4,4603,4742,44430,45988,181,3.6,788,15.6,8229,1182,7047,2.6,17.9,11345,6183,5162,13.4,24.7,-3116,-6.8,35.8,0,615,615,4770
1999,47,f) 5,4097,4244,40826,40940,138,3.1,585,13.1,7630,1967,5663,4.8,18.6,7858,3433,4425,8.4,19.2,-228,-0.6,37.2,0,437,437,2105
1999,47,g) 6 to 10,15531,16764,192758,197023,483,2.8,2020,11.5,27962,4933,23029,2.5,14.2,36492,16335,20157,8.3,18.5,-8530,-4.3,28.4,0,1415,1415,9954
1999,47,h) 11 to 15,13166,15264,229049,229921,543,3.5,1312,8.4,31748,7599,24149,3.3,13.8,33492,13784,19708,6,14.6,-1744,-0.8,27.6,0,812,812,4331
1999,47,i) 16 to 20,7850,9513,165403,164606,370,3.8,733,7.6,25305,8571,16734,5.2,15.4,23710,7714,15996,4.7,14.4,1595,1,28.8,0,428,428,2949
1999,47,j) 21 to 25,3402,5898,143683,143365,236,3.9,411,6.9,17192,5790,11402,4,12,16556,4519,12037,3.2,11.5,636,0.5,23,0,180,180,1053
1999,47,l) Left Censored,15302,33866,1251292,1262867,2007,5.9,2357,6.9,142482,38947,103535,3.1,11.3,165632,51243,114389,4.1,13.1,-23150,-1.8,22.6,0,628,628,4915
1999,48,a) 0,34780,35142,255123,128224,34858,198.4,0,0,253799,253799,0,197.9,197.9,0,0,0,0,0,253799,197.9,0,0,,,
1999,48,b) 1,27524,28216,267990,270454,529,1.6,8401,25.9,77702,15156,62546,5.6,28.7,82629,46934,35695,17.4,30.6,-4927,-1.9,57.4,0,6823,6823,38958
1999,48,c) 2,23127,23815,229693,236245,674,2.6,5263,20.1,56087,6709,49378,2.8,23.7,69191,39211,29980,16.6,29.3,-13104,-5.6,47.4,0,4231,4231,30436
1999,48,d) 3,20087,20911,204292,213954,737,3.3,3895,17.3,39555,5169,34386,2.4,18.5,58878,32549,26329,15.2,27.5,-19323,-9,37,0,3085,3085,26209
1999,48,e) 4,17521,18285,182295,187909,691,3.5,3052,15.7,36779,5495,31284,2.9,19.6,48007,24597,23410,13.1,25.5,-11228,-5.9,39.2,0,2384,2384,20158
1999,48,f) 5,15499,16490,183480,189253,728,4.2,2457,14.1,35585,8777,26808,4.6,18.8,47130,23102,24028,12.2,24.9,-11545,-6.1,37.6,0,1898,1898,14970
1999,48,g) 6 to 10,57507,62789,771768,788799,2082,3.2,7457,11.4,129095,23209,105886,2.9,16.4,163157,69357,93800,8.8,20.7,-34062,-4.3,32.8,0,5300,5300,40353
1999,48,h) 11 to 15,41655,49443,785316,793032,1945,3.8,4327,8.5,114668,34385,80283,4.3,14.5,130100,44837,85263,5.7,16.4,-15432,-1.9,29,0,2707,2707,20463
1999,48,i) 16 to 20,31676,38625,639522,642092,1242,3.1,3096,7.8,95606,20903,74703,3.3,14.9,100747,33179,67568,5.2,15.7,-5141,-0.8,29.8,0,1754,1754,14340
1999,48,j) 21 to 25,9960,16287,337358,332451,730,4.4,1301,7.9,60168,17720,42448,5.3,18.1,50354,18065,32289,5.4,15.1,9814,3,30.2,0,509,509,3299
1999,48,l) Left Censored,39115,105141,3753517,3747667,7868,7.5,7959,7.6,535370,164719,370651,4.4,14.3,523671,176624,347047,4.7,14,11699,0.3,28,0,1869,1869,15078
1999,49,a) 0,4987,5004,31653,15893,4969,198.6,0,0,31520,31520,0,198.3,198.3,0,0,0,0,0,31520,198.3,0,0,,,
1999,49,b) 1,3739,3807,44774,45195,60,1.4,1146,26.1,10187,1565,8622,3.5,22.5,11028,6211,4817,13.7,24.4,-841,-1.9,45,0,888,888,4676
1999,49,c) 2,3059,3120,25417,27129,96,2.8,713,20.8,5886,684,5202,2.5,21.7,9309,6416,2893,23.6,34.3,-3423,-12.6,43.4,0,546,546,5643
1999,49,d) 3,2684,2768,37405,38784,100,3.4,497,16.7,6796,636,6160,1.6,17.5,9553,3312,6241,8.5,24.6,-2757,-7.1,35,0,392,392,2591
1999,49,e) 4,2136,2195,24957,25586,77,3.3,388,16.5,4618,520,4098,2,18,5875,2930,2945,11.5,23,-1257,-5,36,0,297,297,2244
1999,49,f) 5,1877,1940,21599,21965,64,3.1,305,14.8,4246,1018,3228,4.6,19.3,4977,2398,2579,10.9,22.7,-731,-3.4,38.6,0,212,212,1528
1999,49,g) 6 to 10,6110,6557,90868,91800,224,3.3,744,10.9,14759,2345,12414,2.6,16.1,16623,6597,10026,7.2,18.1,-1864,-2,32.2,0,535,535,4555
1999,49,h) 11 to 15,3877,4470,81531,84189,194,4.2,431,9.4,11138,3503,7635,4.2,13.2,16454,6125,10329,7.3,19.5,-5316,-6.3,26.4,0,244,244,2873
1999,49,i) 16 to 20,2905,3456,63074,63129,134,3.8,307,8.7,10430,3405,7025,5.4,16.5,10540,3583,6957,5.7,16.7,-110,-0.2,33,0,163,163,1898
1999,49,j) 21 to 25,1206,1746,35454,35047,71,4,116,6.6,4797,1920,2877,5.5,13.7,3983,1394,2589,4,11.4,814,2.3,22.8,0,57,57,448
1999,49,l) Left Censored,4975,10848,417594,414408,1080,10.2,661,6.2,50533,17448,33085,4.2,12.2,44161,14036,30125,3.4,10.7,6372,1.5,21.4,0,194,194,1640
1999,50,a) 0,1332,1344,7018,3525,1335,198.7,0,0,6986,6986,0,198.2,198.2,0,0,0,0,0,6986,198.2,0,0,,,
1999,50,b) 1,1175,1214,7606,7387,31,2.3,247,18.5,1933,357,1576,4.8,26.2,1494,820,674,11.1,20.2,439,6,40.4,0,200,200,738
1999,50,c) 2,1011,1024,5033,5204,27,2.4,190,17.2,1010,168,842,3.2,19.4,1351,713,638,13.7,26,-341,-6.6,38.8,0,146,146,582
1999,50,d) 3,873,881,5693,5958,20,2.1,123,13.2,853,71,782,1.2,14.3,1383,698,685,11.7,23.2,-530,-8.9,28.6,0,98,98,624
1999,50,e) 4,778,783,5764,5872,13,1.6,99,11.9,670,36,634,0.6,11.4,887,385,502,6.6,15.1,-217,-3.7,22.8,0,76,76,304
1999,50,f) 5,754,778,5009,5110,22,2.7,90,11.1,750,90,660,1.8,14.7,951,558,393,10.9,18.6,-201,-3.9,29.4,0,69,69,488
1999,50,g) 6 to 10,3090,3212,24945,25489,72,2.2,293,8.8,3241,252,2989,1,12.7,4329,1897,2432,7.4,17,-1088,-4.3,25.4,0,227,227,1454
1999,50,h) 11 to 15,2608,2804,32442,32256,98,3.4,233,8.1,4050,690,3360,2.1,12.6,3678,1154,2524,3.6,11.4,372,1.2,22.8,0,164,164,815
1999,50,i) 16 to 20,1495,1690,20741,20705,53,3.1,113,6.6,2338,537,1801,2.6,11.3,2265,614,1651,3,10.9,73,0.4,21.8,0,71,71,378
1999,50,j) 21 to 25,562,742,13407,13348,21,2.8,44,5.8,1400,97,1303,0.7,10.5,1282,539,743,4,9.6,118,0.9,19.2,0,24,24,409
1999,50,l) Left Censored,2743,4290,115936,115446,217,5.1,205,4.8,10599,2899,7700,2.5,9.2,9619,2305,7314,2,8.3,980,0.9,16.6,0,83,83,909
1999,51,a) 0,11750,11834,73981,37106,11755,198.7,0,0,73751,73751,0,198.8,198.8,0,0,0,0,0,73751,198.8,0,0,,,
1999,51,b) 1,9727,9958,76432,76257,196,1.7,2673,23.7,22530,4516,18014,5.9,29.5,22180,12611,9569,16.5,29.1,350,0.4,58.2,0,2067,2067,9616
1999,51,c) 2,8167,8321,63122,64727,249,2.8,1616,17.9,14901,2641,12260,4.1,23,18110,9764,8346,15.1,28,-3209,-5,46,0,1252,1252,7866
1999,51,d) 3,7019,7184,57781,58668,254,3.3,1241,16.1,12619,2287,10332,3.9,21.5,14392,7357,7035,12.5,24.5,-1773,-3,43,0,958,958,5561
1999,51,e) 4,6491,6715,55828,56943,196,2.8,997,14,9888,1155,8733,2,17.4,12117,6097,6020,10.7,21.3,-2229,-3.9,34.8,0,715,715,4485
1999,51,f) 5,5569,5739,60440,59124,174,2.9,742,12.3,12631,2043,10588,3.5,21.4,9998,4467,5531,7.6,16.9,2633,4.5,33.8,0,557,557,3312
1999,51,g) 6 to 10,21767,23114,253192,251397,712,3,2429,10.1,41587,7132,34455,2.8,16.5,37996,14177,23819,5.6,15.1,3591,1.4,30.2,0,1758,1758,9989
1999,51,h) 11 to 15,17572,20294,305457,306900,672,3.2,1558,7.5,39733,7424,32309,2.4,12.9,42619,14181,28438,4.6,13.9,-2886,-1,25.8,0,1004,1004,6233
1999,51,i) 16 to 20,10138,12210,227567,227662,405,3.3,865,7,27664,8288,19376,3.6,12.2,27854,7763,20091,3.4,12.2,-190,0,24.4,0,478,478,3009
1999,51,j) 21 to 25,3864,6166,120521,118185,257,4.1,451,7.2,19150,4945,14205,4.2,16.2,14477,4981,9496,4.2,12.2,4673,4,24.4,0,170,170,1063
1999,51,l) Left Censored,18316,42877,1447196,1442299,2701,6.2,3362,7.8,178162,55273,122889,3.8,12.4,168369,53734,114635,3.7,11.7,9793,0.7,23.4,0,692,692,4880
1999,53,a) 0,13045,13140,78303,39268,13036,198.4,0,0,78070,78070,0,198.8,198.8,0,0,0,0,0,78070,198.8,0,0,,,
1999,53,b) 1,10108,10412,76154,75590,162,1.3,3175,26.4,24409,5981,18428,7.9,32.3,23281,11906,11375,15.8,30.8,1128,1.5,61.6,0,2356,2356,9132
1999,53,c) 2,8395,8539,61440,62967,301,3.2,1863,19.9,14038,1591,12447,2.5,22.3,17091,8727,8364,13.9,27.1,-3053,-4.8,44.6,0,1414,1414,7254
1999,53,d) 3,7338,7502,55334,57320,299,3.7,1434,17.7,10170,1360,8810,2.4,17.7,14141,7078,7063,12.3,24.7,-3971,-7,35.4,0,1103,1103,5439
1999,53,e) 4,6487,6673,61428,58761,246,3.5,1063,15,17083,7184,9899,12.2,29.1,11748,5321,6427,9.1,20,5335,9.1,40,0,790,790,3802
1999,53,f) 5,5724,5937,48140,51232,243,3.9,912,14.5,8947,1566,7381,3.1,17.5,15130,8537,6593,16.7,29.5,-6183,-12,35,0,667,667,6631
1999,53,g) 6 to 10,21362,22646,222469,225295,808,3.4,2723,11.5,35364,6030,29334,2.7,15.7,41016,15794,25222,7,18.2,-5652,-2.5,31.4,0,1909,1909,11043
1999,53,h) 11 to 15,15148,17291,238390,242400,699,3.9,1580,8.9,28797,4837,23960,2,11.9,36816,11455,25361,4.7,15.2,-8019,-3.3,23.8,0,998,998,6213
1999,53,i) 16 to 20,10112,12080,195215,196843,380,3.1,1055,8.5,24539,5877,18662,3,12.5,27794,9886,17908,5,14.1,-3255,-1.6,25,0,599,599,4200
1999,53,j) 21 to 25,3962,5923,109460,109057,244,4.1,452,7.5,15745,2832,12913,2.6,14.4,14938,5043,9895,4.6,13.7,807,0.7,27.4,0,201,201,1221
1999,53,l) Left Censored,14970,31025,997218,992787,1904,6.1,2252,7.2,122203,37987,84216,3.8,12.3,113342,35708,77634,3.6,11.4,8861,0.9,22.8,0,644,644,6132
1999,54,a) 0,2499,2513,13496,6786,2499,198.9,0,0,13420,13420,0,197.8,197.8,0,0,0,0,0,13420,197.8,0,0,,,
1999,54,b) 1,2027,2096,15110,15612,44,1.8,601,25.2,3911,672,3239,4.3,25.1,4915,2759,2156,17.7,31.5,-1004,-6.4,50.2,0,465,465,1731
1999,54,c) 2,1764,1778,11092,11783,43,2.2,372,19.1,2181,141,2040,1.2,18.5,3563,1728,1835,14.7,30.2,-1382,-11.7,37,0,303,303,1448
1999,54,d) 3,1535,1571,10871,11330,57,3.4,251,15,1709,264,1445,2.3,15.1,2626,1072,1554,9.5,23.2,-917,-8.1,30.2,0,193,193,893
1999,54,e) 4,1458,1489,10351,11109,41,2.6,232,14.7,1621,166,1455,1.5,14.6,3136,1474,1662,13.3,28.2,-1515,-13.6,29.2,0,197,197,1284
1999,54,f) 5,1232,1260,9720,9667,42,3.2,177,13.3,2037,605,1432,6.3,21.1,1930,850,1080,8.8,20,107,1.1,40,0,133,133,576
1999,54,g) 6 to 10,5102,5357,47491,48538,163,2.9,608,10.9,6134,791,5343,1.6,12.6,8228,3209,5019,6.6,17,-2094,-4.4,25.2,0,460,460,2441
1999,54,h) 11 to 15,4279,4727,59783,60700,126,2.6,346,7.2,6172,1650,4522,2.7,10.2,8006,2116,5890,3.5,13.2,-1834,-3,20.4,0,229,229,1296
1999,54,i) 16 to 20,2846,3226,39283,39790,81,2.5,223,6.8,3661,633,3028,1.6,9.2,4675,1343,3332,3.4,11.7,-1014,-2.5,18.4,0,150,150,814
1999,54,j) 21 to 25,1197,1928,34022,33746,82,4.2,131,6.7,4939,2284,2655,6.8,14.6,4386,1163,3223,3.4,13,553,1.6,26,0,50,50,233
1999,54,l) Left Censored,6375,11564,285815,289246,542,4.6,800,6.8,26677,7085,19592,2.4,9.2,33538,11212,22326,3.9,11.6,-6861,-2.4,18.4,0,243,243,1494
1999,55,a) 0,8335,8432,53671,26906,8380,198.8,0,0,53531,53531,0,199,199,0,0,0,0,0,53531,199,0,0,,,
1999,55,b) 1,7108,7333,63074,62427,150,1.9,1572,19.4,17198,4303,12895,6.9,27.5,15904,8054,7850,12.9,25.5,1294,2,51,0,1205,1205,5678
1999,55,c) 2,6155,6288,45757,47446,169,2.5,1031,15.3,8552,917,7635,1.9,18,11930,7280,4650,15.3,25.1,-3378,-7.1,36,0,783,783,5869
1999,55,d) 3,5457,5523,45219,45498,162,2.8,837,14.3,8249,887,7362,1.9,18.1,8806,4325,4481,9.5,19.4,-557,-1.3,36.2,0,645,645,3542
1999,55,e) 4,4955,5105,41795,42226,149,2.8,603,11.3,6785,1119,5666,2.7,16.1,7646,3061,4585,7.2,18.1,-861,-2,32.2,0,454,454,2328
1999,55,f) 5,4467,4639,40450,39990,175,3.6,528,11,7821,1743,6078,4.4,19.6,6900,2924,3976,7.3,17.3,921,2.3,34.6,0,420,420,2239
1999,55,g) 6 to 10,17672,18779,190487,191776,450,2.3,1741,9,25495,4771,20724,2.5,13.3,28073,10450,17623,5.4,14.6,-2578,-1.3,26.6,0,1305,1305,7649
1999,55,h) 11 to 15,14151,15987,235016,237374,372,2.3,1264,7.7,27169,4414,22755,1.9,11.4,31884,11740,20144,4.9,13.4,-4715,-2,22.8,0,849,849,5500
1999,55,i) 16 to 20,8920,10428,168306,168952,208,1.9,727,6.8,17434,2708,14726,1.6,10.3,18725,5304,13421,3.1,11.1,-1291,-0.8,20.6,0,461,461,2786
1999,55,j) 21 to 25,3831,5967,107244,107528,309,5.1,395,6.6,12704,3768,8936,3.5,11.8,13272,5387,7885,5,12.3,-568,-0.5,23.6,0,199,199,1003
1999,55,l) Left Censored,20163,36012,1342671,1343120,1479,4.1,2199,6,130438,25776,104662,1.9,9.7,131337,34998,96339,2.6,9.8,-899,-0.1,19.4,0,835,835,7278
1999,56,a) 0,1299,1307,5886,2955,1300,198.9,0,0,5862,5862,0,198.4,198.4,0,0,0,0,0,5862,198.4,0,0,,,
1999,56,b) 1,1091,1111,6863,6911,15,1.2,307,24.1,1795,309,1486,4.5,26,1890,996,894,14.4,27.3,-95,-1.3,52,0,218,218,773
1999,56,c) 2,911,921,4887,5205,25,2.5,191,19,913,67,846,1.3,17.5,1548,899,649,17.3,29.7,-635,-12.2,35,0,150,150,652
1999,56,d) 3,830,840,4884,4942,34,3.8,156,17.3,1008,170,838,3.4,20.4,1124,621,503,12.6,22.7,-116,-2.3,40.8,0,124,124,521
1999,56,e) 4,703,714,4799,4836,21,2.7,135,17.5,1226,117,1109,2.4,25.4,1300,709,591,14.7,26.9,-74,-1.5,50.8,0,106,106,560
1999,56,f) 5,662,673,5087,5137,23,3.2,108,15.1,939,291,648,5.7,18.3,1039,368,671,7.2,20.2,-100,-1.9,36.6,0,87,87,282
1999,56,g) 6 to 10,2224,2336,19993,20290,79,3.3,251,10.4,2716,336,2380,1.7,13.4,3309,1291,2018,6.4,16.3,-593,-2.9,26.8,0,181,181,937
1999,56,h) 11 to 15,1596,1752,19434,19372,48,2.6,165,9.1,2913,771,2142,4,15,2788,929,1859,4.8,14.4,125,0.6,28.8,0,115,115,589
1999,56,i) 16 to 20,1420,1666,16703,16777,55,3.2,137,8,2176,323,1853,1.9,13,2324,664,1660,4,13.9,-148,-0.9,26,0,80,80,398
1999,56,j) 21 to 25,548,723,10905,10869,31,4.2,55,7.5,1609,382,1227,3.5,14.8,1536,546,990,5,14.1,73,0.7,28.2,0,22,22,81
1999,56,l) Left Censored,2095,3440,65857,65515,199,5.8,227,6.6,8464,1967,6497,3,12.9,7780,2863,4917,4.4,11.9,684,1,23.8,0,82,82,469
2000,01,a) 0,6472,6542,38387,19332,6487,198.3,0,0,38110,38110,0,197.1,197.1,0,0,0,0,0,38110,197.1,0,0,,,
2000,01,b) 1,5333,5440,49639,49737,72,1.1,1716,27.2,15938,1717,14221,3.5,32,16133,8115,8018,16.3,32.4,-195,-0.4,64,0,1363,1363,6584
2000,01,c) 2,4823,5014,49911,49787,226,4.2,1045,19.2,12199,2978,9221,6,24.5,11951,5631,6320,11.3,24,248,0.5,48,0,835,835,4623
2000,01,d) 3,4166,4275,36975,38368,140,3,777,16.9,6607,846,5761,2.2,17.2,9393,4926,4467,12.8,24.5,-2786,-7.3,34.4,0,590,590,3248
2000,01,e) 4,3728,3898,30821,31937,116,2.8,601,14.5,5089,528,4561,1.7,15.9,7320,3835,3485,12,22.9,-2231,-7,31.8,0,461,461,2940
2000,01,f) 5,3322,3453,32632,32741,107,2.9,514,14.1,5768,887,4881,2.7,17.6,5985,2528,3457,7.7,18.3,-217,-0.7,35.2,0,389,389,1804
2000,01,g) 6 to 10,12231,12945,151613,152273,332,2.5,1539,11.4,24789,3364,21425,2.2,16.3,26109,10948,15161,7.2,17.1,-1320,-0.8,32.6,0,1108,1108,7821
2000,01,h) 11 to 15,9153,10590,170680,171743,380,3.5,927,8.5,20183,4743,15440,2.8,11.8,22309,7409,14900,4.3,13,-2126,-1.2,23.6,0,582,582,3943
2000,01,i) 16 to 20,6787,7897,136047,136585,216,2.7,601,7.4,17381,3887,13494,2.8,12.7,18458,6772,11686,5,13.5,-1077,-0.8,25.4,0,362,362,2495
2000,01,j) 21 to 25,3585,5729,118224,116293,241,4.2,409,7,19296,5112,14184,4.4,16.6,15433,4787,10646,4.1,13.3,3863,3.3,26.6,0,171,171,1135
2000,01,l) Left Censored,11001,24340,828574,826803,1285,5.2,1778,7.2,94782,23540,71242,2.8,11.5,91240,30184,61056,3.7,11,3542,0.5,22,0,463,463,3006
2000,02,a) 0,1275,1288,6641,3345,1265,196.4,0,0,6592,6592,0,197.1,197.1,0,0,0,0,0,6592,197.1,0,0,,,
2000,02,b) 1,918,933,6354,6087,16,1.5,339,30.8,2248,254,1994,4.2,36.9,1714,1072,642,17.6,28.2,534,8.7,56.4,0,212,212,729
2000,02,c) 2,886,927,7891,7864,52,5.2,201,20,2126,593,1533,7.5,27,2072,1073,999,13.6,26.3,54,0.7,52.6,0,142,142,852
2000,02,d) 3,751,759,5327,5281,36,4.4,137,16.9,1326,351,975,6.6,25.1,1233,458,775,8.7,23.3,93,1.8,46.6,0,103,103,334
2000,02,e) 4,659,669,4198,4297,21,2.9,112,15.7,836,86,750,2,19.5,1034,516,518,12,24.1,-198,-4.6,39,0,79,79,363
2000,02,f) 5,599,618,4339,4365,33,5.1,91,14.1,913,119,794,2.7,20.9,964,535,429,12.3,22.1,-51,-1.2,41.8,0,54,54,376
2000,02,g) 6 to 10,2258,2363,18314,18505,102,4.2,280,11.4,3431,1006,2425,5.4,18.5,3812,1478,2334,8,20.6,-381,-2.1,37,0,180,180,944
2000,02,h) 11 to 15,1652,1807,24605,24613,43,2.3,188,10,3120,407,2713,1.7,12.7,3135,1172,1963,4.8,12.7,-15,0,25.4,0,108,108,736
2000,02,i) 16 to 20,1365,1626,20348,19823,44,2.6,134,8,3500,367,3133,1.9,17.7,2450,786,1664,4,12.4,1050,5.3,24.8,0,68,68,438
2000,02,j) 21 to 25,690,1039,16322,15944,36,3.4,63,6,2578,580,1998,3.6,16.2,1822,336,1486,2.1,11.4,756,4.8,22.8,0,28,28,110
2000,02,l) Left Censored,1572,3110,87326,87050,211,6.7,306,9.7,13620,5252,8368,6,15.6,13068,6855,6213,7.9,15,552,0.6,30,0,39,39,506
2000,04,a) 0,9203,9266,65743,33005,9184,198.2,0,0,65476,65476,0,198.4,198.4,0,0,0,0,0,65476,198.4,0,0,,,
2000,04,b) 1,7375,7528,79904,78217,93,1.1,2193,25.4,21627,2350,19277,3,27.6,18252,10510,7742,13.4,23.3,3375,4.3,46.6,0,1613,1613,8224
2000,04,c) 2,6201,6463,70956,70943,288,4.1,1335,19.1,17691,3831,13860,5.4,24.9,17665,7797,9868,11,24.9,26,0,49.8,0,1013,1013,6229
2000,04,d) 3,5237,5432,58065,57630,216,3.7,1094,18.6,14535,2332,12203,4,25.2,13664,6947,6717,12.1,23.7,871,1.5,47.4,0,809,809,4914
2000,04,e) 4,4587,4729,44399,46380,156,3.1,763,15.2,7601,1084,6517,2.3,16.4,11563,5510,6053,11.9,24.9,-3962,-8.5,32.8,0,567,567,3617
2000,04,f) 5,4044,4357,54276,53582,230,5.1,615,13.5,10781,1706,9075,3.2,20.1,9393,4587,4806,8.6,17.5,1388,2.6,35,0,464,464,3733
2000,04,g) 6 to 10,13833,14801,204381,206967,478,3.1,1905,12.3,33131,4927,28204,2.4,16,38302,15311,22991,7.4,18.5,-5171,-2.5,32,0,1329,1329,8876
2000,04,h) 11 to 15,9884,11580,198922,199703,441,3.7,1183,9.9,28777,8678,20099,4.3,14.4,30339,11019,19320,5.5,15.2,-1562,-0.8,28.8,0,722,722,4718
2000,04,i) 16 to 20,6832,8729,160313,159026,331,3.7,708,7.9,23481,5995,17486,3.8,14.8,20907,7229,13678,4.5,13.1,2574,1.7,26.2,0,408,408,3246
2000,04,j) 21 to 25,3076,4793,126690,126597,240,4.9,370,7.6,18660,5217,13443,4.1,14.7,18475,5327,13148,4.2,14.6,185,0.1,29.2,0,165,165,2347
2000,04,l) Left Censored,7719,21309,826367,814984,2049,9.7,1812,8.6,139462,52669,86793,6.5,17.1,116697,36461,80236,4.5,14.3,22765,2.8,28.6,0,269,269,3195
2000,05,a) 0,4315,4347,27644,13864,4318,198.7,0,0,27561,27561,0,198.8,198.8,0,0,0,0,0,27561,198.8,0,0,,,
2000,05,b) 1,3486,3566,25865,26250,52,1.3,1094,26.6,7058,1405,5653,5.4,26.9,7828,4568,3260,17.4,29.8,-770,-2.9,53.8,0,824,824,3225
2000,05,c) 2,2913,3074,28035,28618,125,3.7,704,20.9,6704,2205,4499,7.7,23.4,7869,3332,4537,11.6,27.5,-1165,-4.1,46.8,0,534,534,2503
2000,05,d) 3,2558,2587,23457,23347,71,2.5,484,17.3,5025,1752,3273,7.5,21.5,4805,2257,2548,9.7,20.6,220,0.9,41.2,0,356,356,1754
2000,05,e) 4,2210,2302,21228,21291,61,2.5,398,16.1,3711,284,3427,1.3,17.4,3836,2225,1611,10.5,18,-125,-0.6,34.8,0,289,289,1664
2000,05,f) 5,2175,2265,20920,21046,75,3.1,326,13.6,3476,469,3007,2.2,16.5,3727,1730,1997,8.2,17.7,-251,-1.2,33,0,239,239,1199
2000,05,g) 6 to 10,7852,8287,80223,81101,219,2.5,1010,11.7,12812,1770,11042,2.2,15.8,14567,6726,7841,8.3,18,-1755,-2.2,31.6,0,700,700,4754
2000,05,h) 11 to 15,5346,6009,87656,87929,175,2.8,548,8.8,11296,2190,9106,2.5,12.8,11841,4055,7786,4.6,13.5,-545,-0.7,25.6,0,357,357,2132
2000,05,i) 16 to 20,4477,5180,77964,76573,108,2,395,7.4,11621,1870,9751,2.4,15.2,8838,2786,6052,3.6,11.5,2783,3.7,23,0,227,227,1937
2000,05,j) 21 to 25,2464,3300,71694,70664,117,3.5,264,7.8,8776,1685,7091,2.4,12.4,6716,1821,4895,2.6,9.5,2060,2.9,19,0,142,142,819
2000,05,l) Left Censored,7157,14553,520659,515629,851,5.8,1040,7.1,58711,14382,44329,2.8,11.4,48651,15207,33444,2.9,9.4,10060,2,18.8,0,274,274,1634
2000,06,a) 0,61075,61602,434346,218063,61105,198.4,0,0,432566,432566,0,198.4,198.4,0,0,0,0,0,432566,198.4,0,0,,,
2000,06,b) 1,47091,48156,450995,429649,628,1.1,12876,23.6,153638,15523,138115,3.6,35.8,110945,61613,49332,14.3,25.8,42693,10,51.6,0,9437,9437,48626
2000,06,c) 2,40510,42289,462391,453948,2035,4.5,8010,17.7,126338,30895,95443,6.8,27.8,109451,54391,55060,12,24.1,16887,3.7,48.2,0,5957,5957,42958
2000,06,d) 3,33882,34697,378694,375258,1235,3.3,6054,16.3,85546,9723,75823,2.6,22.8,78673,42095,36578,11.2,21,6873,1.8,42,0,4499,4499,33766
2000,06,e) 4,29841,30584,324572,325669,1066,3.3,4920,15.1,65993,6745,59248,2.1,20.3,68187,33378,34809,10.2,20.9,-2194,-0.6,40.6,0,3618,3618,24666
2000,06,f) 5,25894,26990,314141,318129,953,3.4,3856,13.6,62481,6813,55668,2.1,19.6,70457,30358,40099,9.5,22.1,-7976,-2.5,39.2,0,2805,2805,22554
2000,06,g) 6 to 10,98119,104685,1302411,1319103,3784,3.5,12592,11.6,220135,36841,183294,2.8,16.7,253518,103632,149886,7.9,19.2,-33383,-2.5,33.4,0,8742,8742,67086
2000,06,h) 11 to 15,78482,89446,1446701,1441107,3641,4,8520,9.3,228900,58545,170355,4.1,15.9,217714,78327,139387,5.4,15.1,11186,0.8,30.2,0,5204,5204,39013
2000,06,i) 16 to 20,55946,68001,1208220,1209030,2236,3.2,5421,7.8,181717,46813,134904,3.9,15,183337,73506,109831,6.1,15.2,-1620,-0.2,30,0,3096,3096,28166
2000,06,j) 21 to 25,27731,40942,955528,944846,1607,3.8,3246,7.8,130398,32690,97708,3.5,13.8,109033,34590,74443,3.7,11.5,21365,2.3,23,0,1504,1504,10179
2000,06,l) Left Censored,63480,146411,5349868,5331297,9209,6.2,12341,8.3,753592,220626,532966,4.1,14.1,716450,262315,454135,4.9,13.4,37142,0.7,26.8,0,2977,2977,24371
2000,08,a) 0,11419,11496,64513,32381,11405,198.4,0,0,64264,64264,0,198.5,198.5,0,0,0,0,0,64264,198.5,0,0,,,
2000,08,b) 1,8842,9026,68011,67826,133,1.3,2491,24.2,21773,3288,18485,4.8,32.1,21402,10441,10961,15.4,31.6,371,0.5,63.2,0,1809,1809,7934
2000,08,c) 2,7744,7945,62540,62782,342,4,1607,18.7,16039,4855,11184,7.7,25.5,16522,8557,7965,13.6,26.3,-483,-0.8,51,0,1197,1197,6790
2000,08,d) 3,6427,6581,57131,57828,247,3.5,1139,16.2,11448,1480,9968,2.6,19.8,12842,6444,6398,11.1,22.2,-1394,-2.4,39.6,0,818,818,5020
2000,08,e) 4,5567,5702,50166,50085,170,2.8,897,14.8,9379,851,8528,1.7,18.7,9216,4365,4851,8.7,18.4,163,0.3,36.8,0,645,645,3230
2000,08,f) 5,5015,5196,48123,49031,185,3.4,783,14.3,8243,1537,6706,3.1,16.8,10058,4223,5835,8.6,20.5,-1815,-3.7,33.6,0,551,551,3052
2000,08,g) 6 to 10,17709,18638,199729,201299,573,2.9,2210,11.4,32452,6113,26339,3,16.1,35592,15784,19808,7.8,17.7,-3140,-1.6,32.2,0,1493,1493,10242
2000,08,h) 11 to 15,11300,12877,200737,202051,500,3.8,1155,8.7,27352,6558,20794,3.2,13.5,29981,10246,19735,5.1,14.8,-2629,-1.3,27,0,692,692,5278
2000,08,i) 16 to 20,8124,9997,185722,185730,345,3.4,860,8.4,24949,6418,18531,3.5,13.4,24964,9995,14969,5.4,13.4,-15,0,26.8,0,470,470,2900
2000,08,j) 21 to 25,4059,5961,128013,128199,271,4.4,532,8.7,18909,6639,12270,5.2,14.7,19280,5536,13744,4.3,15,-371,-0.3,29.4,0,190,190,1269
2000,08,l) Left Censored,10329,23303,812535,796970,1815,7.8,1996,8.5,127126,39943,87183,5,16,95996,32575,63421,4.1,12,31130,4,24,0,374,374,3591
2000,09,a) 0,5230,5250,32464,16330,5203,198.2,0,0,32269,32269,0,197.6,197.6,0,0,0,0,0,32269,197.6,0,0,,,
2000,09,b) 1,4254,4307,36058,33954,57,1.2,1004,20.9,11267,1178,10089,3.5,33.2,7058,3338,3720,9.8,20.8,4209,12.4,41.6,0,757,757,2690
2000,09,c) 2,4010,4165,37930,37827,172,3.9,688,15.6,8449,2336,6113,6.2,22.3,8242,3289,4953,8.7,21.8,207,0.5,43.6,0,535,535,2678
2000,09,d) 3,3330,3390,27538,27897,115,3.2,525,14.6,5179,701,4478,2.5,18.6,5896,2760,3136,9.9,21.1,-717,-2.5,37.2,0,394,394,2146
2000,09,e) 4,3045,3129,34025,33891,92,2.8,415,12.6,5084,550,4534,1.6,15,4815,2351,2464,6.9,14.2,269,0.8,28.4,0,317,317,1751
2000,09,f) 5,2912,2996,27534,28321,69,2.2,386,12.2,5086,309,4777,1.1,18,6659,3810,2849,13.5,23.5,-1573,-5.5,36,0,267,267,1277
2000,09,g) 6 to 10,11290,11678,126223,126276,298,2.5,1162,9.6,18392,2508,15884,2,14.6,18497,6992,11505,5.5,14.6,-105,0,29.2,0,862,862,4421
2000,09,h) 11 to 15,10385,11281,141556,143541,372,3.2,972,8.4,19111,4369,14742,3,13.3,23080,10567,12513,7.4,16.1,-3969,-2.8,26.6,0,605,605,3462
2000,09,i) 16 to 20,6878,7824,107679,108536,198,2.5,632,7.9,12545,2080,10465,1.9,11.6,14259,5865,8394,5.4,13.1,-1714,-1.5,23.2,0,347,347,2522
2000,09,j) 21 to 25,3546,4709,88917,88560,136,2.8,331,6.9,13196,3843,9353,4.3,14.9,12482,3762,8720,4.2,14.1,714,0.8,28.2,0,161,161,1174
2000,09,l) Left Censored,13843,23485,876355,882865,1157,4.9,1737,7.3,90824,25468,65356,2.9,10.3,103843,31102,72741,3.5,11.8,-13019,-1.5,20.6,0,530,530,3663
2000,10,a) 0,1835,1842,9972,5040,1830,198.7,0,0,9864,9864,0,195.7,195.7,0,0,0,0,0,9864,195.7,0,0,,,
2000,10,b) 1,1392,1398,9597,9484,10,0.6,327,20.9,2538,72,2466,0.8,26.8,2312,1596,716,16.8,24.4,226,2.4,48.8,0,231,231,1182
2000,10,c) 2,1203,1231,9866,9535,40,3,227,17.1,2873,823,2050,8.6,30.1,2211,1228,983,12.9,23.2,662,6.9,46.4,0,164,164,842
2000,10,d) 3,953,969,7116,7396,25,2.4,159,15.4,1239,54,1185,0.7,16.8,1798,1160,638,15.7,24.3,-559,-7.5,33.6,0,129,129,849
2000,10,e) 4,834,862,8354,8365,21,2.3,113,12.4,991,94,897,1.1,11.8,1013,506,507,6,12.1,-22,-0.3,23.6,0,86,86,451
2000,10,f) 5,815,840,7776,7710,31,3.6,96,11,1261,183,1078,2.4,16.4,1129,522,607,6.8,14.6,132,1.8,29.2,0,69,69,385
2000,10,g) 6 to 10,2795,2907,29245,29143,75,2.5,322,10.6,4819,452,4367,1.6,16.5,4614,2437,2177,8.4,15.8,205,0.7,31.6,0,231,231,1430
2000,10,h) 11 to 15,2024,2198,29013,29460,74,3.3,215,9.5,3957,911,3046,3.1,13.4,4850,2314,2536,7.9,16.5,-893,-3.1,26.8,0,124,124,864
2000,10,i) 16 to 20,1347,1551,24831,25161,46,2.9,115,7.3,3016,687,2329,2.7,12,3676,1110,2566,4.4,14.6,-660,-2.6,24,0,72,72,312
2000,10,j) 21 to 25,761,1025,32845,33038,39,3.7,92,8.7,3281,679,2602,2.1,9.9,3667,1387,2280,4.2,11.1,-386,-1.2,19.8,0,34,34,166
2000,10,l) Left Censored,3070,5661,200437,194474,494,8.7,481,8.5,37057,18801,18256,9.7,19.1,25130,7321,17809,3.8,12.9,11927,6.2,25.8,0,73,73,559
2000,11,a) 0,1016,1020,7353,3683,1013,198.6,0,0,7341,7341,0,199.3,199.3,0,0,0,0,0,7341,199.3,0,0,,,
2000,11,b) 1,838,854,9702,9284,30,3.2,195,20.6,3457,1326,2131,14.3,37.2,2620,1484,1136,16,28.2,837,9,56.4,0,130,130,1099
2000,11,c) 2,796,812,7738,8193,50,5.9,119,14,1744,574,1170,7,21.3,2653,1652,1001,20.2,32.4,-909,-11.1,42.6,0,92,92,1211
2000,11,d) 3,722,741,7775,7975,23,2.9,110,14.1,1223,233,990,2.9,15.3,1622,540,1082,6.8,20.3,-399,-5,30.6,0,78,78,389
2000,11,e) 4,627,634,6633,6553,21,3.2,81,12.2,1963,396,1567,6,30,1803,773,1030,11.8,27.5,160,2.5,55,0,57,57,613
2000,11,f) 5,557,573,6766,7078,19,3.1,87,14.3,1070,142,928,2,15.1,1693,335,1358,4.7,23.9,-623,-8.8,30.2,0,59,59,237
2000,11,g) 6 to 10,2305,2415,34669,34572,66,2.6,245,9.8,4995,712,4283,2.1,14.4,4800,1809,2991,5.2,13.9,195,0.5,27.8,0,160,160,770
2000,11,h) 11 to 15,1885,2120,36498,36060,103,4.8,196,9,5570,1946,3624,5.4,15.4,4693,1469,3224,4.1,13,877,2.4,26,0,109,109,741
2000,11,i) 16 to 20,1571,1774,31633,31817,51,2.8,131,7.2,3337,658,2679,2.1,10.5,3705,1139,2566,3.6,11.6,-368,-1.1,21,0,68,68,401
2000,11,j) 21 to 25,873,1155,47632,49183,36,3.1,62,5.3,3774,579,3195,1.2,7.7,6877,605,6272,1.2,14,-3103,-6.3,15.4,0,17,17,95
2000,11,l) Left Censored,3557,5870,225164,220096,365,6.2,423,7.2,29276,9212,20064,4.2,13.3,19141,4668,14473,2.1,8.7,10135,4.6,17.4,0,89,89,592
2000,12,a) 0,35581,35824,192862,96970,35526,198.3,0,0,191785,191785,0,197.8,197.8,0,0,0,0,0,191785,197.8,0,0,,,
2000,12,b) 1,27628,28299,208302,204206,338,1,9055,27.5,69608,15308,54300,7.5,34.1,61415,36598,24817,17.9,30.1,8193,4,60.2,0,6871,6871,29050
2000,12,c) 2,23177,23862,197262,197800,1015,3.9,5452,20.9,51983,10081,41902,5.1,26.3,53059,27786,25273,14,26.8,-1076,-0.5,52.6,0,4201,4201,22517
2000,12,d) 3,19262,19646,192999,195645,674,3.2,3932,18.5,39437,4993,34444,2.6,20.2,44729,26567,18162,13.6,22.9,-5292,-2.7,40.4,0,2996,2996,21212
2000,12,e) 4,17103,17586,164411,162934,549,2.9,2951,15.7,34972,6423,28549,3.9,21.5,32018,16569,15449,10.2,19.7,2954,1.8,39.4,0,2198,2198,12446
2000,12,f) 5,15256,15663,162636,157174,504,3,2573,15.4,43222,4099,39123,2.6,27.5,32297,16237,16060,10.3,20.5,10925,7,41,0,1847,1847,11264
2000,12,g) 6 to 10,57798,61043,737212,724711,1849,2.9,7935,12.4,173803,38922,134881,5.4,24,148800,82389,66411,11.4,20.5,25003,3.5,41,0,5526,5526,60581
2000,12,h) 11 to 15,38652,44228,768357,774051,1533,3.4,4565,10,122359,28303,94056,3.7,15.8,133748,46713,87035,6,17.3,-11389,-1.5,31.6,0,2801,2801,19899
2000,12,i) 16 to 20,24422,29249,453666,457689,942,3.1,2638,8.8,63392,13612,49780,3,13.9,71439,32717,38722,7.1,15.6,-8047,-1.7,27.8,0,1466,1466,9746
2000,12,j) 21 to 25,11046,17437,354317,348603,788,4.4,1370,7.7,57273,19403,37870,5.6,16.4,45844,16933,28911,4.9,13.2,11429,3.2,26.4,0,625,625,4497
2000,12,l) Left Censored,26991,76215,2726715,2702304,5757,7.5,7048,9.2,406027,151293,254734,5.6,15,357206,130696,226510,4.8,13.2,48821,1.8,26.4,0,1292,1292,11239
2000,13,a) 0,15676,15759,99275,49822,15641,198.5,0,0,98907,98907,0,198.5,198.5,0,0,0,0,0,98907,198.5,0,0,,,
2000,13,b) 1,12277,12480,120787,119900,142,1,3755,26.1,33605,4448,29157,3.7,28,31831,17516,14315,14.6,26.5,1774,1.5,53,0,2806,2806,13832
2000,13,c) 2,10746,11090,104041,105360,484,4,2309,19.2,24844,5013,19831,4.8,23.6,27482,12963,14519,12.3,26.1,-2638,-2.5,47.2,0,1738,1738,9635
2000,13,d) 3,8757,8983,82113,83659,298,3.1,1751,18,19087,3540,15547,4.2,22.8,22179,13328,8851,15.9,26.5,-3092,-3.7,45.6,0,1292,1292,8441
2000,13,e) 4,7676,7875,73839,75348,253,3,1354,16.1,14241,2012,12229,2.7,18.9,17258,9298,7960,12.3,22.9,-3017,-4,37.8,0,920,920,6646
2000,13,f) 5,6731,7066,79078,79482,238,3.2,1062,14.2,15883,2632,13251,3.3,20,16691,7269,9422,9.1,21,-808,-1,40,0,766,766,5174
2000,13,g) 6 to 10,23787,25323,309259,313303,842,3.2,3074,11.6,50125,7808,42317,2.5,16,58212,23938,34274,7.6,18.6,-8087,-2.6,32,0,2086,2086,14273
2000,13,h) 11 to 15,16746,19618,340314,336992,844,4.2,1987,9.9,55079,13161,41918,3.9,16.3,48436,19936,28500,5.9,14.4,6643,1.9,28.8,0,1163,1163,9262
2000,13,i) 16 to 20,11403,13919,227757,227633,412,2.9,1081,7.6,31932,7686,24246,3.4,14,31684,12191,19493,5.4,13.9,248,0.1,27.8,0,612,612,4060
2000,13,j) 21 to 25,5707,8766,209989,209338,465,5.2,729,8.2,32900,12932,19968,6.2,15.7,31597,7951,23646,3.8,15.1,1303,0.6,30.2,0,309,309,2390
2000,13,l) Left Censored,17043,44263,1762220,1754913,3382,7.6,3581,8.1,246643,81779,164864,4.7,14.1,232029,90898,141131,5.2,13.2,14614,0.9,26.4,0,716,716,6460
2000,15,a) 0,1845,1872,11876,5960,1852,197.9,0,0,11832,11832,0,198.5,198.5,0,0,0,0,0,11832,198.5,0,0,,,
2000,15,b) 1,1345,1389,10843,10949,29,1.9,328,21.1,2939,537,2402,4.9,26.8,3150,1985,1165,18.1,28.8,-211,-2,53.6,0,256,256,1307
2000,15,c) 2,1255,1297,13535,13897,54,3.9,240,17.3,2566,468,2098,3.4,18.5,3289,1596,1693,11.5,23.7,-723,-5.2,37,0,179,179,991
2000,15,d) 3,1088,1101,9302,9251,33,2.8,168,14.4,1749,187,1562,2,18.9,1646,994,652,10.7,17.8,103,1.1,35.6,0,138,138,839
2000,15,e) 4,1014,1053,9878,9754,25,2.2,161,14.4,1850,178,1672,1.8,19,1602,882,720,9,16.4,248,2.6,32.8,0,114,114,598
2000,15,f) 5,878,900,9264,9313,29,3.1,111,11.8,1310,118,1192,1.3,14.1,1407,648,759,7,15.1,-97,-1,28.2,0,81,81,408
2000,15,g) 6 to 10,3550,3823,45682,45880,126,3.2,417,10.5,6402,1237,5165,2.7,14,6799,3723,3076,8.1,14.8,-397,-0.8,28,0,288,288,2149
2000,15,h) 11 to 15,2939,3410,43828,44036,105,3,292,8.3,4921,863,4058,2,11.2,5337,1747,3590,4,12.1,-416,-0.9,22.4,0,174,174,972
2000,15,i) 16 to 20,2329,2818,34635,34108,83,2.9,199,6.9,5054,2024,3030,5.9,14.8,4000,1570,2430,4.6,11.7,1054,3.1,23.4,0,117,117,584
2000,15,j) 21 to 25,1314,1880,33123,32723,32,1.7,80,4.2,3425,914,2511,2.8,10.5,2624,725,1899,2.2,8,801,2.5,16,0,30,30,147
2000,15,l) Left Censored,3835,7238,207515,205865,301,4.1,511,7,20956,5233,15723,2.5,10.2,17656,6810,10846,3.3,8.6,3300,1.6,17.2,0,124,124,565
2000,16,a) 0,2992,3033,17881,9002,3005,198.2,0,0,17758,17758,0,197.3,197.3,0,0,0,0,0,17758,197.3,0,0,,,
2000,16,b) 1,2360,2390,16556,16515,25,0.9,717,26.1,4651,688,3963,4.2,28.2,4568,2644,1924,16,27.7,83,0.5,55.4,0,530,530,2109
2000,16,c) 2,1990,2072,18013,18705,97,4.3,442,19.7,4428,820,3608,4.4,23.7,5811,2230,3581,11.9,31.1,-1383,-7.4,47.4,0,318,318,1522
2000,16,d) 3,1785,1834,14042,14059,55,2.8,348,17.5,2991,229,2762,1.6,21.3,3025,1638,1387,11.7,21.5,-34,-0.2,42.6,0,230,230,1170
2000,16,e) 4,1577,1628,12294,12529,65,3.8,215,12.6,2158,338,1820,2.7,17.2,2628,1342,1286,10.7,21,-470,-3.8,34.4,0,158,158,1046
2000,16,f) 5,1354,1377,9621,9716,49,3.4,191,13.2,1634,210,1424,2.2,16.8,1823,821,1002,8.4,18.8,-189,-2,33.6,0,138,138,644
2000,16,g) 6 to 10,4784,5010,43989,44246,180,3.4,643,12.3,7497,1792,5705,4.1,16.9,8010,3660,4350,8.3,18.1,-513,-1.2,33.8,0,430,430,2564
2000,16,h) 11 to 15,3018,3395,50533,49880,103,2.9,326,9.3,8479,2141,6338,4.3,17,7173,2499,4674,5,14.4,1306,2.6,28.8,0,197,197,1224
2000,16,i) 16 to 20,2158,2596,34449,34230,77,2.9,229,8.6,5328,1067,4261,3.1,15.6,4889,1621,3268,4.7,14.3,439,1.3,28.6,0,131,131,852
2000,16,j) 21 to 25,1277,1719,38478,38400,68,3.9,135,7.7,3445,1172,2273,3.1,9,3289,1055,2234,2.7,8.6,156,0.4,17.2,0,60,60,434
2000,16,l) Left Censored,3525,6926,186395,188168,403,5.8,533,7.6,21528,7501,14027,4,11.4,25073,6669,18404,3.5,13.3,-3545,-1.9,22.8,0,124,124,776
2000,17,a) 0,18823,18968,122355,61401,18814,198.4,0,0,121908,121908,0,198.5,198.5,0,0,0,0,0,121908,198.5,0,0,,,
2000,17,b) 1,15437,15755,133990,130911,210,1.2,3854,21.8,43123,8063,35060,6.2,32.9,36965,16936,20029,12.9,28.2,6158,4.7,56.4,0,2818,2818,12858
2000,17,c) 2,13927,14440,140973,138067,620,4,2390,15.6,38311,8296,30015,6,27.7,32499,15786,16713,11.4,23.5,5812,4.2,47,0,1801,1801,12937
2000,17,d) 3,12229,12766,108459,109823,411,3,1907,14.1,23919,3807,20112,3.5,21.8,26647,15454,11193,14.1,24.3,-2728,-2.5,43.6,0,1405,1405,13241
2000,17,e) 4,10957,11113,104902,104459,322,2.7,1621,13.8,20724,1846,18878,1.8,19.8,19838,9319,10519,8.9,19,886,0.8,38,0,1185,1185,7335
2000,17,f) 5,10122,10461,105873,105737,296,2.7,1334,12.1,18693,2026,16667,1.9,17.7,18420,7821,10599,7.4,17.4,273,0.3,34.8,0,969,969,5566
2000,17,g) 6 to 10,38483,40461,479265,482527,1005,2.4,4299,10.2,74640,11188,63452,2.3,15.5,81165,34570,46595,7.2,16.8,-6525,-1.3,31,0,3039,3039,22346
2000,17,h) 11 to 15,29364,33165,529411,530258,993,2.9,2731,8,69085,15068,54017,2.8,13,70779,22115,48664,4.2,13.3,-1694,-0.3,26,0,1744,1744,11612
2000,17,i) 16 to 20,21312,24673,451091,449702,610,2.4,1747,6.9,54437,9939,44498,2.2,12.1,51658,17545,34113,3.9,11.5,2779,0.6,23,0,1045,1045,8469
2000,17,j) 21 to 25,11049,15571,321122,321421,513,3.2,1091,6.9,40586,9075,31511,2.8,12.6,41184,13725,27459,4.3,12.8,-598,-0.2,25.2,0,538,538,3389
2000,17,l) Left Censored,38464,74963,2909171,2902056,4463,5.9,5989,7.9,370556,108679,261877,3.7,12.8,356327,123156,233171,4.2,12.3,14229,0.5,24.6,0,1555,1555,12305
2000,18,a) 0,8669,8750,58932,29572,8676,198.3,0,0,58720,58720,0,198.6,198.6,0,0,0,0,0,58720,198.6,0,0,,,
2000,18,b) 1,7058,7202,59746,59494,90,1.1,1950,23.8,16396,3215,13181,5.4,27.6,15891,8810,7081,14.8,26.7,505,0.9,53.4,0,1518,1518,6890
2000,18,c) 2,6510,6927,73912,71807,356,4.8,1296,17.5,20521,7521,13000,10.5,28.6,16311,6425,9886,8.9,22.7,4210,5.9,45.4,0,988,988,5109
2000,18,d) 3,5585,5779,48247,48450,163,2.6,989,16,9409,1255,8154,2.6,19.4,9814,4989,4825,10.3,20.3,-405,-0.9,38.8,0,776,776,3794
2000,18,e) 4,5044,5173,54655,54698,118,2.2,752,13.7,8743,769,7974,1.4,16,8828,4373,4455,8,16.1,-85,-0.1,32,0,571,571,3340
2000,18,f) 5,4601,4796,44659,45452,141,2.8,665,13.2,6564,842,5722,1.9,14.4,8150,4356,3794,9.6,17.9,-1586,-3.5,28.8,0,482,482,3434
2000,18,g) 6 to 10,18074,19319,215841,217669,467,2.3,2005,10,31047,4072,26975,1.9,14.3,34703,13999,20704,6.4,15.9,-3656,-1.6,28.6,0,1398,1398,9328
2000,18,h) 11 to 15,13280,15574,252311,252916,414,2.6,1298,8.1,29030,4771,24259,1.9,11.5,30240,10663,19577,4.2,12,-1210,-0.5,23,0,846,846,5780
2000,18,i) 16 to 20,9998,11795,190398,190468,263,2.2,790,6.6,22199,3047,19152,1.6,11.7,22338,6776,15562,3.6,11.7,-139,0,23.4,0,479,479,2994
2000,18,j) 21 to 25,5193,7453,166756,165311,231,3,581,7.6,21690,4991,16699,3,13.1,18800,7115,11685,4.3,11.4,2890,1.7,22.8,0,260,260,1660
2000,18,l) Left Censored,18568,39135,1464198,1454663,2112,5.3,2988,7.6,173651,51203,122448,3.5,11.9,154583,50181,104402,3.4,10.6,19068,1.3,21.2,0,725,725,10458
2000,19,a) 0,4428,4450,28232,14218,4411,198.2,0,0,28028,28028,0,197.1,197.1,0,0,0,0,0,28028,197.1,0,0,,,
2000,19,b) 1,3534,3605,60499,45903,56,1.4,923,22.7,36709,1731,34978,3.8,80,7517,3695,3822,8,16.4,29192,63.6,32.8,0,699,699,2907
2000,19,c) 2,3282,3423,27786,28257,140,3.8,596,16.4,5922,1706,4216,6,21,6864,3181,3683,11.3,24.3,-942,-3.3,42,0,452,452,2697
2000,19,d) 3,2861,2974,25223,25122,91,2.9,432,13.7,4771,1254,3517,5,19,4569,2029,2540,8.1,18.2,202,0.8,36.4,0,341,341,1512
2000,19,e) 4,2636,2699,23148,23213,62,2.2,381,13.3,3614,267,3347,1.2,15.6,3743,1726,2017,7.4,16.1,-129,-0.5,31.2,0,280,280,1272
2000,19,f) 5,2478,2580,21636,22298,61,2.2,345,12.7,3384,400,2984,1.8,15.2,4707,2696,2011,12.1,21.1,-1323,-5.9,30.4,0,264,264,2324
2000,19,g) 6 to 10,9379,9849,90627,91382,241,2.4,1014,9.9,13488,3471,10017,3.8,14.8,14998,5610,9388,6.1,16.4,-1510,-1.6,29.6,0,713,713,3674
2000,19,h) 11 to 15,6982,7975,131261,131272,215,2.6,646,7.9,13556,1911,11645,1.5,10.3,13578,5314,8264,4,10.3,-22,0,20.6,0,427,427,2413
2000,19,i) 16 to 20,6030,7190,94071,92667,154,2.1,484,6.6,12630,3249,9381,3.5,13.6,9822,3285,6537,3.5,10.6,2808,3,21.2,0,298,298,1591
2000,19,j) 21 to 25,3499,5295,81482,81259,126,2.4,263,4.9,8377,2057,6320,2.5,10.3,7931,2584,5347,3.2,9.8,446,0.5,19.6,0,154,154,1258
2000,19,l) Left Censored,12615,22589,703885,701733,1030,4.5,1524,6.7,72781,20917,51864,3,10.4,68476,21323,47153,3,9.8,4305,0.6,19.6,0,460,460,2861
2000,20,a) 0,4746,4771,30225,15187,4729,198.2,0,0,30076,30076,0,198,198,0,0,0,0,0,30076,198,0,0,,,
2000,20,b) 1,3751,3817,31405,31922,68,1.6,1047,24.2,7435,1340,6095,4.2,23.3,8469,4712,3757,14.8,26.5,-1034,-3.2,46.6,0,796,796,3538
2000,20,c) 2,3428,3567,35041,35076,168,4.4,666,17.5,8086,2053,6033,5.9,23.1,8155,3473,4682,9.9,23.2,-69,-0.1,46.2,0,498,498,2857
2000,20,d) 3,2914,3003,27162,27430,129,4.1,480,15.1,4605,939,3666,3.4,16.8,5140,2516,2624,9.2,18.7,-535,-1.9,33.6,0,355,355,2024
2000,20,e) 4,2667,2724,21956,22310,76,2.7,375,13.1,4115,641,3474,2.9,18.4,4822,2257,2565,10.1,21.6,-707,-3.2,36.8,0,286,286,1608
2000,20,f) 5,2329,2403,20796,21408,68,2.7,366,14.3,3439,803,2636,3.8,16.1,4662,2515,2147,11.7,21.8,-1223,-5.7,32.2,0,277,277,1493
2000,20,g) 6 to 10,8648,9085,94191,94712,237,2.5,1043,11,13472,2251,11221,2.4,14.2,14513,6185,8328,6.5,15.3,-1041,-1.1,28.4,0,711,711,4359
2000,20,h) 11 to 15,6518,7337,94666,95588,209,2.8,669,8.8,11487,2766,8721,2.9,12,13330,4697,8633,4.9,13.9,-1843,-1.9,24,0,436,436,2345
2000,20,i) 16 to 20,5504,6318,86542,86583,155,2.4,479,7.4,11742,1917,9825,2.2,13.6,11824,4117,7707,4.8,13.7,-82,-0.1,27.2,0,276,276,1524
2000,20,j) 21 to 25,2878,4258,67545,67836,232,5.4,298,6.9,9273,3550,5723,5.2,13.7,9855,3234,6621,4.8,14.5,-582,-0.8,27.4,0,148,148,779
2000,20,l) Left Censored,10209,19248,604558,604881,1012,5.2,1403,7.2,73251,25540,47711,4.2,12.1,73898,23549,50349,3.9,12.2,-647,-0.1,24.2,0,381,381,2593
2000,21,a) 0,5660,5696,37629,18885,5661,198.8,0,0,37489,37489,0,198.5,198.5,0,0,0,0,0,37489,198.5,0,0,,,
2000,21,b) 1,4639,4748,44149,43083,70,1.3,1293,24,14660,2381,12279,5.5,34,12528,7204,5324,16.7,29.1,2132,4.9,58.2,0,1011,1011,6131
2000,21,c) 2,4271,4482,39513,40294,216,4.5,806,16.9,9171,3385,5786,8.4,22.8,10732,4879,5853,12.1,26.6,-1561,-3.8,45.6,0,652,652,4037
2000,21,d) 3,3532,3645,30945,31404,113,2.9,621,15.9,5699,667,5032,2.1,18.1,6617,3462,3155,11,21.1,-918,-3,36.2,0,503,503,3088
2000,21,e) 4,3089,3206,31621,32186,101,3,479,14.1,5679,1806,3873,5.6,17.6,6808,3403,3405,10.6,21.2,-1129,-3.6,35.2,0,359,359,2554
2000,21,f) 5,2925,3057,30293,30608,71,2.2,456,14,4675,636,4039,2.1,15.3,5304,2315,2989,7.6,17.3,-629,-2,30.6,0,337,337,1676
2000,21,g) 6 to 10,11059,11730,122784,123722,282,2.3,1283,10.5,20209,3536,16673,2.9,16.3,22084,8997,13087,7.3,17.8,-1875,-1.5,32.6,0,938,938,6509
2000,21,h) 11 to 15,8364,9520,153689,152291,266,2.7,807,8.2,21181,4601,16580,3,13.9,18385,7221,11164,4.7,12.1,2796,1.8,24.2,0,512,512,4029
2000,21,i) 16 to 20,6205,7068,110070,109393,167,2.3,513,7.1,14270,2371,11899,2.2,13,12916,4836,8080,4.4,11.8,1354,1.2,23.6,0,307,307,2663
2000,21,j) 21 to 25,3132,4592,102104,102028,158,3.4,344,7.3,13226,4676,8550,4.6,13,13074,4429,8645,4.3,12.8,152,0.2,25.6,0,154,154,1206
2000,21,l) Left Censored,11062,23452,809393,801587,1402,5.9,1686,7.2,93343,29535,63808,3.7,11.6,77730,22475,55255,2.8,9.7,15613,1.9,19.4,0,471,471,2957
2000,22,a) 0,6273,6366,52236,26243,6310,198.2,0,0,51987,51987,0,198.1,198.1,0,0,0,0,0,51987,198.1,0,0,,,
2000,22,b) 1,4964,5062,44697,45416,71,1.2,1513,26,11234,1527,9707,3.4,24.7,12672,7176,5496,15.8,27.9,-1438,-3.2,49.4,0,1161,1161,5708
2000,22,c) 2,4651,4899,47857,48859,182,3.4,958,18.1,11311,3681,7630,7.5,23.2,13314,5724,7590,11.7,27.2,-2003,-4,46.4,0,763,763,4491
2000,22,d) 3,3985,4059,39696,41559,126,2.9,764,17.5,5981,672,5309,1.6,14.4,9707,4992,4715,12,23.4,-3726,-9,28.8,0,557,557,3948
2000,22,e) 4,3499,3560,34939,36005,87,2.3,584,15.3,5114,745,4369,2.1,14.2,7247,3306,3941,9.2,20.1,-2133,-5.9,28.4,0,426,426,2339
2000,22,f) 5,3178,3254,35314,36663,81,2.3,496,14.3,4708,775,3933,2.1,12.8,7406,3259,4147,8.9,20.2,-2698,-7.4,25.6,0,366,366,2421
2000,22,g) 6 to 10,12521,13263,153916,156937,317,2.3,1465,10.6,23983,2659,21324,1.7,15.3,30025,11420,18605,7.3,19.1,-6042,-3.8,30.6,0,1006,1006,7191
2000,22,h) 11 to 15,8693,9976,157934,155925,344,3.4,914,8.9,26353,9152,17201,5.9,16.9,22335,8416,13919,5.4,14.3,4018,2.6,28.6,0,560,560,4510
2000,22,i) 16 to 20,8160,9600,143622,145673,252,2.6,681,6.9,16365,2578,13787,1.8,11.2,20466,6259,14207,4.3,14,-4101,-2.8,22.4,0,372,372,2491
2000,22,j) 21 to 25,4050,5652,98064,99275,189,3.3,415,7.2,13301,4121,9180,4.2,13.4,15722,4270,11452,4.3,15.8,-2421,-2.4,26.8,0,168,168,1873
2000,22,l) Left Censored,11990,25216,760891,765953,1590,6.3,1856,7.3,95329,30809,64520,4,12.4,105452,36643,68809,4.8,13.8,-10123,-1.4,24.8,0,454,454,13343
2000,23,a) 0,2623,2644,16364,8198,2632,199.1,0,0,16333,16333,0,199.2,199.2,0,0,0,0,0,16333,199.2,0,0,,,
2000,23,b) 1,2195,2235,14531,14498,41,1.6,577,22.9,4001,664,3337,4.6,27.6,3934,2186,1748,15.1,27.1,67,0.5,54.2,0,409,409,1695
2000,23,c) 2,2004,2099,14213,14634,88,3.9,366,16.3,3277,1104,2173,7.5,22.4,4118,1799,2319,12.3,28.1,-841,-5.7,44.8,0,281,281,1577
2000,23,d) 3,1655,1681,10266,10387,47,2.6,249,14,1640,184,1456,1.8,15.8,1882,915,967,8.8,18.1,-242,-2.3,31.6,0,188,188,755
2000,23,e) 4,1496,1533,11483,11816,48,3,196,12.2,1780,190,1590,1.6,15.1,2445,1192,1253,10.1,20.7,-665,-5.6,30.2,0,136,136,793
2000,23,f) 5,1327,1352,10474,10145,44,3.1,192,13.5,2364,157,2207,1.5,23.3,1705,705,1000,6.9,16.8,659,6.5,33.6,0,158,158,553
2000,23,g) 6 to 10,4706,4905,42989,43211,129,2.5,476,9.4,6556,743,5813,1.7,15.2,7000,3049,3951,7.1,16.2,-444,-1,30.4,0,351,351,2233
2000,23,h) 11 to 15,4307,4676,52368,52003,153,3.2,355,7.4,6271,693,5578,1.3,12.1,5541,2051,3490,3.9,10.7,730,1.4,21.4,0,248,248,1546
2000,23,i) 16 to 20,2561,3004,45681,45613,90,2.9,198,6.5,4720,1253,3467,2.7,10.3,4583,1390,3193,3,10,137,0.3,20,0,122,122,602
2000,23,j) 21 to 25,1370,2063,36193,35446,89,4.2,156,7.4,5255,1999,3256,5.6,14.8,3761,1413,2348,4,10.6,1494,4.2,21.2,0,80,80,316
2000,23,l) Left Censored,4355,7641,230467,228843,355,4.6,479,6.2,24743,6620,18123,2.9,10.8,21495,6976,14519,3,9.4,3248,1.4,18.8,0,136,136,1020
2000,24,a) 0,8201,8262,47827,24137,8183,198.1,0,0,47381,47381,0,196.3,196.3,0,0,0,0,0,47381,196.3,0,0,,,
2000,24,b) 1,6879,7003,59267,56506,101,1.3,1652,21.1,19625,2942,16683,5.2,34.7,14103,7612,6491,13.5,25,5522,9.7,50,0,1227,1227,6146
2000,24,c) 2,6102,6329,66008,65146,278,4.1,1102,16.3,16783,4200,12583,6.4,25.8,15059,5211,9848,8,23.1,1724,2.7,46.2,0,822,822,3757
2000,24,d) 3,5327,5419,47181,47429,162,2.8,922,15.9,9883,1426,8457,3,20.8,10378,5136,5242,10.8,21.9,-495,-1.1,41.6,0,648,648,3438
2000,24,e) 4,4597,4666,40510,41163,129,2.6,703,14.2,6828,550,6278,1.3,16.6,8133,4041,4092,9.8,19.8,-1305,-3.2,33.2,0,522,522,3185
2000,24,f) 5,4343,4452,40567,40370,138,2.9,604,12.9,7774,936,6838,2.3,19.3,7379,3536,3843,8.8,18.3,395,1,36.6,0,433,433,2453
2000,24,g) 6 to 10,16271,17230,201044,200540,484,2.7,1855,10.4,33040,4342,28698,2.2,16.5,32032,13315,18717,6.6,16,1008,0.5,32,0,1238,1238,8379
2000,24,h) 11 to 15,12893,14382,216491,214658,460,3.1,1358,9.2,33420,8840,24580,4.1,15.6,29755,11456,18299,5.3,13.9,3665,1.7,27.8,0,818,818,5365
2000,24,i) 16 to 20,8155,9616,152536,150942,283,2.9,736,7.5,22601,5450,17151,3.6,15,19412,6977,12435,4.6,12.9,3189,2.1,25.8,0,399,399,2542
2000,24,j) 21 to 25,4075,5995,128248,128224,226,3.7,407,6.7,18162,5284,12878,4.1,14.2,18113,4715,13398,3.7,14.1,49,0.1,28.2,0,196,196,1512
2000,24,l) Left Censored,13812,29112,1029998,1021048,1855,6.3,2317,7.9,140247,43790,96457,4.3,13.7,122346,44455,77891,4.4,12,17901,1.7,24,0,557,557,5476
2000,25,a) 0,10366,10454,66936,33606,10351,198,0,0,66661,66661,0,198.4,198.4,0,0,0,0,0,66661,198.4,0,0,,,
2000,25,b) 1,8560,8705,74671,71003,127,1.3,2006,20.7,24595,3249,21346,4.6,34.6,17259,9718,7541,13.7,24.3,7336,10.3,48.6,0,1485,1485,7512
2000,25,c) 2,7861,8103,85086,79163,365,4.3,1323,15.4,28312,5534,22778,7,35.8,16466,7215,9251,9.1,20.8,11846,15,41.6,0,1014,1014,5938
2000,25,d) 3,6772,6868,62055,63421,208,2.9,1084,14.9,13575,1535,12040,2.4,21.4,16306,10058,6248,15.9,25.7,-2731,-4.3,42.8,0,780,780,7992
2000,25,e) 4,5900,5987,55594,54755,195,3.1,776,12.4,11293,1200,10093,2.2,20.6,9614,3913,5701,7.1,17.6,1679,3,35.2,0,576,576,3219
2000,25,f) 5,5582,5761,59079,59906,177,2.9,758,12.5,10008,865,9143,1.4,16.7,11661,6620,5041,11.1,19.5,-1653,-2.8,33.4,0,507,507,2920
2000,25,g) 6 to 10,19945,21025,242244,242620,535,2.5,1973,9.1,38178,4624,33554,1.9,15.7,38930,17344,21586,7.1,16,-752,-0.3,31.4,0,1414,1414,10542
2000,25,h) 11 to 15,18024,20017,315078,312166,785,3.8,1594,7.8,47064,10593,36471,3.4,15.1,41240,16368,24872,5.2,13.2,5824,1.9,26.4,0,1007,1007,8035
2000,25,i) 16 to 20,11761,14089,290346,289177,496,3.5,980,6.8,41922,13925,27997,4.8,14.5,39583,15932,23651,5.5,13.7,2339,0.8,27.4,0,538,538,3849
2000,25,j) 21 to 25,5881,8356,192809,191342,271,3.2,615,7.2,22551,5043,17508,2.6,11.8,19617,6436,13181,3.4,10.3,2934,1.5,20.6,0,272,272,1542
2000,25,l) Left Censored,23418,41850,1586500,1584634,2128,5,2983,7.1,202238,57552,144686,3.6,12.8,198506,59583,138923,3.8,12.5,3732,0.3,25,0,961,961,7334
2000,26,a) 0,14478,14612,97136,48862,14466,198,0,0,96549,96549,0,197.6,197.6,0,0,0,0,0,96549,197.6,0,0,,,
2000,26,b) 1,11608,11907,115439,106891,222,1.7,2825,21.3,41255,5200,36055,4.9,38.6,24159,13349,10810,12.5,22.6,17096,16,45.2,0,2028,2028,9192
2000,26,c) 2,10681,11174,108532,108497,468,3.9,1872,15.8,24301,6231,18070,5.7,22.4,24230,11120,13110,10.2,22.3,71,0.1,44.6,0,1402,1402,9291
2000,26,d) 3,9670,10143,92990,96018,279,2.6,1525,14.2,15981,2304,13677,2.4,16.6,22036,9534,12502,9.9,22.9,-6055,-6.3,33.2,0,1127,1127,7109
2000,26,e) 4,8713,8855,89954,89147,213,2.3,1185,12.7,18484,967,17517,1.1,20.7,16870,8506,8364,9.5,18.9,1614,1.8,37.8,0,895,895,6719
2000,26,f) 5,8101,8278,79076,80027,216,2.5,1045,12,12757,1142,11615,1.4,15.9,14658,6132,8526,7.7,18.3,-1901,-2.4,31.8,0,761,761,4821
2000,26,g) 6 to 10,29470,31060,351155,351784,768,2.4,3336,10.3,56592,6855,49737,1.9,16.1,57850,23581,34269,6.7,16.4,-1258,-0.3,32.2,0,2292,2292,16268
2000,26,h) 11 to 15,22513,25790,383374,385221,690,2.6,2128,8,50489,9784,40705,2.5,13.1,54183,19386,34797,5,14.1,-3694,-1,26.2,0,1340,1340,10568
2000,26,i) 16 to 20,15765,18897,311248,315538,473,2.4,1331,6.9,38033,7055,30978,2.2,12.1,46612,17217,29395,5.5,14.8,-8579,-2.7,24.2,0,718,718,7337
2000,26,j) 21 to 25,8316,11645,219965,220655,403,3.4,781,6.6,28849,8944,19905,4.1,13.1,30229,8217,22012,3.7,13.7,-1380,-0.6,26.2,0,419,419,2609
2000,26,l) Left Censored,27459,56289,2167748,2179006,2903,5.1,4595,8,253931,75787,178144,3.5,11.7,276447,103980,172467,4.8,12.7,-22516,-1,23.4,0,1141,1141,10504
2000,27,a) 0,8868,8914,55764,27990,8828,198.1,0,0,55549,55549,0,198.5,198.5,0,0,0,0,0,55549,198.5,0,0,,,
2000,27,b) 1,7264,7446,61347,59521,120,1.4,1705,20.6,17214,2380,14834,4,28.9,13561,7248,6313,12.2,22.8,3653,6.1,45.6,0,1190,1190,5544
2000,27,c) 2,6683,7010,64671,65029,337,4.5,1185,15.9,14498,4286,10212,6.6,22.3,15215,5908,9307,9.1,23.4,-717,-1.1,44.6,0,842,842,4994
2000,27,d) 3,5841,6004,47902,49394,169,2.7,884,13.9,8523,1316,7207,2.7,17.3,11506,4388,7118,8.9,23.3,-2983,-6,34.6,0,653,653,3532
2000,27,e) 4,5161,5250,44093,44766,138,2.5,635,11.5,7466,566,6900,1.3,16.7,8812,3687,5125,8.2,19.7,-1346,-3,33.4,0,453,453,2595
2000,27,f) 5,4579,4679,43841,43395,106,2.2,536,11,7675,719,6956,1.7,17.7,6783,2412,4371,5.6,15.6,892,2.1,31.2,0,381,381,1876
2000,27,g) 6 to 10,17500,18639,204034,204620,456,2.4,1900,9.8,29855,4227,25628,2.1,14.6,31026,13493,17533,6.6,15.2,-1171,-0.6,29.2,0,1268,1268,8801
2000,27,h) 11 to 15,12611,14355,215756,215922,370,2.5,1130,7.7,27836,5847,21989,2.7,12.9,28167,10682,17485,4.9,13,-331,-0.1,25.8,0,686,686,5512
2000,27,i) 16 to 20,8823,10526,208096,206355,263,2.4,708,6.6,25269,4334,20935,2.1,12.2,21786,6637,15149,3.2,10.6,3483,1.6,21.2,0,402,402,2672
2000,27,j) 21 to 25,4966,7026,144067,142949,279,3.9,415,5.8,18536,5594,12942,3.9,13,16300,4067,12233,2.8,11.4,2236,1.6,22.8,0,222,222,2043
2000,27,l) Left Censored,16362,31237,1297181,1290646,1503,4.8,1983,6.3,150199,35743,114456,2.8,11.6,137128,35215,101913,2.7,10.6,13071,1,21.2,0,565,565,6756
2000,28,a) 0,3860,3925,25530,12812,3894,198.4,0,0,25437,25437,0,198.5,198.5,0,0,0,0,0,25437,198.5,0,0,,,
2000,28,b) 1,3238,3310,24009,24914,50,1.3,1106,28.7,6760,1144,5616,4.6,27.1,8570,5271,3299,21.2,34.4,-1810,-7.3,54.2,0,879,879,3986
2000,28,c) 2,2767,2872,27746,29260,112,3.6,617,19.7,5446,1522,3924,5.2,18.6,8474,3081,5393,10.5,29,-3028,-10.4,37.2,0,466,466,2162
2000,28,d) 3,2333,2389,18351,19568,57,2.2,509,19.5,2696,156,2540,0.8,13.8,5130,2754,2376,14.1,26.2,-2434,-12.4,27.6,0,373,373,1905
2000,28,e) 4,2123,2185,20331,20417,68,2.9,352,15.2,3976,363,3613,1.8,19.5,4148,2014,2134,9.9,20.3,-172,-0.8,39,0,261,261,1387
2000,28,f) 5,1985,2078,19316,19974,72,3.3,298,13.6,2778,375,2403,1.9,13.9,4094,1992,2102,10,20.5,-1316,-6.6,27.8,0,217,217,1591
2000,28,g) 6 to 10,7091,7524,80274,83750,231,2.9,927,11.8,10533,2042,8491,2.4,12.6,17485,7180,10305,8.6,20.9,-6952,-8.3,25.2,0,634,634,3299
2000,28,h) 11 to 15,5053,5690,88471,87742,222,3.8,534,9.1,12500,3768,8732,4.3,14.2,11042,3830,7212,4.4,12.6,1458,1.6,25.2,0,361,361,2425
2000,28,i) 16 to 20,4378,5038,80598,80978,134,2.6,387,7.5,10780,1331,9449,1.6,13.3,11540,5282,6258,6.5,14.3,-760,-1,26.6,0,210,210,1304
2000,28,j) 21 to 25,2289,3173,67495,67134,122,3.8,231,7.2,7481,2015,5466,3,11.1,6759,1587,5172,2.4,10.1,722,1,20.2,0,125,125,596
2000,28,l) Left Censored,7364,15485,495338,496509,904,5.8,979,6.3,47327,12439,34888,2.5,9.5,49669,13363,36306,2.7,10,-2342,-0.5,19,0,289,289,2825
2000,29,a) 0,9625,9678,59248,29746,9606,198.5,0,0,59005,59005,0,198.4,198.4,0,0,0,0,0,59005,198.4,0,0,,,
2000,29,b) 1,7685,7846,61546,60795,122,1.4,2112,23.8,18220,2757,15463,4.5,30,16718,9315,7403,15.3,27.5,1502,2.5,55,0,1628,1628,7633
2000,29,c) 2,6767,7086,69858,69273,357,4.7,1356,17.9,16054,4260,11794,6.1,23.2,14884,6901,7983,10,21.5,1170,1.7,43,0,1077,1077,5879
2000,29,d) 3,5811,5927,47136,48091,207,3.3,1043,16.4,9873,2017,7856,4.2,20.5,11782,5616,6166,11.7,24.5,-1909,-4,41,0,806,806,4652
2000,29,e) 4,5039,5148,47456,47845,142,2.6,876,15.9,8438,794,7644,1.7,17.6,9215,4574,4641,9.6,19.3,-777,-1.7,35.2,0,651,651,3188
2000,29,f) 5,4806,4938,42040,42884,138,2.7,670,12.9,6369,663,5706,1.5,14.9,8057,3594,4463,8.4,18.8,-1688,-3.9,29.8,0,504,504,2648
2000,29,g) 6 to 10,17644,18734,195315,197278,470,2.4,2180,11.1,28673,3119,25554,1.6,14.5,32598,13357,19241,6.8,16.5,-3925,-2,29,0,1579,1579,9346
2000,29,h) 11 to 15,13892,15714,237680,236496,539,3.3,1361,8.4,34045,10777,23268,4.6,14.4,31676,12091,19585,5.1,13.4,2369,1,26.8,0,890,890,6184
2000,29,i) 16 to 20,9814,11719,200679,202593,291,2.4,849,7.1,23511,6272,17239,3.1,11.6,27338,8696,18642,4.3,13.5,-3827,-1.9,23.2,0,505,505,3275
2000,29,j) 21 to 25,5130,7426,146734,145132,277,3.7,502,6.7,19563,5082,14481,3.5,13.5,16358,5572,10786,3.8,11.3,3205,2.2,22.6,0,255,255,1543
2000,29,l) Left Censored,17607,35616,1264176,1271382,1972,5.5,2723,7.6,143302,36727,106575,2.9,11.3,157714,45285,112429,3.6,12.4,-14412,-1.1,22.6,0,738,738,4820
2000,30,a) 0,2348,2364,10702,5374,2346,198.5,0,0,10657,10657,0,198.3,198.3,0,0,0,0,0,10657,198.3,0,0,,,
2000,30,b) 1,1831,1848,10751,10844,14,0.7,515,24.4,2512,252,2260,2.3,23.2,2697,1463,1234,13.5,24.9,-185,-1.7,46.4,0,381,381,1125
2000,30,c) 2,1766,1824,14106,13911,75,3.8,327,16.7,3266,704,2562,5.1,23.5,2875,1399,1476,10.1,20.7,391,2.8,41.4,0,235,235,944
2000,30,d) 3,1440,1459,9976,9906,54,3.5,266,17,2300,442,1858,4.5,23.2,2159,1166,993,11.8,21.8,141,1.4,43.6,0,200,200,805
2000,30,e) 4,1346,1374,9248,9307,56,3.9,223,15.3,1574,171,1403,1.8,16.9,1692,847,845,9.1,18.2,-118,-1.3,33.8,0,153,153,648
2000,30,f) 5,1199,1216,8359,8432,35,2.7,166,13,1271,77,1194,0.9,15.1,1417,658,759,7.8,16.8,-146,-1.7,30.2,0,120,120,505
2000,30,g) 6 to 10,3997,4096,32467,32937,155,3.6,473,11.1,4490,561,3929,1.7,13.6,5430,2276,3154,6.9,16.5,-940,-2.9,27.2,0,341,341,1631
2000,30,h) 11 to 15,2754,3028,32519,32954,76,2.4,262,8.4,3834,489,3345,1.5,11.6,4704,1978,2726,6,14.3,-870,-2.7,23.2,0,160,160,716
2000,30,i) 16 to 20,2196,2529,28177,27945,72,2.8,226,8.7,4038,1122,2916,4,14.4,3573,1470,2103,5.3,12.8,465,1.6,25.6,0,142,142,800
2000,30,j) 21 to 25,1270,1746,21008,20784,144,8.3,108,6.3,3557,1553,2004,7.5,17.1,3108,701,2407,3.4,15,449,2.1,30,0,63,63,380
2000,30,l) Left Censored,3264,5705,117359,116932,255,4.4,368,6.4,12671,2900,9771,2.5,10.8,11816,2903,8913,2.5,10.1,855,0.7,20.2,0,124,124,633
2000,31,a) 0,2918,2945,17002,8524,2922,198.4,0,0,16956,16956,0,198.9,198.9,0,0,0,0,0,16956,198.9,0,0,,,
2000,31,b) 1,2380,2422,24925,23259,34,1.3,586,21.6,7449,3337,4112,14.3,32,4117,2488,1629,10.7,17.7,3332,14.3,35.4,0,418,418,1857
2000,31,c) 2,2225,2328,20380,20540,131,5.3,369,15.1,5585,1167,4418,5.7,27.2,5904,3264,2640,15.9,28.7,-319,-1.5,54.4,0,277,277,2955
2000,31,d) 3,1888,1956,14238,14285,51,2.4,304,14.6,2329,391,1938,2.7,16.3,2423,1216,1207,8.5,17,-94,-0.7,32.6,0,218,218,952
2000,31,e) 4,1644,1680,12704,13166,55,3.1,217,12.3,1798,187,1611,1.4,13.7,2722,1325,1397,10.1,20.7,-924,-7,27.4,0,167,167,1019
2000,31,f) 5,1494,1538,13663,13494,45,2.8,187,11.6,2198,246,1952,1.8,16.3,1859,758,1101,5.6,13.8,339,2.5,27.6,0,121,121,461
2000,31,g) 6 to 10,5846,6157,57248,57953,151,2.4,651,10.2,7804,1298,6506,2.2,13.5,9213,3559,5654,6.1,15.9,-1409,-2.4,27,0,443,443,2241
2000,31,h) 11 to 15,4508,5080,85122,85181,146,2.8,401,7.7,10499,1976,8523,2.3,12.3,10617,3455,7162,4.1,12.5,-118,-0.2,24.6,0,247,247,1821
2000,31,i) 16 to 20,3727,4371,59065,60264,155,3.5,292,6.6,8057,2965,5092,4.9,13.4,10454,3204,7250,5.3,17.3,-2397,-3.9,26.8,0,168,168,927
2000,31,j) 21 to 25,2083,2914,48955,48807,69,2.3,207,6.9,6431,1799,4632,3.7,13.2,6135,2053,4082,4.2,12.6,296,0.6,25.2,0,102,102,508
2000,31,l) Left Censored,7363,12677,395732,394375,622,4.9,772,6.1,44807,14443,30364,3.7,11.4,42092,12992,29100,3.3,10.7,2715,0.7,21.4,0,256,256,4238
2000,32,a) 0,4659,4682,32644,16387,4651,198.7,0,0,32515,32515,0,198.4,198.4,0,0,0,0,0,32515,198.4,0,0,,,
2000,32,b) 1,3570,3623,39001,38070,52,1.2,1145,27.3,12289,1239,11050,3.3,32.3,10427,6402,4025,16.8,27.4,1862,4.9,54.8,0,869,869,5088
2000,32,c) 2,3000,3125,42522,39446,152,4.5,668,19.7,15385,2074,13311,5.3,39,9232,4145,5087,10.5,23.4,6153,15.6,46.8,0,542,542,3506
2000,32,d) 3,2364,2397,27154,28242,68,2.6,482,18.5,4968,414,4554,1.5,17.6,7144,3686,3458,13.1,25.3,-2176,-7.7,35.2,0,367,367,2717
2000,32,e) 4,1859,1926,32930,33567,67,3.3,321,15.7,4701,436,4265,1.3,14,5974,2104,3870,6.3,17.8,-1273,-3.8,28,0,227,227,1686
2000,32,f) 5,1654,1743,26273,25870,71,3.8,296,16,4593,1023,3570,4,17.8,3786,1531,2255,5.9,14.6,807,3.2,29.2,0,199,199,835
2000,32,g) 6 to 10,5251,5551,81409,83090,177,3,755,12.9,14157,1697,12460,2,17,17520,6417,11103,7.7,21.1,-3363,-4.1,34,0,541,541,4495
2000,32,h) 11 to 15,3476,4253,76920,75485,225,5.1,487,11.1,14004,2790,11214,3.7,18.6,11133,4018,7115,5.3,14.7,2871,3.9,29.4,0,246,246,1705
2000,32,i) 16 to 20,2412,3021,66212,66045,158,5.1,290,9.4,9351,3116,6235,4.7,14.2,9016,3092,5924,4.7,13.7,335,0.5,27.4,0,158,158,1330
2000,32,j) 21 to 25,1334,2075,80844,76504,130,6.2,163,7.8,15751,2766,12985,3.6,20.6,7070,1688,5382,2.2,9.2,8681,11.4,18.4,0,70,70,368
2000,32,l) Left Censored,3518,8363,388850,384702,897,10.8,749,9,51012,23195,27817,6,13.3,42716,14405,28311,3.7,11.1,8296,2.2,22.2,0,102,102,853
2000,33,a) 0,2424,2437,14074,7071,2411,197.9,0,0,14007,14007,0,198.1,198.1,0,0,0,0,0,14007,198.1,0,0,,,
2000,33,b) 1,1974,2006,13915,13289,29,1.3,475,21.2,4413,650,3763,4.9,33.2,3161,1709,1452,12.9,23.8,1252,9.4,47.6,0,360,360,1440
2000,33,c) 2,1863,1910,15527,15425,62,3.1,293,14.5,3253,822,2431,5.3,21.1,3048,1154,1894,7.5,19.8,205,1.3,39.6,0,213,213,953
2000,33,d) 3,1682,1698,12567,12485,39,2.2,265,14.7,2525,241,2284,1.9,20.2,2361,1196,1165,9.6,18.9,164,1.3,37.8,0,206,206,953
2000,33,e) 4,1524,1550,15302,15037,32,2,198,12.2,2783,103,2680,0.7,18.5,2253,897,1356,6,15,530,3.5,30,0,149,149,739
2000,33,f) 5,1358,1376,11563,11703,34,2.4,173,12,1923,124,1799,1.1,16.4,2203,1012,1191,8.6,18.8,-280,-2.4,32.8,0,134,134,808
2000,33,g) 6 to 10,4781,4983,49911,50256,107,2.1,493,9.5,7795,1234,6561,2.5,15.5,8484,3553,4931,7.1,16.9,-689,-1.4,31,0,350,350,2568
2000,33,h) 11 to 15,4327,4690,65116,65266,154,3.2,392,8.2,7579,1153,6426,1.8,11.6,7878,2444,5434,3.7,12.1,-299,-0.5,23.2,0,252,252,1274
2000,33,i) 16 to 20,2450,2770,51520,49278,69,2.4,202,7.1,10442,1776,8666,3.6,21.2,5958,1536,4422,3.1,12.1,4484,9.1,24.2,0,114,114,721
2000,33,j) 21 to 25,1276,1772,35771,36172,74,4.1,137,7.6,4624,1199,3425,3.3,12.8,5426,1820,3606,5,15,-802,-2.2,25.6,0,59,59,439
2000,33,l) Left Censored,4306,7927,254858,254541,492,6.2,589,7.4,26307,7981,18326,3.1,10.3,25674,8858,16816,3.5,10.1,633,0.2,20.2,0,142,142,1475
2000,34,a) 0,15809,15875,83792,42056,15748,198.4,0,0,83472,83472,0,198.5,198.5,0,0,0,0,0,83472,198.5,0,0,,,
2000,34,b) 1,13141,13295,100004,98590,128,0.9,3149,21.2,29903,3527,26376,3.6,30.3,27074,13333,13741,13.5,27.5,2829,2.8,55,0,2258,2258,10200
2000,34,c) 2,12187,12455,101544,102827,415,3.1,2057,15.5,24169,5335,18834,5.2,23.5,26734,14581,12153,14.2,26,-2565,-2.5,47,0,1562,1562,12505
2000,34,d) 3,10448,10625,85814,86927,327,2.9,1779,15.7,17596,2602,14994,3,20.2,19822,10753,9069,12.4,22.8,-2226,-2.6,40.4,0,1358,1358,8839
2000,34,e) 4,9019,9154,79604,78566,251,2.6,1299,13.4,15641,2555,13086,3.3,19.9,13564,5428,8136,6.9,17.3,2077,2.6,34.6,0,977,977,4022
2000,34,f) 5,8162,8527,83131,79643,337,3.8,1212,13.5,21345,1666,19679,2.1,26.8,14369,6507,7862,8.2,18,6976,8.8,36,0,822,822,3924
2000,34,g) 6 to 10,28877,29717,301408,301378,785,2.5,3282,10.6,46741,5509,41232,1.8,15.5,46681,17371,29310,5.8,15.5,60,0,31,0,2338,2338,12616
2000,34,h) 11 to 15,23874,25869,341760,343254,739,2.8,2294,8.6,46052,8339,37713,2.4,13.4,49039,19714,29325,5.7,14.3,-2987,-0.9,26.8,0,1502,1502,8753
2000,34,i) 16 to 20,15722,17637,290338,290414,558,3.1,1562,8.6,38687,9550,29137,3.3,13.3,38839,12306,26533,4.2,13.4,-152,-0.1,26.6,0,905,905,5537
2000,34,j) 21 to 25,8085,10039,213580,211716,346,3.4,726,7.1,26440,7859,18581,3.7,12.5,22712,7261,15451,3.4,10.7,3728,1.8,21.4,0,423,423,2877
2000,34,l) Left Censored,27985,50371,1825680,1821802,3188,6.3,3940,7.8,257339,80924,176415,4.4,14.1,249583,90024,159559,4.9,13.7,7756,0.4,27.4,0,1327,1327,11831
2000,35,a) 0,2917,2937,17617,8851,2917,198.6,0,0,17533,17533,0,198.1,198.1,0,0,0,0,0,17533,198.1,0,0,,,
2000,35,b) 1,2292,2326,18869,19325,25,0.9,740,27.4,4520,687,3833,3.6,23.4,5432,2811,2621,14.5,28.1,-912,-4.7,46.8,0,545,545,2199
2000,35,c) 2,2054,2134,18597,18779,110,4.7,471,20.3,4343,1348,2995,7.2,23.1,4706,2113,2593,11.3,25.1,-363,-2,46.2,0,370,370,1773
2000,35,d) 3,1838,1874,14169,14990,98,4.9,352,17.6,2440,448,1992,3,16.3,4082,1609,2473,10.7,27.2,-1642,-10.9,32.6,0,243,243,1097
2000,35,e) 4,1585,1616,14951,14624,46,2.7,272,15.7,3444,174,3270,1.2,23.6,2789,1508,1281,10.3,19.1,655,4.5,38.2,0,185,185,941
2000,35,f) 5,1485,1542,13387,13892,61,3.7,255,15.6,2492,299,2193,2.2,17.9,3501,1842,1659,13.3,25.2,-1009,-7.3,35.8,0,192,192,955
2000,35,g) 6 to 10,5474,5842,54859,55657,182,3,720,11.8,9213,1489,7724,2.7,16.6,10808,4463,6345,8,19.4,-1595,-2.8,33.2,0,491,491,3154
2000,35,h) 11 to 15,3828,4308,65330,65205,155,3.5,470,10.5,8265,872,7393,1.3,12.7,8015,3182,4833,4.9,12.3,250,0.4,24.6,0,278,278,1581
2000,35,i) 16 to 20,3125,3752,48711,50525,164,4.3,274,7.2,6321,1642,4679,3.2,12.5,9948,4666,5282,9.2,19.7,-3627,-7.2,25,0,159,159,3166
2000,35,j) 21 to 25,1649,2423,38346,38682,158,6.5,192,7.9,5881,2497,3384,6.5,15.2,6553,2290,4263,5.9,16.9,-672,-1.7,30.4,0,98,98,476
2000,35,l) Left Censored,4345,8994,237739,237986,557,6.1,743,8.2,28902,10601,18301,4.5,12.1,29396,9833,19563,4.1,12.4,-494,-0.3,24.2,0,177,177,1146
2000,36,a) 0,34517,34625,201334,101007,34395,198.7,0,0,200655,200655,0,198.7,198.7,0,0,0,0,0,200655,198.7,0,0,,,
2000,36,b) 1,27443,27723,209043,205285,232,0.7,6815,21.9,62889,6718,56171,3.3,30.6,55373,31330,24043,15.3,27,7516,3.6,54,0,5058,5058,25150
2000,36,c) 2,25042,25737,224946,224392,889,3.2,4720,17.1,54128,13197,40931,5.9,24.1,53019,25697,27322,11.5,23.6,1109,0.5,47.2,0,3675,3675,20771
2000,36,d) 3,21775,22134,178575,181002,651,2.8,3713,15.7,34632,4034,30598,2.2,19.1,39485,20850,18635,11.5,21.8,-4853,-2.7,38.2,0,2839,2839,15896
2000,36,e) 4,18647,18910,158273,159494,520,2.6,2708,13.5,27229,3907,23322,2.4,17.1,29671,13774,15897,8.6,18.6,-2442,-1.5,34.2,0,2074,2074,10812
2000,36,f) 5,16489,17503,154175,155867,522,2.8,2416,13.1,27948,2002,25946,1.3,17.9,31331,15827,15504,10.2,20.1,-3383,-2.2,35.8,0,1694,1694,11601
2000,36,g) 6 to 10,60415,62456,628154,631946,1578,2.4,6724,10.3,90804,10512,80292,1.7,14.4,98388,39549,58839,6.3,15.6,-7584,-1.2,28.8,0,4912,4912,27175
2000,36,h) 11 to 15,49311,53167,717636,722011,1503,2.8,4501,8.2,82883,16012,66871,2.2,11.5,91633,39242,52391,5.4,12.7,-8750,-1.2,23,0,2960,2960,17623
2000,36,i) 16 to 20,32890,37274,564419,564853,909,2.4,2766,7.2,66786,13377,53409,2.4,11.8,67653,26439,41214,4.7,12,-867,-0.2,23.6,0,1747,1747,16269
2000,36,j) 21 to 25,16002,21581,441887,436837,718,3.3,1453,6.6,57852,13661,44191,3.1,13.2,47752,15752,32000,3.6,10.9,10100,2.3,21.8,0,801,801,4109
2000,36,l) Left Censored,60571,108006,3813568,3799732,5797,5.3,7867,7.2,472075,132534,339541,3.5,12.4,444403,140641,303762,3.7,11.7,27672,0.7,23.4,0,2819,2819,21566
2000,37,a) 0,14157,14302,90311,45267,14202,198.6,0,0,90088,90088,0,199,199,0,0,0,0,0,90088,199,0,0,,,
2000,37,b) 1,11822,12043,98112,96619,155,1.1,3348,24.4,31514,4141,27373,4.3,32.6,28527,15338,13189,15.9,29.5,2987,3.1,59,0,2554,2554,12110
2000,37,c) 2,10200,10675,103326,102079,462,4,2118,18.4,24509,6892,17617,6.8,24,22015,10606,11409,10.4,21.6,2494,2.4,43.2,0,1604,1604,8156
2000,37,d) 3,8869,9071,77090,78068,284,2.9,1531,15.8,14902,2132,12770,2.7,19.1,16857,8499,8358,10.9,21.6,-1955,-2.5,38.2,0,1146,1146,6861
2000,37,e) 4,7515,7818,71388,72445,229,2.8,1247,15,13499,1619,11880,2.2,18.6,15612,7778,7834,10.7,21.6,-2113,-3,37.2,0,912,912,5709
2000,37,f) 5,6724,6979,60630,61658,231,3.1,989,13.4,10910,1721,9189,2.8,17.7,12965,6343,6622,10.3,21,-2055,-3.3,35.4,0,727,727,4455
2000,37,g) 6 to 10,23529,25014,292818,294646,652,2.5,2869,11,44354,6550,37804,2.2,15.1,48010,19527,28483,6.6,16.3,-3656,-1.2,30.2,0,1952,1952,12928
2000,37,h) 11 to 15,18559,21236,340064,339916,687,3.1,1881,8.6,44405,9104,35301,2.7,13.1,44110,16705,27405,4.9,13,295,0.1,26,0,1141,1141,8121
2000,37,i) 16 to 20,13515,16209,245942,247753,464,2.8,1185,7.2,31042,8796,22246,3.6,12.5,34663,12491,22172,5,14,-3621,-1.5,25,0,627,627,4209
2000,37,j) 21 to 25,6417,9550,194044,192891,361,3.7,612,6.3,23962,6281,17681,3.3,12.4,21655,6369,15286,3.3,11.2,2307,1.2,22.4,0,292,292,1998
2000,37,l) Left Censored,20336,47904,1783358,1784360,2838,5.9,3378,7,205620,60027,145593,3.4,11.5,207624,68592,139032,3.8,11.6,-2004,-0.1,23,0,823,823,7207
2000,38,a) 0,1070,1081,7297,3663,1070,198,0,0,7268,7268,0,198.4,198.4,0,0,0,0,0,7268,198.4,0,0,,,
2000,38,b) 1,817,828,6581,6617,9,1,217,23.1,1653,236,1417,3.6,25,1725,1096,629,16.6,26.1,-72,-1.1,50,0,164,164,885
2000,38,c) 2,839,885,8563,8607,46,4.9,156,16.6,2226,1037,1189,12,25.9,2314,847,1467,9.8,26.9,-88,-1,51.8,0,120,120,769
2000,38,d) 3,753,774,5739,5591,41,5.1,105,13,1424,489,935,8.7,25.5,1128,643,485,11.5,20.2,296,5.3,40.4,0,81,81,470
2000,38,e) 4,668,680,4650,4868,20,2.8,95,13.2,818,61,757,1.3,16.8,1254,772,482,15.9,25.8,-436,-9,33.6,0,72,72,337
2000,38,f) 5,562,565,4848,4948,12,2,69,11.6,638,47,591,0.9,12.9,837,423,414,8.5,16.9,-199,-4,25.8,0,50,50,355
2000,38,g) 6 to 10,2509,2597,22440,22492,68,2.5,293,10.8,2971,371,2600,1.6,13.2,3074,1192,1882,5.3,13.7,-103,-0.5,26.4,0,214,214,937
2000,38,h) 11 to 15,1950,2149,22722,23636,41,1.8,187,8.4,1892,169,1723,0.7,8,3719,1515,2204,6.4,15.7,-1827,-7.7,16,0,118,118,831
2000,38,i) 16 to 20,1723,1975,20994,21143,43,2.1,132,6.5,2599,522,2077,2.5,12.3,2896,1001,1895,4.7,13.7,-297,-1.4,24.6,0,83,83,627
2000,38,j) 21 to 25,918,1203,18234,18198,30,2.4,73,6,1745,152,1593,0.8,9.6,1673,426,1247,2.3,9.2,72,0.4,18.4,0,50,50,269
2000,38,l) Left Censored,3270,5303,131122,130449,190,3.6,288,5.4,12620,2626,9994,2,9.7,11273,2533,8740,1.9,8.6,1347,1.1,17.2,0,117,117,578
2000,39,a) 0,14897,15013,111448,55877,14902,198.5,0,0,111142,111142,0,198.9,198.9,0,0,0,0,0,111142,198.9,0,0,,,
2000,39,b) 1,12241,12563,122800,120056,218,1.5,3142,22.3,36399,7838,28561,6.5,30.3,30910,15577,15333,13,25.7,5489,4.6,51.4,0,2384,2384,11854
2000,39,c) 2,11407,12044,114964,115520,527,4.1,2006,15.7,26646,6768,19878,5.9,23.1,27757,12472,15285,10.8,24,-1111,-0.9,46.2,0,1547,1547,10468
2000,39,d) 3,10023,10499,103345,102908,371,3.3,1605,14.4,21947,3952,17995,3.8,21.3,21072,10452,10620,10.2,20.5,875,0.8,41,0,1211,1211,7790
2000,39,e) 4,8946,9235,87483,88250,278,2.9,1230,12.7,15375,1837,13538,2.1,17.4,16909,7780,9129,8.8,19.2,-1534,-1.8,34.8,0,926,926,5726
2000,39,f) 5,8511,8775,82755,82646,201,2.2,1062,11.5,15401,2657,12744,3.2,18.6,15183,6314,8869,7.6,18.4,218,0.2,36.8,0,819,819,4713
2000,39,g) 6 to 10,31872,34104,388123,383375,832,2.4,3378,9.6,72662,9015,63647,2.4,19,63166,24510,38656,6.4,16.5,9496,2.5,33,0,2425,2425,15836
2000,39,h) 11 to 15,25270,29168,481351,480871,800,2.7,2366,7.9,64469,11224,53245,2.3,13.4,63508,23596,39912,4.9,13.2,961,0.2,26.4,0,1493,1493,10306
2000,39,i) 16 to 20,18126,21767,346493,344541,534,2.4,1518,6.8,44414,9390,35024,2.7,12.9,40509,13144,27365,3.8,11.8,3905,1.1,23.6,0,898,898,5843
2000,39,j) 21 to 25,10185,14742,299220,295793,556,3.7,917,6.1,42205,11608,30597,3.9,14.3,35351,11727,23624,4,12,6854,2.3,24,0,448,448,2585
2000,39,l) Left Censored,36831,76903,2829403,2820493,3967,5.1,5475,7.1,331154,90711,240443,3.2,11.7,313335,95846,217489,3.4,11.1,17819,0.6,22.2,0,1448,1448,12223
2000,40,a) 0,5724,5786,39067,19611,5735,198.2,0,0,38912,38912,0,198.4,198.4,0,0,0,0,0,38912,198.4,0,0,,,
2000,40,b) 1,4566,4649,36587,37250,47,0.9,1424,26.5,10094,1663,8431,4.5,27.1,11419,6659,4760,17.9,30.7,-1325,-3.6,54.2,0,1082,1082,4862
2000,40,c) 2,4058,4263,38963,38169,204,4.4,875,19,10911,2794,8117,7.3,28.6,9323,4636,4687,12.1,24.4,1588,4.2,48.8,0,694,694,3885
2000,40,d) 3,3578,3753,34280,34739,134,3.3,709,17.6,7833,1049,6784,3,22.5,8750,4910,3840,14.1,25.2,-917,-2.7,45,0,522,522,3248
2000,40,e) 4,2982,3061,24204,25007,83,2.5,532,16.2,4442,731,3711,2.9,17.8,6047,3089,2958,12.4,24.2,-1605,-6.4,35.6,0,405,405,2349
2000,40,f) 5,2688,2788,26275,26548,98,3.3,388,13.3,4358,477,3881,1.8,16.4,4903,2450,2453,9.2,18.5,-545,-2.1,32.8,0,282,282,1873
2000,40,g) 6 to 10,10385,10926,108848,109103,290,2.5,1276,11.2,17723,3816,13907,3.5,16.2,18233,8233,10000,7.5,16.7,-510,-0.5,32.4,0,887,887,4700
2000,40,h) 11 to 15,7425,8272,125582,126806,300,3.5,787,9.2,15569,3410,12159,2.7,12.3,18017,5099,12918,4,14.2,-2448,-1.9,24.6,0,489,489,2745
2000,40,i) 16 to 20,7001,8070,113141,114548,184,2.2,664,8,12728,2376,10352,2.1,11.1,15541,6444,9097,5.6,13.6,-2813,-2.5,22.2,0,349,349,1896
2000,40,j) 21 to 25,3225,4410,78815,78044,156,3.5,293,6.5,9719,2059,7660,2.6,12.5,8177,2354,5823,3,10.5,1542,2,21,0,161,161,856
2000,40,l) Left Censored,9453,19688,569416,566135,1065,5.4,1443,7.3,71599,22311,49288,3.9,12.6,65037,18882,46155,3.3,11.5,6562,1.1,23,0,377,377,2618
2000,41,a) 0,6913,6966,38606,19378,6912,198.4,0,0,38456,38456,0,198.5,198.5,0,0,0,0,0,38456,198.5,0,0,,,
2000,41,b) 1,5808,5914,38205,38396,77,1.1,1675,24.8,10197,1774,8423,4.6,26.6,10579,5655,4924,14.7,27.6,-382,-1,53.2,0,1237,1237,4458
2000,41,c) 2,5138,5336,38336,39500,236,4.1,1064,18.5,8660,2604,6056,6.6,21.9,10987,5040,5947,12.8,27.8,-2327,-5.9,43.8,0,782,782,3699
2000,41,d) 3,4426,4520,33161,34169,159,3.3,839,17.3,6075,1093,4982,3.2,17.8,8090,4110,3980,12,23.7,-2015,-5.9,35.6,0,625,625,3147
2000,41,e) 4,4034,4173,43559,44466,121,2.7,649,14.6,5950,968,4982,2.2,13.4,7763,3414,4349,7.7,17.5,-1813,-4.1,26.8,0,471,471,2692
2000,41,f) 5,3795,3893,31532,32387,129,3.1,584,14.2,5452,359,5093,1.1,16.8,7162,3696,3466,11.4,22.1,-1710,-5.3,33.6,0,406,406,2507
2000,41,g) 6 to 10,13467,14257,135122,136961,515,3.5,1728,11.6,22446,5696,16750,4.2,16.4,26124,11600,14524,8.5,19.1,-3678,-2.7,32.8,0,1147,1147,6983
2000,41,h) 11 to 15,8939,10032,129588,129535,351,3.4,873,8.5,18383,3047,15336,2.4,14.2,18277,6127,12150,4.7,14.1,106,0.1,28.2,0,554,554,3475
2000,41,i) 16 to 20,6562,7932,132206,133951,234,2.9,661,8.1,15585,3808,11777,2.8,11.6,19075,7308,11767,5.5,14.2,-3490,-2.6,23.2,0,373,373,2853
2000,41,j) 21 to 25,3615,5005,91732,91961,186,3.7,364,7.2,10186,2318,7868,2.5,11.1,10644,3418,7226,3.7,11.6,-458,-0.5,22.2,0,176,176,811
2000,41,l) Left Censored,9596,19394,624183,625267,1071,5.5,1543,7.9,77648,24530,53118,3.9,12.4,79815,26942,52873,4.3,12.8,-2167,-0.4,24.8,0,373,373,2707
2000,42,a) 0,16489,16617,120208,60295,16482,198.4,0,0,119827,119827,0,198.7,198.7,0,0,0,0,0,119827,198.7,0,0,,,
2000,42,b) 1,13769,14019,122000,117950,163,1,3109,20,34743,4459,30284,3.8,29.5,26642,13799,12843,11.7,22.6,8101,6.9,45.2,0,2349,2349,11187
2000,42,c) 2,12505,13168,132583,128957,518,3.7,2013,14.4,32473,9763,22710,7.6,25.2,25220,10466,14754,8.1,19.6,7253,5.6,39.2,0,1544,1544,7707
2000,42,d) 3,11107,11484,99279,100746,328,2.7,1575,13,16976,2190,14786,2.2,16.9,19909,9299,10610,9.2,19.8,-2933,-2.9,33.8,0,1220,1220,6870
2000,42,e) 4,9600,9926,90486,92478,257,2.5,1268,12.2,14316,1912,12404,2.1,15.5,18299,7722,10577,8.4,19.8,-3983,-4.3,31,0,940,940,5362
2000,42,f) 5,9090,9403,86962,86802,213,2.2,1072,10.9,15469,1021,14448,1.2,17.8,15148,5812,9336,6.7,17.5,321,0.3,35,0,787,787,4215
2000,42,g) 6 to 10,34809,36699,380686,382802,851,2.2,3647,9.6,55492,8395,47097,2.2,14.5,59724,23593,36131,6.2,15.6,-4232,-1.1,29,0,2640,2640,16807
2000,42,h) 11 to 15,30852,34555,465945,466553,914,2.6,2759,7.8,58619,11759,46860,2.5,12.6,59834,23587,36247,5.1,12.8,-1215,-0.2,25.2,0,1831,1831,12096
2000,42,i) 16 to 20,20897,24406,380218,382221,615,2.5,1690,6.8,44402,9538,34864,2.5,11.6,48408,15978,32430,4.2,12.7,-4006,-1.1,23.2,0,1036,1036,7984
2000,42,j) 21 to 25,10994,15313,307029,306041,522,3.4,1004,6.5,44500,16980,27520,5.5,14.5,42524,11177,31347,3.7,13.9,1976,0.6,27.8,0,500,500,3090
2000,42,l) Left Censored,40349,80541,2855381,2847358,4259,5.2,5817,7.2,337002,103752,233250,3.6,11.8,320955,102206,218749,3.6,11.3,16047,0.5,22.6,0,1694,1694,13505
2000,44,a) 0,1711,1722,13359,6698,1707,198.3,0,0,13322,13322,0,198.9,198.9,0,0,0,0,0,13322,198.9,0,0,,,
2000,44,b) 1,1439,1454,9887,9556,13,0.8,345,21.2,3001,164,2837,1.7,31.4,2339,1249,1090,13.1,24.5,662,6.9,49,0,263,263,1031
2000,44,c) 2,1366,1420,10504,10508,64,4.2,232,15.4,2280,572,1708,5.4,21.7,2287,1034,1253,9.8,21.8,-7,-0.1,43.4,0,178,178,897
2000,44,d) 3,1168,1191,11137,11003,40,3.2,189,14.9,1943,179,1764,1.6,17.7,1674,723,951,6.6,15.2,269,2.5,30.4,0,139,139,546
2000,44,e) 4,1016,1025,8189,8358,31,2.9,136,12.6,1392,254,1138,3,16.7,1730,615,1115,7.4,20.7,-338,-4,33.4,0,98,98,499
2000,44,f) 5,907,915,7098,7186,28,2.9,115,12,1058,141,917,2,14.7,1234,546,688,7.6,17.2,-176,-2.5,29.4,0,91,91,473
2000,44,g) 6 to 10,3587,3678,36172,38316,96,2.5,364,9.6,5149,369,4780,1,13.4,9437,5690,3747,14.9,24.6,-4288,-11.2,26.8,0,266,266,5055
2000,44,h) 11 to 15,3228,3466,42437,41887,118,3.3,279,7.9,5908,1361,4547,3.2,14.1,4808,1850,2958,4.4,11.5,1100,2.6,23,0,176,176,897
2000,44,i) 16 to 20,1974,2241,31319,32158,56,2.4,186,8.1,3228,576,2652,1.8,10,4905,1719,3186,5.3,15.3,-1677,-5.3,20,0,125,125,568
2000,44,j) 21 to 25,1134,1341,24854,24960,32,2.3,78,5.7,2199,317,1882,1.3,8.8,2410,721,1689,2.9,9.7,-211,-0.9,17.6,0,48,48,325
2000,44,l) Left Censored,4564,6661,213244,214253,341,5.1,457,6.8,27785,8606,19179,4,13,29803,12200,17603,5.7,13.9,-2018,-0.9,26,0,160,160,1239
2000,45,a) 0,6953,7015,45889,23109,6959,198.4,0,0,45561,45561,0,197.2,197.2,0,0,0,0,0,45561,197.2,0,0,,,
2000,45,b) 1,5718,5844,50361,48852,83,1.2,1738,25.9,16484,2690,13794,5.5,33.7,13465,7918,5547,16.2,27.6,3019,6.1,55.2,0,1318,1318,6210
2000,45,c) 2,4975,5115,53292,53751,223,4,1026,18.6,12763,3664,9099,6.8,23.7,13680,7084,6596,13.2,25.5,-917,-1.8,47.4,0,781,781,5673
2000,45,d) 3,4124,4202,42210,42909,140,3.1,770,17.1,7422,779,6643,1.8,17.3,8819,3964,4855,9.2,20.6,-1397,-3.3,34.6,0,603,603,3115
2000,45,e) 4,3602,3701,45054,43645,109,2.8,592,15,10488,525,9963,1.2,24,7670,3903,3767,8.9,17.6,2818,6.4,35.2,0,453,453,3201
2000,45,f) 5,3250,3339,35391,35392,104,3,439,12.6,6519,669,5850,1.9,18.4,6521,3065,3456,8.7,18.4,-2,0,36.8,0,324,324,2422
2000,45,g) 6 to 10,11475,12273,141290,141379,321,2.5,1395,10.9,22521,3077,19444,2.2,15.9,22699,8865,13834,6.3,16.1,-178,-0.2,31.8,0,976,976,6038
2000,45,h) 11 to 15,8906,10556,163860,163066,410,3.8,906,8.4,24510,5288,19222,3.2,15,22921,8304,14617,5.1,14.1,1589,0.9,28.2,0,551,551,3423
2000,45,i) 16 to 20,6287,7463,110997,112213,188,2.4,626,8.1,13069,2114,10955,1.9,11.6,15500,6682,8818,6,13.8,-2431,-2.2,23.2,0,317,317,2276
2000,45,j) 21 to 25,3028,4608,76078,76780,205,4.4,369,7.9,10816,3689,7127,4.8,14.1,12219,5141,7078,6.7,15.9,-1403,-1.8,28.2,0,139,139,757
2000,45,l) Left Censored,10019,22473,818902,819251,1352,6,1544,6.9,88323,25819,62504,3.2,10.8,89021,27762,61259,3.4,10.9,-698,-0.1,21.6,0,362,362,2368
2000,46,a) 0,1505,1519,9813,4930,1507,198.4,0,0,9766,9766,0,198.1,198.1,0,0,0,0,0,9766,198.1,0,0,,,
2000,46,b) 1,1260,1276,8695,8804,11,0.8,315,22,1978,135,1843,1.5,22.5,2196,1182,1014,13.4,24.9,-218,-2.4,45,0,229,229,994
2000,46,c) 2,1112,1151,8812,8942,48,3.9,226,18.2,2296,644,1652,7.2,25.7,2556,1553,1003,17.4,28.6,-260,-2.9,51.4,0,164,164,1370
2000,46,d) 3,960,974,8092,7717,32,3.1,141,13.7,1993,213,1780,2.8,25.8,1243,721,522,9.3,16.1,750,9.7,32.2,0,104,104,629
2000,46,e) 4,859,875,5805,6075,30,3.2,139,15,798,78,720,1.3,13.1,1337,641,696,10.6,22,-539,-8.9,26.2,0,104,104,470
2000,46,f) 5,775,796,6722,6717,20,2.4,92,11,1311,85,1226,1.3,19.5,1301,800,501,11.9,19.4,10,0.1,38.8,0,63,63,331
2000,46,g) 6 to 10,3049,3160,30043,29562,88,2.7,338,10.3,5283,780,4503,2.6,17.9,4320,1588,2732,5.4,14.6,963,3.3,29.2,0,244,244,1180
2000,46,h) 11 to 15,2169,2346,32792,34970,57,2.3,222,9.1,3689,1206,2483,3.4,10.5,8045,1362,6683,3.9,23,-4356,-12.5,21,0,154,154,877
2000,46,i) 16 to 20,1695,1987,22350,22521,49,2.4,141,6.9,2561,556,2005,2.5,11.4,2903,1206,1697,5.4,12.9,-342,-1.5,22.8,0,86,86,506
2000,46,j) 21 to 25,957,1237,19466,19682,27,2.1,72,5.7,2035,363,1672,1.8,10.3,2466,989,1477,5,12.5,-431,-2.2,20.6,0,45,45,168
2000,46,l) Left Censored,3437,5623,148433,146379,231,4.1,320,5.6,15680,3029,12651,2.1,10.7,11571,4083,7488,2.8,7.9,4109,2.8,15.8,0,105,105,547
2000,47,a) 0,8149,8239,56647,28424,8177,198.5,0,0,56446,56446,0,198.6,198.6,0,0,0,0,0,56446,198.6,0,0,,,
2000,47,b) 1,6724,6992,66250,66562,147,1.8,2198,27.3,21015,4031,16984,6.1,31.6,21639,10592,11047,15.9,32.5,-624,-0.9,63.2,0,1754,1754,8836
2000,47,c) 2,6084,6433,69932,70349,315,4.5,1350,19.4,17677,4489,13188,6.4,25.1,18511,9767,8744,13.9,26.3,-834,-1.2,50.2,0,1045,1045,7452
2000,47,d) 3,4944,5114,48954,49937,204,3.7,1031,18.7,9835,1473,8362,2.9,19.7,11801,6860,4941,13.7,23.6,-1966,-3.9,39.4,0,768,768,4417
2000,47,e) 4,4651,4771,48894,51227,160,3.1,833,16.3,9448,1561,7887,3,18.4,14114,9165,4949,17.9,27.6,-4666,-9.2,36.8,0,607,607,4807
2000,47,f) 5,4119,4252,44829,44604,129,2.9,626,13.9,7887,982,6905,2.2,17.7,7436,2938,4498,6.6,16.7,451,1,33.4,0,453,453,2036
2000,47,g) 6 to 10,15460,16646,197188,198012,570,3.3,1937,11.2,32057,6685,25372,3.4,16.2,33705,13199,20506,6.7,17,-1648,-0.8,32.4,0,1369,1369,8689
2000,47,h) 11 to 15,11957,13845,222921,218235,503,3.5,1289,9.1,37723,8981,28742,4.1,17.3,28351,10529,17822,4.8,13,9372,4.3,26,0,782,782,5108
2000,47,i) 16 to 20,9025,10719,168315,170616,290,2.6,779,7.1,21001,4885,16116,2.9,12.3,25604,7804,17800,4.6,15,-4603,-2.7,24.6,0,416,416,2732
2000,47,j) 21 to 25,4709,7808,195971,190854,519,6.6,650,8.3,36493,13070,23423,6.8,19.1,26258,10296,15962,5.4,13.8,10235,5.3,27.6,0,211,211,1328
2000,47,l) Left Censored,14615,33474,1251243,1251017,2051,6.1,2465,7.3,155513,44680,110833,3.6,12.4,155062,53727,101335,4.3,12.4,451,0,24.8,0,562,562,3768
2000,48,a) 0,33521,33867,238529,119741,33595,198.4,0,0,237576,237576,0,198.4,198.4,0,0,0,0,0,237576,198.4,0,0,,,
2000,48,b) 1,26500,27107,256751,254733,361,1.2,8018,25.8,80955,12529,68426,4.9,31.8,76919,44212,32707,17.4,30.2,4036,1.6,60.4,0,6087,6087,34986
2000,48,c) 2,23051,24123,255880,255485,1138,4.4,5104,19.5,68719,21926,46793,8.6,26.9,67929,33911,34018,13.3,26.6,790,0.3,53.2,0,3937,3937,27151
2000,48,d) 3,19918,20630,212006,219725,694,3.1,3889,17.5,44551,8281,36270,3.8,20.3,59988,34145,25843,15.5,27.3,-15437,-7,40.6,0,2966,2966,26384
2000,48,e) 4,17585,18447,196648,200200,616,3.1,3106,15.8,37938,5062,32876,2.5,19,45041,22856,22185,11.4,22.5,-7103,-3.5,38,0,2274,2274,17078
2000,48,f) 5,15580,16401,175975,179301,619,3.6,2531,14.6,33160,4297,28863,2.4,18.5,39811,19882,19929,11.1,22.2,-6651,-3.7,37,0,1833,1833,15474
2000,48,g) 6 to 10,58257,63319,799743,807048,1927,2.9,7647,11.6,133512,25758,107754,3.2,16.5,148121,62506,85615,7.7,18.4,-14609,-1.9,33,0,5293,5293,38633
2000,48,h) 11 to 15,39307,46574,803581,799245,1825,3.8,4383,9.2,127815,30041,97774,3.8,16,119142,41727,77415,5.2,14.9,8673,1.1,29.8,0,2650,2650,20697
2000,48,i) 16 to 20,33114,40015,653759,655172,1314,3.2,3235,7.9,100225,24377,75848,3.7,15.3,103051,41666,61385,6.4,15.7,-2826,-0.4,30.6,0,1767,1767,12025
2000,48,j) 21 to 25,14731,22842,474100,469578,1105,4.8,1801,7.8,72354,22596,49758,4.8,15.4,63310,18383,44927,3.9,13.5,9044,1.9,27,0,762,762,4405
2000,48,l) Left Censored,37026,104111,3815498,3783348,7761,7.4,9141,8.7,571976,182461,389515,4.8,15.1,507675,180459,327216,4.8,13.4,64301,1.7,26.8,0,1689,1689,12542
2000,49,a) 0,4734,4770,31948,16023,4739,198.7,0,0,31850,31850,0,198.8,198.8,0,0,0,0,0,31850,198.8,0,0,,,
2000,49,b) 1,3761,3799,30203,30999,30,0.7,1177,26.8,8403,801,7602,2.6,27.1,9995,5541,4454,17.9,32.2,-1592,-5.1,54.2,0,905,905,4582
2000,49,c) 2,3126,3222,40412,41712,132,3.8,699,19.9,7236,1843,5393,4.4,17.3,9836,4444,5392,10.7,23.6,-2600,-6.3,34.6,0,538,538,3630
2000,49,d) 3,2682,2745,24661,25019,120,4.1,495,16.9,4985,846,4139,3.4,19.9,5701,2982,2719,11.9,22.8,-716,-2.9,39.8,0,361,361,2306
2000,49,e) 4,2384,2478,30804,30910,91,3.5,382,14.6,5630,795,4835,2.6,18.2,5841,2678,3163,8.7,18.9,-211,-0.7,36.4,0,272,272,2049
2000,49,f) 5,1931,1989,25955,25875,67,3.2,287,13.7,5406,1033,4373,4,20.9,5246,2077,3169,8,20.3,160,0.6,40.6,0,193,193,1334
2000,49,g) 6 to 10,6402,6842,90051,90639,193,2.7,822,11.5,15995,1920,14075,2.1,17.6,17170,7323,9847,8.1,18.9,-1175,-1.3,35.2,0,579,579,4872
2000,49,h) 11 to 15,3877,4480,92873,93702,175,3.8,413,9,12904,3597,9307,3.8,13.8,14561,4564,9997,4.9,15.5,-1657,-1.7,27.6,0,251,251,2495
2000,49,i) 16 to 20,2850,3378,61609,61758,127,3.7,262,7.6,9004,1752,7252,2.8,14.6,9302,2748,6554,4.4,15.1,-298,-0.5,29.2,0,140,140,1333
2000,49,j) 21 to 25,1691,2383,45988,46714,89,3.7,166,6.8,4822,1140,3682,2.4,10.3,6274,1682,4592,3.6,13.4,-1452,-3.1,20.6,0,78,78,531
2000,49,l) Left Censored,4759,11014,431112,426616,962,8.8,810,7.4,57133,17675,39458,4.1,13.4,48140,14363,33777,3.4,11.3,8993,2.1,22.6,0,180,180,1280
2000,50,a) 0,1298,1308,6984,3497,1301,198.9,0,0,6974,6974,0,199.4,199.4,0,0,0,0,0,6974,199.4,0,0,,,
2000,50,b) 1,1072,1094,6618,6814,12,1,251,20.6,1835,341,1494,5,26.9,2226,1221,1005,17.9,32.7,-391,-5.8,53.8,0,179,179,1085
2000,50,c) 2,1024,1070,7013,7288,33,2.9,165,14.5,1303,188,1115,2.6,17.9,1852,1010,842,13.9,25.4,-549,-7.5,35.8,0,128,128,890
2000,50,d) 3,899,913,4961,4994,27,2.8,138,14.2,895,110,785,2.2,17.9,961,497,464,10,19.2,-66,-1.3,35.8,0,106,106,430
2000,50,e) 4,800,807,5549,5605,23,2.7,93,11,808,100,708,1.8,14.4,920,447,473,8,16.4,-112,-2,28.8,0,66,66,307
2000,50,f) 5,709,714,5925,5875,14,1.9,88,11.7,800,63,737,1.1,13.6,699,324,375,5.5,11.9,101,1.7,23.8,0,64,64,252
2000,50,g) 6 to 10,2974,3076,23129,22991,67,2.1,275,8.6,3727,858,2869,3.7,16.2,3451,1154,2297,5,15,276,1.2,30,0,211,211,943
2000,50,h) 11 to 15,2620,2775,27151,27052,86,3,206,7.3,3373,636,2737,2.4,12.5,3175,1103,2072,4.1,11.7,198,0.8,23.4,0,129,129,586
2000,50,i) 16 to 20,1687,1953,28432,28028,59,3,116,5.9,3344,403,2941,1.4,11.9,2536,602,1934,2.1,9,808,2.9,18,0,72,72,340
2000,50,j) 21 to 25,786,999,17758,17587,36,3.6,62,6.1,2019,384,1635,2.2,11.5,1677,366,1311,2.1,9.5,342,2,19,0,37,37,236
2000,50,l) Left Censored,2646,4217,118545,117957,183,4.3,269,6.3,13325,3419,9906,2.9,11.3,12148,3533,8615,3,10.3,1177,1,20.6,0,94,94,399
2000,51,a) 0,11620,11730,70595,35470,11648,198.6,0,0,70250,70250,0,198.1,198.1,0,0,0,0,0,70250,198.1,0,0,,,
2000,51,b) 1,9131,9312,76050,74132,128,1.2,2525,23.9,23565,3333,20232,4.5,31.8,19729,10109,9620,13.6,26.6,3836,5.2,53.2,0,1911,1911,8165
2000,51,c) 2,8407,8772,78461,76959,459,4.9,1600,17.1,20374,5313,15061,6.9,26.5,17369,7710,9659,10,22.6,3005,3.9,45.2,0,1201,1201,5860
2000,51,d) 3,7225,7390,66607,64347,248,3.2,1199,15.3,16148,3021,13127,4.7,25.1,11628,5753,5875,8.9,18.1,4520,7,36.2,0,892,892,4525
2000,51,e) 4,6276,6453,59520,59600,210,3.1,928,13.6,11287,1222,10065,2.1,18.9,11446,5469,5977,9.2,19.2,-159,-0.3,37.8,0,694,694,3628
2000,51,f) 5,5926,6139,56573,56434,203,3.1,820,12.7,10720,926,9794,1.6,19,10441,5015,5426,8.9,18.5,279,0.5,37,0,595,595,3488
2000,51,g) 6 to 10,21704,22932,276374,272703,622,2.6,2411,10.1,48350,9414,38936,3.5,17.7,41007,15647,25360,5.7,15,7343,2.7,30,0,1650,1650,9542
2000,51,h) 11 to 15,16877,19539,301891,299732,677,3.4,1645,8.2,49141,12425,36716,4.1,16.4,44822,15941,28881,5.3,15,4319,1.4,30,0,962,962,6331
2000,51,i) 16 to 20,11126,13279,244771,241610,388,2.9,971,7.2,34528,8596,25932,3.6,14.3,28205,10078,18127,4.2,11.7,6323,2.6,23.4,0,518,518,3339
2000,51,j) 21 to 25,5427,8146,167866,165676,317,3.8,587,7.1,24834,7954,16880,4.8,15,20453,7375,13078,4.5,12.3,4381,2.7,24.6,0,236,236,1561
2000,51,l) Left Censored,17439,42338,1451409,1444718,2753,6.5,3255,7.6,192240,61282,130958,4.2,13.3,178858,67781,111077,4.7,12.4,13382,0.9,24.8,0,691,691,5243
2000,53,a) 0,12297,12383,70597,35411,12263,198.1,0,0,70372,70372,0,198.7,198.7,0,0,0,0,0,70372,198.7,0,0,,,
2000,53,b) 1,9883,10102,83896,80767,159,1.4,3036,26.1,26105,3656,22449,4.5,32.3,19846,9855,9991,12.2,24.6,6259,7.7,49.2,0,2196,2196,7598
2000,53,c) 2,8623,9018,75894,75253,495,5.1,1859,19.2,19634,5567,14067,7.4,26.1,18352,9097,9255,12.1,24.4,1282,1.7,48.8,0,1400,1400,6723
2000,53,d) 3,7328,7501,60808,61123,304,3.8,1367,17,12898,1524,11374,2.5,21.1,13527,6134,7393,10,22.1,-629,-1,42.2,0,1002,1002,4793
2000,53,e) 4,6476,6621,54120,55117,235,3.3,1110,15.7,10252,963,9289,1.7,18.6,12246,6266,5980,11.4,22.2,-1994,-3.6,37.2,0,773,773,4299
2000,53,f) 5,5757,5896,54602,57480,215,3.4,977,15.6,8891,1327,7564,2.3,15.5,14647,5927,8720,10.3,25.5,-5756,-10,31,0,675,675,4120
2000,53,g) 6 to 10,22063,23271,223634,226317,773,3.2,2971,12.2,35782,5069,30713,2.2,15.8,41147,16401,24746,7.2,18.2,-5365,-2.4,31.6,0,1954,1954,10148
2000,53,h) 11 to 15,14117,15913,225837,226769,570,3.5,1536,9.4,31037,4714,26323,2.1,13.7,32901,11863,21038,5.2,14.5,-1864,-0.8,27.4,0,962,962,6588
2000,53,i) 16 to 20,10538,12706,219104,218080,396,3,1101,8.4,29502,7510,21992,3.4,13.5,27454,9512,17942,4.4,12.6,2048,0.9,25.2,0,620,620,3597
2000,53,j) 21 to 25,5488,7841,144623,143004,324,4.1,617,7.7,21105,6043,15062,4.2,14.8,17866,6064,11802,4.2,12.5,3239,2.3,25,0,279,279,1627
2000,53,l) Left Censored,14241,30607,1012851,1005489,1822,5.9,2348,7.6,137066,41370,95696,4.1,13.6,122342,38281,84061,3.8,12.2,14724,1.4,24.4,0,543,556,5076
2000,54,a) 0,2337,2361,12564,6318,2338,198.1,0,0,12492,12492,0,197.7,197.7,0,0,0,0,0,12492,197.7,0,0,,,
2000,54,b) 1,1919,1955,13079,13176,27,1.2,550,24.6,3668,901,2767,6.8,27.8,3861,2381,1480,18.1,29.3,-193,-1.5,55.6,0,415,415,2020
2000,54,c) 2,1704,1855,15517,15382,103,5.2,358,18,3742,1732,2010,11.3,24.3,3472,1468,2004,9.5,22.6,270,1.7,45.2,0,281,281,1203
2000,54,d) 3,1556,1567,10713,10883,47,2.8,254,15.2,2114,122,1992,1.1,19.4,2454,1211,1243,11.1,22.5,-340,-3.1,38.8,0,181,181,840
2000,54,e) 4,1358,1392,10561,10794,39,2.6,222,15,1804,215,1589,2,16.7,2270,1158,1112,10.7,21,-466,-4.3,33.4,0,172,172,912
2000,54,f) 5,1297,1335,10045,10231,31,2.2,194,13.7,1685,359,1326,3.5,16.5,2057,1002,1055,9.8,20.1,-372,-3.6,33,0,144,144,816
2000,54,g) 6 to 10,4943,5149,44927,45269,137,2.5,619,11.5,7570,1216,6354,2.7,16.7,8253,3732,4521,8.2,18.2,-683,-1.5,33.4,0,419,419,2396
2000,54,h) 11 to 15,3963,4396,63612,62943,111,2.5,361,8,8832,3160,5672,5,14,7494,2781,4713,4.4,11.9,1338,2.1,23.8,0,245,245,1570
2000,54,i) 16 to 20,3161,3515,41008,41586,85,2.4,250,7,4047,796,3251,1.9,9.7,5203,1861,3342,4.5,12.5,-1156,-2.8,19.4,0,139,139,975
2000,54,j) 21 to 25,1647,2546,40839,40848,149,5.8,156,6.1,4696,1273,3423,3.1,11.5,4714,1088,3626,2.7,11.5,-18,0,23,0,70,70,398
2000,54,l) Left Censored,6115,11327,289127,287139,570,5,760,6.7,30705,8961,21744,3.1,10.7,26728,6872,19856,2.4,9.3,3977,1.4,18.6,0,230,230,1010
2000,55,a) 0,8201,8239,49200,24762,8172,198.4,0,0,48876,48876,0,197.4,197.4,0,0,0,0,0,48876,197.4,0,0,,,
2000,55,b) 1,6781,7020,60735,58203,86,1.1,1509,19.4,17836,3672,14164,6.3,30.6,12771,6473,6298,11.1,21.9,5065,8.7,43.8,0,1116,1116,4794
2000,55,c) 2,6158,6497,61540,61635,280,4.1,1079,15.6,13740,4481,9259,7.3,22.3,13929,6346,7583,10.3,22.6,-189,-0.3,44.6,0,810,810,4674
2000,55,d) 3,5484,5652,44046,44341,191,3.2,815,13.7,7734,1042,6692,2.3,17.4,8323,4230,4093,9.5,18.8,-589,-1.4,34.8,0,607,607,3188
2000,55,e) 4,4946,5004,43860,44490,108,2.1,625,11.9,6466,575,5891,1.3,14.5,7725,3231,4494,7.3,17.4,-1259,-2.9,29,0,466,466,2403
2000,55,f) 5,4548,4708,42469,42251,126,2.6,526,10.7,6839,722,6117,1.7,16.2,6402,2832,3570,6.7,15.2,437,1,30.4,0,381,381,2161
2000,55,g) 6 to 10,17617,18657,190404,191355,422,2.2,1841,9.5,26432,3430,23002,1.8,13.8,28333,11324,17009,5.9,14.8,-1901,-1,27.6,0,1319,1319,7707
2000,55,h) 11 to 15,13475,15346,223867,227044,365,2.3,1237,7.8,27379,3862,23517,1.7,12.1,33733,13588,20145,6,14.9,-6354,-2.8,24.2,0,850,850,5241
2000,55,i) 16 to 20,9497,11009,175705,175924,271,2.4,735,6.5,18768,3542,15226,2,10.7,19206,5908,13298,3.4,10.9,-438,-0.2,21.4,0,457,457,2772
2000,55,j) 21 to 25,5288,7814,147450,143895,328,4.1,550,6.9,22260,8006,14254,5.6,15.5,15149,4450,10699,3.1,10.5,7111,5,21,0,269,269,1583
2000,55,l) Left Censored,19239,35447,1352698,1349034,1781,5,2249,6.3,135872,38072,97800,2.8,10.1,128543,36652,91891,2.7,9.5,7329,0.6,19,0,761,761,6340
2000,56,a) 0,1334,1339,6720,3375,1323,197.6,0,0,6690,6690,0,198.2,198.2,0,0,0,0,0,6690,198.2,0,0,,,
2000,56,b) 1,1005,1018,5828,5823,8,0.7,284,24.4,1689,191,1498,3.3,29,1678,942,736,16.2,28.8,11,0.2,57.6,0,207,207,742
2000,56,c) 2,954,998,7658,7423,70,6.7,172,16.3,2384,1163,1221,15.7,32.1,1914,717,1197,9.7,25.8,470,6.3,51.6,0,126,126,603
2000,56,d) 3,807,823,4893,4911,37,4.2,141,16.2,968,213,755,4.3,19.7,1003,482,521,9.8,20.4,-35,-0.7,39.4,0,108,108,403
2000,56,e) 4,752,762,4820,4862,16,2,97,12.1,897,144,753,3,18.4,980,445,535,9.2,20.2,-83,-1.8,36.8,0,69,69,323
2000,56,f) 5,646,656,4681,4742,24,3.5,87,12.7,683,68,615,1.4,14.4,805,342,463,7.2,17,-122,-2.6,28.8,0,62,62,292
2000,56,g) 6 to 10,2330,2421,19314,19719,77,3,292,11.6,3014,490,2524,2.5,15.3,3824,1353,2471,6.9,19.4,-810,-4.1,30.6,0,213,213,1067
2000,56,h) 11 to 15,1519,1655,21070,21382,45,2.6,147,8.6,2232,200,2032,0.9,10.4,2855,907,1948,4.2,13.4,-623,-3,20.8,0,100,100,537
2000,56,i) 16 to 20,1389,1613,16394,16161,45,2.7,130,7.9,2417,381,2036,2.4,15,1951,753,1198,4.7,12.1,466,2.9,24.2,0,79,79,371
2000,56,j) 21 to 25,797,1037,14315,14023,38,3.6,59,5.6,2146,406,1740,2.9,15.3,1562,464,1098,3.3,11.1,584,4.2,22.2,0,34,34,140
2000,56,l) Left Censored,2007,3383,65916,65943,167,4.9,227,6.6,7655,1902,5753,2.9,11.6,7709,2827,4882,4.3,11.7,-54,-0.1,23.2,0,54,54,225
2001,01,a) 0,6047,6130,36126,18300,6077,198.3,0,0,35653,35653,0,194.8,194.8,0,0,0,0,0,35653,194.8,0,0,,,
2001,01,b) 1,4882,4997,39231,39035,75,1.3,1612,28,11902,2394,9508,6.1,30.5,11510,6218,5292,15.9,29.5,392,1,59,0,1221,1223,4883
2001,01,c) 2,4473,4625,42367,45974,191,3.8,1024,20.4,8720,2183,6537,4.7,19,15933,9272,6661,20.2,34.7,-7213,-15.7,38,0,775,775,7380
2001,01,d) 3,4200,4434,43708,46662,204,4.3,795,16.9,7990,1686,6304,3.6,17.1,13898,6662,7236,14.3,29.8,-5908,-12.7,34.2,0,624,624,5662
2001,01,e) 4,3697,3808,34783,35895,115,2.8,619,15.3,5644,903,4741,2.5,15.7,7868,3388,4480,9.4,21.9,-2224,-6.2,31.4,0,443,443,2398
2001,01,f) 5,3300,3436,27816,29308,110,3,548,15.1,4363,1045,3318,3.6,14.9,7347,3419,3928,11.7,25.1,-2984,-10.2,29.8,0,380,380,2470
2001,01,g) 6 to 10,12249,12975,144232,150454,370,2.7,1711,12.6,18310,2571,15739,1.7,12.2,30754,13337,17417,8.9,20.4,-12444,-8.2,24.4,0,1141,1141,7368
2001,01,h) 11 to 15,8821,10020,163414,165228,289,2.8,1039,10,20953,5635,15318,3.4,12.7,24580,7444,17136,4.5,14.9,-3627,-2.2,25.4,0,645,645,4152
2001,01,i) 16 to 20,7024,8528,144283,146812,311,3.6,644,7.4,15775,3851,11924,2.6,10.7,20833,6720,14113,4.6,14.2,-5058,-3.5,21.4,0,336,336,3235
2001,01,j) 21 to 25,4407,6656,134127,134616,276,4.1,565,8.3,16415,5158,11257,3.8,12.2,17393,4729,12664,3.5,12.9,-978,-0.7,24.4,0,214,214,1506
2001,01,l) Left Censored,11254,24815,794245,816421,1555,6.2,1855,7.4,74382,24168,50214,3,9.1,118734,30988,87746,3.8,14.5,-44352,-5.4,18.2,0,439,439,3677
2001,02,a) 0,1177,1182,5918,3116,1161,196.4,0,0,5605,5605,0,179.9,179.9,0,0,0,0,0,5605,179.9,0,0,,,
2001,02,b) 1,956,970,6201,6421,9,0.8,323,28.7,1813,126,1687,2,28.2,2253,1477,776,23,35.1,-440,-6.9,56.4,0,177,177,685
2001,02,c) 2,751,776,5781,6068,35,4.1,193,22.6,1284,178,1106,2.9,21.2,1857,983,874,16.2,30.6,-573,-9.4,42.4,0,125,125,760
2001,02,d) 3,783,834,7825,7718,54,6.2,145,16.5,2333,1146,1187,14.8,30.2,2119,579,1540,7.5,27.5,214,2.7,55,0,89,89,384
2001,02,e) 4,673,680,5011,5167,31,4.3,116,16.1,895,138,757,2.7,17.3,1206,451,755,8.7,23.3,-311,-6,34.6,0,66,66,319
2001,02,f) 5,593,601,3876,4067,18,2.8,96,15.1,594,121,473,3,14.6,975,446,529,11,24,-381,-9.4,29.2,0,63,63,311
2001,02,g) 6 to 10,2203,2297,16371,17268,86,3.6,311,13,2542,258,2284,1.5,14.7,4336,1963,2373,11.4,25.1,-1794,-10.4,29.4,0,197,197,1345
2001,02,h) 11 to 15,1633,1745,23801,23922,52,2.9,195,10.8,2662,304,2358,1.3,11.1,2904,975,1929,4.1,12.1,-242,-1,22.2,0,108,108,568
2001,02,i) 16 to 20,1394,1629,19747,19996,33,2,152,9,2397,302,2095,1.5,12,2894,925,1969,4.6,14.5,-497,-2.5,24,0,77,77,439
2001,02,j) 21 to 25,895,1341,24567,23553,82,6.1,96,7.1,4765,1810,2955,7.7,20.2,2737,929,1808,3.9,11.6,2028,8.6,23.2,0,32,32,127
2001,02,l) Left Censored,1638,3287,92267,90429,296,9.1,208,6.4,12940,3495,9445,3.9,14.3,9264,2569,6695,2.8,10.2,3676,4.1,20.4,0,40,40,331
2001,04,a) 0,9145,9253,58321,29428,9190,198.6,0,0,57786,57786,0,196.4,196.4,0,0,0,0,0,57786,196.4,0,0,,,
2001,04,b) 1,7125,7257,68890,67321,101,1.2,2113,25.6,19609,1928,17681,2.9,29.1,16470,9727,6743,14.4,24.5,3139,4.6,49,0,1525,1527,7412
2001,04,c) 2,6290,6480,78377,79033,281,4,1371,19.6,15786,2710,13076,3.4,20,17098,8536,8562,10.8,21.6,-1312,-1.6,40,0,1007,1007,6169
2001,04,d) 3,5409,5744,68206,70117,291,4.8,1037,17,14874,2851,12023,4.1,21.2,18696,8031,10665,11.5,26.7,-3822,-5.5,42.4,0,760,760,6604
2001,04,e) 4,4631,4827,51708,54614,171,3.3,829,16.1,8455,1256,7199,2.3,15.5,14266,5356,8910,9.8,26.1,-5811,-10.6,31,0,584,584,3918
2001,04,f) 5,4116,4261,42604,45230,144,3.2,663,14.7,6832,1211,5621,2.7,15.1,12084,4152,7932,9.2,26.7,-5252,-11.6,30.2,0,465,465,2972
2001,04,g) 6 to 10,14259,15203,201216,207867,494,3.1,1998,12.6,29309,4944,24365,2.4,14.1,42610,15126,27484,7.3,20.5,-13301,-6.4,28.2,0,1279,1279,8557
2001,04,h) 11 to 15,9647,11213,194792,196196,401,3.5,1194,10.3,28621,10147,18474,5.2,14.6,31429,12956,18473,6.6,16,-2808,-1.4,29.2,0,664,664,5858
2001,04,i) 16 to 20,6996,9127,173294,174712,593,6.4,834,9,25595,8361,17234,4.8,14.6,28431,11692,16739,6.7,16.3,-2836,-1.7,29.2,0,381,381,3666
2001,04,j) 21 to 25,4125,6307,159857,156606,357,5.6,459,7.2,24812,6853,17959,4.4,15.8,18310,6600,11710,4.2,11.7,6502,4.1,23.4,0,187,187,1413
2001,04,l) Left Censored,8163,22196,830872,833924,2266,10.3,1956,8.9,126087,47583,78504,5.7,15.1,132192,46408,85784,5.6,15.9,-6105,-0.8,30.2,0,262,262,3024
2001,05,a) 0,4136,4198,23750,11937,4167,198.5,0,0,23627,23627,0,197.9,197.9,0,0,0,0,0,23627,197.9,0,0,,,
2001,05,b) 1,3242,3312,23891,25833,47,1.2,1080,28.2,6726,1288,5438,5,26,10609,6166,4443,23.9,41.1,-3883,-15.1,52,0,793,793,4817
2001,05,c) 2,2893,2989,22813,24119,89,2.7,682,20.8,4323,883,3440,3.7,17.9,6934,3104,3830,12.9,28.7,-2611,-10.8,35.8,0,503,503,2377
2001,05,d) 3,2546,2758,24471,25930,152,5.2,485,16.7,4338,1849,2489,7.1,16.7,7256,2012,5244,7.8,28,-2918,-11.3,33.4,0,354,354,1529
2001,05,e) 4,2241,2268,19364,21510,68,2.8,412,17,2890,356,2534,1.7,13.4,7181,3633,3548,16.9,33.4,-4291,-20,26.8,0,291,291,1639
2001,05,f) 5,2007,2098,20042,20696,88,4,320,14.5,3046,606,2440,2.9,14.7,4354,1632,2722,7.9,21,-1308,-6.3,29.4,0,229,229,1156
2001,05,g) 6 to 10,8005,8493,82455,84837,276,3.1,1032,11.7,11287,2365,8922,2.8,13.3,16050,5465,10585,6.4,18.9,-4763,-5.6,26.6,0,667,667,3669
2001,05,h) 11 to 15,5256,5891,78757,80329,184,3,614,10.1,8881,1850,7031,2.3,11.1,12025,4198,7827,5.2,15,-3144,-3.9,22.2,0,393,393,2682
2001,05,i) 16 to 20,4504,5134,76147,77771,170,3.3,394,7.5,8794,2283,6511,2.9,11.3,12041,3756,8285,4.8,15.5,-3247,-4.2,22.6,0,205,205,1233
2001,05,j) 21 to 25,3058,4184,89669,90103,188,4.4,329,7.7,9449,2466,6983,2.7,10.5,10317,2118,8199,2.4,11.5,-868,-1,21,0,178,179,894
2001,05,l) Left Censored,7877,15439,523829,525338,975,6.3,1001,6.5,57636,13998,43638,2.7,11,60653,16681,43972,3.2,11.5,-3017,-0.5,22,0,239,239,1413
2001,06,a) 0,61353,61983,401337,201821,61466,198.3,0,0,399033,399033,0,197.7,197.7,0,0,0,0,0,399033,197.7,0,0,,,
2001,06,b) 1,47544,48485,471776,454054,569,1,13693,24.9,156398,17007,139391,3.7,34.4,120953,60978,59975,13.4,26.6,35445,7.8,53.2,0,9593,9597,45277
2001,06,c) 2,40070,41540,431631,436419,1813,4,8637,19.3,109025,16754,92271,3.8,25,118600,60205,58395,13.8,27.2,-9575,-2.2,50,0,6216,6216,44003
2001,06,d) 3,35475,37764,459575,459327,1925,4.8,6592,16.5,109262,33877,75385,7.4,23.8,108766,48937,59829,10.7,23.7,496,0.1,47.4,0,4717,4717,38104
2001,06,e) 4,29983,30837,352684,363042,1078,3.3,5236,16,64559,8041,56518,2.2,17.8,85277,39614,45663,10.9,23.5,-20718,-5.7,35.6,0,3671,3671,25754
2001,06,f) 5,26638,27531,320269,324222,1047,3.6,4437,15.3,60035,7645,52390,2.4,18.5,67941,31153,36788,9.6,21,-7906,-2.5,37,0,3095,3095,21462
2001,06,g) 6 to 10,96268,102402,1336633,1349638,3685,3.4,13654,12.8,224923,48810,176113,3.6,16.7,250934,104709,146225,7.8,18.6,-26011,-1.9,33.4,0,8918,8919,66521
2001,06,h) 11 to 15,77705,88212,1397934,1423093,3309,3.6,9522,10.5,192360,32509,159851,2.3,13.5,242679,81189,161490,5.7,17.1,-50319,-3.6,27,0,5621,5621,39447
2001,06,i) 16 to 20,56125,68747,1275310,1278629,2835,4,6180,8.8,190299,53369,136930,4.2,14.9,196937,62490,134447,4.9,15.4,-6638,-0.5,29.8,0,3208,3216,22597
2001,06,j) 21 to 25,35806,51096,1119920,1128606,2120,4.1,4187,8,151830,35800,116030,3.2,13.5,169202,71394,97808,6.3,15,-17372,-1.5,27,0,1988,2003,13111
2001,06,l) Left Censored,67086,152662,5572783,5550289,11810,7.8,11180,7.4,773863,246852,527011,4.4,13.9,728877,217527,511350,3.9,13.1,44986,0.8,26.2,0,2818,2827,23456
2001,08,a) 0,11468,11553,62101,31379,11462,198.4,0,0,61444,61444,0,195.8,195.8,0,0,0,0,0,61444,195.8,0,0,,,
2001,08,b) 1,8866,9002,66717,65247,96,0.9,2588,25.3,21729,4037,17692,6.2,33.3,18789,10576,8213,16.2,28.8,2940,4.5,57.6,0,1800,1803,8230
2001,08,c) 2,7492,7718,62565,64912,306,3.7,1651,19.8,13457,2684,10773,4.1,20.7,18151,9039,9112,13.9,28,-4694,-7.3,41.4,0,1178,1178,6783
2001,08,d) 3,6805,7083,60391,61385,345,4.6,1242,16.6,13780,4843,8937,7.9,22.4,15767,7426,8341,12.1,25.7,-1987,-3.3,44.8,0,883,883,4971
2001,08,e) 4,5724,5885,53340,56441,212,3.4,970,15.5,7851,932,6919,1.7,13.9,14053,6740,7313,11.9,24.9,-6202,-11,27.8,0,676,676,5142
2001,08,f) 5,5050,5201,49026,50165,178,3.3,741,13.6,8626,1491,7135,3,17.2,10904,5142,5762,10.3,21.7,-2278,-4.5,34.4,0,516,516,3264
2001,08,g) 6 to 10,18271,19232,201750,206229,690,3.4,2401,12,31330,5304,26026,2.6,15.2,40287,16011,24276,7.8,19.5,-8957,-4.3,30.4,0,1579,1579,9774
2001,08,h) 11 to 15,11201,12699,196535,199672,419,3.2,1290,9.8,26183,6147,20036,3.1,13.1,32457,11965,20492,6,16.3,-6274,-3.2,26.2,0,742,742,6152
2001,08,i) 16 to 20,8295,10445,202832,199632,808,7.7,1053,10,46784,24310,22474,12.2,23.4,40383,19027,21356,9.5,20.2,6401,3.2,40.4,0,454,454,2829
2001,08,j) 21 to 25,5249,7492,155502,155549,381,5,551,7.3,21161,7304,13857,4.7,13.6,21254,6209,15045,4,13.7,-93,-0.1,27.2,0,269,269,1611
2001,08,l) Left Censored,11098,24624,841934,830369,2141,8.8,1919,7.8,134202,38762,95440,4.7,16.2,111073,31675,79398,3.8,13.4,23129,2.8,26.8,0,382,383,2989
2001,09,a) 0,4935,4970,29892,15032,4910,197.6,0,0,29720,29720,0,197.7,197.7,0,0,0,0,0,29720,197.7,0,0,,,
2001,09,b) 1,4176,4244,35869,34366,61,1.3,1068,22.5,12476,2109,10367,6.1,36.3,9470,4183,5287,12.2,27.6,3006,8.7,55.2,0,731,731,2741
2001,09,c) 2,3661,3744,35983,36044,134,3.3,705,17.5,8033,1521,6512,4.2,22.3,8154,4262,3892,11.8,22.6,-121,-0.3,44.6,0,516,516,3506
2001,09,d) 3,3609,3829,37091,37229,180,4.5,536,13.4,6846,2257,4589,6.1,18.4,7121,2409,4712,6.5,19.1,-275,-0.7,36.8,0,379,379,1740
2001,09,e) 4,3002,3062,26621,27122,88,2.7,436,13.5,3903,620,3283,2.3,14.4,4904,2048,2856,7.6,18.1,-1001,-3.7,28.8,0,309,309,1462
2001,09,f) 5,2747,2797,34413,35060,82,2.8,402,13.6,3851,507,3344,1.4,11,5144,2174,2970,6.2,14.7,-1293,-3.7,22,0,289,289,1738
2001,09,g) 6 to 10,11095,11496,124421,127649,267,2.2,1282,10.7,14758,2861,11897,2.2,11.6,21213,8080,13133,6.3,16.6,-6455,-5,23.2,0,884,884,5520
2001,09,h) 11 to 15,10022,10796,134861,136162,300,2.7,1026,9.2,16137,4892,11245,3.6,11.9,18738,6228,12510,4.6,13.8,-2601,-1.9,23.8,0,631,631,3402
2001,09,i) 16 to 20,7163,8200,115328,116451,266,3.2,615,7.4,12880,2452,10428,2.1,11.1,15125,4663,10462,4,13,-2245,-1.9,22.2,0,361,362,2434
2001,09,j) 21 to 25,4497,5810,100548,103145,190,3.2,410,6.9,11473,3220,8253,3.1,11.1,16667,5990,10677,5.8,16.2,-5194,-5.1,22.2,0,191,191,1465
2001,09,l) Left Censored,13820,23953,887519,886446,1663,7,1640,6.9,110389,37306,73083,4.2,12.5,108242,38143,70099,4.3,12.2,2147,0.3,24.4,0,477,477,3590
2001,10,a) 0,1604,1618,7798,3959,1596,197.3,0,0,7679,7679,0,194,194,0,0,0,0,0,7679,194,0,0,,,
2001,10,b) 1,1497,1514,9936,9858,21,1.3,345,20.6,2920,203,2717,2.1,29.6,2764,1589,1175,16.1,28,156,1.6,56,0,239,239,1234
2001,10,c) 2,1195,1209,8921,9262,46,3.5,235,18.1,1618,374,1244,4,17.5,2299,1099,1200,11.9,24.8,-681,-7.3,35,0,168,168,876
2001,10,d) 3,1083,1117,8425,9196,50,4.3,177,15.1,1290,327,963,3.6,14,2831,1466,1365,15.9,30.8,-1541,-16.8,28,0,132,132,1323
2001,10,e) 4,848,872,6726,7014,26,2.8,130,14.1,1028,133,895,1.9,14.7,1604,829,775,11.8,22.9,-576,-8.2,29.4,0,94,94,562
2001,10,f) 5,768,795,7657,8019,25,3,102,12.3,889,66,823,0.8,11.1,1612,969,643,12.1,20.1,-723,-9,22.2,0,65,65,700
2001,10,g) 6 to 10,2880,3005,30530,31733,77,2.5,352,11.3,3418,623,2795,2,10.8,5824,2975,2849,9.4,18.4,-2406,-7.6,21.6,0,226,226,1305
2001,10,h) 11 to 15,2044,2203,25671,26269,74,3.3,201,8.9,3020,936,2084,3.6,11.5,4216,1363,2853,5.2,16,-1196,-4.5,23,0,125,125,943
2001,10,i) 16 to 20,1423,1634,27748,28009,66,4,131,7.9,2827,411,2416,1.5,10.1,3349,999,2350,3.6,12,-522,-1.9,20.2,0,67,67,571
2001,10,j) 21 to 25,923,1217,35641,35228,44,3.5,104,8.4,3233,570,2663,1.6,9.2,2406,684,1722,1.9,6.8,827,2.4,13.6,0,41,42,272
2001,10,l) Left Censored,3256,6029,209849,206323,575,9.7,410,6.9,33870,10539,23331,5.1,16.4,26817,5786,21031,2.8,13,7053,3.4,26,0,76,76,597
2001,11,a) 0,1018,1021,8039,4037,1010,197.8,0,0,8005,8005,0,198.3,198.3,0,0,0,0,0,8005,198.3,0,0,,,
2001,11,b) 1,839,847,9021,8429,15,1.6,189,20.2,3421,301,3120,3.6,40.6,2237,1106,1131,13.1,26.5,1184,14.1,53,0,117,117,571
2001,11,c) 2,757,780,9639,9666,45,5.5,122,15,2083,468,1615,4.8,21.5,2136,613,1523,6.3,22.1,-53,-0.6,43,0,79,79,364
2001,11,d) 3,735,763,8539,8377,49,6.2,102,13,2060,847,1213,10.1,24.6,1735,520,1215,6.2,20.7,325,3.9,41.4,0,71,71,322
2001,11,e) 4,658,673,7004,7410,26,3.7,99,14,1013,94,919,1.3,13.7,1825,883,942,11.9,24.6,-812,-10.9,27.4,0,58,58,663
2001,11,f) 5,570,577,6545,6643,17,2.8,84,13.9,1156,338,818,5.1,17.4,1351,884,467,13.3,20.3,-195,-2.9,34.8,0,60,60,650
2001,11,g) 6 to 10,2276,2396,36320,36184,86,3.5,265,10.7,4978,1708,3270,4.7,13.8,4706,1800,2906,5,13,272,0.8,26,0,162,162,1007
2001,11,h) 11 to 15,1843,2063,35244,34861,94,4.5,183,8.7,5446,2404,3042,6.9,15.6,4680,1598,3082,4.6,13.4,766,2.2,26.8,0,94,94,577
2001,11,i) 16 to 20,1622,1834,34177,34717,70,3.7,165,8.8,4348,859,3489,2.5,12.5,5427,2650,2777,7.6,15.6,-1079,-3.1,25,0,73,75,638
2001,11,j) 21 to 25,1083,1417,46441,49039,74,5.2,80,5.6,5382,1196,4186,2.4,11,10577,2746,7831,5.6,21.6,-5195,-10.6,22,0,27,27,60
2001,11,l) Left Censored,3541,5907,228300,227724,366,6.2,423,7.1,26736,8529,18207,3.7,11.7,25584,8809,16775,3.9,11.2,1152,0.5,22.4,0,95,95,856
2001,12,a) 0,36464,36898,196103,98766,36560,198.2,0,0,194674,194674,0,197.1,197.1,0,0,0,0,0,194674,197.1,0,0,,,
2001,12,b) 1,26877,27336,196185,193231,271,0.9,8781,27.8,65990,16500,49490,8.5,34.2,60081,37332,22749,19.3,31.1,5909,3.1,62.2,0,6296,6297,28086
2001,12,c) 2,23189,24022,213440,210885,1000,3.8,5431,20.8,67118,11727,55391,5.6,31.8,62008,35100,26908,16.6,29.4,5110,2.4,58.8,0,3918,3918,28177
2001,12,d) 3,20036,20940,184152,190974,1068,4.8,4059,18.2,39724,10304,29420,5.4,20.8,53368,26354,27014,13.8,27.9,-13644,-7.1,41.6,0,2936,2936,17766
2001,12,e) 4,17035,17420,159460,177960,570,3.1,2982,16.1,32269,6554,25715,3.7,18.1,69269,25464,43805,14.3,38.9,-37000,-20.8,36.2,0,2104,2104,12079
2001,12,f) 5,15236,15812,179208,173195,557,3.3,2555,15.3,55663,3307,52356,1.9,32.1,43638,16218,27420,9.4,25.2,12025,6.9,50.4,0,1798,1798,11933
2001,12,g) 6 to 10,57375,60555,718523,729669,1998,3.2,8123,12.8,152257,62696,89561,8.6,20.9,174549,62878,111671,8.6,23.9,-22292,-3,41.8,0,5337,5338,35315
2001,12,h) 11 to 15,39123,44188,725376,725510,1510,3.3,4596,10.1,110816,20836,89980,2.9,15.3,111083,44835,66248,6.2,15.3,-267,0,30.6,0,2697,2697,18078
2001,12,i) 16 to 20,25435,30742,602924,600891,1177,3.7,2890,9.2,85112,13719,71393,2.3,14.2,81046,30872,50174,5.1,13.5,4066,0.7,27,0,1453,1457,11155
2001,12,j) 21 to 25,14100,20846,415008,416215,1094,5.2,1844,8.7,58666,18550,40116,4.5,14.1,61079,24466,36613,5.9,14.7,-2413,-0.6,28.2,0,802,804,4564
2001,12,l) Left Censored,28139,79433,2865954,2851167,6651,8.4,6175,7.8,456458,137694,318764,4.8,16,426885,109215,317670,3.8,15,29573,1,30,0,1110,1120,8647
2001,13,a) 0,15000,15169,94309,47630,15046,198.4,0,0,93358,93358,0,196,196,0,0,0,0,0,93358,196,0,0,,,
2001,13,b) 1,12103,12248,100811,99389,111,0.8,3608,25.8,33011,5828,27183,5.9,33.2,30166,16850,13316,17,30.4,2845,2.8,60.8,0,2575,2577,13344
2001,13,c) 2,10381,10676,114168,116082,471,4.1,2335,20.2,27688,5108,22580,4.4,23.9,31515,15838,15677,13.6,27.1,-3827,-3.2,47.8,0,1681,1681,12456
2001,13,d) 3,9335,9781,101005,102561,470,4.5,1816,17.4,21707,7604,14103,7.4,21.2,24819,10256,14563,10,24.2,-3112,-3,42.4,0,1286,1286,7984
2001,13,e) 4,7749,7958,76675,79680,294,3.5,1394,16.5,13536,1958,11578,2.5,17,19545,9407,10138,11.8,24.5,-6009,-7.5,34,0,990,990,5655
2001,13,f) 5,6891,7115,70453,71832,269,3.6,1096,14.6,12219,2681,9538,3.7,17,14976,6674,8302,9.3,20.8,-2757,-3.8,34,0,749,749,4394
2001,13,g) 6 to 10,24396,26267,314734,322504,942,3.4,3305,12.1,48461,11317,37144,3.5,15,64000,28721,35279,8.9,19.8,-15539,-4.8,30,0,2157,2157,18769
2001,13,h) 11 to 15,16258,18865,313022,320389,658,3.4,1911,9.8,35831,7678,28153,2.4,11.2,50565,15453,35112,4.8,15.8,-14734,-4.6,22.4,0,1074,1075,6878
2001,13,i) 16 to 20,12141,14722,259394,262185,600,4,1261,8.4,35226,9067,26159,3.5,13.4,40807,11509,29298,4.4,15.6,-5581,-2.2,26.8,0,605,605,4411
2001,13,j) 21 to 25,7146,10742,241525,243500,617,5.7,946,8.7,30147,10723,19424,4.4,12.4,34097,11739,22358,4.8,14,-3950,-1.6,24.8,0,348,348,1908
2001,13,l) Left Censored,17764,45588,1748748,1772895,3765,8.3,3710,8.2,222719,83225,139494,4.7,12.6,271015,77259,193756,4.4,15.3,-48296,-2.7,25.2,0,634,634,5596
2001,15,a) 0,1831,1851,16909,8581,1838,198.6,0,0,16656,16656,0,194.1,194.1,0,0,0,0,0,16656,194.1,0,0,,,
2001,15,b) 1,1495,1535,12471,12206,22,1.3,365,21.4,3775,812,2963,6.7,30.9,3245,1564,1681,12.8,26.6,530,4.3,53.2,0,275,277,980
2001,15,c) 2,1164,1224,10927,11038,45,3.4,222,17,2201,449,1752,4.1,19.9,2423,1312,1111,11.9,22,-222,-2.1,39.8,0,155,155,934
2001,15,d) 3,1120,1173,12591,13049,53,4.3,180,14.6,2008,633,1375,4.9,15.4,2923,1521,1402,11.7,22.4,-915,-7,30.8,0,126,126,1202
2001,15,e) 4,965,978,8821,9079,20,1.9,153,14.7,1222,92,1130,1,13.5,1738,961,777,10.6,19.1,-516,-5.6,27,0,110,110,848
2001,15,f) 5,924,955,9643,9853,21,2.1,125,12.5,1261,54,1207,0.5,12.8,1681,921,760,9.3,17.1,-420,-4.3,25.6,0,91,91,753
2001,15,g) 6 to 10,3564,3764,46577,46964,114,2.9,376,9.7,4972,600,4372,1.3,10.6,5745,2269,3476,4.8,12.2,-773,-1.6,21.2,0,244,244,1469
2001,15,h) 11 to 15,2834,3261,41604,41812,99,3,310,9.3,4341,761,3580,1.8,10.4,4756,1902,2854,4.5,11.4,-415,-1,20.8,0,160,160,1157
2001,15,i) 16 to 20,2363,2858,40383,40433,107,3.7,192,6.6,4747,749,3998,1.9,11.7,4846,2166,2680,5.4,12,-99,-0.3,23.4,0,110,110,586
2001,15,j) 21 to 25,1687,2388,35125,36437,130,5.4,184,7.6,3707,902,2805,2.5,10.2,6330,3408,2922,9.4,17.4,-2623,-7.2,20.4,0,62,62,2026
2001,15,l) Left Censored,3906,7418,213848,212623,404,5.4,418,5.6,23105,7796,15309,3.7,10.9,20655,4849,15806,2.3,9.7,2450,1.2,19.4,0,102,102,347
2001,16,a) 0,2967,2999,31736,15909,2971,198.1,0,0,31654,31654,0,199,199,0,0,0,0,0,31654,199,0,0,,,
2001,16,b) 1,2300,2368,20902,19475,38,1.4,702,26,7347,555,6792,2.8,37.7,4493,2611,1882,13.4,23.1,2854,14.6,46.2,0,462,462,1832
2001,16,c) 2,1985,2038,14840,15519,80,3.6,442,20,3048,798,2250,5.1,19.6,4406,2112,2294,13.6,28.4,-1358,-8.8,39.2,0,301,301,1602
2001,16,d) 3,1732,1836,16150,17101,97,5,352,18.1,2535,676,1859,4,14.8,4437,1972,2465,11.5,25.9,-1902,-11.1,29.6,0,232,232,1572
2001,16,e) 4,1582,1626,12713,13408,66,3.8,289,16.7,1679,318,1361,2.4,12.5,3069,1572,1497,11.7,22.9,-1390,-10.4,25,0,190,190,1085
2001,16,f) 5,1428,1470,15132,16305,48,3.1,228,14.7,1722,224,1498,1.4,10.6,4068,1232,2836,7.6,24.9,-2346,-14.3,21.2,0,141,141,876
2001,16,g) 6 to 10,4786,4946,41988,43509,152,2.9,717,13.8,6426,880,5546,2,14.8,9467,3903,5564,9,21.8,-3041,-7,29.6,0,422,422,2207
2001,16,h) 11 to 15,3022,3395,43079,44234,118,3.4,370,10.5,5447,1249,4198,2.8,12.3,7757,3129,4628,7.1,17.5,-2310,-5.2,24.6,0,200,200,1642
2001,16,i) 16 to 20,2211,2699,36606,37081,129,4.7,267,9.7,4784,1758,3026,4.7,12.9,5733,2173,3560,5.9,15.5,-949,-2.6,25.8,0,123,123,574
2001,16,j) 21 to 25,1560,2056,47720,46779,78,3.7,184,8.7,5892,1498,4394,3.2,12.6,4009,1000,3009,2.1,8.6,1883,4,17.2,0,92,92,494
2001,16,l) Left Censored,4195,7641,201563,195648,732,9.6,776,10.2,33955,15178,18777,7.8,17.4,22125,7186,14939,3.7,11.3,11830,6.1,22.6,0,123,124,1129
2001,17,a) 0,17905,18041,111943,56327,17875,198.2,0,0,111233,111233,0,197.5,197.5,0,0,0,0,0,111233,197.5,0,0,,,
2001,17,b) 1,14982,15262,122326,121867,172,1,3896,22.8,33162,5156,28006,4.2,27.2,32243,17060,15183,14,26.5,919,0.7,53,0,2718,2720,12361
2001,17,c) 2,13318,13715,130758,131601,501,3.4,2575,17.5,31402,8692,22710,6.6,23.9,33089,15106,17983,11.5,25.1,-1687,-1.2,47.8,0,1886,1887,11876
2001,17,d) 3,12410,13065,134338,136608,584,4.3,1975,14.4,25699,6525,19174,4.8,18.8,30238,11629,18609,8.5,22.1,-4539,-3.3,37.6,0,1442,1442,8647
2001,17,e) 4,10951,11503,105711,108796,315,2.6,1675,13.8,18399,2261,16138,2.1,16.9,24568,11080,13488,10.2,22.6,-6169,-5.7,33.8,0,1149,1149,7213
2001,17,f) 5,9959,10131,96764,99799,300,2.8,1359,12.8,15319,2940,12379,2.9,15.3,21389,8121,13268,8.1,21.4,-6070,-6.1,30.6,0,948,948,5794
2001,17,g) 6 to 10,38638,40668,456253,469579,1153,2.7,4543,10.8,61657,11110,50547,2.4,13.1,88308,31564,56744,6.7,18.8,-26651,-5.7,26.2,0,2946,2946,19824
2001,17,h) 11 to 15,28699,32118,526598,527167,872,2.6,2977,9,66880,13857,53023,2.6,12.7,68019,23589,44430,4.5,12.9,-1139,-0.2,25.4,0,1793,1793,11605
2001,17,i) 16 to 20,21900,25503,479816,485944,735,2.8,2040,7.8,56190,12894,43296,2.7,11.6,68445,22613,45832,4.7,14.1,-12255,-2.5,23.2,0,1115,1115,8624
2001,17,j) 21 to 25,13972,19094,385270,389771,611,3.1,1365,7,42554,10988,31566,2.8,10.9,51556,14064,37492,3.6,13.2,-9002,-2.3,21.8,0,668,671,4538
2001,17,l) Left Censored,40625,77923,2842903,2888602,4776,6.1,5541,7.1,308462,102212,206250,3.5,10.7,399861,111290,288571,3.9,13.8,-91399,-3.1,21.4,0,1463,1479,12722
2001,18,a) 0,8291,8463,52541,26533,8377,198,0,0,52017,52017,0,196,196,0,0,0,0,0,52017,196,0,0,,,
2001,18,b) 1,6737,6865,62776,61339,87,1.1,1980,25.3,22108,2532,19576,4.1,36,19234,8943,10291,14.6,31.4,2874,4.6,62.8,0,1454,1459,6913
2001,18,c) 2,6058,6252,55682,57602,217,3.2,1200,17.9,10600,2517,8083,4.4,18.4,14439,7163,7276,12.4,25.1,-3839,-6.7,36.8,0,907,907,5818
2001,18,d) 3,5696,6171,69192,71429,280,4.3,1049,16.1,12605,4226,8379,5.9,17.6,17079,7850,9229,11,23.9,-4474,-6.3,35.2,0,753,753,6432
2001,18,e) 4,4950,5159,44130,46696,142,2.6,814,14.9,6787,852,5935,1.8,14.5,11918,4467,7451,9.6,25.5,-5131,-11,29,0,611,611,3522
2001,18,f) 5,4482,4617,51425,52824,131,2.7,722,14.7,7031,1106,5925,2.1,13.3,9828,4684,5144,8.9,18.6,-2797,-5.3,26.6,0,486,486,3303
2001,18,g) 6 to 10,17888,19117,203763,210817,486,2.4,2111,10.6,26162,3363,22799,1.6,12.4,40270,18850,21420,8.9,19.1,-14108,-6.7,24.8,0,1410,1410,10716
2001,18,h) 11 to 15,13032,15173,242781,249049,443,2.8,1393,8.9,26856,7340,19516,2.9,10.8,39391,12673,26718,5.1,15.8,-12535,-5,21.6,0,794,794,5384
2001,18,i) 16 to 20,10320,12172,192824,196603,310,2.5,1018,8.1,23559,3002,20557,1.5,12,31116,9406,21710,4.8,15.8,-7557,-3.8,24,0,521,523,3651
2001,18,j) 21 to 25,6584,9189,191496,193047,326,3.5,604,6.5,21834,7702,14132,4,11.3,24935,6297,18638,3.3,12.9,-3101,-1.6,22.6,0,294,296,1707
2001,18,l) Left Censored,19114,39999,1424963,1462307,2443,6.1,2915,7.3,139344,40238,99106,2.8,9.5,214032,72851,141181,5,14.6,-74688,-5.1,19,0,666,666,6420
2001,19,a) 0,4021,4057,24607,12383,4015,197.9,0,0,24448,24448,0,197.4,197.4,0,0,0,0,0,24448,197.4,0,0,,,
2001,19,b) 1,3500,3547,26741,27471,34,0.9,939,23.5,6096,560,5536,2,22.2,7555,3651,3904,13.3,27.5,-1459,-5.3,44.4,0,641,641,2606
2001,19,c) 2,3026,3126,24504,34940,119,3.5,605,18,4350,1608,2742,4.6,12.4,25222,2650,22572,7.6,72.2,-20872,-59.8,24.8,0,405,405,1893
2001,19,d) 3,2873,3037,25869,26741,124,3.9,505,15.7,4160,1296,2864,4.8,15.6,5904,2379,3525,8.9,22.1,-1744,-6.5,31.2,0,356,356,1996
2001,19,e) 4,2552,2650,23275,24275,53,1.9,391,13.9,3254,310,2944,1.3,13.4,5253,2295,2958,9.5,21.6,-1999,-8.2,26.8,0,267,267,1781
2001,19,f) 5,2351,2421,20769,21984,57,2.2,353,13.8,2592,408,2184,1.9,11.8,5021,2492,2529,11.3,22.8,-2429,-11,23.6,0,267,267,2217
2001,19,g) 6 to 10,9355,9849,92304,93976,244,2.4,1161,11.3,12749,3372,9377,3.6,13.6,16093,5635,10458,6,17.1,-3344,-3.5,27.2,0,784,784,3566
2001,19,h) 11 to 15,6773,7610,119531,121061,177,2.3,662,8.5,10434,2921,7513,2.4,8.6,13493,4485,9008,3.7,11.1,-3059,-2.5,17.2,0,415,415,2191
2001,19,i) 16 to 20,5959,7225,100529,103489,241,3.3,546,7.4,8886,2036,6850,2,8.6,14805,4164,10641,4,14.3,-5919,-5.7,17.2,0,295,295,1595
2001,19,j) 21 to 25,4375,6410,93929,95169,172,2.6,396,6.1,8185,2008,6177,2.1,8.6,10665,2293,8372,2.4,11.2,-2480,-2.6,17.2,0,195,196,857
2001,19,l) Left Censored,14928,25052,700708,714590,1605,6.4,1852,7.4,66104,17812,48292,2.5,9.3,93867,21205,72662,3,13.1,-27763,-3.8,18.6,0,472,472,3648
2001,20,a) 0,4520,4576,26937,13567,4542,198.5,0,0,26740,26740,0,197.1,197.1,0,0,0,0,0,26740,197.1,0,0,,,
2001,20,b) 1,3636,3682,29188,29722,37,0.9,1126,26.6,7892,1605,6287,5.4,26.6,8959,4572,4387,15.4,30.1,-1067,-3.5,53.2,0,809,809,3448
2001,20,c) 2,3158,3261,24955,27016,130,3.7,691,19.6,4948,1381,3567,5.1,18.3,9069,4970,4099,18.4,33.6,-4121,-15.3,36.6,0,497,497,2257
2001,20,d) 3,3042,3219,33453,34052,170,5,517,15.3,6184,2285,3899,6.7,18.2,7382,2360,5022,6.9,21.7,-1198,-3.5,36.4,0,385,385,1685
2001,20,e) 4,2564,2651,23772,25628,85,3,456,16.1,3334,423,2911,1.7,13,7045,2310,4735,9,27.5,-3711,-14.5,26,0,312,312,1776
2001,20,f) 5,2422,2483,20818,21340,69,2.7,330,12.7,3230,435,2795,2,15.1,4273,1753,2520,8.2,20,-1043,-4.9,30.2,0,229,229,1343
2001,20,g) 6 to 10,8691,9148,91982,94805,289,3,1148,12,11789,2171,9618,2.3,12.4,17434,7457,9977,7.9,18.4,-5645,-6,24.8,0,760,760,4920
2001,20,h) 11 to 15,6259,6918,88727,91070,183,2.6,664,9.3,8975,1563,7412,1.7,9.9,13661,4387,9274,4.8,15,-4686,-5.1,19.8,0,416,416,2680
2001,20,i) 16 to 20,5581,6526,88067,90576,217,3.3,529,7.9,9948,2483,7465,2.7,11,14966,6258,8708,6.9,16.5,-5018,-5.5,22,0,284,284,4056
2001,20,j) 21 to 25,3601,5167,83231,83925,205,3.9,375,7.2,10683,3185,7498,3.8,12.7,12070,4195,7875,5,14.4,-1387,-1.7,25.4,0,173,173,1148
2001,20,l) Left Censored,11664,20819,598555,604729,1411,6.8,1507,7.2,58132,18208,39924,3,9.6,70480,18231,52249,3,11.7,-12348,-2.1,19.2,0,356,357,2428
2001,21,a) 0,5340,5374,33641,16916,5342,198.8,0,0,33450,33450,0,197.7,197.7,0,0,0,0,0,33450,197.7,0,0,,,
2001,21,b) 1,4403,4489,34719,36254,73,1.4,1290,25.3,8867,1192,7675,3.3,24.5,11936,7108,4828,19.6,32.9,-3069,-8.4,49,0,955,956,5725
2001,21,c) 2,3953,4074,39255,41443,144,3.3,819,18.6,6577,1267,5310,3.1,15.9,10952,4739,6213,11.4,26.4,-4375,-10.5,31.8,0,595,595,3490
2001,21,d) 3,3727,3983,39456,39653,182,4.3,667,15.8,7956,2607,5349,6.6,20.1,8350,3584,4766,9,21.1,-394,-1,40.2,0,502,502,2882
2001,21,e) 4,3111,3282,28018,29766,84,2.4,537,15.4,3632,452,3180,1.5,12.2,7127,3355,3772,11.3,23.9,-3495,-11.7,24.4,0,401,401,2757
2001,21,f) 5,2788,2899,29171,30416,85,2.8,411,13.5,3699,444,3255,1.5,12.2,6188,2880,3308,9.5,20.3,-2489,-8.1,24.4,0,298,298,2137
2001,21,g) 6 to 10,11055,11730,122650,126343,288,2.4,1346,11,16554,2059,14495,1.6,13.1,23939,9486,14453,7.5,18.9,-7385,-5.8,26.2,0,926,926,5607
2001,21,h) 11 to 15,8242,9250,148442,150188,240,2.5,826,8.7,17655,2869,14786,1.9,11.8,21147,6223,14924,4.1,14.1,-3492,-2.3,23.6,0,496,496,2927
2001,21,i) 16 to 20,6537,7618,119496,121496,224,2.9,521,6.7,12709,4075,8634,3.4,10.5,16708,5156,11552,4.2,13.8,-3999,-3.3,21,0,255,255,2136
2001,21,j) 21 to 25,3875,5465,115895,116525,200,3.6,413,7.4,12221,2691,9530,2.3,10.5,13480,3216,10264,2.8,11.6,-1259,-1.1,21,0,201,206,1235
2001,21,l) Left Censored,11688,24078,792841,803982,1542,6.4,1732,7.2,82729,22523,60206,2.8,10.3,105010,29941,75069,3.7,13.1,-22281,-2.8,20.6,0,352,353,2085
2001,22,a) 0,6081,6170,45397,22868,6094,197.5,0,0,45058,45058,0,197,197,0,0,0,0,0,45058,197,0,0,,,
2001,22,b) 1,4870,4998,54854,53133,49,0.9,1412,24.9,15510,772,14738,1.5,29.2,12068,6599,5469,12.4,22.7,3442,6.5,45.4,0,1014,1015,4759
2001,22,c) 2,4224,4360,41640,43313,184,3.9,914,19.4,10590,3591,6999,8.3,24.4,13936,6161,7775,14.2,32.2,-3346,-7.8,48.8,0,670,670,4884
2001,22,d) 3,4114,4384,45547,46759,194,4.2,730,15.8,8918,2507,6411,5.4,19.1,11341,3692,7649,7.9,24.3,-2423,-5.2,38.2,0,529,529,2625
2001,22,e) 4,3598,3665,38010,38595,115,3,545,14.1,7103,1422,5681,3.7,18.4,8272,3449,4823,8.9,21.4,-1169,-3,36.8,0,391,391,2641
2001,22,f) 5,3183,3258,36260,37148,106,3.1,454,13.3,4751,961,3790,2.6,12.8,6526,3000,3526,8.1,17.6,-1775,-4.8,25.6,0,301,301,1814
2001,22,g) 6 to 10,12502,13220,149938,154271,358,2.6,1569,11.4,19269,2249,17020,1.5,12.5,27934,11394,16540,7.4,18.1,-8665,-5.6,25,0,1098,1098,8429
2001,22,h) 11 to 15,8482,9528,156510,159892,276,2.8,924,9.4,16689,4094,12595,2.6,10.4,23452,7264,16188,4.5,14.7,-6763,-4.3,20.8,0,507,507,3706
2001,22,i) 16 to 20,8156,9617,135424,137055,310,3.2,707,7.2,15628,2420,13208,1.8,11.4,18889,5452,13437,4,13.8,-3261,-2.4,22.8,0,385,385,2486
2001,22,j) 21 to 25,5077,7007,130579,131638,286,4,548,7.7,14202,4034,10168,3.1,10.8,16320,4312,12008,3.3,12.4,-2118,-1.6,21.6,0,266,267,1614
2001,22,l) Left Censored,12456,25814,747978,756637,1620,6.2,1980,7.6,89633,27716,61917,3.7,11.8,106953,31298,75655,4.1,14.1,-17320,-2.3,23.6,0,417,417,3070
2001,23,a) 0,2555,2572,12505,6295,2546,198,0,0,12421,12421,0,197.3,197.3,0,0,0,0,0,12421,197.3,0,0,,,
2001,23,b) 1,2073,2108,15257,15579,17,0.7,551,23.2,3650,366,3284,2.3,23.4,4294,1784,2510,11.5,27.6,-644,-4.2,46.8,0,356,356,1352
2001,23,c) 2,1919,1983,13530,13986,96,4.6,351,16.7,2803,861,1942,6.2,20,3714,1792,1922,12.8,26.6,-911,-6.6,40,0,239,239,1392
2001,23,d) 3,1782,1924,14017,14035,120,6,289,14.4,2731,1236,1495,8.8,19.5,2766,954,1812,6.8,19.7,-35,-0.2,39,0,211,211,645
2001,23,e) 4,1474,1504,9320,9690,34,2.1,223,14,1284,68,1216,0.7,13.3,2024,986,1038,10.2,20.9,-740,-7.6,26.6,0,173,173,830
2001,23,f) 5,1364,1398,10311,10846,48,3.3,195,13.3,1375,150,1225,1.4,12.7,2445,987,1458,9.1,22.5,-1070,-9.8,25.4,0,131,131,748
2001,23,g) 6 to 10,4756,4969,41804,42582,136,2.6,554,10.7,5551,556,4995,1.3,13,7106,2995,4111,7,16.7,-1555,-3.7,26,0,394,394,2046
2001,23,h) 11 to 15,4120,4435,50533,52297,124,2.7,431,9.4,4759,823,3936,1.6,9.1,8286,2241,6045,4.3,15.8,-3527,-6.7,18.2,0,287,287,1594
2001,23,i) 16 to 20,2746,3223,45916,46087,107,3.3,244,7.4,4231,907,3324,2,9.2,4573,1627,2946,3.5,9.9,-342,-0.7,18.4,0,134,134,767
2001,23,j) 21 to 25,1753,2609,45674,44722,197,7.6,188,7.2,6822,2439,4383,5.5,15.3,4917,1310,3607,2.9,11,1905,4.3,22,0,65,65,336
2001,23,l) Left Censored,4529,7889,234853,234668,412,5.2,454,5.7,25131,8677,16454,3.7,10.7,24762,7394,17368,3.2,10.6,369,0.1,21.2,0,140,143,712
2001,24,a) 0,8317,8366,49969,25114,8286,198.1,0,0,49710,49710,0,197.9,197.9,0,0,0,0,0,49710,197.9,0,0,,,
2001,24,b) 1,6525,6637,48930,48441,84,1.1,1713,23,14377,1752,12625,3.6,29.7,13399,7444,5955,15.4,27.7,978,2,55.4,0,1174,1174,5707
2001,24,c) 2,5967,6134,58026,58372,225,3.4,1111,16.9,13009,2366,10643,4.1,22.3,13701,7263,6438,12.4,23.5,-692,-1.2,44.6,0,797,797,6138
2001,24,d) 3,5448,5744,59843,62692,301,5,890,14.8,12987,4566,8421,7.3,20.7,18684,9177,9507,14.6,29.8,-5697,-9.1,41.4,0,623,623,6182
2001,24,e) 4,4826,4921,47207,47400,201,3.9,762,14.7,9284,1475,7809,3.1,19.6,9670,4480,5190,9.5,20.4,-386,-0.8,39.2,0,534,534,3105
2001,24,f) 5,4196,4273,40345,40548,144,3.2,578,12.9,6639,1654,4985,4.1,16.4,7045,3258,3787,8,17.4,-406,-1,32.8,0,389,389,2288
2001,24,g) 6 to 10,16231,17187,199477,201598,515,2.9,1964,11,30246,5617,24629,2.8,15,34488,14654,19834,7.3,17.1,-4242,-2.1,30,0,1234,1234,8887
2001,24,h) 11 to 15,12970,14370,217041,218490,514,3.5,1251,8.5,28702,7671,21031,3.5,13.1,31599,10061,21538,4.6,14.5,-2897,-1.4,26.2,0,711,711,5325
2001,24,i) 16 to 20,8743,10369,162393,163387,372,3.5,729,6.9,19578,3677,15901,2.3,12,21566,5380,16186,3.3,13.2,-1988,-1.2,24,0,383,384,2003
2001,24,j) 21 to 25,5158,7254,150955,152396,284,3.8,555,7.5,18396,5429,12967,3.6,12.1,21277,7801,13476,5.1,14,-2881,-1.9,24.2,0,236,237,1952
2001,24,l) Left Censored,13928,29440,1041677,1039107,2090,7.1,2342,7.9,125068,42854,82214,4.1,12,119928,37120,82808,3.6,11.5,5140,0.5,23,0,478,482,4412
2001,25,a) 0,9762,9832,62036,31461,9750,198.3,0,0,61150,61150,0,194.4,194.4,0,0,0,0,0,61150,194.4,0,0,,,
2001,25,b) 1,8403,8563,71133,69188,120,1.3,2009,21.1,22972,3862,19110,5.6,33.2,19081,9028,10053,13,27.6,3891,5.6,55.2,0,1382,1382,7025
2001,25,c) 2,7466,7673,73079,73508,275,3.4,1343,16.4,17296,3894,13402,5.3,23.5,18153,8916,9237,12.1,24.7,-857,-1.2,47,0,992,992,6740
2001,25,d) 3,7020,7336,78395,81527,334,4.3,1109,14.4,17573,4772,12801,5.9,21.6,23836,13384,10452,16.4,29.2,-6263,-7.6,43.2,0,792,792,12264
2001,25,e) 4,6113,6211,61610,62332,203,3.1,905,13.8,10945,1158,9787,1.9,17.6,12388,5843,6545,9.4,19.9,-1443,-2.3,35.2,0,639,639,4520
2001,25,f) 5,5397,5482,52885,54093,158,2.8,693,12.1,8364,628,7736,1.2,15.5,10779,4418,6361,8.2,19.9,-2415,-4.4,31,0,515,515,3709
2001,25,g) 6 to 10,20302,21215,246678,249478,570,2.6,2358,10.7,36602,6150,30452,2.5,14.7,42202,17356,24846,7,16.9,-5600,-2.2,29.4,0,1598,1598,11025
2001,25,h) 11 to 15,17198,19156,304525,306969,579,2.9,1745,8.9,37021,7677,29344,2.5,12.1,41909,15066,26843,4.9,13.7,-4888,-1.6,24.2,0,1017,1017,6289
2001,25,i) 16 to 20,12459,14723,289685,291084,459,3.1,1124,7.5,35919,9967,25952,3.4,12.3,38717,12349,26368,4.2,13.3,-2798,-1,24.6,0,596,600,4275
2001,25,j) 21 to 25,7544,10419,251805,248621,375,3.5,697,6.6,34705,6812,27893,2.7,14,28337,7830,20507,3.1,11.4,6368,2.6,22.8,0,304,304,1487
2001,25,l) Left Censored,25188,44102,1593280,1596680,3084,7,2999,6.8,195442,54014,141428,3.4,12.2,202241,52925,149316,3.3,12.7,-6799,-0.5,24.4,0,912,912,9721
2001,26,a) 0,13710,13803,98413,49460,13662,198,0,0,97906,97906,0,197.9,197.9,0,0,0,0,0,97906,197.9,0,0,,,
2001,26,b) 1,11280,11463,97731,96851,102,0.8,3239,24.9,28094,3498,24596,3.6,29,26334,14443,11891,14.9,27.2,1760,1.8,54.4,0,2210,2214,10255
2001,26,c) 2,10016,10362,99847,106703,367,3.3,1956,17.6,18499,3829,14670,3.6,17.3,32210,13746,18464,12.9,30.2,-13711,-12.9,34.6,0,1417,1417,11233
2001,26,d) 3,9495,10107,102633,106232,430,4.1,1537,14.5,18815,5372,13443,5.1,17.7,26013,10576,15437,10,24.5,-7198,-6.8,35.4,0,1086,1086,7031
2001,26,e) 4,8541,9019,84379,88772,252,2.6,1439,15,12453,1832,10621,2.1,14,21239,10357,10882,11.7,23.9,-8786,-9.9,28,0,986,986,7901
2001,26,f) 5,7819,7948,81068,85555,201,2.4,1164,13.9,9780,924,8856,1.1,11.4,18754,7745,11009,9.1,21.9,-8974,-10.5,22.8,0,803,803,5977
2001,26,g) 6 to 10,29451,30970,325018,342931,845,2.6,3670,11.4,43275,8815,34460,2.6,12.6,79100,25971,53129,7.6,23.1,-35825,-10.5,25.2,0,2396,2396,15995
2001,26,h) 11 to 15,22313,25202,349096,362611,724,2.8,2360,9.1,38792,10882,27910,3,10.7,65821,19107,46714,5.3,18.2,-27029,-7.5,21.4,0,1389,1389,8384
2001,26,i) 16 to 20,16413,19870,332993,337121,628,3.1,1479,7.3,41160,10594,30566,3.1,12.2,49416,16430,32986,4.9,14.7,-8256,-2.5,24.4,0,764,766,6254
2001,26,j) 21 to 25,10395,14263,255017,258825,458,3.2,1031,7.1,31571,10058,21513,3.9,12.2,39187,10060,29127,3.9,15.1,-7616,-2.9,24.4,0,470,470,3363
2001,26,l) Left Censored,28014,57809,2153989,2172286,3771,6.5,3982,6.9,257149,72153,184996,3.3,11.8,293744,89878,203866,4.1,13.5,-36595,-1.7,23.6,0,1002,1003,11620
2001,27,a) 0,8766,8849,52661,26430,8782,198.5,0,0,52462,52462,0,198.5,198.5,0,0,0,0,0,52462,198.5,0,0,,,
2001,27,b) 1,7175,7281,55347,54994,94,1.2,1725,21.3,15782,2804,12978,5.1,28.7,15075,8129,6946,14.8,27.4,707,1.3,54.8,0,1151,1151,5648
2001,27,c) 2,6325,6560,60411,60855,238,3.4,1150,16.4,11674,2502,9172,4.1,19.2,12562,6452,6110,10.6,20.6,-888,-1.4,38.4,0,800,800,5169
2001,27,d) 3,5940,6362,62711,63378,325,4.9,944,14.2,11965,4501,7464,7.1,18.9,13298,6261,7037,9.9,21,-1333,-2.1,37.8,0,624,624,4831
2001,27,e) 4,5250,5414,46185,47086,156,2.7,774,13.6,7761,901,6860,1.9,16.5,9562,4406,5156,9.4,20.3,-1801,-3.8,33,0,512,512,2779
2001,27,f) 5,4732,4817,44201,44235,118,2.3,593,11.8,6992,603,6389,1.4,15.8,7060,3122,3938,7.1,16,-68,-0.2,31.6,0,420,420,2318
2001,27,g) 6 to 10,17669,18692,197192,202649,505,2.6,1978,10.2,26114,4464,21650,2.2,12.9,37028,14404,22624,7.1,18.3,-10914,-5.4,25.8,0,1240,1240,8909
2001,27,h) 11 to 15,12412,13995,202385,204393,408,2.8,1209,8.4,23989,4967,19022,2.4,11.7,28005,9314,18691,4.6,13.7,-4016,-2,23.4,0,749,749,5671
2001,27,i) 16 to 20,9173,11369,230631,233081,503,4.4,810,7,32108,12381,19727,5.3,13.8,37007,12285,24722,5.3,15.9,-4899,-2.1,27.6,0,440,443,3944
2001,27,j) 21 to 25,6237,8597,168355,168959,319,3.7,571,6.6,20382,6065,14317,3.6,12.1,21590,6621,14969,3.9,12.8,-1208,-0.7,24.2,0,273,273,2171
2001,27,l) Left Censored,18360,33985,1307510,1307595,2647,7.8,2330,6.9,153368,46554,106814,3.6,11.7,153539,41035,112504,3.1,11.7,-171,0,23.4,0,497,499,4889
2001,28,a) 0,3722,3752,23914,12010,3730,198.8,0,0,23809,23809,0,198.2,198.2,0,0,0,0,0,23809,198.2,0,0,,,
2001,28,b) 1,2888,2984,22859,23947,39,1.1,975,28.2,5852,687,5165,2.9,24.4,8027,5196,2831,21.7,33.5,-2175,-9.1,48.8,0,713,713,3739
2001,28,c) 2,2678,2775,23094,23954,113,3.7,661,21.8,5298,930,4368,3.9,22.1,7018,3601,3417,15,29.3,-1720,-7.2,44.2,0,491,491,3097
2001,28,d) 3,2385,2515,23925,26053,102,3.8,470,17.5,3855,1238,2617,4.8,14.8,8110,2531,5579,9.7,31.1,-4255,-16.3,29.6,0,334,334,1734
2001,28,e) 4,2055,2107,16981,17682,80,3.6,378,16.8,2638,431,2207,2.4,14.9,4040,1920,2120,10.9,22.8,-1402,-7.9,29.8,0,273,273,1460
2001,28,f) 5,1887,1946,21091,22097,58,2.8,319,15.4,2500,292,2208,1.3,11.3,4512,1491,3021,6.7,20.4,-2012,-9.1,22.6,0,224,224,1105
2001,28,g) 6 to 10,7157,7626,78759,81957,242,3,1017,12.8,9962,1543,8419,1.9,12.2,16358,6258,10100,7.6,20,-6396,-7.8,24.4,0,674,674,3868
2001,28,h) 11 to 15,4798,5302,78686,82063,145,2.6,604,11,8816,1316,7500,1.6,10.7,15569,6828,8741,8.3,19,-6753,-8.3,21.4,0,373,373,3298
2001,28,i) 16 to 20,4405,5109,72470,74801,197,3.8,435,8.3,8667,1697,6970,2.3,11.6,13329,3977,9352,5.3,17.8,-4662,-6.2,23.2,0,250,250,1764
2001,28,j) 21 to 25,2864,3843,84842,86790,157,4,435,11,9824,3192,6632,3.7,11.3,13720,4081,9639,4.7,15.8,-3896,-4.5,22.6,0,155,155,1034
2001,28,l) Left Censored,7790,16041,474823,486668,971,6,1144,7.1,43355,12602,30753,2.6,8.9,67045,18418,48627,3.8,13.8,-23690,-4.9,17.8,0,277,277,1442
2001,29,a) 0,8738,8834,52135,26402,8757,198.3,0,0,51466,51466,0,194.9,194.9,0,0,0,0,0,51466,194.9,0,0,,,
2001,29,b) 1,7397,7492,57400,57937,72,0.8,2263,26.4,16205,3226,12979,5.6,28,17279,9226,8053,15.9,29.8,-1074,-1.8,56,0,1615,1616,7276
2001,29,c) 2,6455,6668,58036,59553,240,3.3,1445,19.9,12548,2555,9993,4.3,21.1,15582,7852,7730,13.2,26.2,-3034,-5.1,42.2,0,1065,1065,6168
2001,29,d) 3,5895,6312,66535,67968,294,4.4,1088,16.3,14049,6242,7807,9.2,20.7,16915,6644,10271,9.8,24.9,-2866,-4.2,41.4,0,825,825,5002
2001,29,e) 4,5112,5245,45903,46315,147,2.6,874,15.6,8792,1189,7603,2.6,19,9616,4289,5327,9.3,20.8,-824,-1.8,38,0,639,639,3206
2001,29,f) 5,4550,4679,46246,47128,147,3,671,13.6,7473,1639,5834,3.5,15.9,9237,3368,5869,7.1,19.6,-1764,-3.7,31.8,0,486,486,2396
2001,29,g) 6 to 10,17828,18935,194516,199176,569,2.9,2272,11.5,27060,4692,22368,2.4,13.6,36380,13802,22578,6.9,18.3,-9320,-4.7,27.2,0,1533,1533,9282
2001,29,h) 11 to 15,13144,14787,204590,209262,447,2.9,1448,9.5,25536,5265,20271,2.5,12.2,34879,11250,23629,5.4,16.7,-9343,-4.5,24.4,0,883,883,5621
2001,29,i) 16 to 20,10410,12483,224743,228872,376,2.9,979,7.7,21164,4280,16884,1.9,9.2,29421,10931,18490,4.8,12.9,-8257,-3.7,18.4,0,517,517,3910
2001,29,j) 21 to 25,6411,9066,178483,178929,355,3.9,607,6.6,21141,6267,14874,3.5,11.8,22033,6003,16030,3.4,12.3,-892,-0.5,23.6,0,299,299,1885
2001,29,l) Left Censored,18544,36887,1260442,1264572,2137,5.8,2416,6.5,140399,41946,98453,3.3,11.1,148660,40673,107987,3.2,11.8,-8261,-0.7,22.2,0,619,620,4981
2001,30,a) 0,2307,2312,10137,5118,2284,197.6,0,0,10038,10038,0,196.1,196.1,0,0,0,0,0,10038,196.1,0,0,,,
2001,30,b) 1,1842,1866,10797,10810,15,0.7,516,24.4,2959,167,2792,1.5,27.4,2985,1777,1208,16.4,27.6,-26,-0.2,54.8,0,329,329,1170
2001,30,c) 2,1564,1591,10009,10381,57,3.3,322,18.7,1862,366,1496,3.5,17.9,2605,1343,1262,12.9,25.1,-743,-7.2,35.8,0,227,227,982
2001,30,d) 3,1595,1672,13659,13852,75,4.3,234,13.4,2806,1132,1674,8.2,20.3,3192,894,2298,6.5,23,-386,-2.7,40.6,0,150,150,691
2001,30,e) 4,1306,1322,9831,9881,41,3,186,13.4,1682,213,1469,2.2,17,1781,898,883,9.1,18,-99,-1,34,0,128,128,595
2001,30,f) 5,1202,1222,8638,8985,36,2.8,199,15.3,1062,91,971,1,11.8,1756,931,825,10.4,19.5,-694,-7.7,23.6,0,134,134,648
2001,30,g) 6 to 10,4216,4326,33296,34334,127,2.8,489,10.9,4166,425,3741,1.2,12.1,6242,2061,4181,6,18.2,-2076,-6.1,24.2,0,325,325,1322
2001,30,h) 11 to 15,2722,2946,29616,29994,82,2.7,249,8.3,3423,395,3028,1.3,11.4,4179,1155,3024,3.9,13.9,-756,-2.5,22.8,0,156,156,662
2001,30,i) 16 to 20,2188,2519,27197,27878,121,4.7,254,9.9,2940,786,2154,2.8,10.5,4302,1288,3014,4.6,15.4,-1362,-4.9,21,0,135,135,785
2001,30,j) 21 to 25,1585,2150,28249,28152,69,3.2,149,6.8,3342,723,2619,2.6,11.9,3148,760,2388,2.7,11.2,194,0.7,22.4,0,81,82,453
2001,30,l) Left Censored,3803,6368,120979,120496,515,8.2,440,7,14248,5039,9209,4.2,11.8,13282,3402,9880,2.8,11,966,0.8,22,0,102,102,850
2001,31,a) 0,2871,2907,18548,9297,2880,198.1,0,0,18502,18502,0,199,199,0,0,0,0,0,18502,199,0,0,,,
2001,31,b) 1,2344,2385,15683,16285,28,1.1,585,22,3848,423,3425,2.6,23.6,5051,2420,2631,14.9,31,-1203,-7.4,47.2,0,390,390,1673
2001,31,c) 2,2039,2100,23436,24133,96,4.3,425,18.8,3828,1193,2635,4.9,15.9,5221,2627,2594,10.9,21.6,-1393,-5.7,31.8,0,288,288,1821
2001,31,d) 3,1979,2105,23732,22866,104,4.7,317,14.4,7273,4245,3028,18.6,31.8,5540,2290,3250,10,24.2,1733,7.6,48.4,0,223,223,1507
2001,31,e) 4,1721,1788,12797,13586,38,2,220,11.8,1693,115,1578,0.8,12.5,3271,1861,1410,13.7,24.1,-1578,-11.6,25,0,149,149,601
2001,31,f) 5,1474,1510,11391,12062,37,2.3,223,14,1110,90,1020,0.7,9.2,2451,1333,1118,11.1,20.3,-1341,-11.1,18.4,0,151,151,858
2001,31,g) 6 to 10,5800,6057,55294,56996,160,2.5,712,11.3,7444,1220,6224,2.1,13.1,10847,4520,6327,7.9,19,-3403,-5.9,26.2,0,467,467,2707
2001,31,h) 11 to 15,4330,4897,73122,75122,159,3.2,436,8.7,8275,2743,5532,3.7,11,12274,4419,7855,5.9,16.3,-3999,-5.3,22,0,233,233,1631
2001,31,i) 16 to 20,3814,4494,68535,69856,159,3.5,323,7.1,7662,2682,4980,3.8,11,10303,2898,7405,4.1,14.7,-2641,-3.7,22,0,168,168,1206
2001,31,j) 21 to 25,2629,3546,56582,57270,93,2.6,240,6.6,7047,1510,5537,2.6,12.3,8423,3077,5346,5.4,14.7,-1376,-2.4,24.6,0,116,116,605
2001,31,l) Left Censored,9320,14836,414892,406899,1144,7.8,1038,7,62233,14501,47732,3.6,15.3,46247,13574,32673,3.3,11.4,15986,3.9,22.8,0,236,236,1129
2001,32,a) 0,4567,4603,30366,15221,4573,198.7,0,0,30291,30291,0,199,199,0,0,0,0,0,30291,199,0,0,,,
2001,32,b) 1,3455,3505,32262,32482,46,1.1,1223,29.9,10262,1206,9056,3.7,31.6,10701,6068,4633,18.7,32.9,-439,-1.3,63.2,0,940,942,5002
2001,32,c) 2,2933,3012,35195,36433,147,4.4,777,23.4,7662,1163,6499,3.2,21,10137,5086,5051,14,27.8,-2475,-6.8,42,0,572,572,4088
2001,32,d) 3,2530,2686,45333,43955,134,4.6,578,19.9,11137,1368,9769,3.1,25.3,8380,3186,5194,7.2,19.1,2757,6.2,38.2,0,434,434,2649
2001,32,e) 4,2036,2083,26005,26492,76,3.4,413,18.4,5319,1082,4237,4.1,20.1,6292,2632,3660,9.9,23.8,-973,-3.7,40.2,0,309,309,2258
2001,32,f) 5,1649,1720,31609,31121,69,3.8,288,15.8,5869,2551,3318,8.2,18.9,4892,1964,2928,6.3,15.7,977,3.2,31.4,0,214,214,1628
2001,32,g) 6 to 10,5437,5775,86957,90237,223,3.7,813,13.5,10876,2094,8782,2.3,12.1,17435,7148,10287,7.9,19.3,-6559,-7.2,24.2,0,554,554,5064
2001,32,h) 11 to 15,3550,4185,73247,74533,174,4,474,11,10953,2208,8745,3,14.7,13524,4707,8817,6.3,18.1,-2571,-3.4,29.4,0,276,276,3023
2001,32,i) 16 to 20,2405,3167,66567,67714,167,5.2,284,8.8,10465,4897,5568,7.2,15.5,12759,4831,7928,7.1,18.8,-2294,-3.3,31,0,121,121,848
2001,32,j) 21 to 25,1687,2592,95224,96564,169,6.5,205,7.9,8115,2712,5403,2.8,8.4,10795,1760,9035,1.8,11.2,-2680,-2.8,16.8,0,86,86,517
2001,32,l) Left Censored,3739,8684,390866,390871,915,10.6,813,9.4,48086,17423,30663,4.5,12.3,48096,13084,35012,3.3,12.3,-10,0,24.6,0,91,91,1046
2001,33,a) 0,2335,2368,15074,7576,2339,197.6,0,0,14997,14997,0,198,198,0,0,0,0,0,14997,198,0,0,,,
2001,33,b) 1,1945,1973,13311,13697,26,1.2,488,22.1,3272,423,2849,3.1,23.9,4044,2206,1838,16.1,29.5,-772,-5.6,47.8,0,332,332,1658
2001,33,c) 2,1686,1727,13643,13741,48,2.6,341,18.3,2950,365,2585,2.7,21.5,3145,1702,1443,12.4,22.9,-195,-1.4,43,0,254,254,1360
2001,33,d) 3,1663,1728,15741,15576,66,3.6,251,13.8,3061,633,2428,4.1,19.7,2731,1220,1511,7.8,17.5,330,2.2,35,0,188,188,931
2001,33,e) 4,1499,1518,11780,12152,39,2.4,231,14.4,1691,158,1533,1.3,13.9,2434,999,1435,8.2,20,-743,-6.1,27.8,0,172,172,741
2001,33,f) 5,1348,1363,12936,14030,28,1.9,216,14.9,1532,93,1439,0.7,10.9,3719,2073,1646,14.8,26.5,-2187,-15.6,21.8,0,153,153,1846
2001,33,g) 6 to 10,4904,5065,50041,51047,128,2.4,515,9.8,6241,833,5408,1.6,12.2,8253,3099,5154,6.1,16.2,-2012,-4,24.4,0,372,372,2105
2001,33,h) 11 to 15,4196,4528,58422,59928,162,3.5,395,8.5,6959,1222,5737,2,11.6,9971,3567,6404,6,16.6,-3012,-5,23.2,0,251,251,1370
2001,33,i) 16 to 20,2682,3023,49187,50415,110,3.6,254,8.2,6113,2490,3623,4.9,12.1,8569,3110,5459,6.2,17,-2456,-4.9,24.2,0,142,142,1082
2001,33,j) 21 to 25,1587,2189,43466,43338,114,5.2,146,6.6,5423,1920,3503,4.4,12.5,5167,1651,3516,3.8,11.9,256,0.6,23.8,0,74,74,418
2001,33,l) Left Censored,4373,8045,272169,267339,457,5.7,553,6.8,34358,7371,26987,2.8,12.9,24698,6414,18284,2.4,9.2,9660,3.7,18.4,0,131,132,1102
2001,34,a) 0,15496,15597,100786,50619,15480,198.5,0,0,100335,100335,0,198.2,198.2,0,0,0,0,0,100335,198.2,0,0,,,
2001,34,b) 1,12546,12655,92130,89392,83,0.6,3296,23.1,28732,4654,24078,5.2,32.1,23256,13035,10221,14.6,26,5476,6.1,52,0,2283,2284,9578
2001,34,c) 2,11458,11691,100401,100496,426,3.4,2100,16.8,21809,3473,18336,3.5,21.7,21999,8435,13564,8.4,21.9,-190,-0.2,43.4,0,1500,1500,6628
2001,34,d) 3,10837,11194,100335,100358,467,4,1758,14.9,22584,7387,15197,7.4,22.5,22629,9868,12761,9.8,22.5,-45,0,45,0,1264,1264,7758
2001,34,e) 4,9478,9675,83789,84908,293,2.9,1347,13.3,14007,1691,12316,2,16.5,16244,7037,9207,8.3,19.1,-2237,-2.6,33,0,969,969,5209
2001,34,f) 5,8242,8395,76540,78334,284,3.2,1151,13.1,12883,1379,11504,1.8,16.4,16470,7016,9454,9,21,-3587,-4.6,32.8,0,829,829,5796
2001,34,g) 6 to 10,29335,30326,312842,319464,887,2.8,3644,11.5,46593,7122,39471,2.2,14.6,59837,28088,31749,8.8,18.7,-13244,-4.1,29.2,0,2368,2368,20363
2001,34,h) 11 to 15,23383,25180,326667,332812,714,2.8,2366,9.1,41606,7851,33755,2.4,12.5,53895,17709,36186,5.3,16.2,-12289,-3.7,25,0,1502,1502,9346
2001,34,i) 16 to 20,16224,18279,301862,305834,528,2.8,1496,8,33263,7148,26115,2.3,10.9,41206,12139,29067,4,13.5,-7943,-2.6,21.8,0,903,903,5940
2001,34,j) 21 to 25,10297,12604,258384,260269,452,3.5,940,7.3,28211,7441,20770,2.9,10.8,31981,10463,21518,4,12.3,-3770,-1.5,21.6,0,528,528,2867
2001,34,l) Left Censored,27898,51074,1852175,1840871,3635,7.1,3870,7.6,260396,93321,167075,5.1,14.1,237788,68914,168874,3.7,12.9,22608,1.2,25.8,0,1228,1228,11891
2001,35,a) 0,2931,2970,17997,9044,2935,197.6,0,0,17907,17907,0,198,198,0,0,0,0,0,17907,198,0,0,,,
2001,35,b) 1,2247,2277,15865,16403,21,0.8,674,25.9,4230,719,3511,4.4,25.8,5305,3021,2284,18.4,32.3,-1075,-6.5,51.6,0,471,471,1745
2001,35,c) 2,1930,1981,16691,17747,84,3.9,445,20.7,2517,599,1918,3.4,14.2,4628,2520,2108,14.2,26.1,-2111,-11.9,28.4,0,304,304,2112
2001,35,d) 3,1780,1882,18697,18677,88,4.4,358,17.9,3879,812,3067,4.3,20.8,3838,1808,2030,9.7,20.5,41,0.3,41,0,244,244,1336
2001,35,e) 4,1644,1686,13798,13963,62,3.5,272,15.3,2467,302,2165,2.2,17.7,2797,1260,1537,9,20,-330,-2.3,35.4,0,195,195,983
2001,35,f) 5,1420,1453,13180,14066,58,3.8,241,15.7,2319,504,1815,3.6,16.5,4090,1739,2351,12.4,29.1,-1771,-12.6,33,0,156,156,1183
2001,35,g) 6 to 10,5461,5830,55843,57011,191,3.1,815,13.3,8094,1138,6956,2,14.2,10429,4576,5853,8,18.3,-2335,-4.1,28.4,0,492,492,2621
2001,35,h) 11 to 15,3745,4153,65426,65535,155,3.6,439,10.3,9155,1673,7482,2.6,14,9372,3350,6022,5.1,14.3,-217,-0.3,28,0,267,267,2206
2001,35,i) 16 to 20,3126,3849,51137,50931,202,5.2,307,7.9,8016,2614,5402,5.1,15.7,7603,2586,5017,5.1,14.9,413,0.8,29.8,0,141,141,852
2001,35,j) 21 to 25,2135,3115,46127,46468,188,6,209,6.7,5402,1232,4170,2.7,11.6,6084,1748,4336,3.8,13.1,-682,-1.5,23.2,0,103,103,753
2001,35,l) Left Censored,4641,9216,241218,244413,616,6.6,822,8.8,32754,10966,21788,4.5,13.4,39144,12332,26812,5,16,-6390,-2.6,26.8,0,135,135,1018
2001,36,a) 0,33616,33791,192575,96945,33530,198.5,0,0,191260,191260,0,197.3,197.3,0,0,0,0,0,191260,197.3,0,0,,,
2001,36,b) 1,27327,27571,198967,200475,202,0.6,7245,23.3,58080,6335,51745,3.2,29,61096,35053,26043,17.5,30.5,-3016,-1.5,58,0,5174,5174,27895
2001,36,c) 2,23612,24061,196903,201571,835,3.2,4609,17.8,40373,6822,33551,3.4,20,49709,25950,23759,12.9,24.7,-9336,-4.7,40,0,3406,3406,21411
2001,36,d) 3,22244,23113,211637,215576,983,4,3671,15.1,37899,9588,28311,4.4,17.6,45777,19153,26624,8.9,21.2,-7878,-3.6,35.2,0,2671,2671,15364
2001,36,e) 4,19461,19820,170460,175397,564,2.7,3003,14.3,27425,3506,23919,2,15.6,37298,17651,19647,10.1,21.3,-9873,-5.7,31.2,0,2204,2204,14160
2001,36,f) 5,16806,17083,150117,154610,483,2.7,2430,13.5,20731,2800,17931,1.8,13.4,29717,12843,16874,8.3,19.2,-8986,-5.8,26.8,0,1827,1827,9953
2001,36,g) 6 to 10,60651,62721,634947,654052,1512,2.3,7710,11.7,89744,12245,77499,1.9,13.7,127954,55591,72363,8.5,19.6,-38210,-5.9,27.4,0,4960,4960,28695
2001,36,h) 11 to 15,48519,51948,688755,697409,1353,2.5,4479,8.4,75477,14808,60669,2.1,10.8,92784,29417,63367,4.2,13.3,-17307,-2.5,21.6,0,2851,2851,17078
2001,36,i) 16 to 20,34518,38954,581481,588640,979,2.5,3023,7.6,60661,10274,50387,1.7,10.3,74978,27976,47002,4.8,12.7,-14317,-2.4,20.6,0,1737,1741,11951
2001,36,j) 21 to 25,20316,26818,531774,535655,823,3,1877,6.9,61153,19347,41806,3.6,11.4,68914,18124,50790,3.4,12.9,-7761,-1.5,22.8,0,1061,1061,6148
2001,36,l) Left Censored,62408,110854,3814053,3831700,7482,6.8,7779,7,421261,126201,295060,3.3,11,456554,133409,323145,3.5,11.9,-35293,-0.9,22,0,2625,2641,21823
2001,37,a) 0,14177,14293,87280,43914,14178,198.4,0,0,86732,86732,0,197.5,197.5,0,0,0,0,0,86732,197.5,0,0,,,
2001,37,b) 1,11036,11328,88429,89511,171,1.3,3166,24.7,23996,3260,20736,3.6,26.8,26159,14236,11923,15.9,29.2,-2163,-2.4,53.6,0,2277,2278,11523
2001,37,c) 2,10095,10393,92437,95204,409,3.7,2099,18.7,20656,4516,16140,4.7,21.7,26189,12537,13652,13.2,27.5,-5533,-5.8,43.4,0,1564,1564,9504
2001,37,d) 3,9020,9618,100670,102099,485,4.8,1577,15.6,20418,6795,13623,6.7,20,23275,9179,14096,9,22.8,-2857,-2.8,40,0,1171,1171,6446
2001,37,e) 4,7855,8092,72299,74596,303,3.5,1357,15.8,12127,1672,10455,2.2,16.3,16720,8193,8527,11,22.4,-4593,-6.1,32.6,0,928,930,4954
2001,37,f) 5,6766,7111,71300,71674,244,3.3,1030,13.8,18343,4461,13882,6.2,25.6,19091,11284,7807,15.7,26.6,-748,-1,51.2,0,717,717,5497
2001,37,g) 6 to 10,23816,25294,275245,281317,730,2.8,3061,11.6,39601,7443,32158,2.6,14.1,51745,20938,30807,7.4,18.4,-12144,-4.3,28.2,0,1987,1987,12470
2001,37,h) 11 to 15,17958,20420,322866,325738,648,3.1,1904,9.1,39862,8474,31388,2.6,12.2,45605,15633,29972,4.8,14,-5743,-1.8,24.4,0,1114,1114,6493
2001,37,i) 16 to 20,14489,17325,267249,272213,570,3.2,1401,7.9,31149,8255,22894,3,11.4,41078,13456,27622,4.9,15.1,-9929,-3.7,22.8,0,674,674,3441
2001,37,j) 21 to 25,8002,11570,234380,234937,490,4.2,889,7.6,28097,8274,19823,3.5,12,29211,9397,19814,4,12.4,-1114,-0.4,24,0,409,412,2323
2001,37,l) Left Censored,21210,49329,1827897,1818805,3522,7.1,3526,7.2,257361,73419,183942,4,14.2,239176,68546,170630,3.8,13.2,18185,1,26.4,0,695,696,4586
2001,38,a) 0,999,1008,6617,3320,1000,198.4,0,0,6595,6595,0,198.6,198.6,0,0,0,0,0,6595,198.6,0,0,,,
2001,38,b) 1,853,871,7184,7226,13,1.3,226,23.1,1901,380,1521,5.3,26.3,1985,1162,823,16.1,27.5,-84,-1.2,52.6,0,144,144,941
2001,38,c) 2,695,708,5702,6158,24,3.1,144,18.8,747,154,593,2.5,12.1,1658,802,856,13,26.9,-911,-14.8,24.2,0,102,102,600
2001,38,d) 3,730,790,8302,8448,36,4.3,131,15.7,1539,526,1013,6.2,18.2,1831,656,1175,7.8,21.7,-292,-3.5,36.4,0,105,105,560
2001,38,e) 4,684,706,5336,5540,14,1.9,90,12.2,809,274,535,4.9,14.6,1216,371,845,6.7,21.9,-407,-7.3,29.2,0,71,71,317
2001,38,f) 5,597,609,4131,4279,11,1.7,85,13.2,548,22,526,0.5,12.8,844,302,542,7.1,19.7,-296,-6.9,25.6,0,59,59,227
2001,38,g) 6 to 10,2463,2539,22267,22893,57,2.2,254,9.7,2350,148,2202,0.6,10.3,3602,1525,2077,6.7,15.7,-1252,-5.4,20.6,0,183,183,922
2001,38,h) 11 to 15,1883,2044,21328,22161,47,2.2,168,8,1611,235,1376,1.1,7.3,3277,1349,1928,6.1,14.8,-1666,-7.5,14.6,0,104,104,970
2001,38,i) 16 to 20,1693,1941,20354,20517,62,3.1,151,7.6,2218,678,1540,3.3,10.8,2544,568,1976,2.8,12.4,-326,-1.6,21.6,0,79,79,352
2001,38,j) 21 to 25,1198,1521,21512,21889,32,2.1,90,5.8,1778,440,1338,2,8.1,2532,438,2094,2,11.6,-754,-3.5,16.2,0,45,45,174
2001,38,l) Left Censored,4518,6642,135285,134755,630,9.6,493,7.5,14102,5081,9021,3.8,10.5,13042,3502,9540,2.6,9.7,1060,0.8,19.4,0,111,111,847
2001,39,a) 0,14146,14278,95832,48152,14154,198.3,0,0,95360,95360,0,198,198,0,0,0,0,0,95360,198,0,0,,,
2001,39,b) 1,11685,11919,104080,106411,158,1.2,3242,24.1,26951,3791,23160,3.6,25.3,31613,15851,15762,14.9,29.7,-4662,-4.4,50.6,0,2306,2306,12274
2001,39,c) 2,10539,10975,114666,117250,403,3.4,2012,17.1,23772,6285,17487,5.4,20.3,28940,14345,14595,12.2,24.7,-5168,-4.4,40.6,0,1499,1499,10002
2001,39,d) 3,10051,10836,107257,110821,512,4.5,1706,15,19225,6321,12904,5.7,17.3,26352,9979,16373,9,23.8,-7127,-6.5,34.6,0,1283,1283,6995
2001,39,e) 4,8925,9429,87870,94142,267,2.7,1404,14.1,12216,1821,10395,1.9,13,24759,10652,14107,11.3,26.3,-12543,-13.3,26,0,995,995,7772
2001,39,f) 5,8046,8331,85447,87727,198,2.3,1148,13.1,12658,1408,11250,1.6,14.4,17218,7028,10190,8,19.6,-4560,-5.2,28.8,0,839,839,5228
2001,39,g) 6 to 10,32070,34182,377232,387631,882,2.5,3583,10.1,47151,7278,39873,1.9,12.2,67948,22962,44986,5.9,17.5,-20797,-5.3,24.4,0,2364,2364,14347
2001,39,h) 11 to 15,24740,28160,424204,436601,737,2.5,2587,8.9,45837,9567,36270,2.2,10.5,70631,24011,46620,5.5,16.2,-24794,-5.7,21,0,1518,1518,10361
2001,39,i) 16 to 20,18664,22877,397974,401762,759,3.3,1572,6.8,43725,10138,33587,2.5,10.9,51300,14851,36449,3.7,12.8,-7575,-1.9,21.8,0,838,839,5846
2001,39,j) 21 to 25,12794,17930,347084,351236,635,3.5,1237,6.8,43737,16370,27367,4.7,12.5,52041,13791,38250,3.9,14.8,-8304,-2.3,25,0,567,573,3919
2001,39,l) Left Censored,37092,78021,2763862,2805768,4459,5.7,4992,6.4,287264,84022,203242,3,10.2,371076,97164,273912,3.5,13.2,-83812,-3,20.4,0,1247,1261,11567
2001,40,a) 0,5578,5628,34505,17483,5556,197.4,0,0,34044,34044,0,194.7,194.7,0,0,0,0,0,34044,194.7,0,0,,,
2001,40,b) 1,4366,4453,35405,36980,44,0.9,1369,26.8,9374,1342,8032,3.6,25.3,12524,6785,5739,18.3,33.9,-3150,-8.6,50.6,0,978,978,5330
2001,40,c) 2,3847,3959,33428,37789,150,3.5,867,20.2,7500,2405,5095,6.4,19.8,16221,10714,5507,28.4,42.9,-8721,-23.1,39.6,0,648,648,3230
2001,40,d) 3,3545,3809,41956,41307,172,4.3,650,16.2,10207,2021,8186,4.9,24.7,8908,3241,5667,7.8,21.6,1299,3.1,43.2,0,478,478,2598
2001,40,e) 4,3148,3344,30591,32579,135,3.8,580,16.3,4783,921,3862,2.8,14.7,8759,4645,4114,14.3,26.9,-3976,-12.2,29.4,0,392,392,2511
2001,40,f) 5,2676,2762,23983,24988,74,2.5,408,14,3305,349,2956,1.4,13.2,5315,2042,3273,8.2,21.3,-2010,-8.1,26.4,0,283,283,1483
2001,40,g) 6 to 10,10310,10851,102559,105513,356,3.2,1340,11.9,14136,2585,11551,2.4,13.4,20044,7862,12182,7.5,19,-5908,-5.6,26.8,0,875,875,5092
2001,40,h) 11 to 15,7211,7942,118470,120920,202,2.5,815,9.9,16543,2255,14288,1.9,13.7,21442,9625,11817,8,17.7,-4899,-4,27.4,0,487,487,3127
2001,40,i) 16 to 20,7025,8146,121096,121541,281,3.4,623,7.5,14628,3220,11408,2.6,12,15518,3675,11843,3,12.8,-890,-0.8,24,0,345,345,1664
2001,40,j) 21 to 25,4139,5769,106280,104296,297,5.1,456,7.8,17039,5168,11871,5,16.3,13071,4119,8952,3.9,12.5,3968,3.8,25,0,209,211,1143
2001,40,l) Left Censored,10092,20389,556915,560692,1295,6.3,1488,7.3,62629,21004,41625,3.7,11.2,70183,21871,48312,3.9,12.5,-7554,-1.3,22.4,0,417,417,3212
2001,41,a) 0,6729,6773,34442,17272,6721,198.5,0,0,34340,34340,0,198.8,198.8,0,0,0,0,0,34340,198.8,0,0,,,
2001,41,b) 1,5365,5439,36493,37416,53,0.9,1572,25.4,8857,860,7997,2.3,23.7,10703,5723,4980,15.3,28.6,-1846,-4.9,47.4,0,1057,1059,3774
2001,41,c) 2,4957,5111,35951,36920,232,4.2,1046,19,8100,2625,5475,7.1,21.9,10037,4800,5237,13,27.2,-1937,-5.3,43.8,0,770,770,3760
2001,41,d) 3,4544,4796,37704,38073,250,4.9,794,15.7,7992,2455,5537,6.4,21,8730,3667,5063,9.6,22.9,-738,-1.9,42,0,568,568,2451
2001,41,e) 4,3918,4025,31612,32465,174,4.1,700,16.4,5367,805,4562,2.5,16.5,7072,3611,3461,11.1,21.8,-1705,-5.3,33,0,489,489,2754
2001,41,f) 5,3574,3718,41349,42292,127,3.2,610,15.5,4535,754,3781,1.8,10.7,6420,2912,3508,6.9,15.2,-1885,-4.5,21.4,0,427,427,2008
2001,41,g) 6 to 10,13567,14273,132112,134668,499,3.4,1841,12.4,20053,4489,15564,3.3,14.9,25165,10099,15066,7.5,18.7,-5112,-3.8,29.8,0,1212,1212,6874
2001,41,h) 11 to 15,9129,10170,126126,129845,326,3.1,1052,10,15545,3788,11757,2.9,12,22982,7624,15358,5.9,17.7,-7437,-5.7,24,0,623,623,4335
2001,41,i) 16 to 20,6554,8037,133991,136225,361,4.4,595,7.3,15694,3944,11750,2.9,11.5,20162,4756,15406,3.5,14.8,-4468,-3.3,23,0,310,312,1783
2001,41,j) 21 to 25,4645,6327,115230,114781,241,3.7,468,7.3,13634,3590,10044,3.1,11.9,12735,3208,9527,2.8,11.1,899,0.8,22.2,0,226,233,1082
2001,41,l) Left Censored,10843,21024,625701,629413,1941,9.3,1513,7.3,79319,24487,54832,3.9,12.6,86743,19801,66942,3.1,13.8,-7424,-1.2,25.2,0,323,324,2174
2001,42,a) 0,16032,16148,105257,52822,16032,198.6,0,0,104871,104871,0,198.5,198.5,0,0,0,0,0,104871,198.5,0,0,,,
2001,42,b) 1,13456,13689,117073,118550,149,1,3066,20.2,35713,8164,27549,6.9,30.1,38667,16601,22066,14,32.6,-2954,-2.5,60.2,0,2143,2146,13452
2001,42,c) 2,12020,12371,110679,114379,419,3.2,2127,16.1,21088,5334,15754,4.7,18.4,28487,13689,14798,12,24.9,-7399,-6.5,36.8,0,1559,1559,9204
2001,42,d) 3,11288,12150,126512,128457,544,4.3,1619,12.8,23181,7181,16000,5.6,18,27071,8756,18315,6.8,21.1,-3890,-3.1,36,0,1177,1177,6794
2001,42,e) 4,10002,10389,92372,95756,280,2.6,1438,13.1,13908,1745,12163,1.8,14.5,20675,10023,10652,10.5,21.6,-6767,-7.1,29,0,1060,1060,7312
2001,42,f) 5,8741,9077,86870,88808,245,2.6,1156,12.2,12129,1766,10363,2,13.7,16004,7028,8976,7.9,18,-3875,-4.3,27.4,0,849,849,5325
2001,42,g) 6 to 10,34342,36196,370053,381715,914,2.4,3860,10.3,46842,7760,39082,2,12.3,70166,27495,42671,7.2,18.4,-23324,-6.1,24.6,0,2629,2629,18808
2001,42,h) 11 to 15,30142,33121,421644,427603,911,2.7,2892,8.5,50043,12886,37157,3,11.7,61961,20422,41539,4.8,14.5,-11918,-2.8,23.4,0,1812,1812,11752
2001,42,i) 16 to 20,21869,26119,435359,440484,718,2.7,1959,7.3,43802,11261,32541,2.6,9.9,54052,18360,35692,4.2,12.3,-10250,-2.4,19.8,0,1069,1069,8302
2001,42,j) 21 to 25,13837,18802,361540,364669,679,3.6,1254,6.6,41641,11758,29883,3.2,11.4,47899,14778,33121,4.1,13.1,-6258,-1.7,22.8,0,640,642,4860
2001,42,l) Left Censored,40643,82107,2869616,2867156,5168,6.3,5392,6.6,343754,112095,231659,3.9,12,338834,99686,239148,3.5,11.8,4920,0.2,23.6,0,1524,1525,12151
2001,44,a) 0,1690,1697,8612,4313,1688,198.9,0,0,8598,8598,0,199.4,199.4,0,0,0,0,0,8598,199.4,0,0,,,
2001,44,b) 1,1377,1396,12772,13026,13,0.8,338,21.7,1994,204,1790,1.6,15.3,2502,1126,1376,8.6,19.2,-508,-3.9,30.6,0,253,253,911
2001,44,c) 2,1257,1281,8962,9318,47,3.4,225,16.5,1915,507,1408,5.4,20.6,2627,818,1809,8.8,28.2,-712,-7.6,41.2,0,163,163,593
2001,44,d) 3,1225,1288,9868,9990,56,4.2,186,13.8,1811,589,1222,5.9,18.1,2054,741,1313,7.4,20.6,-243,-2.5,36.2,0,130,130,535
2001,44,e) 4,1039,1059,9611,10382,30,2.7,170,15.1,1195,73,1122,0.7,11.5,2736,1327,1409,12.8,26.4,-1541,-14.9,23,0,121,121,1106
2001,44,f) 5,945,948,7591,7880,33,3.4,112,11.4,985,94,891,1.2,12.5,1562,554,1008,7,19.8,-577,-7.3,25,0,91,91,469
2001,44,g) 6 to 10,3572,3659,34892,36072,95,2.5,397,10.5,4022,346,3676,1,11.1,6382,2153,4229,6,17.7,-2360,-6.6,22.2,0,281,281,1620
2001,44,h) 11 to 15,3132,3342,40491,40949,80,2.3,296,8.6,4333,699,3634,1.7,10.6,5248,1986,3262,4.8,12.8,-915,-2.2,21.2,0,185,185,742
2001,44,i) 16 to 20,2071,2308,32230,32432,60,2.5,174,7.4,3657,761,2896,2.3,11.3,4061,1309,2752,4,12.5,-404,-1.2,22.6,0,107,107,524
2001,44,j) 21 to 25,1418,1696,30043,30213,45,2.6,114,6.6,3316,1259,2057,4.2,11,3655,684,2971,2.3,12.1,-339,-1.1,22,0,56,56,299
2001,44,l) Left Censored,4518,6696,213259,214232,382,5.7,451,6.7,21652,6581,15071,3.1,10.1,23597,4727,18870,2.2,11,-1945,-0.9,20.2,0,164,164,946
2001,45,a) 0,6680,6742,43871,22057,6688,198.4,0,0,43629,43629,0,197.8,197.8,0,0,0,0,0,43629,197.8,0,0,,,
2001,45,b) 1,5376,5500,48461,49052,56,0.9,1586,25.3,12782,2168,10614,4.4,26.1,13963,7560,6403,15.4,28.5,-1181,-2.4,52.2,0,1153,1153,5788
2001,45,c) 2,4757,4906,50831,50461,188,3.5,1153,21.5,12790,2738,10052,5.4,25.3,12050,5994,6056,11.9,23.9,740,1.4,47.8,0,842,842,4904
2001,45,d) 3,4299,4479,48833,50941,200,4.2,854,17.9,8226,1711,6515,3.4,16.1,12442,5023,7419,9.9,24.4,-4216,-8.3,32.2,0,649,649,3975
2001,45,e) 4,3599,3666,36872,39517,101,2.6,671,17.1,4756,539,4217,1.4,12,10045,4589,5456,11.6,25.4,-5289,-13.4,24,0,470,473,3434
2001,45,f) 5,3194,3293,30711,37896,88,2.5,521,14.9,3965,430,3535,1.1,10.5,18335,2545,15790,6.7,48.4,-14370,-37.9,21,0,385,385,1881
2001,45,g) 6 to 10,11668,12430,145866,148910,410,3.2,1572,12.1,20936,3036,17900,2,14.1,27023,10582,16441,7.1,18.1,-6087,-4,28.2,0,1047,1047,6771
2001,45,h) 11 to 15,8463,9915,152407,154778,315,3.1,982,9.6,18937,4749,14188,3.1,12.2,23679,7655,16024,4.9,15.3,-4742,-3.1,24.4,0,592,592,3475
2001,45,i) 16 to 20,6680,7972,116756,119095,248,3,654,8,12775,3306,9469,2.8,10.7,17452,5278,12174,4.4,14.7,-4677,-4,21.4,0,343,345,2192
2001,45,j) 21 to 25,3872,5738,98140,98228,261,4.5,426,7.3,13251,3647,9604,3.7,13.5,13427,4085,9342,4.2,13.7,-176,-0.2,27,0,191,191,1037
2001,45,l) Left Censored,10271,22920,815936,821506,1513,6.6,1657,7.2,88375,27382,60993,3.3,10.8,99515,29291,70224,3.6,12.1,-11140,-1.3,21.6,0,353,353,3068
2001,46,a) 0,1456,1475,8079,4097,1450,196.6,0,0,7964,,,,194.4,0,0,0,0,0,7964,194.4,0,1,,,
2001,46,b) 1,1189,1220,13418,11603,19,1.4,319,23.3,6464,775,5689,6.7,55.7,2833,1249,1584,10.8,24.4,3631,31.3,48.8,0,212,212,1019
2001,46,c) 2,1070,1095,7780,8252,31,2.6,218,18.4,1214,257,957,3.1,14.7,2157,1106,1051,13.4,26.1,-943,-11.4,29.4,0,154,154,891
2001,46,d) 3,988,1032,8444,8645,48,4.4,174,16,1724,502,1222,5.8,19.9,2126,951,1175,11,24.6,-402,-4.7,39.8,0,123,123,638
2001,46,e) 4,861,886,7683,7904,35,3.8,132,14.2,1474,240,1234,3,18.6,1915,775,1140,9.8,24.2,-441,-5.6,37.2,0,88,88,564
2001,46,f) 5,784,801,5354,5676,23,2.7,107,12.8,644,163,481,2.9,11.3,1288,514,774,9.1,22.7,-644,-11.4,22.6,0,73,73,403
2001,46,g) 6 to 10,3021,3143,27217,28618,79,2.4,343,10.5,2722,451,2271,1.6,9.5,5524,2120,3404,7.4,19.3,-2802,-9.8,19,0,222,222,1193
2001,46,h) 11 to 15,2107,2284,39524,37830,59,2.5,215,9.1,7598,,,,20.1,4209,977,3232,2.6,11.1,3389,9,22.2,1,146,146,658
2001,46,i) 16 to 20,1753,2029,21911,22298,61,2.9,174,8.4,2158,446,1712,2,9.7,2931,945,1986,4.2,13.1,-773,-3.4,19.4,0,82,82,390
2001,46,j) 21 to 25,1181,1505,21171,21827,35,2.3,114,7.4,2028,592,1436,2.7,9.3,3339,1438,1901,6.6,15.3,-1311,-6,18.6,0,55,56,318
2001,46,l) Left Censored,4429,6681,154230,153517,539,8.2,468,7.1,16424,6554,9870,4.3,10.7,14997,3157,11840,2.1,9.8,1427,0.9,19.6,0,102,102,557
2001,47,a) 0,7901,7983,53847,27048,7911,198.2,0,0,53598,53598,0,198.2,198.2,0,0,0,0,0,53598,198.2,0,0,,,
2001,47,b) 1,6045,6190,54372,55420,88,1.2,2128,29.5,16548,2187,14361,3.9,29.9,18644,10975,7669,19.8,33.6,-2096,-3.7,59.8,0,1617,1618,8341
2001,47,c) 2,5565,5845,56314,61253,227,3.5,1381,21.6,11434,2797,8637,4.6,18.7,21312,10542,10770,17.2,34.8,-9878,-16.1,37.4,0,1037,1037,8614
2001,47,d) 3,5238,5661,65549,67306,295,4.9,1059,17.6,13293,3996,9297,5.9,19.8,16806,7100,9706,10.5,25,-3513,-5.2,39.6,0,803,803,5406
2001,47,e) 4,4414,4625,46779,48345,196,4,752,15.4,8605,2300,6305,4.8,17.8,11737,4311,7426,8.9,24.3,-3132,-6.5,35.6,0,549,549,3169
2001,47,f) 5,4117,4276,45517,47699,133,2.9,682,15.1,7769,2184,5585,4.6,16.3,12132,6180,5952,13,25.4,-4363,-9.1,32.6,0,485,485,3563
2001,47,g) 6 to 10,15521,16689,193830,199690,545,3.1,2065,11.9,27254,4455,22799,2.2,13.6,38974,16527,22447,8.3,19.5,-11720,-5.9,27.2,0,1376,1376,8941
2001,47,h) 11 to 15,11581,13385,213202,219742,445,3.2,1264,9.2,24631,5661,18970,2.6,11.2,37711,15507,22204,7.1,17.2,-13080,-6,22.4,0,758,758,10545
2001,47,i) 16 to 20,9465,11322,174456,177543,376,3.3,890,7.7,17984,4034,13950,2.3,10.1,24159,7456,16703,4.2,13.6,-6175,-3.5,20.2,0,427,427,2951
2001,47,j) 21 to 25,5760,9209,216803,217214,601,6.5,791,8.5,33884,10040,23844,4.6,15.6,34706,11678,23028,5.4,16,-822,-0.4,31.2,0,281,285,1715
2001,47,l) Left Censored,14790,33756,1240965,1250544,2062,6.1,2556,7.5,144489,41329,103160,3.3,11.6,163646,44483,119163,3.6,13.1,-19157,-1.5,23.2,0,590,591,4933
2001,48,a) 0,33505,33887,250745,126819,33628,198.5,0,0,247853,247853,0,195.4,195.4,0,0,0,0,0,247853,195.4,0,0,,,
2001,48,b) 1,25618,26211,232973,235030,319,1.1,7988,26.6,68774,10490,58284,4.5,29.3,72887,39835,33052,16.9,31,-4113,-1.7,58.6,0,5927,5942,31317
2001,48,c) 2,22270,23111,246389,251803,965,3.8,5073,20.2,58601,13509,45092,5.4,23.3,69428,34312,35116,13.6,27.6,-10827,-4.3,46.6,0,3753,3753,26476
2001,48,d) 3,20070,21516,244367,248098,1166,5.1,3813,16.8,52962,16486,36476,6.6,21.3,60424,27693,32731,11.2,24.4,-7462,-3.1,42.6,0,2846,2846,20056
2001,48,e) 4,17617,18411,210646,211483,653,3.3,3072,15.7,46493,6495,39998,3.1,22,48167,22191,25976,10.5,22.8,-1674,-0.8,44,0,2189,2189,15407
2001,48,f) 5,15726,16587,180950,192077,576,3.3,2611,14.9,27208,4365,22843,2.3,14.2,49462,26325,23137,13.7,25.8,-22254,-11.6,28.4,0,1829,1830,12362
2001,48,g) 6 to 10,58595,63512,792887,809473,2154,3.3,8106,12.2,123383,23170,100213,2.9,15.2,156557,63146,93411,7.8,19.3,-33174,-4.1,30.4,0,5296,5296,40190
2001,48,h) 11 to 15,38766,45532,762837,779855,1705,3.6,4633,9.9,107112,27919,79193,3.6,13.7,141149,61084,80065,7.8,18.1,-34037,-4.4,27.4,0,2602,2602,20611
2001,48,i) 16 to 20,35684,43647,753861,759640,1650,3.7,3586,8.1,108421,29056,79365,3.8,14.3,119978,38560,81418,5.1,15.8,-11557,-1.5,28.6,0,1875,1880,12978
2001,48,j) 21 to 25,16865,26087,515117,516851,1314,5,2115,8,73377,24979,48398,4.8,14.2,76844,27488,49356,5.3,14.9,-3467,-0.7,28.4,0,891,892,5025
2001,48,l) Left Censored,40655,110136,3883364,3869177,9426,8.6,8255,7.6,558115,205414,352701,5.3,14.4,529741,168617,361124,4.4,13.7,28374,0.7,27.4,0,1546,1551,13715
2001,49,a) 0,4966,5012,30424,15322,4959,197.9,0,0,30204,30204,0,197.1,197.1,0,0,0,0,0,30204,197.1,0,0,,,
2001,49,b) 1,3635,3693,30516,31480,37,0.9,1114,26.3,8422,730,7692,2.3,26.8,10350,5201,5149,16.5,32.9,-1928,-6.1,53.6,0,780,782,4065
2001,49,c) 2,3125,3172,31110,30549,118,3.4,768,22,9037,750,8287,2.5,29.6,7914,4113,3801,13.5,25.9,1123,3.7,51.8,0,550,550,3072
2001,49,d) 3,2681,2805,27394,28236,132,4.4,562,18.7,4787,1193,3594,4.2,17,6471,3260,3211,11.5,22.9,-1684,-5.9,34,0,393,393,2500
2001,49,e) 4,2363,2430,22701,23870,88,3.4,425,16.4,3562,495,3067,2.1,14.9,5900,3080,2820,12.9,24.7,-2338,-9.8,29.8,0,295,295,2072
2001,49,f) 5,2093,2195,28767,29902,65,2.8,382,16.3,4122,803,3319,2.7,13.8,6391,3259,3132,10.9,21.4,-2269,-7.6,27.6,0,253,253,2197
2001,49,g) 6 to 10,6735,7148,87653,92759,243,3.3,905,12.1,12108,2345,9763,2.5,13.1,22320,11489,10831,12.4,24.1,-10212,-11,26.2,0,608,608,9374
2001,49,h) 11 to 15,3902,4494,84234,88484,168,3.6,433,9.4,13050,4931,8119,5.6,14.7,21550,8600,12950,9.7,24.4,-8500,-9.7,29.4,0,249,249,1947
2001,49,i) 16 to 20,2862,3510,70556,70320,202,5.7,312,8.8,11686,3669,8017,5.2,16.6,11213,4589,6624,6.5,15.9,473,0.7,31.8,0,152,152,956
2001,49,j) 21 to 25,2125,2914,56338,56559,111,3.7,223,7.5,7339,1591,5748,2.8,13,7780,2948,4832,5.2,13.8,-441,-0.8,26,0,97,98,857
2001,49,l) Left Censored,4985,11120,440971,442815,1046,9.3,1221,10.9,62230,18869,43361,4.3,14.1,65917,19868,46049,4.5,14.9,-3687,-0.8,28.2,0,159,161,1164
2001,50,a) 0,1178,1183,5905,2984,1171,198,0,0,5843,5843,0,195.8,195.8,0,0,0,0,0,5843,195.8,0,0,,,
2001,50,b) 1,1074,1095,6885,6690,15,1.2,227,18.9,2030,662,1368,9.9,30.3,1639,857,782,12.8,24.5,391,5.8,49,0,165,165,698
2001,50,c) 2,919,950,5913,6258,27,2.6,173,16.9,947,171,776,2.7,15.1,1637,839,798,13.4,26.2,-690,-11.1,30.2,0,125,125,726
2001,50,d) 3,916,971,6799,6915,35,3.4,139,13.6,1255,349,906,5,18.1,1486,757,729,10.9,21.5,-231,-3.4,36.2,0,96,96,582
2001,50,e) 4,828,842,4662,4807,25,2.8,102,11.6,603,50,553,1,12.5,892,390,502,8.1,18.6,-289,-6.1,25,0,77,77,310
2001,50,f) 5,730,737,5264,5395,14,1.8,90,11.7,631,38,593,0.7,11.7,893,405,488,7.5,16.6,-262,-4.9,23.4,0,64,64,248
2001,50,g) 6 to 10,2929,3037,23789,24159,89,2.9,272,8.7,3161,570,2591,2.4,13.1,3900,1296,2604,5.4,16.1,-739,-3,26.2,0,191,191,973
2001,50,h) 11 to 15,2572,2693,25440,25749,66,2.4,245,8.8,2936,641,2295,2.5,11.4,3553,1191,2362,4.6,13.8,-617,-2.4,22.8,0,149,149,707
2001,50,i) 16 to 20,1795,2091,32354,31804,48,2.3,135,6.3,3572,574,2998,1.8,11.2,2472,673,1799,2.1,7.8,1100,3.4,15.6,0,83,83,353
2001,50,j) 21 to 25,1024,1279,21071,21156,44,3.4,73,5.7,1930,459,1471,2.2,9.1,2099,425,1674,2,9.9,-169,-0.8,18.2,0,37,37,140
2001,50,l) Left Censored,2867,4475,121845,121087,254,5.7,249,5.6,11646,2951,8695,2.4,9.6,10130,2728,7402,2.3,8.4,1516,1.2,16.8,0,100,100,665
2001,51,a) 0,11493,11597,67279,33791,11509,198.5,0,0,66976,66976,0,198.2,198.2,0,0,0,0,0,66976,198.2,0,0,,,
2001,51,b) 1,9141,9333,70182,69720,141,1.3,2542,24.1,21609,3174,18435,4.6,31,20684,10906,9778,15.6,29.7,925,1.3,59.4,0,1781,1783,8167
2001,51,c) 2,7895,8146,71144,73367,351,4,1559,17.9,16266,4128,12138,5.6,22.2,20711,8966,11745,12.2,28.2,-4445,-6,44.4,0,1090,1090,6390
2001,51,d) 3,7528,8024,78260,78647,457,5.5,1213,14.5,16769,6536,10233,8.3,21.3,17543,6588,10955,8.4,22.3,-774,-1,42.6,0,859,859,4773
2001,51,e) 4,6439,6612,61348,62649,214,3.1,1038,14.8,10653,1090,9563,1.7,17,13254,5099,8155,8.1,21.2,-2601,-4.2,34,0,741,741,3595
2001,51,f) 5,5705,5882,58400,59738,177,2.9,814,13.2,9019,1462,7557,2.4,15.1,11694,4944,6750,8.3,19.6,-2675,-4.5,30.2,0,578,578,3888
2001,51,g) 6 to 10,21959,23210,274546,278700,655,2.7,2596,10.8,38121,5966,32155,2.1,13.7,46429,17143,29286,6.2,16.7,-8308,-3,27.4,0,1693,1693,11624
2001,51,h) 11 to 15,16522,18596,282332,284593,577,3,1695,8.9,39101,8624,30477,3,13.7,43623,14274,29349,5,15.3,-4522,-1.6,27.4,0,983,983,5960
2001,51,i) 16 to 20,11937,14656,262489,267123,502,3.4,1068,7.2,31851,9190,22661,3.4,11.9,41118,10290,30828,3.9,15.4,-9267,-3.5,23.8,0,510,511,3797
2001,51,j) 21 to 25,6930,10016,194955,197461,348,3.4,686,6.8,21689,5294,16395,2.7,11,26701,7522,19179,3.8,13.5,-5012,-2.5,22,0,297,298,1611
2001,51,l) Left Censored,18083,43349,1490338,1483390,3060,7.1,3304,7.6,209464,77098,132366,5.2,14.1,195568,53091,142477,3.6,13.2,13896,0.9,26.4,0,597,598,5148
2001,53,a) 0,11890,11962,62869,31647,11860,198.3,0,0,62444,62444,0,197.3,197.3,0,0,0,0,0,62444,197.3,0,0,,,
2001,53,b) 1,9402,9563,69599,69709,106,1,2927,26.7,20271,3185,17086,4.6,29.1,20490,11238,9252,16.1,29.4,-219,-0.3,58.2,0,1995,1999,8185
2001,53,c) 2,8353,8659,75733,79729,401,4.3,1893,20.2,17001,5488,11513,6.9,21.3,24993,13372,11621,16.8,31.3,-7992,-10,42.6,0,1354,1354,11522
2001,53,d) 3,7537,7993,72849,74322,370,4.4,1427,16.8,15082,4134,10948,5.6,20.3,18027,6900,11127,9.3,24.3,-2945,-4,40.6,0,983,983,4804
2001,53,e) 4,6502,6670,58257,60106,265,3.7,1151,16.3,10416,1120,9296,1.9,17.3,14113,6972,7141,11.6,23.5,-3697,-6.2,34.6,0,764,764,5442
2001,53,f) 5,5784,5915,50085,52247,214,3.4,984,15.7,7913,1823,6090,3.5,15.1,12237,4896,7341,9.4,23.4,-4324,-8.3,30.2,0,668,668,3513
2001,53,g) 6 to 10,21649,22718,221197,228380,831,3.5,3063,12.9,31365,5573,25792,2.4,13.7,45730,19027,26703,8.3,20,-14365,-6.3,27.4,0,1910,1910,12472
2001,53,h) 11 to 15,14602,16222,214360,219652,612,3.7,1688,10.1,25761,6089,19672,2.8,11.7,36344,11959,24385,5.4,16.5,-10583,-4.8,23.4,0,963,963,7054
2001,53,i) 16 to 20,10674,13199,229892,232727,642,4.8,1167,8.7,32863,8157,24706,3.5,14.1,38533,9269,29264,4,16.6,-5670,-2.5,28.2,0,598,598,3474
2001,53,j) 21 to 25,6986,9644,173366,174312,399,4.1,766,7.8,20702,5184,15518,3,11.9,22594,7611,14983,4.4,13,-1892,-1.1,23.8,0,318,322,1875
2001,53,l) Left Censored,15095,32108,1024633,1024192,2528,7.9,2327,7.3,129017,42455,86562,4.1,12.6,128136,36341,91795,3.5,12.5,881,0.1,25,0,559,562,4570
2001,54,a) 0,2066,2080,13029,6666,2058,197.9,0,0,12726,12726,0,190.9,190.9,0,0,0,0,0,12726,190.9,0,0,,,
2001,54,b) 1,1809,1855,12100,12432,24,1.1,533,25.3,3261,603,2658,4.9,26.2,3925,2080,1845,16.7,31.6,-664,-5.4,52.4,0,381,381,1576
2001,54,c) 2,1595,1640,12297,12710,61,3.4,390,21.7,2515,571,1944,4.5,19.8,3341,1556,1785,12.2,26.3,-826,-6.5,39.6,0,286,286,1145
2001,54,d) 3,1511,1692,14237,14805,93,5.3,256,14.5,2579,839,1740,5.7,17.4,3715,1622,2093,11,25.1,-1136,-7.7,34.8,0,187,187,1408
2001,54,e) 4,1375,1385,9473,10105,44,3,233,15.8,1322,165,1157,1.6,13.1,2585,1266,1319,12.5,25.6,-1263,-12.5,26.2,0,166,166,878
2001,54,f) 5,1191,1217,9716,10138,33,2.5,217,16.7,1597,142,1455,1.4,15.8,2440,1343,1097,13.2,24.1,-843,-8.3,31.6,0,152,152,822
2001,54,g) 6 to 10,4871,5099,44146,44892,169,3.2,652,12.3,7546,1998,5548,4.5,16.8,9038,4298,4740,9.6,20.1,-1492,-3.3,33.6,0,433,433,2195
2001,54,h) 11 to 15,3812,4107,52652,53075,102,2.4,409,9.6,6596,1294,5302,2.4,12.4,7441,2552,4889,4.8,14,-845,-1.6,24.8,0,244,244,1266
2001,54,i) 16 to 20,3276,3746,50151,50800,91,2.4,259,6.8,4846,1135,3711,2.2,9.5,6143,1640,4503,3.2,12.1,-1297,-2.6,19,0,147,147,638
2001,54,j) 21 to 25,2047,3046,47697,47806,91,2.9,186,6,5501,1259,4242,2.6,11.5,5719,1466,4253,3.1,12,-218,-0.5,23,0,102,102,412
2001,54,l) Left Censored,6072,11193,285181,289853,547,4.8,881,7.8,27480,5853,21627,2,9.5,36825,12679,24146,4.4,12.7,-9345,-3.2,19,0,243,244,945
2001,55,a) 0,7668,7780,50403,25936,7700,197.9,0,0,48935,48935,0,188.7,188.7,0,0,0,0,0,48935,188.7,0,0,,,
2001,55,b) 1,6692,6795,49907,49938,95,1.3,1547,20.6,13096,2714,10382,5.4,26.2,13158,5724,7434,11.5,26.3,-62,-0.1,52.4,0,1067,1069,4136
2001,55,c) 2,5901,6212,57212,58557,238,3.6,1060,16,12225,3698,8527,6.3,20.9,14914,6029,8885,10.3,25.5,-2689,-4.6,41.8,0,798,798,4507
2001,55,d) 3,5549,5952,58645,59670,261,4.2,808,13,11428,4943,6485,8.3,19.2,13477,5005,8472,8.4,22.6,-2049,-3.4,38.4,0,608,608,3808
2001,55,e) 4,4955,5136,41358,42744,140,2.6,702,13,5557,692,4865,1.6,13,8329,3611,4718,8.4,19.5,-2772,-6.5,26,0,508,508,2616
2001,55,f) 5,4477,4547,41650,42797,102,2.1,592,12.4,5302,562,4740,1.3,12.4,7595,3111,4484,7.3,17.7,-2293,-5.3,24.8,0,424,424,2331
2001,55,g) 6 to 10,17688,18651,183867,190283,454,2.3,1991,10.3,19783,2561,17222,1.3,10.4,32614,12333,20281,6.5,17.1,-12831,-6.7,20.8,0,1359,1359,8428
2001,55,h) 11 to 15,13131,14737,203714,207854,405,2.7,1333,8.8,22273,4510,17763,2.2,10.7,30552,9338,21214,4.5,14.7,-8279,-4,21.4,0,778,778,4690
2001,55,i) 16 to 20,9934,11639,189857,191834,285,2.4,796,6.7,20656,3871,16785,2,10.8,24610,8857,15753,4.6,12.8,-3954,-2,21.6,0,446,447,3060
2001,55,j) 21 to 25,6616,9388,180817,181135,347,3.6,713,7.5,21673,7549,14124,4.2,12,22308,5960,16348,3.3,12.3,-635,-0.3,24,0,298,301,1476
2001,55,l) Left Censored,21949,38665,1333396,1356497,2373,6.1,2508,6.5,122066,33978,88088,2.5,9,168268,56752,111516,4.2,12.4,-46202,-3.4,18,0,697,702,7157
2001,56,a) 0,1262,1269,6580,3295,1262,198.9,0,0,6571,,,,199.4,0,0,0,0,0,6571,199.4,0,1,,,
2001,56,b) 1,1072,1087,6614,6666,15,1.2,271,22.3,1730,193,1537,2.9,26,1834,937,897,14.1,27.5,-104,-1.5,52,0,175,175,663
2001,56,c) 2,847,864,5508,5671,26,2.8,184,19.6,1150,166,984,2.9,20.3,1475,639,836,11.3,26,-325,-5.7,40.6,0,134,134,434
2001,56,d) 3,850,900,7123,7377,48,5.1,149,15.8,1268,226,1042,3.1,17.2,1775,723,1052,9.8,24.1,-507,-6.9,34.4,0,97,97,412
2001,56,e) 4,700,713,4784,4848,12,1.6,129,16.8,882,96,786,2,18.2,1009,525,484,10.8,20.8,-127,-2.6,36.4,0,84,84,348
2001,56,f) 5,673,683,4540,4689,13,1.8,98,13.6,678,46,632,1,14.5,975,364,611,7.8,20.8,-297,-6.3,29,0,58,58,250
2001,56,g) 6 to 10,2370,2448,19601,20239,72,2.8,337,13.1,2586,374,2212,1.8,12.8,3862,1692,2170,8.4,19.1,-1276,-6.3,25.6,0,215,215,1247
2001,56,h) 11 to 15,1454,1591,20015,20379,47,2.9,161,9.8,1867,,,,9.2,2594,882,1712,4.3,12.7,-727,-3.5,18.4,1,112,112,591
2001,56,i) 16 to 20,1376,1582,16826,16966,49,3,142,8.8,2066,351,1715,2.1,12.2,2345,549,1796,3.2,13.8,-279,-1.6,24.4,0,80,81,394
2001,56,j) 21 to 25,987,1267,17696,17781,33,2.5,93,7.2,2133,246,1887,1.4,12,2302,623,1679,3.5,12.9,-169,-0.9,24,0,59,59,432
2001,56,l) Left Censored,2375,3758,65914,66240,324,8.7,307,8.2,7480,1891,5589,2.9,11.3,8131,2319,5812,3.5,12.3,-651,-1,22.6,0,57,57,267
2002,01,a) 0,6408,6490,40677,20339,6490,200,0,0,40677,40677,0,200,200,0,0,0,0,0,40677,200,0,0,,,
2002,01,b) 1,4753,4843,37415,36609,39,0.7,1401,25.4,12131,457,11674,1.2,33.1,10519,6040,4479,16.5,28.7,1612,4.4,57.4,0,1058,1058,4572
2002,01,c) 2,4144,4263,35728,36676,218,4.7,934,20.2,7961,1520,6441,4.1,21.7,9856,4960,4896,13.5,26.9,-1895,-5.2,43.4,0,704,705,3738
2002,01,d) 3,4018,4177,38116,38635,216,4.9,642,14.6,7748,1865,5883,4.8,20.1,8786,3228,5558,8.4,22.7,-1038,-2.6,40.2,0,505,505,2831
2002,01,e) 4,3680,3962,40952,42567,233,5.6,620,14.9,6892,2056,4836,4.8,16.2,10122,3106,7016,7.3,23.8,-3230,-7.6,32.4,0,470,470,2391
2002,01,f) 5,3397,3492,31894,33096,184,5,509,13.9,5227,1227,4000,3.7,15.8,7630,2597,5033,7.8,23.1,-2403,-7.3,31.6,0,363,363,1705
2002,01,g) 6 to 10,12552,13210,131798,137126,623,4.5,1640,12,19461,4201,15260,3.1,14.2,30117,9836,20281,7.2,22,-10656,-7.8,28.4,0,1122,1122,5768
2002,01,h) 11 to 15,8834,10002,152834,155613,466,4.5,1004,9.8,19064,5499,13565,3.5,12.3,24622,7366,17256,4.7,15.8,-5558,-3.5,24.6,0,597,597,3608
2002,01,i) 16 to 20,7364,8866,149367,153479,390,4.3,715,7.9,17130,4234,12896,2.8,11.2,25353,6945,18408,4.5,16.5,-8223,-5.3,22.4,0,351,358,2696
2002,01,j) 21 to 25,5234,7804,142197,150153,455,5.8,638,8.1,16869,4291,12578,2.9,11.2,32781,14866,17915,9.9,21.8,-15912,-10.6,22.4,0,247,247,1298
2002,01,l) Left Censored,10171,23883,772728,785621,1799,7.5,2322,9.6,102908,39015,63893,5,13.1,128693,40261,88432,5.1,16.4,-25785,-3.3,26.2,0,383,384,5850
2002,02,a) 0,1383,1404,7410,3705,1404,200,0,0,7410,7410,0,200,200,0,0,0,0,0,7410,200,0,0,,,
2002,02,b) 1,875,887,4914,5233,8,0.8,314,30.2,1173,112,1061,2.1,22.4,1810,1120,690,21.4,34.6,-637,-12.2,44.8,0,178,178,735
2002,02,c) 2,838,861,5914,6014,55,6,174,18.9,1561,395,1166,6.6,26,1761,895,866,14.9,29.3,-200,-3.3,52,0,102,102,583
2002,02,d) 3,665,704,5613,5554,65,8.8,130,17.7,1312,405,907,7.3,23.6,1193,538,655,9.7,21.5,119,2.1,43,0,79,79,379
2002,02,e) 4,712,765,7706,7565,57,7.2,100,12.7,1526,345,1181,4.6,20.2,1243,447,796,5.9,16.4,283,3.8,32.8,0,66,66,325
2002,02,f) 5,604,611,4736,4807,41,6.4,103,16,903,194,709,4,18.8,1044,369,675,7.7,21.7,-141,-2.9,37.6,0,55,55,198
2002,02,g) 6 to 10,2214,2293,15902,16390,152,6.4,324,13.6,3028,662,2366,4,18.5,4004,1560,2444,9.5,24.4,-976,-5.9,37,0,189,189,1055
2002,02,h) 11 to 15,1598,1704,23722,23633,83,4.7,208,11.8,3239,516,2723,2.2,13.7,3061,1075,1986,4.5,13,178,0.7,26,0,112,112,430
2002,02,i) 16 to 20,1441,1704,18858,19130,96,5.5,169,9.7,3630,985,2645,5.1,19,4173,1387,2786,7.3,21.8,-543,-2.8,38,0,74,76,643
2002,02,j) 21 to 25,1040,1566,30488,29879,104,6.6,117,7.4,5581,1171,4410,3.9,18.7,4363,1094,3269,3.7,14.6,1218,4.1,29.2,0,42,42,411
2002,02,l) Left Censored,1490,3110,89188,90622,194,6.1,289,9.2,11167,3525,7642,3.9,12.3,14034,3417,10617,3.8,15.5,-2867,-3.2,24.6,0,38,38,228
2002,04,a) 0,9564,9645,63618,31809,9645,200,0,0,63618,63618,0,200,200,0,0,0,0,0,63618,200,0,0,,,
2002,04,b) 1,7098,7243,54337,55731,72,0.9,2244,26.9,15713,1647,14066,3,28.2,18500,9998,8502,17.9,33.2,-2787,-5,56.4,0,1557,1561,7696
2002,04,c) 2,5984,6135,62967,64639,285,4.3,1372,20.5,12582,1871,10711,2.9,19.5,15925,7826,8099,12.1,24.6,-3343,-5.1,39,0,1017,1021,6270
2002,04,d) 3,5488,5699,68102,71610,327,5.4,1013,16.8,11100,2795,8305,3.9,15.5,18116,6524,11592,9.1,25.3,-7016,-9.8,31,0,762,762,5241
2002,04,e) 4,4834,5202,60437,61575,313,5.8,758,14,11323,3264,8059,5.3,18.4,13599,4773,8826,7.8,22.1,-2276,-3.7,36.8,0,531,531,3835
2002,04,f) 5,4119,4322,47811,49823,221,4.8,718,15.7,7499,1442,6057,2.9,15.1,11522,4785,6737,9.6,23.1,-4023,-8,30.2,0,502,502,3177
2002,04,g) 6 to 10,14745,15621,190360,201392,743,4.6,2141,13.1,28893,6193,22700,3.1,14.3,50957,19636,31321,9.8,25.3,-22064,-11,28.6,0,1371,1371,10978
2002,04,h) 11 to 15,9570,10967,187419,188026,580,5.1,1215,10.8,30401,10220,20181,5.4,16.2,31615,10600,21015,5.6,16.8,-1214,-0.6,32.4,0,673,673,4073
2002,04,i) 16 to 20,7301,9499,179690,182596,550,5.7,1015,10.4,28268,10144,18124,5.6,15.5,34079,10459,23620,5.7,18.7,-5811,-3.2,31,0,440,450,4188
2002,04,j) 21 to 25,5023,7380,192130,192415,494,6.5,870,11.5,33128,9246,23882,4.8,17.2,33698,14176,19522,7.4,17.5,-570,-0.3,34.4,0,254,255,2625
2002,04,l) Left Censored,7353,21869,816208,823794,2227,10.2,2344,10.7,139436,49703,89733,6,16.9,154608,49299,105309,6,18.8,-15172,-1.9,33.8,0,251,254,2010
2002,05,a) 0,4556,4593,27185,13593,4593,200,0,0,27185,27185,0,200,200,0,0,0,0,0,27185,200,0,0,,,
2002,05,b) 1,3246,3308,20957,22178,32,0.8,994,26.2,5000,572,4428,2.6,22.5,7441,4119,3322,18.6,33.6,-2441,-11.1,45,0,742,742,3253
2002,05,c) 2,2805,2869,20010,21542,156,5,623,20.1,4231,1078,3153,5,19.6,7294,2998,4296,13.9,33.9,-3063,-14.3,39.2,0,473,473,2615
2002,05,d) 3,2609,2737,20056,20298,184,6.4,466,16.2,4872,2014,2858,9.9,24,5356,2195,3161,10.8,26.4,-484,-2.4,48,0,338,338,1745
2002,05,e) 4,2292,2542,20504,20877,169,6.4,371,14,3739,1014,2725,4.9,17.9,4484,1543,2941,7.4,21.5,-745,-3.6,35.8,0,272,272,1254
2002,05,f) 5,2049,2090,17677,18478,131,6,327,14.9,2900,920,1980,5,15.7,4501,1921,2580,10.4,24.4,-1601,-8.7,31.4,0,217,217,1369
2002,05,g) 6 to 10,8289,8714,81736,84792,463,5.1,1075,11.9,13136,3788,9348,4.5,15.5,19247,6439,12808,7.6,22.7,-6111,-7.2,31,0,709,711,4311
2002,05,h) 11 to 15,5593,6288,81998,81410,347,5.4,628,9.8,16160,3052,13108,3.7,19.9,14983,4989,9994,6.1,18.4,1177,1.5,36.8,0,354,354,1955
2002,05,i) 16 to 20,4595,5319,83075,80579,249,4.6,421,7.8,17017,3340,13677,4.1,21.1,12025,3071,8954,3.8,14.9,4992,6.2,29.8,0,211,211,1156
2002,05,j) 21 to 25,3621,4827,89562,96278,223,4.5,433,8.8,11156,2958,8198,3.1,11.6,24587,15445,9142,16,25.5,-13431,-13.9,23.2,0,178,179,1071
2002,05,l) Left Censored,6718,14450,513640,519864,1061,7.3,1219,8.4,57325,23816,33509,4.6,11,69773,20185,49588,3.9,13.4,-12448,-2.4,22,0,228,229,1389
2002,06,a) 0,64059,64959,455793,228720,64958,200,0,0,454147,454147,0,198.6,198.6,0,0,0,0,0,454147,198.6,0,0,,,
2002,06,b) 1,47428,48374,379051,393328,430,0.8,15264,27.4,101187,8587,92600,2.2,25.7,129741,69033,60708,17.6,33,-28554,-7.3,51.4,0,10727,10732,52089
2002,06,c) 2,40394,41517,407747,437313,2173,4.8,9252,20.5,84371,19368,65003,4.4,19.3,143503,69481,74022,15.9,32.8,-59132,-13.5,38.6,0,6749,6776,55094
2002,06,d) 3,35188,36900,378185,399263,2173,5.6,6572,16.8,78257,22840,55417,5.7,19.6,120413,50418,69995,12.6,30.2,-42156,-10.6,39.2,0,4800,4800,39054
2002,06,e) 4,31482,34203,395780,410402,2162,6,5280,14.8,83433,20706,62727,5,20.3,112677,41819,70858,10.2,27.5,-29244,-7.2,40.6,0,3846,3849,31476
2002,06,f) 5,26967,27778,315517,348129,1368,4.7,4372,14.9,51418,10362,41056,3,14.8,116642,34290,82352,9.8,33.5,-65224,-18.7,29.6,0,3024,3031,22114
2002,06,g) 6 to 10,97595,102917,1282523,1357473,5434,5.1,13757,12.8,204582,51903,152679,3.8,15.1,354483,124761,229722,9.2,26.1,-149901,-11,30.2,0,8860,8868,76769
2002,06,h) 11 to 15,77244,86876,1318162,1352670,4864,5.5,9535,10.7,214994,47942,167052,3.5,15.9,284009,100922,183087,7.5,21,-69015,-5.1,31.8,0,5246,5253,42077
2002,06,i) 16 to 20,56871,69165,1201954,1248451,3445,4.9,7088,10,167565,47400,120165,3.8,13.4,260559,92156,168403,7.4,20.9,-92994,-7.5,26.8,0,3196,3251,36974
2002,06,j) 21 to 25,43931,61289,1326896,1352132,3291,5.2,6131,9.8,181460,61395,120065,4.5,13.4,231931,75447,156484,5.6,17.2,-50471,-3.8,26.8,0,2284,2308,20073
2002,06,l) Left Censored,58751,146238,5342299,5418614,12056,8.2,14437,9.8,801254,300747,500507,5.6,14.8,953884,304349,649535,5.6,17.6,-152630,-2.8,29.6,0,2513,2529,27484
2002,08,a) 0,11668,11777,62555,31278,11777,200,0,0,62555,62555,0,200,200,0,0,0,0,0,62555,200,0,0,,,
2002,08,b) 1,8761,8884,59513,59732,69,0.7,2933,28.4,18975,1169,17806,2,31.8,19412,10659,8753,17.8,32.5,-437,-0.7,63.6,0,1989,1989,7799
2002,08,c) 2,7503,7667,60562,63892,374,4.5,1751,21,12494,2449,10045,3.8,19.6,19153,8072,11081,12.6,30,-6659,-10.4,39.2,0,1216,1218,6534
2002,08,d) 3,6525,6746,52581,55199,378,5.3,1279,17.8,9863,2694,7169,4.9,17.9,15099,6086,9013,11,27.4,-5236,-9.5,35.8,0,885,885,4651
2002,08,e) 4,5984,6294,53355,54518,398,6,1052,15.9,10784,4021,6763,7.4,19.8,13110,4835,8275,8.9,24,-2326,-4.2,39.6,0,705,705,3478
2002,08,f) 5,5081,5205,47098,50120,250,4.5,908,16.4,7545,1909,5636,3.8,15.1,13588,5971,7617,11.9,27.1,-6043,-12,30.2,0,581,582,4113
2002,08,g) 6 to 10,18890,19798,199829,208091,966,4.7,2656,12.9,32172,7909,24263,3.8,15.5,48696,18476,30220,8.9,23.4,-16524,-7.9,31,0,1512,1516,10031
2002,08,h) 11 to 15,11622,13113,191632,195203,651,4.8,1350,10,27591,6505,21086,3.3,14.1,34732,11573,23159,5.9,17.8,-7141,-3.7,28.2,0,666,666,4517
2002,08,i) 16 to 20,8465,10318,192219,199526,519,4.9,1193,11.2,26222,7343,18879,3.7,13.1,40836,11637,29199,5.8,20.5,-14614,-7.4,26.2,0,423,425,3136
2002,08,j) 21 to 25,6390,8944,174064,181617,496,5.4,866,9.5,21514,7233,14281,4,11.8,36619,12247,24372,6.7,20.2,-15105,-8.4,23.6,0,288,290,2268
2002,08,l) Left Censored,9720,23533,779066,812630,2131,9,2417,10.2,112350,43476,68874,5.4,13.8,179477,70934,108543,8.7,22.1,-67127,-8.3,27.6,0,343,346,4959
2002,09,a) 0,5288,5333,36205,18103,5333,200,0,0,36205,36205,0,200,200,0,0,0,0,0,36205,200,0,0,,,
2002,09,b) 1,4032,4085,26731,27539,23,0.5,1047,22.8,6581,216,6365,0.8,23.9,8196,3755,4441,13.6,29.8,-1615,-5.9,47.8,0,717,717,2740
2002,09,c) 2,3656,3743,30400,31377,167,4.2,712,17.7,5980,1359,4621,4.3,19.1,7933,3362,4571,10.7,25.3,-1953,-6.2,38.2,0,489,489,2624
2002,09,d) 3,3262,3359,33334,33770,158,4.5,513,14.5,6514,1294,5220,3.8,19.3,7385,2518,4867,7.5,21.9,-871,-2.6,38.6,0,354,354,1972
2002,09,e) 4,3218,3444,33670,33635,170,4.7,454,12.7,6475,1580,4895,4.7,19.3,6404,1817,4587,5.4,19,71,0.3,38,0,298,298,1408
2002,09,f) 5,2721,2766,23044,24694,91,3.1,374,12.9,3344,381,2963,1.5,13.5,6644,2676,3968,10.8,26.9,-3300,-13.4,27,0,228,228,1403
2002,09,g) 6 to 10,11028,11312,125254,129541,381,3.2,1333,11.3,15801,2322,13479,1.8,12.2,24374,9519,14855,7.3,18.8,-8573,-6.6,24.4,0,845,845,6457
2002,09,h) 11 to 15,9450,10147,128117,129536,385,3.7,1004,9.6,19374,4143,15231,3.2,15,22212,7895,14317,6.1,17.1,-2838,-2.1,30,0,542,543,3424
2002,09,i) 16 to 20,7412,8419,112898,114580,327,3.8,721,8.4,14314,2996,11318,2.6,12.5,17677,5211,12466,4.5,15.4,-3363,-2.9,25,0,341,342,2243
2002,09,j) 21 to 25,5404,6982,124831,126827,278,3.9,626,8.7,17504,5922,11582,4.7,13.8,21495,7265,14230,5.7,16.9,-3991,-3.1,27.6,0,244,245,1384
2002,09,l) Left Censored,12853,23024,883251,886519,1541,6.6,2190,9.4,117794,42336,75458,4.8,13.3,124330,35395,88935,4,14,-6536,-0.7,26.6,0,498,498,3731
2002,10,a) 0,1604,1634,9692,4846,1634,200,0,0,9692,9692,0,200,200,0,0,0,0,0,9692,200,0,0,,,
2002,10,b) 1,1324,1335,7068,7453,7,0.5,329,22,1460,17,1443,0.2,19.6,2229,1076,1153,14.4,29.9,-769,-10.3,39.2,0,227,229,776
2002,10,c) 2,1211,1227,7752,8212,57,4.3,240,18.2,1376,320,1056,3.9,16.8,2295,1038,1257,12.6,27.9,-919,-11.1,33.6,0,181,181,854
2002,10,d) 3,1014,1041,8515,8659,54,4.9,174,15.8,1570,613,957,7.1,18.1,1857,686,1171,7.9,21.4,-287,-3.3,36.2,0,124,124,478
2002,10,e) 4,920,952,7233,7245,57,5.7,145,14.6,1181,264,917,3.6,16.3,1205,496,709,6.8,16.6,-24,-0.3,32.6,0,107,107,386
2002,10,f) 5,736,759,6537,6658,33,4.1,113,14.1,936,159,777,2.4,14.1,1177,345,832,5.2,17.7,-241,-3.6,28.2,0,76,76,207
2002,10,g) 6 to 10,2876,3008,32540,32983,170,5.5,358,11.5,5096,1744,3352,5.3,15.5,5982,2375,3607,7.2,18.1,-886,-2.6,31,0,222,222,788
2002,10,h) 11 to 15,2067,2202,25424,25604,114,5.1,213,9.5,3572,889,2683,3.5,14,3932,1735,2197,6.8,15.4,-360,-1.4,28,0,115,116,634
2002,10,i) 16 to 20,1486,1723,25439,25633,83,4.7,159,9,3960,1601,2359,6.2,15.4,4348,1810,2538,7.1,17,-388,-1.6,30.8,0,78,78,1251
2002,10,j) 21 to 25,1163,1565,47422,45628,97,6.2,118,7.5,13722,5750,7972,12.6,30.1,10134,1655,8479,3.6,22.2,3588,7.9,44.4,0,45,45,367
2002,10,l) Left Censored,3176,6198,208682,210529,615,9.9,601,9.7,28018,12338,15680,5.9,13.3,31711,10405,21306,4.9,15.1,-3693,-1.8,26.6,0,62,65,404
2002,11,a) 0,1143,1147,9628,4814,1147,200,0,0,9628,9628,0,200,200,0,0,0,0,0,9628,200,0,0,,,
2002,11,b) 1,851,855,7967,7842,9,0.9,200,21,2037,200,1837,2.6,26,1786,905,881,11.5,22.8,251,3.2,45.6,0,143,143,683
2002,11,c) 2,743,754,8251,8512,38,4.7,133,16.6,2269,930,1339,10.9,26.7,2790,1250,1540,14.7,32.8,-521,-6.1,53.4,0,103,103,1036
2002,11,d) 3,715,752,9535,9262,57,7.4,90,11.7,2387,767,1620,8.3,25.8,1840,665,1175,7.2,19.9,547,5.9,39.8,0,60,60,397
2002,11,e) 4,676,703,6977,7016,57,8,68,9.6,1306,581,725,8.3,18.6,1383,345,1038,4.9,19.7,-77,-1.1,37.2,0,46,46,230
2002,11,f) 5,596,611,5880,6283,24,3.8,82,12.8,730,199,531,3.2,11.6,1535,637,898,10.1,24.4,-805,-12.8,23.2,0,58,58,408
2002,11,g) 6 to 10,2290,2380,35202,36393,100,4,291,11.8,4836,1022,3814,2.8,13.3,7218,2408,4810,6.6,19.8,-2382,-6.5,26.6,0,177,177,848
2002,11,h) 11 to 15,1811,1998,33201,34266,106,5.2,197,9.6,6192,1044,5148,3,18.1,8321,4611,3710,13.5,24.3,-2129,-6.2,36.2,0,86,86,2657
2002,11,i) 16 to 20,1600,1834,30389,30475,116,6.2,190,10.2,4250,1676,2574,5.5,13.9,4422,1471,2951,4.8,14.5,-172,-0.6,27.8,0,67,68,357
2002,11,j) 21 to 25,1339,1697,52768,53388,114,6.6,161,9.4,6598,1196,5402,2.2,12.4,7838,1649,6189,3.1,14.7,-1240,-2.3,24.8,0,44,46,214
2002,11,l) Left Censored,3394,5807,229012,230293,521,8.9,614,10.5,32104,13915,18189,6,13.9,34666,9143,25523,4,15.1,-2562,-1.2,27.8,0,81,81,1143
2002,12,a) 0,39587,39909,218706,109353,39909,200,0,0,218706,218706,0,200,200,0,0,0,0,0,218706,200,0,0,,,
2002,12,b) 1,27300,27703,188869,191661,159,0.5,9692,29.8,62350,3744,58606,2,32.5,67933,41954,25979,21.9,35.4,-5583,-2.9,65,0,6688,6694,29689
2002,12,c) 2,22572,23112,169272,176984,1126,4.5,5365,21.3,39279,6777,32502,3.8,22.2,54702,27251,27451,15.4,30.9,-15423,-8.7,44.4,0,3864,3865,20449
2002,12,d) 3,20183,21156,194139,198945,1192,5.3,4012,17.8,43814,9968,33846,5,22,53426,26020,27406,13.1,26.9,-9612,-4.9,44,0,2838,2849,19497
2002,12,e) 4,17850,19041,196028,197969,1157,5.8,3064,15.3,38140,11605,26535,5.9,19.3,42021,19140,22881,9.7,21.2,-3881,-1.9,38.6,0,2188,2188,14342
2002,12,f) 5,15275,15616,141588,147958,760,4.6,2557,15.5,28935,5928,23007,4,19.6,41676,22765,18911,15.4,28.2,-12741,-8.6,39.2,0,1718,1723,18497
2002,12,g) 6 to 10,58377,61282,682738,721893,2992,4.7,8216,12.9,128232,34274,93958,4.7,17.8,206541,106041,100500,14.7,28.6,-78309,-10.8,35.6,0,5166,5169,43155
2002,12,h) 11 to 15,39683,44387,687056,702572,2080,4.5,4852,10.6,99143,22057,77086,3.1,14.1,130175,51587,78588,7.3,18.5,-31032,-4.4,28.2,0,2701,2704,19644
2002,12,i) 16 to 20,26347,31625,580395,604144,1489,4.6,3247,10,82646,22260,60386,3.7,13.7,130143,69980,60163,11.6,21.5,-47497,-7.8,27.4,0,1489,1503,10584
2002,12,j) 21 to 25,17499,25137,480302,488049,1497,5.8,2459,9.6,78873,31203,47670,6.4,16.2,94367,38407,55960,7.9,19.3,-15494,-3.1,32.4,0,850,859,6281
2002,12,l) Left Censored,24836,75970,2762822,2791608,6364,8.3,8173,10.6,416774,146874,269900,5.3,14.9,474347,174564,299783,6.3,17,-57573,-2.1,29.8,0,1058,1067,10761
2002,13,a) 0,16197,16370,106732,56585,16369,200,0,0,100295,100295,0,177.2,177.2,0,0,0,0,0,100295,177.2,0,0,,,
2002,13,b) 1,11576,11819,84186,87094,132,1,3738,27.4,22676,2855,19821,3.3,26,28491,16871,11620,19.4,32.7,-5815,-6.7,52,0,2615,2616,12792
2002,13,c) 2,10214,10410,89060,93910,509,4.5,2361,20.8,17559,3975,13584,4.2,18.7,27259,12845,14414,13.7,29,-9700,-10.3,37.4,0,1686,1690,10346
2002,13,d) 3,9144,9516,91144,99628,593,5.9,1684,16.7,16861,4729,12132,4.7,16.9,33829,19706,14123,19.8,34,-16968,-17.1,33.8,0,1200,1200,15881
2002,13,e) 4,8266,8788,81605,85921,545,5.9,1412,15.3,14231,4245,9986,4.9,16.6,22862,8712,14150,10.1,26.6,-8631,-10,33.2,0,985,985,6630
2002,13,f) 5,7000,7215,72501,74623,354,4.7,1096,14.4,13253,3985,9268,5.3,17.8,17497,6079,11418,8.1,23.4,-4244,-5.6,35.6,0,711,712,4258
2002,13,g) 6 to 10,25473,26994,315274,325298,1283,4.6,3610,12.8,56869,12794,44075,3.9,17.5,76918,28860,48058,8.9,23.6,-20049,-6.1,35,0,2135,2147,16830
2002,13,h) 11 to 15,16380,18963,297517,303496,1045,5.4,1985,10.2,43469,12706,30763,4.2,14.3,55426,19921,35505,6.6,18.3,-11957,-4,28.6,0,1033,1034,8612
2002,13,i) 16 to 20,12699,15221,265987,271656,772,5,1479,9.5,38386,14010,24376,5.2,14.1,49724,15544,34180,5.7,18.3,-11338,-4.2,28.2,0,688,690,5116
2002,13,j) 21 to 25,8657,12786,277109,284575,818,6.3,1222,9.4,38508,12966,25542,4.6,13.5,53439,17951,35488,6.3,18.8,-14931,-5.3,27,0,381,381,3696
2002,13,l) Left Censored,15938,43717,1685439,1714608,3658,8.3,4597,10.4,232409,93841,138568,5.5,13.6,290747,98387,192360,5.7,17,-58338,-3.4,27.2,0,560,564,6709
2002,15,a) 0,1988,2016,12920,6460,2016,200,0,0,12920,12920,0,200,200,0,0,0,0,0,12920,200,0,0,,,
2002,15,b) 1,1441,1467,11068,15352,11,0.7,409,24.5,2399,201,2198,1.3,15.6,10966,1697,9269,11.1,71.4,-8567,-55.8,31.2,0,297,297,1293
2002,15,c) 2,1285,1339,11237,11627,56,3.9,245,17.1,2109,441,1668,3.8,18.1,2889,984,1905,8.5,24.8,-780,-6.7,36.2,0,188,188,809
2002,15,d) 3,1048,1087,9383,9734,59,5.2,163,14.3,1583,376,1207,3.9,16.3,2284,644,1640,6.6,23.5,-701,-7.2,32.6,0,120,120,532
2002,15,e) 4,1025,1086,10350,10596,82,7.3,149,13.3,2272,967,1305,9.1,21.4,2764,1317,1447,12.4,26.1,-492,-4.7,42.8,0,101,101,1077
2002,15,f) 5,872,882,8314,8524,37,4,125,13.5,1272,201,1071,2.4,14.9,1691,686,1005,8,19.8,-419,-4.9,29.8,0,85,85,521
2002,15,g) 6 to 10,3556,3723,45449,46964,158,4.1,413,10.7,5353,743,4610,1.6,11.4,8382,2815,5567,6,17.8,-3029,-6.4,22.8,0,267,267,1511
2002,15,h) 11 to 15,2898,3273,41978,42354,170,5.1,326,9.7,5843,1345,4498,3.2,13.8,6595,2493,4102,5.9,15.6,-752,-1.8,27.6,0,158,159,786
2002,15,i) 16 to 20,2296,2726,36522,37236,101,3.6,252,9,4115,1125,2990,3,11.1,5543,1851,3692,5,14.9,-1428,-3.8,22.2,0,113,115,601
2002,15,j) 21 to 25,2089,2929,45157,46214,134,4.5,230,7.7,6210,2252,3958,4.9,13.4,8323,2204,6119,4.8,18,-2113,-4.6,26.8,0,72,73,720
2002,15,l) Left Censored,3624,7134,207898,210263,427,5.9,638,8.8,23592,7282,16310,3.5,11.2,28321,8663,19658,4.1,13.5,-4729,-2.3,22.4,0,114,114,1063
2002,16,a) 0,3101,3138,20137,10069,3138,200,0,0,20137,20137,0,200,200,0,0,0,0,0,20137,200,0,0,,,
2002,16,b) 1,2295,2326,14820,15388,11,0.4,755,28,3765,298,3467,1.9,24.5,4900,2819,2081,18.3,31.8,-1135,-7.3,49,0,461,461,2049
2002,16,c) 2,2032,2096,17783,18746,127,5.7,404,18.1,3818,606,3212,3.2,20.4,5744,3506,2238,18.7,30.6,-1926,-10.2,40.8,0,282,282,2804
2002,16,d) 3,1816,1875,13912,13827,140,7.2,283,14.5,3150,967,2183,7,22.8,2980,1197,1783,8.7,21.6,170,1.2,43.2,0,184,184,904
2002,16,e) 4,1594,1703,14379,14838,129,7.3,269,15.2,2404,536,1868,3.6,16.2,3321,1087,2234,7.3,22.4,-917,-6.2,32.4,0,172,175,847
2002,16,f) 5,1494,1533,11501,12086,95,6,213,13.4,1593,346,1247,2.9,13.2,2763,868,1895,7.2,22.9,-1170,-9.7,26.4,0,118,118,507
2002,16,g) 6 to 10,5288,5442,47446,49343,337,6,709,12.6,6445,1804,4641,3.7,13.1,10238,3541,6697,7.2,20.7,-3793,-7.6,26.2,0,386,387,2111
2002,16,h) 11 to 15,3303,3640,40940,41871,239,6.4,410,11,5874,2011,3863,4.8,14,7735,2296,5439,5.5,18.5,-1861,-4.5,28,0,175,175,1030
2002,16,i) 16 to 20,2283,2761,36572,44930,180,6.4,275,9.8,4913,1603,3310,3.6,10.9,21628,1932,19696,4.3,48.1,-16715,-37.2,21.8,0,117,120,736
2002,16,j) 21 to 25,1870,2430,52817,54754,135,5.4,260,10.4,6892,1839,5053,3.4,12.6,10765,4370,6395,8,19.7,-3873,-7.1,25.2,0,95,107,1002
2002,16,l) Left Censored,3324,6867,186542,192765,496,7.2,617,8.9,25307,7933,17374,4.1,13.1,37752,11134,26618,5.8,19.6,-12445,-6.5,26.2,0,113,113,4659
2002,17,a) 0,18903,19094,130298,65149,19094,200,0,0,130298,130298,0,200,200,0,0,0,0,0,130298,200,0,0,,,
2002,17,b) 1,14190,14430,101046,104112,167,1,4056,24.8,26049,2350,23699,2.3,25,32181,17356,14825,16.7,30.9,-6132,-5.9,50,0,2685,2686,12779
2002,17,c) 2,12936,13254,113596,115198,560,3.9,2647,18.5,28595,4518,24077,3.9,24.8,31799,14723,17076,12.8,27.6,-3204,-2.8,49.6,0,1791,1793,11882
2002,17,d) 3,11741,12211,112977,119038,601,4.6,2103,16.2,21603,5075,16528,4.3,18.1,33725,13157,20568,11.1,28.3,-12122,-10.2,36.2,0,1430,1439,10586
2002,17,e) 4,11214,11929,121073,122298,646,5.2,1650,13.3,25227,5714,19513,4.7,20.6,27677,8738,18939,7.1,22.6,-2450,-2,41.2,0,1060,1060,5931
2002,17,f) 5,9989,10515,99901,102050,412,3.7,1499,13.6,19133,3797,15336,3.7,18.7,23431,7979,15452,7.8,23,-4298,-4.3,37.4,0,934,935,4755
2002,17,g) 6 to 10,39311,40844,428065,442542,1580,3.7,4911,11.6,65582,10681,54901,2.4,14.8,94535,31919,62616,7.2,21.4,-28953,-6.6,29.6,0,2876,2886,19243
2002,17,h) 11 to 15,29673,32953,477205,504981,1401,4.1,3342,9.9,57209,15447,41762,3.1,11.3,112760,54878,57882,10.9,22.3,-55551,-11,22.6,0,1700,1703,11681
2002,17,i) 16 to 20,22233,25908,455420,466861,1078,4.1,2360,8.9,56940,17983,38957,3.9,12.2,79821,23565,56256,5,17.1,-22881,-4.9,24.4,0,1113,1116,8312
2002,17,j) 21 to 25,16750,22505,457782,467431,1028,4.5,2110,9.2,56795,16765,40030,3.6,12.2,76093,24065,52028,5.1,16.3,-19298,-4.1,24.4,0,778,787,5807
2002,17,l) Left Censored,35478,72758,2700933,2778817,5396,7.3,7559,10.2,323489,122375,201114,4.4,11.6,479258,144868,334390,5.2,17.2,-155769,-5.6,23.2,0,1331,1364,16576
2002,18,a) 0,9054,9147,66878,33439,9147,200,0,0,66878,66878,0,200,200,0,0,0,0,0,66878,200,0,0,,,
2002,18,b) 1,6501,6694,47256,48512,88,1.2,1934,25.4,12129,1239,10890,2.6,25,14641,7959,6682,16.4,30.2,-2512,-5.2,50,0,1368,1373,6091
2002,18,c) 2,5837,5996,50030,52172,268,4.2,1164,18.1,9363,2234,7129,4.3,17.9,13646,6042,7604,11.6,26.2,-4283,-8.3,35.8,0,819,819,4777
2002,18,d) 3,5308,5516,51876,52719,255,4.3,959,16.3,10699,2954,7745,5.6,20.3,12385,5308,7077,10.1,23.5,-1686,-3.2,40.6,0,666,666,3983
2002,18,e) 4,5127,5661,60641,62354,333,5.7,753,12.8,10799,4068,6731,6.5,17.3,14224,5050,9174,8.1,22.8,-3425,-5.5,34.6,0,515,515,3200
2002,18,f) 5,4508,4700,40114,42032,214,4.3,711,14.4,6461,1694,4767,4,15.4,10296,4678,5618,11.1,24.5,-3835,-9.1,30.8,0,489,489,3054
2002,18,g) 6 to 10,18126,19137,198055,206117,765,3.9,2223,11.2,25423,5284,20139,2.6,12.3,41546,15194,26352,7.4,20.2,-16123,-7.9,24.6,0,1352,1354,8868
2002,18,h) 11 to 15,13314,15204,220220,223874,687,4.4,1452,9.3,30910,7432,23478,3.3,13.8,38218,12985,25233,5.8,17.1,-7308,-3.3,27.6,0,735,737,5344
2002,18,i) 16 to 20,10695,12810,199404,205958,530,4,1120,8.5,22762,5994,16768,2.9,11.1,35872,12100,23772,5.9,17.4,-13110,-6.3,22.2,0,509,514,4096
2002,18,j) 21 to 25,7824,10804,218367,223804,643,5.9,871,8,25582,8909,16673,4,11.4,36456,10642,25814,4.8,16.3,-10874,-4.9,22.8,0,329,329,2296
2002,18,l) Left Censored,17335,38155,1364027,1397906,2586,6.7,3562,9.2,158807,56485,102322,4,11.4,226564,63778,162786,4.6,16.2,-67757,-4.8,22.8,0,588,603,6426
2002,19,a) 0,4821,4908,29527,14764,4908,200,0,0,29527,29527,0,200,200,0,0,0,0,0,29527,200,0,0,,,
2002,19,b) 1,3385,3448,22635,23322,36,0.9,920,23.7,5507,713,4794,3.1,23.6,6880,3541,3339,15.2,29.5,-1373,-5.9,47.2,0,596,598,2654
2002,19,c) 2,3158,3216,24451,25412,148,4.3,580,16.9,4557,1373,3184,5.4,17.9,6478,3373,3105,13.3,25.5,-1921,-7.6,35.8,0,380,380,2024
2002,19,d) 3,2827,2965,23789,24151,180,5.8,458,14.8,4632,1626,3006,6.7,19.2,5355,2208,3147,9.1,22.2,-723,-3,38.4,0,292,292,1576
2002,19,e) 4,2688,2880,21979,22821,178,5.9,404,13.5,3702,1445,2257,6.3,16.2,5386,1712,3674,7.5,23.6,-1684,-7.4,32.4,0,279,279,1434
2002,19,f) 5,2545,2644,22898,23652,113,4.1,338,12.3,3206,559,2647,2.4,13.6,4714,1710,3004,7.2,19.9,-1508,-6.3,27.2,0,201,201,1141
2002,19,g) 6 to 10,10338,10737,88773,90868,515,4.6,1219,11,14584,5004,9580,5.5,16,18774,6845,11929,7.5,20.7,-4190,-4.7,32,0,652,652,4661
2002,19,h) 11 to 15,7398,8047,103434,106388,360,4.3,851,10.3,12291,3459,8832,3.3,11.6,18198,6567,11631,6.2,17.1,-5907,-5.5,23.2,0,406,406,2799
2002,19,i) 16 to 20,5918,7230,110960,111386,309,4.2,610,8.3,14219,3285,10934,2.9,12.8,15070,4527,10543,4.1,13.5,-851,-0.7,25.6,0,254,255,1411
2002,19,j) 21 to 25,5190,7399,112210,113568,299,4,635,8.4,13032,3357,9675,3,11.5,15747,4996,10751,4.4,13.9,-2715,-2.4,23,0,244,246,1470
2002,19,l) Left Censored,11665,21840,674944,685268,1208,5.5,1747,7.9,68396,24408,43988,3.6,10,89044,27083,61961,4,13,-20648,-3,20,0,383,389,2650
2002,20,a) 0,4987,5038,31415,15708,5038,200,0,0,31415,31415,0,200,200,0,0,0,0,0,31415,200,0,0,,,
2002,20,b) 1,3645,3713,26049,26597,37,0.9,1099,25.9,6303,460,5843,1.7,23.7,7399,3878,3521,14.6,27.8,-1096,-4.1,47.4,0,771,771,3048
2002,20,c) 2,3243,3308,27073,27759,193,5.4,663,18.7,5880,1700,4180,6.1,21.2,7251,3180,4071,11.5,26.1,-1371,-4.9,42.4,0,483,483,2807
2002,20,d) 3,2878,2984,21743,22689,171,5.4,507,16.1,4651,1530,3121,6.7,20.5,6542,2736,3806,12.1,28.8,-1891,-8.3,41,0,357,357,1929
2002,20,e) 4,2794,3057,27776,29195,201,6.3,440,13.9,5098,1192,3906,4.1,17.5,7935,3259,4676,11.2,27.2,-2837,-9.7,35,0,304,304,2780
2002,20,f) 5,2420,2514,23592,23760,152,5.8,358,13.7,4415,632,3783,2.7,18.6,4750,1913,2837,8.1,20,-335,-1.4,37.2,0,233,233,1486
2002,20,g) 6 to 10,9383,9796,86520,89362,470,4.6,1251,12.3,13774,3810,9964,4.3,15.4,19458,7849,11609,8.8,21.8,-5684,-6.4,30.8,0,772,775,4239
2002,20,h) 11 to 15,6673,7351,92920,93910,374,5,689,9.2,12009,3568,8441,3.8,12.8,13989,4437,9552,4.7,14.9,-1980,-2.1,25.6,0,367,367,2311
2002,20,i) 16 to 20,5545,6411,83873,84969,276,4.2,571,8.7,11572,3255,8317,3.8,13.6,13763,4425,9338,5.2,16.2,-2191,-2.6,27.2,0,257,260,1728
2002,20,j) 21 to 25,4409,6146,99222,101069,325,5.2,610,9.7,13701,4413,9288,4.4,13.6,17394,6635,10759,6.6,17.2,-3693,-3.6,27.2,0,190,191,1269
2002,20,l) Left Censored,9484,18626,579964,588773,1223,6.5,1685,8.9,71334,25328,46006,4.3,12.1,88952,24562,64390,4.2,15.1,-17618,-3,24.2,0,280,280,1431
2002,21,a) 0,5573,5638,40327,20164,5638,200,0,0,40327,40327,0,200,200,0,0,0,0,0,40327,200,0,0,,,
2002,21,b) 1,4243,4272,30262,31272,20,0.4,1218,25,7580,294,7286,0.9,24.2,9600,5169,4431,16.5,30.7,-2020,-6.5,48.4,0,928,932,3930
2002,21,c) 2,3821,3935,30813,32235,158,3.7,747,17.7,5851,1065,4786,3.3,18.2,8695,3677,5018,11.4,27,-2844,-8.8,36.4,0,565,565,3080
2002,21,d) 3,3520,3679,36289,36851,197,5.1,580,15,6966,2117,4849,5.7,18.9,8089,3354,4735,9.1,22,-1123,-3.1,37.8,0,431,431,2784
2002,21,e) 4,3313,3616,33223,33567,230,6.1,509,13.6,8222,3242,4980,9.7,24.5,8909,3080,5829,9.2,26.5,-687,-2,49,0,379,379,2423
2002,21,f) 5,2845,3004,26545,27222,124,3.9,423,13.4,4605,1122,3483,4.1,16.9,5959,2303,3656,8.5,21.9,-1354,-5,33.8,0,278,278,1674
2002,21,g) 6 to 10,11306,11989,121961,126756,619,5,1431,11.5,17148,4419,12729,3.5,13.5,26737,9808,16929,7.7,21.1,-9589,-7.6,27,0,886,890,5594
2002,21,h) 11 to 15,8457,9503,131548,136025,451,4.7,831,8.6,17229,3941,13288,2.9,12.7,26183,6181,20002,4.5,19.2,-8954,-6.5,25.4,0,468,468,2990
2002,21,i) 16 to 20,6793,7972,125835,128030,362,4.5,615,7.6,16875,5121,11754,4,13.2,21264,6929,14335,5.4,16.6,-4389,-3.4,26.4,0,300,300,1784
2002,21,j) 21 to 25,4690,6684,133441,136141,481,7.2,546,8.1,16138,5578,10560,4.1,11.9,21537,5888,15649,4.3,15.8,-5399,-3.9,23.8,0,215,219,1337
2002,21,l) Left Censored,10339,22598,765212,779352,1344,5.9,1980,8.6,83336,24114,59222,3.1,10.7,111615,29434,82181,3.8,14.3,-28279,-3.6,21.4,0,374,378,2811
2002,22,a) 0,6512,6582,47301,23651,6582,200,0,0,47301,47301,0,200,200,0,0,0,0,0,47301,200,0,0,,,
2002,22,b) 1,4869,4959,42588,43126,30,0.5,1351,24,11449,836,10613,1.9,26.5,12524,6560,5964,15.2,29,-1075,-2.5,53,0,971,971,5238
2002,22,c) 2,4253,4402,52310,54254,224,4.7,858,18.2,10440,3200,7240,5.9,19.2,14327,5125,9202,9.4,26.4,-3887,-7.2,38.4,0,658,660,4143
2002,22,d) 3,3782,3938,35941,36602,221,5.3,613,14.8,7635,1761,5874,4.8,20.9,8956,3427,5529,9.4,24.5,-1321,-3.6,41.8,0,444,444,2504
2002,22,e) 4,3729,4035,40813,42161,236,5.6,533,12.7,7409,2206,5203,5.2,17.6,10104,3369,6735,8,24,-2695,-6.4,35.2,0,391,391,2485
2002,22,f) 5,3292,3354,35245,36715,147,4.2,479,13.6,6691,1665,5026,4.5,18.2,9631,3544,6087,9.7,26.2,-2940,-8,36.4,0,353,355,2314
2002,22,g) 6 to 10,12788,13334,151213,153422,590,4.3,1468,10.7,22950,3726,19224,2.4,15,27367,10344,17023,6.7,17.8,-4417,-2.8,30,0,981,982,5812
2002,22,h) 11 to 15,8603,9720,153037,155331,421,4.2,933,9.4,22699,4458,18241,2.9,14.6,27287,8309,18978,5.3,17.6,-4588,-3,29.2,0,525,527,4640
2002,22,i) 16 to 20,8103,9429,121556,124291,424,4.4,777,8.1,17240,4645,12595,3.7,13.9,22709,6945,15764,5.6,18.3,-5469,-4.4,27.8,0,383,383,3351
2002,22,j) 21 to 25,6322,8617,153393,159763,421,4.8,697,8,20504,5370,15134,3.4,12.8,33244,15260,17984,9.6,20.8,-12740,-8,25.6,0,233,236,5190
2002,22,l) Left Censored,11260,24525,732564,741999,1592,6.4,2200,8.9,90258,33000,57258,4.4,12.2,109129,32929,76200,4.4,14.7,-18871,-2.5,24.4,0,403,403,3812
2002,23,a) 0,2651,2667,15475,7738,2667,200,0,0,15475,15475,0,200,200,0,0,0,0,0,15475,200,0,0,,,
2002,23,b) 1,2034,2058,11385,11894,8,0.3,573,24.5,2495,82,2413,0.7,21,3512,2110,1402,17.7,29.5,-1017,-8.5,42,0,377,377,1691
2002,23,c) 2,1775,1819,11913,13193,101,5.1,408,20.7,1979,453,1526,3.4,15,4538,2513,2025,19,34.4,-2559,-19.4,30,0,264,264,1629
2002,23,d) 3,1687,1745,12868,13412,92,5,299,16.2,1990,498,1492,3.7,14.8,3077,1285,1792,9.6,22.9,-1087,-8.1,29.6,0,200,200,974
2002,23,e) 4,1578,1745,13302,13526,93,5.1,238,13.1,2482,827,1655,6.1,18.3,2929,770,2159,5.7,21.7,-447,-3.4,36.6,0,151,151,491
2002,23,f) 5,1332,1357,8262,8746,51,3.6,201,14,1072,168,904,1.9,12.3,2039,814,1225,9.3,23.3,-967,-11,24.6,0,132,132,587
2002,23,g) 6 to 10,4952,5117,41744,43373,200,3.8,604,11.4,5720,1338,4382,3.1,13.2,8978,3447,5531,7.9,20.7,-3258,-7.5,26.4,0,360,360,1791
2002,23,h) 11 to 15,3925,4218,44431,45623,185,4.3,449,10.3,5844,1767,4077,3.9,12.8,8227,3324,4903,7.3,18,-2383,-5.2,25.6,0,236,236,1943
2002,23,i) 16 to 20,2914,3431,45439,46521,126,3.6,320,9.1,5700,1082,4618,2.3,12.3,7864,2789,5075,6,16.9,-2164,-4.6,24.6,0,151,152,821
2002,23,j) 21 to 25,2077,2995,52371,53577,147,4.8,283,9.2,6767,1962,4805,3.7,12.6,9179,2753,6426,5.1,17.1,-2412,-4.5,25.2,0,76,76,807
2002,23,l) Left Censored,4121,7625,224834,229614,456,5.9,581,7.6,22448,7559,14889,3.3,9.8,32007,9181,22826,4,13.9,-9559,-4.1,19.6,0,119,119,1744
2002,24,a) 0,9056,9133,59937,29969,9133,200,0,0,59937,59937,0,200,200,0,0,0,0,0,59937,200,0,0,,,
2002,24,b) 1,6591,6666,45432,47229,42,0.6,1853,24.5,11535,591,10944,1.3,24.4,15128,7103,8025,15,32,-3593,-7.6,48.8,0,1239,1240,5433
2002,24,c) 2,5697,5850,45341,46359,316,5.1,1075,17.3,9761,2298,7463,5,21.1,11796,5663,6133,12.2,25.4,-2035,-4.3,42.2,0,748,748,4518
2002,24,d) 3,5273,5494,52853,54018,267,4.6,864,14.9,10137,2393,7744,4.4,18.8,12467,5439,7028,10.1,23.1,-2330,-4.3,37.6,0,583,586,3919
2002,24,e) 4,4949,5348,53009,52931,298,5.4,660,11.9,11416,3361,8055,6.3,21.6,11259,4320,6939,8.2,21.3,157,0.3,42.6,0,453,453,3488
2002,24,f) 5,4378,4487,44411,45378,205,4.4,632,13.4,7656,1615,6041,3.6,16.9,9589,3311,6278,7.3,21.1,-1933,-4.2,33.8,0,435,435,2532
2002,24,g) 6 to 10,16453,17221,183417,189668,737,4.1,1976,11.1,26887,4580,22307,2.4,14.2,39388,16293,23095,8.6,20.8,-12501,-6.6,28.4,0,1204,1206,10284
2002,24,h) 11 to 15,12765,14013,208218,214053,622,4.3,1372,9.5,29424,7766,21658,3.6,13.7,41093,14646,26447,6.8,19.2,-11669,-5.5,27.4,0,719,719,7956
2002,24,i) 16 to 20,9243,10843,160719,164455,432,3.9,1008,9.1,23321,5776,17545,3.5,14.2,30792,11327,19465,6.9,18.7,-7471,-4.5,28.4,0,426,427,3682
2002,24,j) 21 to 25,6244,8641,178302,180156,426,4.8,754,8.6,23792,7150,16642,4,13.2,27500,9773,17727,5.4,15.3,-3708,-2.1,26.4,0,293,294,2216
2002,24,l) Left Censored,12947,28567,1022174,1034586,2226,7.7,2808,9.7,130732,49848,80884,4.8,12.6,155555,49628,105927,4.8,15,-24823,-2.4,25.2,0,367,372,4794
2002,25,a) 0,10762,10842,68113,34057,10842,200,0,0,68113,68113,0,200,200,0,0,0,0,0,68113,200,0,0,,,
2002,25,b) 1,8576,8683,59565,61341,58,0.6,2037,21.1,14249,1332,12917,2.2,23.2,17800,8458,9342,13.8,29,-3551,-5.8,46.4,0,1416,1416,6467
2002,25,c) 2,7672,7889,57674,62664,378,4.5,1511,17.9,12096,2807,9289,4.5,19.3,22076,9021,13055,14.4,35.2,-9980,-15.9,38.6,0,1030,1030,6529
2002,25,d) 3,7502,7742,61914,66411,353,4.4,1084,13.4,10295,2264,8031,3.4,15.5,19288,8134,11154,12.2,29,-8993,-13.5,31,0,736,736,5929
2002,25,e) 4,6203,6593,66452,69415,342,5,939,13.6,11174,3764,7410,5.4,16.1,17099,5543,11556,8,24.6,-5925,-8.5,32.2,0,648,648,4359
2002,25,f) 5,5482,5559,51974,56207,227,3.9,873,14.8,7743,1880,5863,3.3,13.8,16209,7338,8871,13.1,28.8,-8466,-15,27.6,0,544,544,5402
2002,25,g) 6 to 10,20800,21510,229737,239440,767,3.4,2509,11.2,33754,9158,24596,3.8,14.1,53160,21646,31514,9,22.2,-19406,-8.1,28.2,0,1472,1472,10331
2002,25,h) 11 to 15,16307,18049,269503,280005,709,3.8,1641,8.9,36602,9900,26702,3.5,13.1,57605,18496,39109,6.6,20.6,-21003,-7.5,26.2,0,849,849,7810
2002,25,i) 16 to 20,12885,15270,278591,285775,680,4.4,1374,8.8,37388,9258,28130,3.2,13.1,51756,18512,33244,6.5,18.1,-14368,-5,26.2,0,631,636,5155
2002,25,j) 21 to 25,9194,12426,290295,296748,577,4.5,1134,8.9,35228,10075,25153,3.4,11.9,48134,17003,31131,5.7,16.2,-12906,-4.3,23.8,0,398,399,2661
2002,25,l) Left Censored,21694,41235,1557600,1581003,2838,6.8,3356,8.1,208990,72986,136004,4.6,13.2,255795,76206,179589,4.8,16.2,-46805,-3,26.4,0,792,794,9641
2002,26,a) 0,14694,14855,115655,57828,14855,200,0,0,115655,115655,0,200,200,0,0,0,0,0,115655,200,0,0,,,
2002,26,b) 1,10642,10796,94392,95751,93,0.8,3288,26.5,22553,1214,21339,1.3,23.6,25271,13713,11558,14.3,26.4,-2718,-2.8,47.2,0,2215,2217,10607
2002,26,c) 2,9586,9811,84599,89564,457,4.3,2091,19.7,15649,2862,12787,3.2,17.5,25578,10748,14830,12,28.6,-9929,-11.1,35,0,1401,1401,8594
2002,26,d) 3,8752,9031,87065,90553,442,4.6,1718,17.8,18860,2927,15933,3.2,20.8,25835,12866,12969,14.2,28.5,-6975,-7.7,41.6,0,1092,1102,8815
2002,26,e) 4,8393,9103,89845,93061,480,5,1364,14.3,15522,3667,11855,3.9,16.7,21954,7641,14313,8.2,23.6,-6432,-6.9,33.4,0,862,862,4785
2002,26,f) 5,7660,8103,78930,81557,385,4.5,1303,15.2,15059,3684,11375,4.5,18.5,20313,10561,9752,12.9,24.9,-5254,-6.4,37,0,789,789,7815
2002,26,g) 6 to 10,29664,30888,309939,323803,1312,4.1,4065,12.6,43632,9692,33940,3,13.5,71359,26231,45128,8.1,22,-27727,-8.5,27,0,2411,2411,14326
2002,26,h) 11 to 15,22450,25259,334320,343453,1097,4.2,2680,10.3,43481,11172,32309,3.3,12.7,61747,20306,41441,5.9,18,-18266,-5.3,25.4,0,1344,1349,8957
2002,26,i) 16 to 20,16727,20074,324458,332203,891,4.3,1939,9.4,45649,19052,26597,5.7,13.7,61138,19178,41960,5.8,18.4,-15489,-4.7,27.4,0,728,730,5171
2002,26,j) 21 to 25,12469,16654,291397,303723,830,4.9,1741,10.2,39104,11510,27594,3.8,12.9,63755,25790,37965,8.5,21,-24651,-8.1,25.8,0,566,570,8242
2002,26,l) Left Censored,25302,54925,2064454,2114045,3762,6.8,5381,9.7,252740,87451,165289,4.1,12,351921,112171,239750,5.3,16.6,-99181,-4.6,24,0,951,967,9169
2002,27,a) 0,9571,9667,60019,30010,9667,200,0,0,60019,60019,0,200,200,0,0,0,0,0,60019,200,0,0,,,
2002,27,b) 1,7010,7111,48231,49366,49,0.6,2035,25.1,12392,971,11421,2,25.1,14662,7697,6965,15.6,29.7,-2270,-4.6,50.2,0,1275,1279,5934
2002,27,c) 2,6260,6407,50800,52356,290,4.2,1283,18.6,10253,2260,7993,4.3,19.6,13365,6049,7316,11.6,25.5,-3112,-5.9,39.2,0,810,812,4385
2002,27,d) 3,5581,5823,53624,55547,305,4.9,1028,16.6,8377,1950,6427,3.5,15.1,12222,4776,7446,8.6,22,-3845,-6.9,30.2,0,627,628,3624
2002,27,e) 4,5368,5950,56384,57068,385,6.2,833,13.5,10204,3839,6365,6.7,17.9,11572,3658,7914,6.4,20.3,-1368,-2.4,35.8,0,497,497,2708
2002,27,f) 5,4849,5008,42744,44299,205,3.9,724,13.7,6546,990,5556,2.2,14.8,9656,3521,6135,7.9,21.8,-3110,-7,29.6,0,440,441,2512
2002,27,g) 6 to 10,18713,19574,194466,198683,878,4.3,2349,11.6,30932,6250,24682,3.1,15.6,39366,14678,24688,7.4,19.8,-8434,-4.2,31.2,0,1269,1270,8604
2002,27,h) 11 to 15,12873,14360,189888,203677,637,4.3,1418,9.6,23564,5829,17735,2.9,11.6,51142,28379,22763,13.9,25.1,-27578,-13.5,23.2,0,711,712,6528
2002,27,i) 16 to 20,9448,11543,208782,213707,479,4,1096,9.2,27947,8894,19053,4.2,13.1,37796,10679,27117,5,17.7,-9849,-4.6,26.2,0,430,431,3041
2002,27,j) 21 to 25,7379,10121,216735,221834,422,4.1,964,9.3,26307,7542,18765,3.4,11.9,36505,10775,25730,4.9,16.5,-10198,-4.6,23.8,0,327,327,2710
2002,27,l) Left Censored,15354,31168,1245373,1264562,1989,6.3,2582,8.2,151053,45459,105594,3.6,11.9,189432,60845,128587,4.8,15,-38379,-3.1,23.8,0,474,475,5282
2002,28,a) 0,4036,4062,28256,14128,4062,200,0,0,28256,28256,0,200,200,0,0,0,0,0,28256,200,0,0,,,
2002,28,b) 1,2873,2923,21418,22563,25,0.7,935,27.7,4741,348,4393,1.5,21,7031,4200,2831,18.6,31.2,-2290,-10.2,42,0,708,709,3365
2002,28,c) 2,2469,2580,19891,21427,145,5.2,584,20.9,4592,1505,3087,7,21.4,7663,4006,3657,18.7,35.8,-3071,-14.4,42.8,0,427,427,3041
2002,28,d) 3,2369,2489,21397,22008,153,5.8,435,16.5,4292,1299,2993,5.9,19.5,5513,1750,3763,8,25,-1221,-5.5,39,0,317,321,1249
2002,28,e) 4,2189,2362,20011,20878,146,6,322,13.1,3765,812,2953,3.9,18,5499,1998,3501,9.6,26.3,-1734,-8.3,36,0,243,243,1429
2002,28,f) 5,1866,1930,16115,16771,92,4.5,302,14.8,2644,424,2220,2.5,15.8,3955,1505,2450,9,23.6,-1311,-7.8,31.6,0,221,221,1151
2002,28,g) 6 to 10,7450,7849,81878,83800,413,5.1,978,12,12801,2463,10338,2.9,15.3,16645,6739,9906,8,19.9,-3844,-4.6,30.6,0,629,630,3757
2002,28,h) 11 to 15,5057,5628,79612,81287,293,5.1,567,9.8,10062,2947,7115,3.6,12.4,13412,3994,9418,4.9,16.5,-3350,-4.1,24.8,0,338,338,2257
2002,28,i) 16 to 20,4415,5075,61970,64445,255,4.9,454,8.8,7959,2220,5739,3.4,12.4,12909,3872,9037,6,20,-4950,-7.6,24.8,0,224,224,996
2002,28,j) 21 to 25,3439,4611,94053,95777,285,6.1,340,7.3,12208,3910,8298,4.1,12.7,15655,5895,9760,6.2,16.3,-3447,-3.6,25.4,0,146,146,1369
2002,28,l) Left Censored,6884,15038,456600,465496,960,6.3,1339,8.8,51578,18741,32837,4,11.1,69370,22964,46406,4.9,14.9,-17792,-3.8,22.2,0,230,230,1765
2002,29,a) 0,10437,10515,66708,34502,10514,200,0,0,64413,64413,0,186.7,186.7,0,0,0,0,0,64413,186.7,0,0,,,
2002,29,b) 1,6906,7051,46239,48624,86,1.1,2035,25.4,12238,1667,10571,3.4,25.2,17007,8897,8110,18.3,35,-4769,-9.8,50.4,0,1439,1439,6974
2002,29,c) 2,6467,6633,51316,53935,352,5,1285,18.1,10827,2847,7980,5.3,20.1,16064,7933,8131,14.7,29.8,-5237,-9.7,40.2,0,930,930,6135
2002,29,d) 3,5681,5891,49838,52018,304,4.9,1053,16.8,9396,2050,7346,3.9,18.1,13755,6878,6877,13.2,26.4,-4359,-8.3,36.2,0,757,757,5511
2002,29,e) 4,5227,5683,55854,57294,312,5.2,884,14.8,10815,2713,8102,4.7,18.9,13694,5015,8679,8.8,23.9,-2879,-5,37.8,0,646,646,3920
2002,29,f) 5,4623,4760,40308,43003,210,4.2,747,14.9,6397,1066,5331,2.5,14.9,11787,5359,6428,12.5,27.4,-5390,-12.5,29.8,0,531,531,4186
2002,29,g) 6 to 10,18203,19070,189647,198480,865,4.4,2470,12.4,27310,5676,21634,2.9,13.8,44975,17986,26989,9.1,22.7,-17665,-8.9,27.6,0,1510,1513,9019
2002,29,h) 11 to 15,13149,14813,193081,199555,670,4.4,1574,10.3,25075,6326,18749,3.2,12.6,38022,14387,23635,7.2,19.1,-12947,-6.5,25.2,0,881,881,6938
2002,29,i) 16 to 20,10674,12608,217529,219480,588,4.6,1122,8.7,29231,6593,22638,3,13.3,33132,9915,23217,4.5,15.1,-3901,-1.8,26.6,0,549,552,3652
2002,29,j) 21 to 25,7701,10996,222706,222494,666,6,958,8.6,31794,12270,19524,5.5,14.3,31369,9808,21561,4.4,14.1,425,0.2,28.2,0,384,386,2904
2002,29,l) Left Censored,16401,34823,1213303,1235678,2411,6.8,3197,9.1,149113,50694,98419,4.1,12.1,193863,53188,140675,4.3,15.7,-44750,-3.6,24.2,0,575,576,4090
2002,30,a) 0,2495,2514,11567,5784,2514,200,0,0,11567,11567,0,200,200,0,0,0,0,0,11567,200,0,0,,,
2002,30,b) 1,1872,1880,9333,9777,10,0.5,549,25.5,2211,118,2093,1.2,22.6,3098,1639,1459,16.8,31.7,-887,-9.1,45.2,0,345,345,1104
2002,30,c) 2,1626,1652,9439,10052,82,4.6,328,18.5,1748,241,1507,2.4,17.4,2973,1097,1876,10.9,29.6,-1225,-12.2,34.8,0,212,212,775
2002,30,d) 3,1423,1456,9605,9729,71,4.6,232,15.1,1732,390,1342,4,17.8,1979,761,1218,7.8,20.3,-247,-2.5,35.6,0,139,139,508
2002,30,e) 4,1436,1557,12168,12857,89,5.5,231,14.2,1974,508,1466,4,15.4,3352,921,2431,7.2,26.1,-1378,-10.7,30.8,0,139,139,618
2002,30,f) 5,1210,1227,8133,8351,48,3.7,167,13,1232,207,1025,2.5,14.8,1668,600,1068,7.2,20,-436,-5.2,29.6,0,109,109,465
2002,30,g) 6 to 10,4515,4616,34324,35271,228,4.7,598,12.5,5277,1326,3951,3.8,15,7171,2619,4552,7.4,20.3,-1894,-5.3,30,0,335,335,1594
2002,30,h) 11 to 15,2837,3050,28912,28880,158,5,321,10.3,5046,637,4409,2.2,17.5,4982,1704,3278,5.9,17.3,64,0.2,34.6,0,160,160,920
2002,30,i) 16 to 20,2225,2581,30454,30423,131,4.9,274,10.3,4502,797,3705,2.6,14.8,4440,1291,3149,4.2,14.6,62,0.2,29.2,0,113,113,551
2002,30,j) 21 to 25,1911,2520,32785,33619,129,5,204,8,3971,1281,2690,3.8,11.8,5638,1296,4342,3.9,16.8,-1667,-5,23.6,0,81,81,379
2002,30,l) Left Censored,3031,5587,114344,116043,304,5.4,466,8.2,12467,3739,8728,3.2,10.7,15865,4745,11120,4.1,13.7,-3398,-3,21.4,0,129,130,885
2002,31,a) 0,3301,3353,17648,8824,3353,200,0,0,17648,17648,0,200,200,0,0,0,0,0,17648,200,0,0,,,
2002,31,b) 1,2570,2609,17863,18165,17,0.6,585,20.2,4365,361,4004,2,24,4969,2406,2563,13.2,27.4,-604,-3.4,48,0,378,378,1609
2002,31,c) 2,2171,2213,13655,14247,125,5.3,418,17.7,2316,374,1942,2.6,16.3,3500,1399,2101,9.8,24.6,-1184,-8.3,32.6,0,269,269,1067
2002,31,d) 3,1935,2003,22416,22470,111,5.3,331,15.7,3264,903,2361,4,14.5,3372,1329,2043,5.9,15,-108,-0.5,29,0,220,220,943
2002,31,e) 4,1870,2058,23757,23685,129,6,281,13.2,4087,1102,2985,4.7,17.3,3942,1717,2225,7.2,16.6,145,0.7,33.2,0,188,188,1125
2002,31,f) 5,1718,1784,12576,12814,83,4.5,214,11.6,1878,503,1375,3.9,14.7,2354,782,1572,6.1,18.4,-476,-3.7,29.4,0,134,134,499
2002,31,g) 6 to 10,6522,6738,53663,55992,339,4.9,773,11.1,6921,1383,5538,2.5,12.4,11579,4820,6759,8.6,20.7,-4658,-8.3,24.8,0,431,431,3117
2002,31,h) 11 to 15,4860,5393,70881,82550,300,5.5,522,9.5,10750,4868,5882,5.9,13,34088,3694,30394,4.5,41.3,-23338,-28.3,26,0,233,235,1410
2002,31,i) 16 to 20,3834,4454,65366,65647,162,3.6,358,7.9,7136,1172,5964,1.8,10.9,7698,2119,5579,3.2,11.7,-562,-0.8,21.8,0,176,177,887
2002,31,j) 21 to 25,3132,4211,75252,74370,198,4.6,335,7.8,11543,2820,8723,3.8,15.5,9779,2694,7085,3.6,13.1,1764,2.4,26.2,0,135,136,612
2002,31,l) Left Censored,6897,12475,378412,382169,717,5.7,994,7.9,43148,11699,31449,3.1,11.3,50662,14096,36566,3.7,13.3,-7514,-2,22.6,0,215,215,1375
2002,32,a) 0,4964,4998,36706,18353,4998,200,0,0,36706,36706,0,200,200,0,0,0,0,0,36706,200,0,0,,,
2002,32,b) 1,3425,3474,30279,29452,31,0.8,1192,29.4,10956,461,10495,1.6,37.2,9302,5370,3932,18.2,31.6,1654,5.6,63.2,0,872,872,4351
2002,32,c) 2,2846,2907,31448,31183,148,4.6,727,22.7,9600,2499,7101,8,30.8,9069,4353,4716,14,29.1,531,1.7,58.2,0,542,542,3500
2002,32,d) 3,2471,2558,30271,32030,156,5.7,541,19.7,5713,1395,4318,4.4,17.8,9231,3552,5679,11.1,28.8,-3518,-11,35.6,0,399,399,2898
2002,32,e) 4,2228,2411,31524,34462,165,6.5,388,15.4,4219,1379,2840,4,12.2,10095,2304,7791,6.7,29.3,-5876,-17.1,24.4,0,265,265,1813
2002,32,f) 5,1797,1846,23943,24745,86,4.4,307,15.7,3817,553,3264,2.2,15.4,5420,2115,3305,8.5,21.9,-1603,-6.5,30.8,0,226,226,1639
2002,32,g) 6 to 10,5646,5984,108500,110406,305,4.9,848,13.6,16208,3722,12486,3.4,14.7,20020,6596,13424,6,18.1,-3812,-3.4,29.4,0,543,543,3852
2002,32,h) 11 to 15,3625,4244,69840,71041,252,5.8,482,11.1,11697,4071,7626,5.7,16.5,14099,6195,7904,8.7,19.8,-2402,-3.3,33,0,249,251,2338
2002,32,i) 16 to 20,2449,3195,69204,70065,216,6.6,379,11.6,11363,3109,8254,4.4,16.2,13085,2908,10177,4.2,18.7,-1722,-2.5,32.4,0,138,138,626
2002,32,j) 21 to 25,2079,3080,102235,104603,196,6.2,312,9.9,14818,6881,7937,6.6,14.2,19553,3657,15896,3.5,18.7,-4735,-4.5,28.4,0,93,93,759
2002,32,l) Left Censored,3479,8745,393814,396879,981,11.3,851,9.8,53184,19899,33285,5,13.4,59313,17280,42033,4.4,14.9,-6129,-1.5,26.8,0,106,106,2630
2002,33,a) 0,2368,2379,14097,7049,2379,200,0,0,14097,14097,0,200,200,0,0,0,0,0,14097,200,0,0,,,
2002,33,b) 1,1843,1883,14891,14981,15,0.7,526,24.6,3758,479,3279,3.2,25.1,3937,1712,2225,11.4,26.3,-179,-1.2,50.2,0,361,361,1351
2002,33,c) 2,1686,1721,11684,11976,81,4.4,315,17.1,2378,660,1718,5.5,19.9,2962,1281,1681,10.7,24.7,-584,-4.8,39.8,0,225,225,1055
2002,33,d) 3,1475,1516,12616,12859,77,4.8,264,16.4,2625,749,1876,5.8,20.4,3110,979,2131,7.6,24.2,-485,-3.8,40.8,0,190,190,775
2002,33,e) 4,1497,1580,13211,13402,80,4.9,208,12.7,2374,791,1583,5.9,17.7,2755,996,1759,7.4,20.6,-381,-2.9,35.4,0,147,147,838
2002,33,f) 5,1334,1347,10162,10959,44,3.1,213,14.9,1437,82,1355,0.7,13.1,3031,1639,1392,15,27.7,-1594,-14.6,26.2,0,148,149,1262
2002,33,g) 6 to 10,5041,5159,48611,50815,173,3.2,594,11.1,6452,930,5522,1.8,12.7,10860,3994,6866,7.9,21.4,-4408,-8.7,25.4,0,375,375,2232
2002,33,h) 11 to 15,3878,4145,49776,51560,136,3.2,439,10.2,6742,2193,4549,4.3,13.1,10310,3918,6392,7.6,20,-3568,-6.9,26.2,0,259,259,2129
2002,33,i) 16 to 20,2969,3378,50768,52406,149,4.3,324,9.3,7147,2252,4895,4.3,13.6,10423,3348,7075,6.4,19.9,-3276,-6.3,27.2,0,155,155,831
2002,33,j) 21 to 25,1880,2529,47880,49328,115,4.4,240,9.3,6063,1873,4190,3.8,12.3,8959,3507,5452,7.1,18.2,-2896,-5.9,24.6,0,86,86,784
2002,33,l) Left Censored,4124,7917,265945,271054,556,7,602,7.6,27205,8417,18788,3.1,10,37422,11413,26009,4.2,13.8,-10217,-3.8,20,0,104,104,494
2002,34,a) 0,16264,16338,93203,46602,16338,200,0,0,93203,93203,0,200,200,0,0,0,0,0,93203,200,0,0,,,
2002,34,b) 1,12460,12631,98417,101485,104,0.7,3521,24.6,23582,2571,21011,2.5,23.2,29718,13543,16175,13.3,29.3,-6136,-6.1,46.4,0,2357,2358,10086
2002,34,c) 2,10890,11011,84275,86172,533,4.5,2229,18.8,17284,2714,14570,3.1,20.1,21078,10415,10663,12.1,24.5,-3794,-4.4,40.2,0,1536,1537,8468
2002,34,d) 3,10180,10470,87735,92112,512,4.6,1723,15.6,15982,3396,12586,3.7,17.4,24735,10108,14627,11,26.9,-8753,-9.5,34.8,0,1206,1209,8006
2002,34,e) 4,9651,10086,95596,95910,537,5.1,1529,14.4,20012,4943,15069,5.2,20.9,20639,7112,13527,7.4,21.5,-627,-0.6,41.8,0,1032,1032,5345
2002,34,f) 5,8523,8732,78076,79887,382,4.2,1302,14.2,14970,3415,11555,4.3,18.7,18591,8287,10304,10.4,23.3,-3621,-4.6,37.4,0,851,851,6102
2002,34,g) 6 to 10,30114,31041,322048,327747,1275,3.9,3816,11.8,53454,9017,44437,2.8,16.3,64853,23685,41168,7.2,19.8,-11399,-3.5,32.6,0,2431,2433,14519
2002,34,h) 11 to 15,22421,23920,293344,299858,943,3.8,2552,10.3,41456,8102,33354,2.7,13.8,54483,20364,34119,6.8,18.2,-13027,-4.4,27.6,0,1460,1462,9999
2002,34,i) 16 to 20,16816,19125,306626,309506,828,4.2,1772,9,42118,14431,27687,4.7,13.6,47878,14915,32963,4.8,15.5,-5760,-1.9,27.2,0,864,864,5267
2002,34,j) 21 to 25,12422,15102,317710,319157,638,4.1,1361,8.8,43169,9564,33605,3,13.5,46063,13137,32926,4.1,14.4,-2894,-0.9,27,0,602,608,3687
2002,34,l) Left Censored,25601,49288,1798901,1821530,3396,6.8,4324,8.7,248841,83532,165309,4.6,13.7,294099,93572,200527,5.1,16.1,-45258,-2.4,27.4,0,1092,1098,10717
2002,35,a) 0,3031,3046,20234,10117,3046,200,0,0,20234,20234,0,200,200,0,0,0,0,0,20234,200,0,0,,,
2002,35,b) 1,2271,2360,17783,18082,44,1.6,738,27.3,4951,556,4395,3.1,27.4,5549,3079,2470,17,30.7,-598,-3.3,54.8,0,509,509,2403
2002,35,c) 2,1925,1965,16816,16853,106,5,427,20.1,4367,1376,2991,8.2,25.9,4440,2345,2095,13.9,26.3,-73,-0.4,51.8,0,303,304,2007
2002,35,d) 3,1696,1739,14917,15550,122,6.6,320,17.4,3120,1218,1902,7.8,20.1,4386,2035,2351,13.1,28.2,-1266,-8.1,40.2,0,222,222,1715
2002,35,e) 4,1616,1713,16953,16810,116,6.5,243,13.7,3198,650,2548,3.9,19,2912,1033,1879,6.1,17.3,286,1.7,34.6,0,169,169,840
2002,35,f) 5,1495,1522,13444,13646,95,5.9,268,16.7,2618,649,1969,4.8,19.2,3021,1257,1764,9.2,22.1,-403,-2.9,38.4,0,165,165,824
2002,35,g) 6 to 10,5607,5875,57881,58365,328,5.4,734,12.1,10390,1770,8620,3,17.8,11358,4033,7325,6.9,19.5,-968,-1.7,35.6,0,467,467,2781
2002,35,h) 11 to 15,3906,4385,64964,67258,234,5.2,420,9.4,7555,2272,5283,3.4,11.2,12143,4394,7749,6.5,18.1,-4588,-6.9,22.4,0,230,230,1741
2002,35,i) 16 to 20,3191,3826,52996,53157,226,5.8,371,9.5,8489,2809,5680,5.3,16,8811,2391,6420,4.5,16.6,-322,-0.6,32,0,155,155,954
2002,35,j) 21 to 25,2574,3589,56866,57010,188,5.1,449,12.1,9359,2134,7225,3.7,16.4,9647,3720,5927,6.5,16.9,-288,-0.5,32.8,0,105,105,567
2002,35,l) Left Censored,4078,8657,225171,227828,613,7,834,9.5,31598,11822,19776,5.2,13.9,36912,11672,25240,5.1,16.2,-5314,-2.3,27.8,0,122,122,1052
2002,36,a) 0,36123,36386,209682,105364,36385,200,0,0,208637,208637,0,198,198,0,0,0,0,0,208637,198,0,0,,,
2002,36,b) 1,27741,27949,177781,185334,137,0.4,7737,24.4,43132,2751,40381,1.5,23.3,58238,30374,27864,16.4,31.4,-15106,-8.1,46.6,0,5359,5359,24147
2002,36,c) 2,23737,24027,182374,188334,1022,3.9,5172,19.8,43871,6186,37685,3.3,23.3,55791,27826,27965,14.8,29.6,-11920,-6.3,46.6,0,3836,3837,23604
2002,36,d) 3,21084,21680,181243,186140,1035,4.5,3653,15.9,36997,7078,29919,3.8,19.9,46790,19491,27299,10.5,25.1,-9793,-5.2,39.8,0,2666,2667,16521
2002,36,e) 4,19804,20981,189864,195424,1063,4.8,3141,14.3,35457,8482,26975,4.3,18.1,46577,18477,28100,9.5,23.8,-11120,-5.7,36.2,0,2220,2220,14803
2002,36,f) 5,17548,17884,157581,161168,676,3.6,2575,13.7,28602,2993,25609,1.9,17.7,35775,14458,21317,9,22.2,-7173,-4.5,35.4,0,1809,1811,11040
2002,36,g) 6 to 10,61517,63355,632948,651091,2320,3.5,7811,11.8,99700,19588,80112,3,15.3,135986,54730,81256,8.4,20.9,-36286,-5.6,30.6,0,5108,5115,32137
2002,36,h) 11 to 15,47365,50458,653730,668979,1743,3.3,5012,9.6,84747,18173,66574,2.7,12.7,115245,37255,77990,5.6,17.2,-30498,-4.5,25.4,0,2810,2814,16462
2002,36,i) 16 to 20,35857,40081,546613,557203,1417,3.5,3369,8.2,67038,16198,50840,2.9,12,88218,25664,62554,4.6,15.8,-21180,-3.8,24,0,1724,1727,11013
2002,36,j) 21 to 25,24600,32023,642281,651975,1241,3.8,2696,8.2,77309,18403,58906,2.8,11.9,96697,26281,70416,4,14.8,-19388,-2.9,23.8,0,1233,1236,8465
2002,36,l) Left Censored,55349,103617,3706361,3768594,7103,6.7,10463,9.9,509469,198314,311155,5.3,13.5,633934,241643,392291,6.4,16.8,-124465,-3.3,27,0,2341,2351,25841
2002,37,a) 0,14055,14232,89824,44912,14232,200,0,0,89824,89824,0,200,200,0,0,0,0,0,89824,200,0,0,,,
2002,37,b) 1,11069,11230,78227,80774,75,0.6,3347,26,19765,1124,18641,1.4,24.5,24858,14182,10676,17.6,30.8,-5093,-6.3,49,0,2344,2345,11125
2002,37,c) 2,9510,9838,78821,82517,467,4.4,1998,18.8,15575,4008,11567,4.9,18.9,22967,10512,12455,12.7,27.8,-7392,-8.9,37.8,0,1425,1425,7969
2002,37,d) 3,8810,9222,82380,85535,508,5.2,1623,16.6,15401,4120,11281,4.8,18,21710,8737,12973,10.2,25.4,-6309,-7.4,36,0,1156,1156,6471
2002,37,e) 4,7928,8603,85657,88207,477,5.3,1321,14.6,15330,4468,10862,5.1,17.4,20430,7452,12978,8.4,23.2,-5100,-5.8,34.8,0,921,921,5705
2002,37,f) 5,7178,7432,70093,71014,393,5.1,1089,14,13022,2910,10112,4.1,18.3,14863,5669,9194,8,20.9,-1841,-2.6,36.6,0,751,754,4145
2002,37,g) 6 to 10,24773,26323,282326,293411,1137,4.2,3206,11.7,41730,11651,30079,4,14.2,63900,21116,42784,7.2,21.8,-22170,-7.6,28.4,0,2007,2009,11479
2002,37,h) 11 to 15,17818,20047,290364,300134,904,4.4,2037,9.9,33437,8284,25153,2.8,11.1,52977,17029,35948,5.7,17.7,-19540,-6.6,22.2,0,1110,1114,7893
2002,37,i) 16 to 20,15137,17995,261346,270794,825,4.5,1635,8.9,35244,12590,22654,4.6,13,54140,15669,38471,5.8,20,-18896,-7,26,0,680,688,4197
2002,37,j) 21 to 25,9621,13696,279943,288183,704,5,1242,8.9,35121,12196,22925,4.2,12.2,51601,13962,37639,4.8,17.9,-16480,-5.7,24.4,0,400,402,2623
2002,37,l) Left Censored,19005,47257,1740861,1778381,3273,6.9,4192,8.8,204016,74125,129891,4.2,11.5,279055,88181,190874,5,15.7,-75039,-4.2,23,0,686,701,6425
2002,38,a) 0,1293,1314,6514,3257,1314,200,0,0,6514,6514,0,200,200,0,0,0,0,0,6514,200,0,0,,,
2002,38,b) 1,967,982,5874,6553,14,1.3,244,22.2,1133,147,986,2.2,17.3,2491,753,1738,11.5,38,-1358,-20.7,34.6,0,133,133,490
2002,38,c) 2,821,831,5226,5930,48,5.4,150,17,966,176,790,3,16.3,2374,1501,873,25.3,40,-1408,-23.7,32.6,0,87,87,1377
2002,38,d) 3,700,719,4865,5134,43,5.7,106,14.1,900,425,475,8.3,17.5,1437,382,1055,7.4,28,-537,-10.5,35,0,66,66,239
2002,38,e) 4,721,782,7183,7248,48,5.9,110,13.5,1222,515,707,7.1,16.9,1351,425,926,5.9,18.6,-129,-1.7,33.8,0,60,60,319
2002,38,f) 5,676,698,4830,5159,35,4.7,122,16.5,693,166,527,3.2,13.4,1351,563,788,10.9,26.2,-658,-12.8,26.8,0,70,70,314
2002,38,g) 6 to 10,2841,2908,22126,22344,146,4.9,347,11.5,3330,808,2522,3.6,14.9,3765,1217,2548,5.4,16.9,-435,-2,29.8,0,180,180,816
2002,38,h) 11 to 15,2109,2242,21408,21824,127,5.5,238,10.4,2705,667,2038,3.1,12.4,3537,1177,2360,5.4,16.2,-832,-3.8,24.8,0,110,110,513
2002,38,i) 16 to 20,1685,1961,20381,20041,81,4.1,154,7.7,3306,1589,1717,7.9,16.5,2625,826,1799,4.1,13.1,681,3.4,26.2,0,68,68,334
2002,38,j) 21 to 25,1445,1801,24890,25610,63,3.4,158,8.5,2479,406,2073,1.6,9.7,3918,1124,2794,4.4,15.3,-1439,-5.6,19.4,0,70,70,447
2002,38,l) Left Censored,3126,5321,132006,133351,282,5.3,340,6.4,15000,6643,8357,5,11.2,17690,6066,11624,4.5,13.3,-2690,-2.1,22.4,0,85,85,1014
2002,39,a) 0,14963,15199,115249,57625,15199,200,0,0,115249,115249,0,200,200,0,0,0,0,0,115249,200,0,0,,,
2002,39,b) 1,11279,11450,85368,88366,108,0.8,3077,23.8,21493,1637,19856,1.9,24.3,27488,14603,12885,16.5,31.1,-5995,-6.8,48.6,0,2134,2134,11701
2002,39,c) 2,9973,10238,91025,93655,443,4,2031,18.4,19369,3700,15669,4,20.7,24629,12756,11873,13.6,26.3,-5260,-5.6,41.4,0,1404,1404,10366
2002,39,d) 3,9311,9780,94829,98494,476,4.6,1539,14.9,18192,3641,14551,3.7,18.5,25521,10358,15163,10.5,25.9,-7329,-7.4,37,0,1070,1072,8863
2002,39,e) 4,8946,9881,92845,95998,560,5.4,1351,13.1,16367,5596,10771,5.8,17,22673,7772,14901,8.1,23.6,-6306,-6.6,34,0,958,958,6289
2002,39,f) 5,8130,8579,80383,83187,349,3.9,1208,13.4,12765,2020,10745,2.4,15.3,18373,7176,11197,8.6,22.1,-5608,-6.8,30.6,0,767,767,4863
2002,39,g) 6 to 10,32186,34114,365222,382054,1394,3.9,4092,11.5,53561,13005,40556,3.4,14,87225,30405,56820,8,22.8,-33664,-8.8,28,0,2472,2472,16349
2002,39,h) 11 to 15,24465,27911,386349,399395,1139,4,2759,9.6,47850,13325,34525,3.3,12,73942,23932,50010,6,18.5,-26092,-6.5,24,0,1449,1452,11276
2002,39,i) 16 to 20,19016,23057,382551,391904,853,3.6,2124,9,48542,12082,36460,3.1,12.4,67248,19689,47559,5,17.2,-18706,-4.8,24.8,0,900,903,6331
2002,39,j) 21 to 25,15267,21031,409491,416151,1027,4.8,1950,9.1,54143,17630,36513,4.2,13,67463,23505,43958,5.6,16.2,-13320,-3.2,26,0,669,683,5105
2002,39,l) Left Censored,34227,74630,2648979,2711799,4477,5.9,6646,8.8,321071,102877,218194,3.8,11.8,446710,121621,325089,4.5,16.5,-125639,-4.7,23.6,0,1270,1277,12813
2002,40,a) 0,6105,6173,39397,19699,6173,200,0,0,39397,39397,0,200,200,0,0,0,0,0,39397,200,0,0,,,
2002,40,b) 1,4366,4433,29401,31386,37,0.7,1342,26.4,7652,1026,6626,3.3,24.4,11622,6977,4645,22.2,37,-3970,-12.6,48.8,0,948,948,5451
2002,40,c) 2,3795,3915,30332,32027,229,5.4,830,19.7,6725,2136,4589,6.7,21,10115,4725,5390,14.8,31.6,-3390,-10.6,42,0,613,613,3821
2002,40,d) 3,3473,3583,32814,32176,203,5.4,584,15.5,9126,1604,7522,5,28.4,7850,3275,4575,10.2,24.4,1276,4,48.8,0,442,442,1828
2002,40,e) 4,3238,3552,34093,35133,243,6.6,474,12.9,6221,1882,4339,5.4,17.7,8301,3377,4924,9.6,23.6,-2080,-5.9,35.4,0,323,323,2641
2002,40,f) 5,2904,3107,28668,29769,195,6,448,13.9,5432,1346,4086,4.5,18.2,7633,3319,4314,11.1,25.6,-2201,-7.4,36.4,0,299,299,2094
2002,40,g) 6 to 10,10658,11152,100030,103489,564,4.9,1318,11.4,17062,4431,12631,4.3,16.5,23979,10974,13005,10.6,23.2,-6917,-6.7,33,0,819,819,5874
2002,40,h) 11 to 15,7424,8166,115533,117770,398,4.8,815,9.7,16143,4530,11613,3.8,13.7,20617,7039,13578,6,17.5,-4474,-3.8,27.4,0,453,454,3232
2002,40,i) 16 to 20,7007,8044,112314,115428,370,4.5,749,9.1,16677,5839,10838,5.1,14.4,22905,7662,15243,6.6,19.8,-6228,-5.4,28.8,0,344,350,3009
2002,40,j) 21 to 25,5158,6929,126520,128342,345,4.9,613,8.7,17149,5154,11995,4,13.4,20792,6423,14369,5,16.2,-3643,-2.8,26.8,0,219,221,1514
2002,40,l) Left Censored,8780,18887,542813,549267,1137,5.9,1725,9,70014,20754,49260,3.8,12.7,82922,26299,56623,4.8,15.1,-12908,-2.4,25.4,0,307,315,3520
2002,41,a) 0,7305,7386,38397,19199,7386,200,0,0,38397,38397,0,200,200,0,0,0,0,0,38397,200,0,0,,,
2002,41,b) 1,5571,5646,34116,34815,44,0.7,1647,25.5,8989,462,8527,1.3,25.8,10386,6029,4357,17.3,29.8,-1397,-4,51.6,0,1114,1114,4354
2002,41,c) 2,4845,4930,32440,33605,251,4.8,942,17.9,6736,1667,5069,5,20,9066,4079,4987,12.1,27,-2330,-7,40,0,658,658,3376
2002,41,d) 3,4340,4485,31109,32335,235,4.9,828,17.3,5754,1377,4377,4.3,17.8,8206,3691,4515,11.4,25.4,-2452,-7.6,35.6,0,551,558,2865
2002,41,e) 4,4053,4330,34515,34399,239,5.3,654,14.4,8118,2119,5999,6.2,23.6,7886,3158,4728,9.2,22.9,232,0.7,45.8,0,452,452,2295
2002,41,f) 5,3549,3653,28762,30018,157,4.1,540,14,4082,552,3530,1.8,13.6,6594,2095,4499,7,22,-2512,-8.4,27.2,0,339,339,1478
2002,41,g) 6 to 10,13861,14505,141001,145910,668,4.4,1930,12.8,21251,3368,17883,2.3,14.6,31069,13144,17925,9,21.3,-9818,-6.7,29.2,0,1179,1179,7650
2002,41,h) 11 to 15,9258,10237,122968,125723,496,4.7,1167,11,18367,4000,14367,3.2,14.6,23876,8019,15857,6.4,19,-5509,-4.4,29.2,0,614,614,3165
2002,41,i) 16 to 20,6723,8176,128218,132884,367,4.4,783,9.3,16020,5042,10978,3.8,12.1,25352,7590,17762,5.7,19.1,-9332,-7,24.2,0,304,310,1949
2002,41,j) 21 to 25,5611,7387,131564,134609,375,5,701,9.3,15687,4342,11345,3.2,11.7,21776,5955,15821,4.4,16.2,-6089,-4.5,23.4,0,271,272,1695
2002,41,l) Left Censored,8945,19503,603377,613553,1483,7.6,1754,8.9,79723,34407,45316,5.6,13,100074,29240,70834,4.8,16.3,-20351,-3.3,26,0,336,337,4076
2002,42,a) 0,16879,17070,119638,59819,17070,200,0,0,119638,119638,0,200,200,0,0,0,0,0,119638,200,0,0,,,
2002,42,b) 1,13145,13329,122955,113354,98,0.7,3220,21.6,45734,2389,43345,2.1,40.3,26532,12512,14020,11,23.4,19202,16.9,46.8,0,2174,2174,9856
2002,42,c) 2,11746,11970,101705,105604,451,3.5,2169,16.9,20798,3624,17174,3.4,19.7,28595,10035,18560,9.5,27.1,-7797,-7.4,39.4,0,1523,1534,8030
2002,42,d) 3,10642,11096,101494,103951,514,4.4,1720,14.7,19745,6893,12852,6.6,19,24658,9558,15100,9.2,23.7,-4913,-4.7,38,0,1193,1201,7569
2002,42,e) 4,10207,11355,112842,115698,572,4.9,1372,11.7,20282,5657,14625,4.9,17.5,25993,8413,17580,7.3,22.5,-5711,-5,35,0,936,936,6045
2002,42,f) 5,9065,9448,83636,87312,343,3.5,1281,12.9,12627,2377,10250,2.7,14.5,19978,8342,11636,9.6,22.9,-7351,-8.4,29,0,857,858,5879
2002,42,g) 6 to 10,34257,35862,364191,373781,1297,3.5,3932,10.6,52452,9438,43014,2.5,14,71632,27609,44023,7.4,19.2,-19180,-5.2,28,0,2432,2432,16412
2002,42,h) 11 to 15,29586,32393,408831,409911,1206,3.6,3005,9,65121,23696,41425,5.8,15.9,67280,24249,43031,5.9,16.4,-2159,-0.5,31.8,0,1602,1607,10470
2002,42,i) 16 to 20,22915,27122,449616,458436,1129,4.1,2390,8.6,55104,15438,39666,3.4,12,72744,27043,45701,5.9,15.9,-17640,-3.9,24,0,1063,1070,7914
2002,42,j) 21 to 25,16543,22001,421338,425121,1061,4.7,2031,9,56828,19119,37709,4.5,13.4,64394,23418,40976,5.5,15.1,-7566,-1.7,26.8,0,761,764,5341
2002,42,l) Left Censored,37405,78652,2778156,2819214,4896,6.1,6971,8.7,350362,124754,225608,4.4,12.4,432479,168440,264039,6,15.3,-82117,-2.9,24.8,0,1427,1437,22710
2002,44,a) 0,1835,1842,9175,4588,1842,200,0,0,9175,9175,0,200,200,0,0,0,0,0,9175,200,0,0,,,
2002,44,b) 1,1373,1383,8355,8491,7,0.5,347,22.3,2314,75,2239,0.9,27.3,2585,1387,1198,16.3,30.4,-271,-3.1,54.6,0,216,216,916
2002,44,c) 2,1170,1191,11858,12127,44,3.4,244,18.9,1639,240,1399,2,13.5,2177,895,1282,7.4,18,-538,-4.5,27,0,160,160,702
2002,44,d) 3,1095,1122,8809,8811,48,4,206,17.2,1682,347,1335,3.9,19.1,1686,698,988,7.9,19.1,-4,0,38.2,0,136,136,541
2002,44,e) 4,1105,1191,8732,8898,76,6.2,158,12.8,1504,499,1005,5.6,16.9,1835,613,1222,6.9,20.6,-331,-3.7,33.8,0,113,113,484
2002,44,f) 5,937,957,9003,9380,32,3.2,141,13.9,1176,108,1068,1.2,12.5,1929,766,1163,8.2,20.6,-753,-8.1,25,0,94,94,568
2002,44,g) 6 to 10,3599,3657,31890,33052,108,2.8,448,11.7,3877,333,3544,1,11.7,6200,1973,4227,6,18.8,-2323,-7.1,23.4,0,281,281,1292
2002,44,h) 11 to 15,2943,3140,40831,41265,112,3.5,288,8.9,5106,1010,4096,2.4,12.4,5974,1298,4676,3.1,14.5,-868,-2.1,24.8,0,155,155,756
2002,44,i) 16 to 20,2220,2471,33942,34185,96,3.8,211,8.3,4802,1410,3392,4.1,14,5287,1777,3510,5.2,15.5,-485,-1.5,28,0,88,88,351
2002,44,j) 21 to 25,1676,1981,34799,34962,78,3.9,164,8.1,5136,2106,3030,6,14.7,5462,1777,3685,5.1,15.6,-326,-0.9,29.4,0,68,68,390
2002,44,l) Left Censored,4219,6447,216798,216154,371,5.7,556,8.5,28130,11631,16499,5.4,13,26842,7997,18845,3.7,12.4,1288,0.6,24.8,0,158,158,1191
2002,45,a) 0,7000,7090,46414,23207,7090,200,0,0,46414,46414,0,200,200,0,0,0,0,0,46414,200,0,0,,,
2002,45,b) 1,5194,5277,44572,47577,46,0.8,1596,26.4,11273,895,10378,1.9,23.7,17282,7246,10036,15.2,36.3,-6009,-12.6,47.4,0,1118,1118,5635
2002,45,c) 2,4567,4718,37831,40195,213,4.2,979,19.2,7137,1178,5959,2.9,17.8,11865,5155,6710,12.8,29.5,-4728,-11.7,35.6,0,732,732,3961
2002,45,d) 3,4178,4376,44162,46102,275,5.9,776,16.8,8072,2021,6051,4.4,17.5,11951,3420,8531,7.4,25.9,-3879,-8.4,35,0,586,586,2736
2002,45,e) 4,3796,4040,38191,39917,214,5,623,14.7,6799,2397,4402,6,17,10250,3604,6646,9,25.7,-3451,-8.7,34,0,449,449,2872
2002,45,f) 5,3256,3326,34845,36075,144,4.1,501,14.3,4963,840,4123,2.3,13.8,7422,2499,4923,6.9,20.6,-2459,-6.8,27.6,0,335,335,1780
2002,45,g) 6 to 10,11821,12416,139848,145688,539,4.1,1688,13,22418,5993,16425,4.1,15.4,34099,13275,20824,9.1,23.4,-11681,-8,30.8,0,1084,1090,8758
2002,45,h) 11 to 15,8526,9894,137594,141209,438,4.3,923,9.1,19015,3359,15656,2.4,13.5,26245,6756,19489,4.8,18.6,-7230,-5.1,27,0,507,507,2987
2002,45,i) 16 to 20,6995,8397,113325,116785,409,4.8,765,8.9,14401,4852,9549,4.2,12.3,21321,6712,14609,5.7,18.3,-6920,-6,24.6,0,346,346,1754
2002,45,j) 21 to 25,4621,6762,117590,120061,375,5.5,595,8.7,15548,5928,9620,4.9,13,20489,6068,14421,5.1,17.1,-4941,-4.1,26,0,233,234,2042
2002,45,l) Left Censored,9380,22107,778037,798829,1412,6.3,1852,8.3,83593,25098,58495,3.1,10.5,125177,35891,89286,4.5,15.7,-41584,-5.2,21,0,307,311,2710
2002,46,a) 0,1906,1922,9022,4511,1922,200,0,0,9022,9022,0,200,200,0,0,0,0,0,9022,200,0,0,,,
2002,46,b) 1,1296,1324,7364,7580,15,1,329,22.2,1712,219,1493,2.9,22.6,2144,1145,999,15.1,28.3,-432,-5.7,45.2,0,193,193,808
2002,46,c) 2,1103,1136,7921,8192,49,4.1,188,15.6,1330,165,1165,2,16.2,1871,805,1066,9.8,22.8,-541,-6.6,32.4,0,133,133,687
2002,46,d) 3,992,1017,7386,7429,59,5.5,181,16.8,1508,615,893,8.3,20.3,1594,688,906,9.3,21.5,-86,-1.2,40.6,0,119,119,520
2002,46,e) 4,980,1025,7159,7267,67,6.4,116,11.1,1267,287,980,3.9,17.4,1483,459,1024,6.3,20.4,-216,-3,34.8,0,72,72,356
2002,46,f) 5,863,890,6289,6988,49,5.3,113,12.3,953,171,782,2.4,13.6,2350,1599,751,22.9,33.6,-1397,-20,27.2,0,67,67,1160
2002,46,g) 6 to 10,3401,3504,26232,26994,207,5.7,410,11.4,3758,962,2796,3.6,13.9,5282,1912,3370,7.1,19.6,-1524,-5.7,27.8,0,245,245,1262
2002,46,h) 11 to 15,2360,2528,28672,29468,137,5.3,267,10.3,3075,820,2255,2.8,10.4,4667,1814,2853,6.2,15.8,-1592,-5.4,20.8,0,129,129,896
2002,46,i) 16 to 20,1769,2076,27592,32921,90,4.3,171,8.1,5272,768,4504,2.3,16,15929,8903,7026,27,48.4,-10657,-32.4,32,0,84,84,442
2002,46,j) 21 to 25,1429,1765,24856,24897,91,5.1,159,8.8,3750,764,2986,3.1,15.1,3832,1473,2359,5.9,15.4,-82,-0.3,30.2,0,71,71,520
2002,46,l) Left Censored,3230,5593,151713,153133,317,5.6,393,7,17879,4754,13125,3.1,11.7,20718,4831,15887,3.2,13.5,-2839,-1.8,23.4,0,116,116,669
2002,47,a) 0,8298,8401,62399,31200,8401,200,0,0,62399,62399,0,200,200,0,0,0,0,0,62399,200,0,0,,,
2002,47,b) 1,5947,6032,46718,49014,54,0.8,2043,29.1,11748,931,10817,1.9,24,16339,8971,7368,18.3,33.3,-4591,-9.3,48,0,1520,1525,7205
2002,47,c) 2,5116,5267,46102,48481,277,4.8,1201,21,10213,2145,8068,4.4,21.1,14970,7221,7749,14.9,30.9,-4757,-9.8,42.2,0,887,889,5656
2002,47,d) 3,4748,5097,48350,50953,301,5.5,996,18.3,9656,2608,7048,5.1,19,14862,5970,8892,11.7,29.2,-5206,-10.2,38,0,754,755,4109
2002,47,e) 4,4617,5149,53070,54628,333,6.2,778,14.5,10824,2931,7893,5.4,19.8,13940,5247,8693,9.6,25.5,-3116,-5.7,39.6,0,579,579,3798
2002,47,f) 5,3974,4174,42030,43787,207,4.7,659,15,7757,1692,6065,3.9,17.7,11270,4316,6954,9.9,25.7,-3513,-8,35.4,0,437,439,3086
2002,47,g) 6 to 10,15698,16721,177746,184164,779,4.5,2172,12.5,27414,5630,21784,3.1,14.9,40249,15050,25199,8.2,21.9,-12835,-7,29.8,0,1429,1429,8116
2002,47,h) 11 to 15,11473,13272,204069,210816,593,4.3,1319,9.7,26227,6763,19464,3.2,12.4,39722,13733,25989,6.5,18.8,-13495,-6.4,24.8,0,761,763,6931
2002,47,i) 16 to 20,9820,11608,183745,186730,517,4.4,1070,9,24207,8814,15393,4.7,13,30178,9809,20369,5.3,16.2,-5971,-3.2,26,0,498,500,3067
2002,47,j) 21 to 25,6810,10523,222221,237276,532,4.9,1012,9.4,27190,6808,20382,2.9,11.5,57300,22711,34589,9.6,24.1,-30110,-12.6,23,0,331,333,2791
2002,47,l) Left Censored,13540,32439,1200098,1222211,2280,6.9,3107,9.5,148710,49933,98777,4.1,12.2,192936,58260,134676,4.8,15.8,-44226,-3.6,24.4,0,505,514,5775
2002,48,a) 0,35631,36241,300646,150323,36241,200,0,0,300646,300646,0,200,200,0,0,0,0,0,300646,200,0,0,,,
2002,48,b) 1,25911,26447,220991,230632,237,0.8,8261,27.1,57634,4362,53272,1.9,25,76915,41990,34925,18.2,33.3,-19281,-8.3,50,0,6152,6156,33158
2002,48,c) 2,22186,22937,206843,215426,1131,4.6,4717,19.1,46761,9326,37435,4.3,21.7,63927,30366,33561,14.1,29.7,-17166,-8,43.4,0,3529,3538,24773
2002,48,d) 3,19630,20592,219168,227082,1140,5.2,3618,16.6,42909,10473,32436,4.6,18.9,58737,22795,35942,10,25.9,-15828,-7,37.8,0,2633,2637,18000
2002,48,e) 4,18015,19766,227291,229803,1283,6.2,2925,14.2,47677,14523,33154,6.3,20.7,52701,19369,33332,8.4,22.9,-5024,-2.2,41.4,0,2112,2112,13870
2002,48,f) 5,16004,16726,187593,197565,789,4.5,2516,14.3,35873,8625,27248,4.4,18.2,55816,20546,35270,10.4,28.3,-19943,-10.1,36.4,0,1746,1750,12704
2002,48,g) 6 to 10,60147,64689,767434,796866,3254,4.8,8194,12.2,123550,31102,92448,3.9,15.5,182414,72785,109629,9.1,22.9,-58864,-7.4,31,0,5245,5257,35475
2002,48,h) 11 to 15,40574,47203,748182,770562,2552,5.3,4936,10.2,110680,25371,85309,3.3,14.4,155440,55422,100018,7.2,20.2,-44760,-5.8,28.8,0,2611,2622,22272
2002,48,i) 16 to 20,33168,40665,662877,677131,1945,4.7,3875,9.3,100863,32976,67887,4.9,14.9,129371,47191,82180,7,19.1,-28508,-4.2,29.8,0,1718,1733,14136
2002,48,j) 21 to 25,24043,34740,649301,668552,2069,5.8,3425,9.7,98833,32967,65866,4.9,14.8,137334,50283,87051,7.5,20.5,-38501,-5.7,29.6,0,1208,1226,8419
2002,48,l) Left Censored,34506,104119,3773184,3832008,8717,8.3,10945,10.4,536630,205619,331011,5.4,14,654280,208952,445328,5.5,17.1,-117650,-3.1,28,0,1382,1405,12160
2002,49,a) 0,5544,5599,34908,17454,5599,200,0,0,34908,34908,0,200,200,0,0,0,0,0,34908,200,0,0,,,
2002,49,b) 1,3739,3800,26432,27712,24,0.5,1288,29.1,7465,472,6993,1.7,26.9,10025,6030,3995,21.8,36.2,-2560,-9.3,53.8,0,848,849,4329
2002,49,c) 2,3076,3129,25272,26029,156,4.6,694,20.4,6497,1859,4638,7.1,25,8011,3968,4043,15.2,30.8,-1514,-5.8,50,0,470,471,3055
2002,49,d) 3,2709,2770,28088,29057,169,5.7,550,18.6,5884,828,5056,2.8,20.2,7822,3295,4527,11.3,26.9,-1938,-6.7,40.4,0,356,356,2457
2002,49,e) 4,2366,2515,22727,23936,174,6.6,426,16.1,4272,1484,2788,6.2,17.8,6690,3087,3603,12.9,27.9,-2418,-10.1,35.6,0,281,281,2127
2002,49,f) 5,2110,2175,21266,22339,106,4.6,363,15.8,3544,567,2977,2.5,15.9,5689,1943,3746,8.7,25.5,-2145,-9.6,31.8,0,229,229,1180
2002,49,g) 6 to 10,7159,7535,94614,98328,378,4.8,1060,13.5,14144,4357,9787,4.4,14.4,21572,7870,13702,8,21.9,-7428,-7.5,28.8,0,592,592,4619
2002,49,h) 11 to 15,4122,4664,91928,90436,236,4.9,506,10.5,20586,3044,17542,3.4,22.8,17601,8213,9388,9.1,19.5,2985,3.3,39,0,249,249,4799
2002,49,i) 16 to 20,2890,3509,61883,64385,178,4.9,357,9.9,8504,2865,5639,4.4,13.2,13507,5012,8495,7.8,21,-5003,-7.8,26.4,0,136,137,1132
2002,49,j) 21 to 25,2563,3458,70701,72647,213,6,349,9.9,10410,3207,7203,4.4,14.3,14301,4711,9590,6.5,19.7,-3891,-5.4,28.6,0,110,110,847
2002,49,l) Left Censored,4490,10742,429426,436834,893,8.3,1017,9.4,51530,20770,30760,4.8,11.8,66346,16871,49475,3.9,15.2,-14816,-3.4,23.6,0,152,155,1702
2002,50,a) 0,1282,1289,7942,3971,1289,200,0,0,7942,7942,0,200,200,0,0,0,0,0,7942,200,0,0,,,
2002,50,b) 1,997,1004,5874,5795,6,0.5,224,20.1,1359,174,1185,3,23.5,1200,646,554,11.1,20.7,159,2.8,41.4,0,148,148,461
2002,50,c) 2,932,959,7296,7232,27,2.6,183,17.6,2360,288,2072,4,32.6,2232,1332,900,18.4,30.9,128,1.7,61.8,0,115,115,914
2002,50,d) 3,843,872,5435,5454,40,4.4,126,13.8,1112,156,956,2.9,20.4,1149,449,700,8.2,21.1,-37,-0.7,40.8,0,80,80,268
2002,50,e) 4,845,902,6685,6715,56,6,122,13,1369,640,729,9.5,20.4,1428,520,908,7.7,21.3,-59,-0.9,40.8,0,72,72,378
2002,50,f) 5,743,751,4191,4412,21,2.6,114,14.3,583,60,523,1.4,13.2,1025,377,648,8.5,23.2,-442,-10,26.4,0,71,71,267
2002,50,g) 6 to 10,2913,3006,23636,24465,92,2.9,364,11.6,3059,385,2674,1.6,12.5,4717,1688,3029,6.9,19.3,-1658,-6.8,25,0,226,226,1191
2002,50,h) 11 to 15,2538,2648,23005,23543,90,3.3,262,9.6,2679,407,2272,1.7,11.4,3754,1240,2514,5.3,15.9,-1075,-4.5,22.8,0,129,129,760
2002,50,i) 16 to 20,1896,2139,31424,31844,72,3.3,197,8.9,3421,608,2813,1.9,10.7,4260,1240,3020,3.9,13.4,-839,-2.7,21.4,0,84,84,544
2002,50,j) 21 to 25,1246,1557,24064,24973,55,3.4,133,8.3,2247,436,1811,1.7,9,4065,1498,2567,6,16.3,-1818,-7.3,18,0,53,53,280
2002,50,l) Left Censored,2512,4113,120059,121302,268,6.4,389,9.3,14261,5656,8605,4.7,11.8,16746,5741,11005,4.7,13.8,-2485,-2,23.6,0,76,77,891
2002,51,a) 0,12203,12321,77752,38876,12321,200,0,0,77752,77752,0,200,200,0,0,0,0,0,77752,200,0,0,,,
2002,51,b) 1,8940,9132,63253,65234,103,1,2769,26.5,17469,1361,16108,2.1,26.8,21430,11948,9482,18.3,32.9,-3961,-6.1,53.6,0,1937,1938,8557
2002,51,c) 2,7954,8134,60448,63755,397,4.6,1572,18,12998,2260,10738,3.5,20.4,19612,8919,10693,14,30.8,-6614,-10.4,40.8,0,1110,1111,7098
2002,51,d) 3,7013,7284,61778,63994,397,5.2,1190,15.5,13010,3901,9109,6.1,20.3,17442,7603,9839,11.9,27.3,-4432,-7,40.6,0,837,841,6143
2002,51,e) 4,6757,7323,70950,71444,417,5.5,959,12.6,14608,3935,10673,5.5,20.4,15595,5126,10469,7.2,21.8,-987,-1.4,40.8,0,657,657,3741
2002,51,f) 5,5898,6087,54974,57361,281,4.4,810,12.8,9361,2216,7145,3.9,16.3,14134,4885,9249,8.5,24.6,-4773,-8.3,32.6,0,536,536,3093
2002,51,g) 6 to 10,22494,23676,265955,273108,1070,4.4,2717,11.1,43112,9575,33537,3.5,15.8,57417,23589,33828,8.6,21,-14305,-5.2,31.6,0,1723,1724,12992
2002,51,h) 11 to 15,16536,18510,273733,279317,829,4.4,1627,8.6,37262,10607,26655,3.8,13.3,48429,17657,30772,6.3,17.3,-11167,-4,26.6,0,881,881,7547
2002,51,i) 16 to 20,12808,15565,258409,261462,753,4.8,1255,7.9,36258,11686,24572,4.5,13.9,42363,13663,28700,5.2,16.2,-6105,-2.3,27.8,0,497,498,3659
2002,51,j) 21 to 25,8460,12012,243405,248511,724,5.9,1099,9,33374,11155,22219,4.5,13.4,43585,18263,25322,7.3,17.5,-10211,-4.1,26.8,0,341,346,2722
2002,51,l) Left Censored,16460,41803,1465590,1481423,3246,7.7,3922,9.3,197524,72232,125292,4.9,13.3,229190,74439,154751,5,15.5,-31666,-2.2,26.6,0,523,529,5160
2002,53,a) 0,12421,12558,63594,31797,12558,200,0,0,63594,63594,0,200,200,0,0,0,0,0,63594,200,0,0,,,
2002,53,b) 1,9111,9224,57442,60732,64,0.6,3075,28.7,13892,1180,12712,1.9,22.9,20472,11369,9103,18.7,33.7,-6580,-10.8,45.8,0,2100,2100,8744
2002,53,c) 2,7959,8162,55257,60742,455,5.1,1885,21.2,11142,2862,8280,4.7,18.3,22112,10989,11123,18.1,36.4,-10970,-18.1,36.6,0,1312,1313,9256
2002,53,d) 3,7256,7600,63518,67166,503,6.2,1440,17.8,12635,3421,9214,5.1,18.8,19930,7199,12731,10.7,29.7,-7295,-10.9,37.6,0,1011,1011,5713
2002,53,e) 4,6638,7106,62788,65585,440,5.9,1214,16.2,12341,2603,9738,4,18.8,17934,6219,11715,9.5,27.3,-5593,-8.5,37.6,0,809,819,4914
2002,53,f) 5,5882,6052,49592,52995,333,5.2,953,15,7737,1606,6131,3,14.6,14542,5987,8555,11.3,27.4,-6805,-12.8,29.2,0,601,601,3616
2002,53,g) 6 to 10,21882,22819,205693,217052,1259,5.3,3221,13.5,30015,8425,21590,3.9,13.8,52732,19199,33533,8.8,24.3,-22717,-10.5,27.6,0,1956,1957,11768
2002,53,h) 11 to 15,14866,16423,209635,216498,878,5.2,1939,11.4,28486,8814,19672,4.1,13.2,42211,13874,28337,6.4,19.5,-13725,-6.3,26.4,0,995,996,6466
2002,53,i) 16 to 20,10984,13310,216760,221308,627,4.6,1413,10.3,28253,7319,20934,3.3,12.8,37348,11144,26204,5,16.9,-9095,-4.1,25.6,0,623,627,4167
2002,53,j) 21 to 25,8327,11394,205958,211998,641,5.5,1147,9.8,25737,7975,17762,3.8,12.1,37816,11832,25984,5.6,17.8,-12079,-5.7,24.2,0,429,430,2728
2002,53,l) Left Censored,13278,30493,998826,1010245,2246,7.3,2810,9.1,151256,75712,75544,7.5,15,174094,42867,131227,4.2,17.2,-22838,-2.2,30,0,446,450,4563
2002,54,a) 0,2247,2289,13318,6659,2289,200,0,0,13318,13318,0,200,200,0,0,0,0,0,13318,200,0,0,,,
2002,54,b) 1,1639,1664,11735,12383,16,0.8,468,24.8,3202,276,2926,2.2,25.9,4497,2192,2305,17.7,36.3,-1295,-10.4,51.8,0,342,342,1853
2002,54,c) 2,1560,1604,11352,11440,83,4.8,327,18.9,2756,364,2392,3.2,24.1,2931,1532,1399,13.4,25.6,-175,-1.5,48.2,0,231,231,1137
2002,54,d) 3,1395,1457,11776,11916,94,6.1,266,17.2,2433,542,1891,4.5,20.4,2712,942,1770,7.9,22.8,-279,-2.4,40.8,0,187,187,688
2002,54,e) 4,1326,1543,13359,13576,86,5.3,223,13.8,2426,536,1890,3.9,17.9,2859,948,1911,7,21.1,-433,-3.2,35.8,0,167,167,784
2002,54,f) 5,1247,1255,8754,8874,66,5,200,15.1,1568,220,1348,2.5,17.7,1807,832,975,9.4,20.4,-239,-2.7,35.4,0,133,133,552
2002,54,g) 6 to 10,4825,5011,44068,44886,264,5.1,643,12.4,7532,1683,5849,3.7,16.8,9167,2921,6246,6.5,20.4,-1635,-3.6,33.6,0,415,415,1935
2002,54,h) 11 to 15,3750,4033,49997,50587,167,4,421,10.1,7229,1892,5337,3.7,14.3,8408,3260,5148,6.4,16.6,-1179,-2.3,28.6,0,244,244,1965
2002,54,i) 16 to 20,3340,3876,50666,52303,153,3.9,309,7.8,7159,1313,5846,2.5,13.7,10433,6189,4244,11.8,19.9,-3274,-6.2,27.4,0,161,163,781
2002,54,j) 21 to 25,2431,3470,53869,54365,170,4.8,308,8.7,7174,1514,5660,2.8,13.2,8166,2458,5708,4.5,15,-992,-1.8,26.4,0,107,108,650
2002,54,l) Left Censored,5643,10773,287796,286745,623,5.7,906,8.3,36790,9302,27488,3.2,12.8,34688,9584,25104,3.3,12.1,2102,0.7,24.2,0,214,216,1421
2002,55,a) 0,8752,8870,56128,28064,8870,200,0,0,56128,56128,0,200,200,0,0,0,0,0,56128,200,0,0,,,
2002,55,b) 1,6376,6527,54244,54146,64,0.9,1616,22.1,14844,1847,12997,3.4,27.4,14648,7265,7383,13.4,27.1,196,0.3,54.2,0,1092,1092,5603
2002,55,c) 2,5863,6015,46555,47763,260,4,1152,17.8,9643,2125,7518,4.4,20.2,12058,5864,6194,12.3,25.2,-2415,-5,40.4,0,764,764,4419
2002,55,d) 3,5330,5667,52655,54481,246,4.1,855,14.3,8932,1982,6950,3.6,16.4,12583,4894,7689,9,23.1,-3651,-6.7,32.8,0,562,562,3097
2002,55,e) 4,5091,5499,51199,52141,267,4.7,728,12.7,8894,2809,6085,5.4,17.1,10778,4166,6612,8,20.7,-1884,-3.6,34.2,0,477,477,3258
2002,55,f) 5,4613,4786,37941,39450,173,3.5,617,12.3,5412,822,4590,2.1,13.7,8430,3372,5058,8.5,21.4,-3018,-7.7,27.4,0,395,395,2448
2002,55,g) 6 to 10,18339,19050,180033,184465,795,4,2216,11.2,25397,5904,19493,3.2,13.8,34261,12567,21694,6.8,18.6,-8864,-4.8,27.6,0,1262,1262,7074
2002,55,h) 11 to 15,14528,16101,192863,197014,725,4.4,1653,10,24858,7126,17732,3.6,12.6,33159,11746,21413,6,16.8,-8301,-4.2,25.2,0,766,767,6243
2002,55,i) 16 to 20,10070,11863,194101,197346,467,3.8,1028,8.5,24822,8089,16733,4.1,12.6,31312,8583,22729,4.3,15.9,-6490,-3.3,25.2,0,496,500,3513
2002,55,j) 21 to 25,7888,10931,210088,214624,484,4.3,929,8.3,24835,6674,18161,3.1,11.6,33907,9492,24415,4.4,15.8,-9072,-4.2,23.2,0,359,361,2236
2002,55,l) Left Censored,17848,34635,1289039,1308344,1980,5.6,2863,8.2,136245,42100,94145,3.2,10.4,174854,47220,127634,3.6,13.4,-38609,-3,20.8,0,648,660,6659
2002,56,a) 0,1588,1593,7627,3814,1593,200,0,0,7627,7627,0,200,200,0,0,0,0,0,7627,200,0,0,,,
2002,56,b) 1,1056,1065,5784,6260,4,0.3,312,25.6,1304,25,1279,0.4,20.8,2256,1394,862,22.3,36,-952,-15.2,41.6,0,192,192,908
2002,56,c) 2,954,968,5632,6027,52,5,188,18.1,1092,194,898,3.2,18.1,1882,880,1002,14.6,31.2,-790,-13.1,36.2,0,126,126,680
2002,56,d) 3,786,803,5081,5226,44,5.2,131,15.5,959,134,825,2.6,18.4,1249,527,722,10.1,23.9,-290,-5.5,36.8,0,88,88,392
2002,56,e) 4,794,866,7056,6950,61,6.9,106,11.9,1372,392,980,5.6,19.7,1160,383,777,5.5,16.7,212,3,33.4,0,67,67,284
2002,56,f) 5,655,666,4335,4525,36,5.2,89,12.9,663,161,502,3.6,14.7,1043,464,579,10.3,23,-380,-8.3,29.4,0,57,57,190
2002,56,g) 6 to 10,2505,2577,19920,20525,139,5.2,355,13.2,3204,659,2545,3.2,15.6,4413,1807,2606,8.8,21.5,-1209,-5.9,31.2,0,222,222,1202
2002,56,h) 11 to 15,1590,1730,21918,21981,95,5.4,172,9.7,3370,1216,2154,5.5,15.3,3496,986,2510,4.5,15.9,-126,-0.6,30.6,0,89,89,595
2002,56,i) 16 to 20,1325,1505,15267,15763,57,3.7,132,8.6,1794,328,1466,2.1,11.4,2785,616,2169,3.9,17.7,-991,-6.3,22.8,0,64,64,279
2002,56,j) 21 to 25,1211,1523,19205,19433,88,5.7,136,8.8,2725,1002,1723,5.2,14,3181,802,2379,4.1,16.4,-456,-2.4,28,0,57,58,329
2002,56,l) Left Censored,1933,3319,64827,65484,193,5.8,263,7.8,9908,2298,7610,3.5,15.1,11222,5416,5806,8.3,17.1,-1314,-2,30.2,0,56,56,337
2003,01,a) 0,6489,6523,42879,21440,6523,200,0,0,42879,42879,0,200,200,0,0,0,0,0,42879,200,0,0,,,
2003,01,b) 1,4746,4838,37033,38426,24,0.4,1531,27,9762,151,9611,0.4,25.4,12548,7733,4815,20.1,32.7,-2786,-7.3,50.8,0,1267,1267,6484
2003,01,c) 2,4057,4160,34097,35639,191,4.2,810,18,7535,1079,6456,3,21.1,10619,4849,5770,13.6,29.8,-3084,-8.7,42.2,0,668,668,4292
2003,01,d) 3,3654,3778,35244,35194,179,4.5,593,14.8,7316,1113,6203,3.2,20.8,7216,3183,4033,9,20.5,100,0.3,41,0,464,464,2531
2003,01,e) 4,3600,3780,37813,37960,146,3.7,504,12.7,6598,767,5831,2,17.4,6891,2259,4632,6,18.2,-293,-0.8,34.8,0,408,408,1889
2003,01,f) 5,3373,3702,40043,40427,164,4.3,412,10.7,6935,1200,5735,3,17.2,7702,2692,5010,6.7,19.1,-767,-1.9,34.4,0,346,346,2355
2003,01,g) 6 to 10,12893,13475,134701,134503,573,4.1,1409,10.1,24633,6212,18421,4.6,18.3,24236,9021,15215,6.7,18,397,0.3,36,0,1101,1101,6604
2003,01,h) 11 to 15,8669,9708,136925,137324,387,3.9,794,8,20698,3127,17571,2.3,15.1,21496,5471,16025,4,15.7,-798,-0.6,30.2,0,578,578,3183
2003,01,i) 16 to 20,7586,9107,168233,168209,264,2.9,522,5.6,19151,3718,15433,2.2,11.4,19103,5610,13493,3.3,11.4,48,0,22.8,0,371,371,2955
2003,01,j) 21 to 25,4856,6457,122317,121221,199,3,336,5.1,16465,4915,11550,4.1,13.6,14273,3001,11272,2.5,11.8,2192,1.8,23.6,0,220,222,1438
2003,01,k) 26+,1161,2343,43841,43219,108,4.6,88,3.8,5716,1111,4605,2.6,13.2,4472,736,3736,1.7,10.3,1244,2.9,20.6,0,48,48,167
2003,01,l) Left Censored,9771,23629,756853,757272,1384,5.9,1000,4.3,83395,24781,58614,3.3,11,84232,18679,65553,2.5,11.1,-837,-0.1,22,0,355,355,2323
2003,02,a) 0,1257,1274,7765,3883,1274,200,0,0,7765,7765,0,200,200,0,0,0,0,0,7765,200,0,0,,,
2003,02,b) 1,1012,1038,6593,6939,8,0.7,332,27.2,1908,32,1876,0.5,27.5,2600,1699,901,24.5,37.5,-692,-10,55,0,216,216,1385
2003,02,c) 2,766,782,4763,4810,59,7.1,144,17.3,1047,194,853,4,21.8,1140,524,616,10.9,23.7,-93,-1.9,43.6,0,98,98,308
2003,02,d) 3,750,781,5778,5826,64,7.8,129,15.7,1125,218,907,3.7,19.3,1220,565,655,9.7,20.9,-95,-1.6,38.6,0,95,95,466
2003,02,e) 4,617,660,4679,5056,61,9,86,12.7,759,159,600,3.1,15,1512,459,1053,9.1,29.9,-753,-14.9,30,0,59,59,305
2003,02,f) 5,655,717,7831,7753,46,6.2,83,11.2,1384,313,1071,4,17.9,1227,238,989,3.1,15.8,157,2.1,31.6,0,53,53,175
2003,02,g) 6 to 10,2312,2369,18643,18217,152,6.2,282,11.5,3998,840,3158,4.6,21.9,3146,1235,1911,6.8,17.3,852,4.6,34.6,0,196,196,972
2003,02,h) 11 to 15,1527,1624,16726,16914,75,4.5,140,8.4,2159,352,1807,2.1,12.8,2534,719,1815,4.3,15,-375,-2.2,25.6,0,69,69,391
2003,02,i) 16 to 20,1457,1722,24769,24099,74,4.3,98,5.6,3516,401,3115,1.7,14.6,2176,397,1779,1.6,9,1340,5.6,18,0,56,56,290
2003,02,j) 21 to 25,998,1298,23624,23116,50,3.8,52,4,4626,718,3908,3.1,20,3609,1360,2249,5.9,15.6,1017,4.4,31.2,0,30,30,455
2003,02,k) 26+,222,476,10162,9951,29,6.1,22,4.7,1788,364,1424,3.7,18,1366,321,1045,3.2,13.7,422,4.3,27.4,0,6,6,19
2003,02,l) Left Censored,1467,3114,88043,88678,208,6.7,146,4.7,10991,3906,7085,4.4,12.4,12261,2054,10207,2.3,13.8,-1270,-1.4,24.8,0,27,27,123
2003,04,a) 0,9768,9830,66545,33273,9830,200,0,0,66545,66545,0,200,200,0,0,0,0,0,66545,200,0,0,,,
2003,04,b) 1,7209,7310,61888,62535,34,0.4,2149,25.3,17769,378,17391,0.6,28.4,19062,11902,7160,19,30.5,-1293,-2.1,56.8,0,1723,1723,10114
2003,04,c) 2,6078,6262,53347,53466,328,4.9,1170,17.4,12456,2309,10147,4.3,23.3,12693,7027,5666,13.1,23.7,-237,-0.4,46.6,0,953,953,5974
2003,04,d) 3,5258,5426,68833,64923,297,5.1,907,15.7,17344,1714,15630,2.6,26.7,9523,4869,4654,7.5,14.7,7821,12,29.4,0,725,725,4065
2003,04,e) 4,4874,5096,70527,68871,253,4.7,748,13.9,16376,1812,14564,2.6,23.8,13063,6816,6247,9.9,19,3313,4.8,38,0,584,584,5967
2003,04,f) 5,4361,4766,59557,59628,235,4.7,580,11.6,10681,1970,8711,3.3,17.9,10822,4284,6538,7.2,18.1,-141,-0.2,35.8,0,459,459,3439
2003,04,g) 6 to 10,15332,16160,200115,201161,748,4.5,1728,10.3,33937,7992,25945,4,16.9,36028,12206,23822,6.1,17.9,-2091,-1,33.8,0,1291,1291,9226
2003,04,h) 11 to 15,9335,11086,172458,172702,500,4.4,949,8.4,25899,7417,18482,4.3,15,26387,9700,16687,5.6,15.3,-488,-0.3,30,0,694,697,6392
2003,04,i) 16 to 20,7405,9564,199273,199132,422,4.3,768,7.9,29801,5993,23808,3,15,29519,11011,18508,5.5,14.8,282,0.2,29.6,0,426,432,4838
2003,04,j) 21 to 25,4960,6544,136700,134576,297,4.5,418,6.3,20892,5458,15434,4.1,15.5,16644,4211,12433,3.1,12.4,4248,3.1,24.8,0,258,258,1944
2003,04,k) 26+,956,2184,80958,82022,140,6.4,118,5.4,13865,2400,11465,2.9,16.9,15993,1653,14340,2,19.5,-2128,-2.6,33.8,0,41,43,340
2003,04,l) Left Censored,7084,21324,793761,795225,1887,9,1328,6.3,119142,43007,76135,5.4,15,122071,29531,92540,3.7,15.4,-2929,-0.4,30,0,217,225,4311
2003,05,a) 0,4491,4501,24174,12087,4501,200,0,0,24174,24174,0,200,200,0,0,0,0,0,24174,200,0,0,,,
2003,05,b) 1,3404,3451,25270,26048,20,0.5,1059,26.4,6232,175,6057,0.7,23.9,7787,5064,2723,19.4,29.9,-1555,-6,47.8,0,849,849,4192
2003,05,c) 2,2794,2869,19541,20079,133,4.3,506,16.4,3552,474,3078,2.4,17.7,4628,2152,2476,10.7,23,-1076,-5.3,35.4,0,417,417,1603
2003,05,d) 3,2486,2558,20032,19950,125,4.6,393,14.5,4145,590,3555,3,20.8,3981,1677,2304,8.4,20,164,0.8,40,0,315,315,1445
2003,05,e) 4,2361,2499,20056,20012,126,4.8,329,12.6,3946,512,3434,2.6,19.7,3857,1764,2093,8.8,19.3,89,0.4,38.6,0,261,261,1382
2003,05,f) 5,2101,2365,20141,20432,109,4.4,269,11,3240,486,2754,2.4,15.9,3822,1359,2463,6.7,18.7,-582,-2.8,31.8,0,199,199,926
2003,05,g) 6 to 10,8308,8620,80587,81335,372,4.2,884,9.9,12792,2252,10540,2.8,15.7,14287,4683,9604,5.8,17.6,-1495,-1.9,31.4,0,695,695,3556
2003,05,h) 11 to 15,5625,6150,75869,76505,273,4.3,533,8.5,9836,1861,7975,2.4,12.9,11108,3489,7619,4.6,14.5,-1272,-1.6,25.8,0,377,377,2247
2003,05,i) 16 to 20,4705,5564,94506,91979,225,4,347,6.1,14680,2596,12084,2.8,16,9625,2455,7170,2.7,10.5,5055,5.5,21,0,262,262,1958
2003,05,j) 21 to 25,3346,4140,66641,67294,138,3.3,285,6.7,7582,1026,6556,1.5,11.3,8887,1990,6897,3,13.2,-1305,-1.9,22.6,0,196,196,1108
2003,05,k) 26+,748,1310,34553,34689,47,3.6,53,4,2974,533,2441,1.5,8.6,3245,665,2580,1.9,9.4,-271,-0.8,17.2,0,28,29,161
2003,05,l) Left Censored,6535,14575,502959,503041,968,6.7,541,3.8,48604,14000,34604,2.8,9.7,48767,9451,39316,1.9,9.7,-163,0,19.4,0,199,204,1640
2003,06,a) 0,65137,65527,436689,218345,65527,200,0,0,436689,436689,0,200,200,0,0,0,0,0,436689,200,0,0,,,
2003,06,b) 1,48724,49734,421770,435939,199,0.3,13879,24.2,108756,2125,106631,0.5,24.9,137093,76334,60759,17.5,31.4,-28337,-6.5,49.8,0,10849,10867,64113
2003,06,c) 2,40622,41775,363528,367735,2364,5.3,7975,17.7,86552,14564,71988,4,23.5,94968,46219,48749,12.6,25.8,-8416,-2.3,47,0,6295,6295,35372
2003,06,d) 3,35313,36449,366982,384263,1854,4.8,6231,16,74657,11391,63266,3,19.4,109219,44426,64793,11.6,28.4,-34562,-9,38.8,0,4954,4954,37525
2003,06,e) 4,31405,33146,352365,361745,1688,4.8,4840,13.8,67074,11038,56036,3.1,18.5,85833,38461,47372,10.6,23.7,-18759,-5.2,37,0,3768,3789,28267
2003,06,f) 5,28387,31330,374351,383104,1603,4.9,3992,12.2,74538,11890,62648,3.1,19.5,92043,31990,60053,8.4,24,-17505,-4.5,39,0,3077,3078,22496
2003,06,g) 6 to 10,99385,103812,1317366,1336038,4851,4.5,12162,11.2,228615,46179,182436,3.5,17.1,265958,94597,171361,7.1,19.9,-37343,-2.8,34.2,0,9275,9277,73626
2003,06,h) 11 to 15,73744,82604,1172024,1178429,3907,4.6,7608,9,188578,30915,157663,2.6,16,201387,67116,134271,5.7,17.1,-12809,-1.1,32,0,5254,5259,44414
2003,06,i) 16 to 20,58398,70697,1288601,1288650,3102,4.3,5128,7.1,176422,45211,131211,3.5,13.7,176520,51762,124758,4,13.7,-98,0,27.4,0,3452,3479,29605
2003,06,j) 21 to 25,42798,54299,1094247,1093481,2112,3.8,3652,6.6,143524,30976,112548,2.8,13.1,141991,37071,104920,3.4,13,1533,0.1,26,0,2321,2338,19645
2003,06,k) 26+,8031,16440,447281,446854,868,5.3,953,5.8,63996,12348,51648,2.8,14.3,63141,17009,46132,3.8,14.1,855,0.2,28.2,0,370,382,3339
2003,06,l) Left Censored,55792,143366,5307083,5282767,9663,6.7,9011,6.3,705865,232430,473435,4.4,13.4,657233,163478,493755,3.1,12.4,48632,1,24.8,0,2490,3082,28108
2003,08,a) 0,11675,11749,68791,34396,11749,200,0,0,68791,68791,0,200,200,0,0,0,0,0,68791,200,0,0,,,
2003,08,b) 1,8703,8816,55176,58575,32,0.3,2771,26.9,12708,278,12430,0.5,21.7,19505,12510,6995,21.4,33.3,-6797,-11.6,43.4,0,2039,2039,10705
2003,08,c) 2,7513,7665,54306,56607,429,5.2,1485,18,9596,1649,7947,2.9,17,14197,6724,7473,11.9,25.1,-4601,-8.1,34,0,1175,1175,5753
2003,08,d) 3,6554,6732,55249,57444,356,4.9,1169,16.3,9076,1102,7974,1.9,15.8,13465,6163,7302,10.7,23.4,-4389,-7.6,31.6,0,883,883,5121
2003,08,e) 4,5810,6044,48255,50043,306,4.8,897,14,7983,1198,6785,2.4,16,11558,5464,6094,10.9,23.1,-3575,-7.1,32,0,658,658,4513
2003,08,f) 5,5448,5784,51486,52189,320,5.3,750,12.4,8603,2173,6430,4.2,16.5,10008,3618,6390,6.9,19.2,-1405,-2.7,33,0,516,517,3030
2003,08,g) 6 to 10,19401,20177,191996,200860,950,4.5,2299,11,26084,4746,21338,2.4,13,43811,17035,26776,8.5,21.8,-17727,-8.8,26,0,1618,1618,13212
2003,08,h) 11 to 15,11668,12901,172339,173769,552,4.2,1180,8.9,24896,4783,20113,2.8,14.3,27755,8723,19032,5,16,-2859,-1.7,28.6,0,745,746,5222
2003,08,i) 16 to 20,8559,10468,196122,199442,480,4.5,807,7.6,30382,9174,21208,4.6,15.2,37022,9951,27071,5,18.6,-6640,-3.4,30.4,0,445,446,3602
2003,08,j) 21 to 25,6222,7992,145979,148134,324,4,527,6.5,18514,5968,12546,4,12.5,22823,4457,18366,3,15.4,-4309,-2.9,25,0,318,321,2292
2003,08,k) 26+,1173,2359,59522,58312,176,7.5,140,6,11575,3411,8164,5.8,19.9,9155,1719,7436,2.9,15.7,2420,4.2,31.4,0,36,39,237
2003,08,l) Left Censored,9285,23197,754302,760598,1753,7.6,1438,6.2,90876,30125,60751,4,11.9,103469,33456,70013,4.4,13.6,-12593,-1.7,23.8,0,303,306,3845
2003,09,a) 0,4860,4874,27163,13582,4874,200,0,0,27163,27163,0,200,200,0,0,0,0,0,27163,200,0,0,,,
2003,09,b) 1,4108,4170,32146,33025,28,0.6,1077,22.7,7692,559,7133,1.7,23.3,9449,5741,3708,17.4,28.6,-1757,-5.3,46.6,0,808,808,5037
2003,09,c) 2,3471,3531,27372,27292,141,3.7,622,16.4,5931,751,5180,2.8,21.7,5771,2894,2877,10.6,21.1,160,0.6,42.2,0,489,489,2290
2003,09,d) 3,3251,3352,30445,31305,149,4.2,513,14.4,4817,684,4133,2.2,15.4,6536,2850,3686,9.1,20.9,-1719,-5.5,30.8,0,378,378,2374
2003,09,e) 4,2961,3064,33667,33390,133,4.1,386,12,5944,1114,4830,3.3,17.8,5390,2230,3160,6.7,16.1,554,1.7,32.2,0,302,302,1400
2003,09,f) 5,2956,3202,33431,33400,127,3.8,343,10.3,5562,810,4752,2.4,16.7,5500,1727,3773,5.2,16.5,62,0.2,33,0,259,259,1305
2003,09,g) 6 to 10,11008,11243,117097,115899,411,3.5,1161,10,19894,2493,17401,2.2,17.2,17498,5961,11537,5.1,15.1,2396,2.1,30.2,0,843,846,4575
2003,09,h) 11 to 15,8903,9443,126188,126059,314,3.2,729,7.5,16552,1603,14949,1.3,13.1,16293,4146,12147,3.3,12.9,259,0.2,25.8,0,487,487,2844
2003,09,i) 16 to 20,7720,8704,124067,123562,240,2.7,567,6.4,15488,1812,13676,1.5,12.5,14478,3687,10791,3,11.7,1010,0.8,23.4,0,372,375,2028
2003,09,j) 21 to 25,5183,6212,97040,96904,201,3.2,451,7.1,11481,2965,8516,3.1,11.8,11209,3131,8078,3.2,11.6,272,0.2,23.2,0,216,216,1188
2003,09,k) 26+,1108,1766,40901,41279,82,4.6,104,5.8,4705,653,4052,1.6,11.4,5460,916,4544,2.2,13.2,-755,-1.8,22.8,0,52,52,258
2003,09,l) Left Censored,12312,22515,857480,865693,1098,4.9,1266,5.6,86649,20549,66100,2.4,10,103075,32476,70599,3.8,11.9,-16426,-1.9,20,0,427,427,4550
2003,10,a) 0,1699,1701,10185,5093,1701,200,0,0,10185,10185,0,200,200,0,0,0,0,0,10185,200,0,0,,,
2003,10,b) 1,1248,1273,8550,8724,3,0.2,334,23,2627,7,2620,0.1,30.1,2975,2016,959,23.1,34.1,-348,-4,60.2,0,250,250,1800
2003,10,c) 2,1157,1167,6929,6974,53,4.2,203,16.2,1445,231,1214,3.3,20.7,1534,681,853,9.8,22,-89,-1.3,41.4,0,164,164,603
2003,10,d) 3,1083,1099,7435,7577,53,4.6,168,14.5,1252,202,1050,2.7,16.5,1535,714,821,9.4,20.3,-283,-3.8,33,0,136,136,626
2003,10,e) 4,898,931,7636,8059,42,4.3,134,13.6,1246,287,959,3.6,15.5,2091,1050,1041,13,25.9,-845,-10.4,31,0,102,102,710
2003,10,f) 5,824,855,7092,7115,41,4.6,121,13.5,1113,140,973,2,15.6,1158,525,633,7.4,16.3,-45,-0.7,31.2,0,89,89,389
2003,10,g) 6 to 10,2954,3072,33225,33291,122,3.8,304,9.6,4574,847,3727,2.5,13.7,4706,1591,3115,4.8,14.1,-132,-0.4,27.4,0,249,249,1229
2003,10,h) 11 to 15,2004,2141,23583,24146,78,3.5,176,8,2839,562,2277,2.3,11.8,3964,1452,2512,6,16.4,-1125,-4.6,23.6,0,128,128,709
2003,10,i) 16 to 20,1550,1799,23880,24244,71,3.9,99,5.4,2320,325,1995,1.3,9.6,3047,524,2523,2.2,12.6,-727,-3,19.2,0,68,68,365
2003,10,j) 21 to 25,1057,1246,24784,25373,29,2.3,69,5.4,2478,417,2061,1.6,9.8,3656,948,2708,3.7,14.4,-1178,-4.6,19.6,0,36,36,172
2003,10,k) 26+,286,495,24297,25819,20,4,36,7.1,1911,411,1500,1.6,7.4,4955,674,4281,2.6,19.2,-3044,-11.8,14.8,0,7,9,35
2003,10,l) Left Censored,3076,6159,203556,205788,416,6.8,325,5.3,20125,6174,13951,3,9.8,24589,7796,16793,3.8,11.9,-4464,-2.1,19.6,0,65,65,1015
2003,11,a) 0,887,895,6388,3194,895,200,0,0,6388,6388,0,200,200,0,0,0,0,0,6388,200,0,0,,,
2003,11,b) 1,915,926,9721,9619,11,1.1,206,19.9,2170,296,1874,3.1,22.6,1966,1039,927,10.8,20.4,204,2.2,40.8,0,167,167,884
2003,11,c) 2,765,777,7982,7905,44,5.4,111,13.6,1440,137,1303,1.7,18.2,1285,457,828,5.8,16.3,155,1.9,32.6,0,86,86,362
2003,11,d) 3,678,689,7793,7959,24,3.3,81,11.3,1497,167,1330,2.1,18.8,1828,1087,741,13.7,23,-331,-4.2,37.6,0,67,67,1031
2003,11,e) 4,654,693,9811,9678,25,3.5,80,11.1,1693,353,1340,3.6,17.5,1426,345,1081,3.6,14.7,267,2.8,29.4,0,67,67,297
2003,11,f) 5,637,683,7521,7230,46,6.7,58,8.4,1872,857,1015,11.9,25.9,1290,356,934,4.9,17.8,582,8.1,35.6,0,43,43,291
2003,11,g) 6 to 10,2310,2384,30404,29879,97,4,212,8.7,5228,898,4330,3,17.5,4178,1041,3137,3.5,14,1050,3.5,28,0,161,161,824
2003,11,h) 11 to 15,1790,1953,37255,37860,63,3.1,152,7.6,3816,550,3266,1.5,10.1,5026,1331,3695,3.5,13.3,-1210,-3.2,20.2,0,100,100,687
2003,11,i) 16 to 20,1563,1767,28276,28921,66,3.7,119,6.6,3035,602,2433,2.1,10.5,4325,1538,2787,5.3,15,-1290,-4.5,21,0,74,74,979
2003,11,j) 21 to 25,1247,1456,29590,29722,57,3.9,88,6,2897,638,2259,2.1,9.7,3160,999,2161,3.4,10.6,-263,-0.9,19.4,0,51,51,722
2003,11,k) 26+,308,530,24040,25845,30,5.7,19,3.6,1969,643,1326,2.5,7.6,5579,280,5299,1.1,21.6,-3610,-14,15.2,0,6,6,56
2003,11,l) Left Censored,3303,5688,229386,226765,366,6.4,365,6.4,27382,7787,19595,3.4,12.1,22139,4745,17394,2.1,9.8,5243,2.3,19.6,0,75,75,345
2003,12,a) 0,42618,42772,253082,126541,42772,200,0,0,253082,253082,0,200,200,0,0,0,0,0,253082,200,0,0,,,
2003,12,b) 1,29263,29643,203928,209180,88,0.3,9439,27.1,60859,6735,54124,3.2,29.1,71363,46748,24615,22.3,34.1,-10504,-5,58.2,0,7512,7512,39961
2003,12,c) 2,23272,23695,172195,179170,1315,5.1,4734,18.5,45540,6403,39137,3.6,25.4,59490,39562,19928,22.1,33.2,-13950,-7.8,50.8,0,3745,3746,35396
2003,12,d) 3,19757,20343,176350,168376,1124,5.2,3499,16.1,55002,7631,47371,4.5,32.7,39053,20653,18400,12.3,23.2,15949,9.5,46.4,0,2757,2757,16478
2003,12,e) 4,18032,19015,175496,185417,1048,5.2,2850,14.2,40812,6437,34375,3.5,22,60653,40296,20357,21.7,32.7,-19841,-10.7,44,0,2165,2176,34384
2003,12,f) 5,16063,17289,187970,191907,878,4.8,2329,12.8,38967,5962,33005,3.1,20.3,46842,11639,35203,6.1,24.4,-7875,-4.1,40.6,0,1779,1779,9072
2003,12,g) 6 to 10,58853,61314,701396,696607,3029,4.8,7165,11.2,165415,29802,135613,4.3,23.7,155837,53012,102825,7.6,22.4,9578,1.3,44.8,0,5411,5419,37636
2003,12,h) 11 to 15,39819,44227,615585,614623,1976,4.3,4019,8.8,112649,22533,90116,3.7,18.3,110725,32172,78553,5.2,18,1924,0.3,36,0,2770,2777,18072
2003,12,i) 16 to 20,27396,32796,677719,676428,1391,4.2,2388,7.1,95111,34180,60931,5.1,14.1,92528,28080,64448,4.2,13.7,2583,0.4,27.4,0,1590,1595,15726
2003,12,j) 21 to 25,17381,21972,415018,408121,911,4.1,1477,6.6,67030,24496,42534,6,16.4,53235,14283,38952,3.5,13,13795,3.4,26,0,975,981,7296
2003,12,k) 26+,3217,7066,159063,159391,455,6.4,498,7,25214,6485,18729,4.1,15.8,25870,6695,19175,4.2,16.2,-656,-0.4,31.6,0,178,195,1538
2003,12,l) Left Censored,23646,74869,2686192,2693073,5642,7.6,4532,6.1,339076,125825,213251,4.7,12.6,352840,115379,237461,4.3,13.1,-13764,-0.5,25.2,0,1018,1035,9451
2003,13,a) 0,16237,16294,102849,51425,16294,200,0,0,102849,102849,0,200,200,0,0,0,0,0,102849,200,0,0,,,
2003,13,b) 1,12011,12217,91893,98414,61,0.4,3824,26.8,22021,1164,20857,1.2,22.4,35063,21387,13676,21.7,35.6,-13042,-13.2,44.8,0,2948,2952,18665
2003,13,c) 2,9924,10176,82354,83171,482,4.4,1936,17.6,18743,1872,16871,2.3,22.5,20376,11447,8929,13.8,24.5,-1633,-2,45,0,1542,1542,9657
2003,13,d) 3,8958,9362,78998,83645,637,6.4,1515,15.3,16565,3527,13038,4.2,19.8,25859,8067,17792,9.6,30.9,-9294,-11.1,39.6,0,1169,1169,6803
2003,13,e) 4,8167,8558,86514,89117,436,4.8,1293,14.3,14428,2358,12070,2.6,16.2,19634,6383,13251,7.2,22,-5206,-5.8,32.4,0,976,976,4956
2003,13,f) 5,7588,8181,85017,83967,438,5.2,974,11.5,15634,3349,12285,4,18.6,13533,5520,8013,6.6,16.1,2101,2.5,32.2,0,743,743,4062
2003,13,g) 6 to 10,26446,27654,319619,323257,1333,4.7,2963,10.3,54674,11404,43270,3.5,16.9,61949,22331,39618,6.9,19.2,-7275,-2.3,33.8,0,2208,2210,15224
2003,13,h) 11 to 15,16423,18731,271147,270435,836,4.4,1511,7.9,41812,8052,33760,3,15.5,40387,12568,27819,4.6,14.9,1425,0.6,29.8,0,981,982,6716
2003,13,i) 16 to 20,13045,15621,282636,282804,633,4,1089,6.9,36889,8088,28801,2.9,13,37225,9415,27810,3.3,13.2,-336,-0.2,26,0,671,672,5780
2003,13,j) 21 to 25,8279,11054,230070,228804,418,3.7,625,5.6,27996,7857,20139,3.4,12.2,25463,6088,19375,2.7,11.1,2533,1.1,22.2,0,387,390,2532
2003,13,k) 26+,1818,3772,94835,94898,263,7,208,5.5,13304,3253,10051,3.4,14,13429,3443,9986,3.6,14.2,-125,-0.2,28,0,63,66,378
2003,13,l) Left Censored,15273,42900,1624251,1638777,3134,7.4,2431,5.7,182767,63082,119685,3.8,11.2,211819,49085,162734,3,12.9,-29052,-1.7,22.4,0,552,553,4341
2003,15,a) 0,1955,2039,14202,7101,2039,200,0,0,14202,14202,0,200,200,0,0,0,0,0,14202,200,0,0,,,
2003,15,b) 1,1557,1591,12324,12583,8,0.4,400,22.2,3270,82,3188,0.7,26,3787,2559,1228,20.3,30.1,-517,-4.1,52,0,332,332,2428
2003,15,c) 2,1251,1279,10653,10807,50,3.7,208,15.2,2268,209,2059,1.9,21,2576,1647,929,15.2,23.8,-308,-2.8,42,0,167,167,1369
2003,15,d) 3,1153,1212,11086,11108,50,3.9,157,12.3,2337,229,2108,2.1,21,2380,1338,1042,12,21.4,-43,-0.4,42,0,127,127,1184
2003,15,e) 4,978,1018,10350,9805,44,4.2,101,9.6,2512,895,1617,9.1,25.6,1421,720,701,7.3,14.5,1091,11.1,29,0,81,81,672
2003,15,f) 5,953,1020,9813,10110,53,5,109,10.3,1317,233,1084,2.3,13,1911,931,980,9.2,18.9,-594,-5.9,26,0,89,89,895
2003,15,g) 6 to 10,3561,3664,45983,45466,151,4,359,9.5,6551,734,5817,1.6,14.4,5517,2762,2755,6.1,12.1,1034,2.3,24.2,0,278,278,1895
2003,15,h) 11 to 15,2874,3234,38300,37862,143,4.4,204,6.2,5105,706,4399,1.9,13.5,4228,1323,2905,3.5,11.2,877,2.3,22.4,0,133,133,893
2003,15,i) 16 to 20,2294,2705,44216,43514,84,3.1,158,5.7,5823,1097,4726,2.5,13.4,4418,1493,2925,3.4,10.2,1405,3.2,20.4,0,98,98,718
2003,15,j) 21 to 25,2034,2529,39939,39402,90,3.5,129,5,4871,1066,3805,2.7,12.4,3797,820,2977,2.1,9.6,1074,2.8,19.2,0,74,74,430
2003,15,k) 26+,414,789,11355,11397,19,2.4,31,3.9,1210,64,1146,0.6,10.6,1293,271,1022,2.4,11.3,-83,-0.7,21.2,0,10,10,31
2003,15,l) Left Censored,3525,7029,210518,208582,324,4.6,308,4.4,21945,4427,17518,2.1,10.5,18072,4452,13620,2.1,8.7,3873,1.8,17.4,0,98,98,553
2003,16,a) 0,3295,3329,16884,8442,3329,200,0,0,16884,16884,0,200,200,0,0,0,0,0,16884,200,0,0,,,
2003,16,b) 1,2344,2385,19621,19778,9,0.3,682,24.7,4405,372,4033,1.9,22.3,4718,3082,1636,15.6,23.9,-313,-1.6,44.6,0,510,510,2473
2003,16,c) 2,2011,2053,15013,14743,141,6.5,370,16.9,3775,725,3050,4.9,25.6,3234,1397,1837,9.5,21.9,541,3.7,43.8,0,280,280,1139
2003,16,d) 3,1805,1862,16606,17160,95,4.8,303,15.3,2383,299,2084,1.7,13.9,3490,1406,2084,8.2,20.3,-1107,-6.4,27.8,0,214,225,1033
2003,16,e) 4,1677,1740,12998,13435,88,4.9,201,11.1,2163,305,1858,2.3,16.1,3037,864,2173,6.4,22.6,-874,-6.5,32.2,0,144,144,616
2003,16,f) 5,1476,1594,16197,15228,95,5.8,187,11.3,4138,502,3636,3.3,27.2,2199,901,1298,5.9,14.4,1939,12.8,28.8,0,133,133,774
2003,16,g) 6 to 10,5541,5710,48609,49829,359,6.1,655,11.1,7632,1698,5934,3.4,15.3,10072,3170,6902,6.4,20.2,-2440,-4.9,30.6,0,457,457,2240
2003,16,h) 11 to 15,3448,3702,39547,39626,231,6.1,343,9.1,5708,1423,4285,3.6,14.4,5865,1839,4026,4.6,14.8,-157,-0.4,28.8,0,212,212,1110
2003,16,i) 16 to 20,2326,2769,39505,38776,140,5,212,7.5,6364,1312,5052,3.4,16.4,4906,1385,3521,3.6,12.7,1458,3.7,25.4,0,141,141,884
2003,16,j) 21 to 25,1746,2201,42124,42722,80,3.6,125,5.6,4296,1230,3066,2.9,10.1,5492,974,4518,2.3,12.9,-1196,-2.8,20.2,0,68,68,525
2003,16,k) 26+,373,643,14381,14871,38,5.9,37,5.7,1367,490,877,3.3,9.2,2347,666,1681,4.5,15.8,-980,-6.6,18.4,0,15,15,61
2003,16,l) Left Censored,3210,6789,187796,185875,426,6.3,337,5,22297,4950,17347,2.7,12,18454,4806,13648,2.6,9.9,3843,2.1,19.8,0,104,104,1049
2003,17,a) 0,19199,19379,121493,60747,19379,200,0,0,121493,121493,0,200,200,0,0,0,0,0,121493,200,0,0,,,
2003,17,b) 1,14615,14841,118348,123079,53,0.3,3930,23.2,28795,325,28470,0.3,23.4,38257,22679,15578,18.4,31.1,-9462,-7.7,46.8,0,2857,2857,18935
2003,17,c) 2,12328,12638,98012,99634,649,4.8,2217,16.4,20095,2792,17303,2.8,20.2,23339,11478,11861,11.5,23.4,-3244,-3.2,40.4,0,1656,1656,8795
2003,17,d) 3,11512,11848,108387,110288,524,4.2,1761,14,19122,2043,17079,1.9,17.3,22923,9632,13291,8.7,20.8,-3801,-3.5,34.6,0,1318,1318,7534
2003,17,e) 4,10563,11072,115839,114686,450,3.9,1449,12.5,22789,2413,20376,2.1,19.9,20482,7960,12522,6.9,17.9,2307,2,35.8,0,1066,1066,5947
2003,17,f) 5,10298,11069,121057,120761,507,4.4,1252,10.9,22253,3447,18806,2.9,18.4,21660,7030,14630,5.8,17.9,593,0.5,35.8,0,907,907,5873
2003,17,g) 6 to 10,39611,41139,426726,433324,1630,3.8,4236,9.9,67562,10757,56805,2.5,15.6,80758,30048,50710,6.9,18.6,-13196,-3,31.2,0,3010,3010,20742
2003,17,h) 11 to 15,29208,31826,428999,429199,1243,3.8,2675,8.2,66013,9620,56393,2.2,15.4,66413,23585,42828,5.5,15.5,-400,-0.1,30.8,0,1695,1696,17019
2003,17,i) 16 to 20,22492,26368,489146,487911,821,3.1,1722,6.4,58127,8103,50024,1.7,11.9,55657,12459,43198,2.6,11.4,2470,0.5,22.8,0,1100,1178,7323
2003,17,j) 21 to 25,16071,19373,378135,379168,605,3.1,1196,6.1,45074,10006,35068,2.6,11.9,47140,9856,37284,2.6,12.4,-2066,-0.5,23.8,0,763,765,5499
2003,17,k) 26+,3506,6625,158515,161048,304,4.6,335,5,17335,4949,12386,3.1,10.8,22400,3880,18520,2.4,13.9,-5065,-3.1,21.6,0,122,122,708
2003,17,l) Left Censored,33957,71757,2636132,2648312,4372,6.1,3928,5.5,278004,86018,191986,3.2,10.5,302364,80589,221775,3,11.4,-24360,-0.9,21,0,1296,1311,12792
2003,18,a) 0,8565,8640,57378,28689,8640,200,0,0,57378,57378,0,200,200,0,0,0,0,0,57378,200,0,0,,,
2003,18,b) 1,6915,7016,55385,58874,25,0.3,1975,24.5,12627,149,12478,0.3,21.4,19604,12408,7196,21.1,33.3,-6977,-11.9,42.8,0,1557,1557,10900
2003,18,c) 2,5626,5877,46823,46659,292,4.7,995,15.8,10580,1790,8790,3.8,22.7,10251,4679,5572,10,22,329,0.7,44,0,766,766,3697
2003,18,d) 3,5194,5368,48673,48587,232,4.1,800,14.1,9370,1128,8242,2.3,19.3,9198,3634,5564,7.5,18.9,172,0.4,37.8,0,584,584,2987
2003,18,e) 4,4796,5044,53288,52457,242,4.6,649,12.3,11479,1676,9803,3.2,21.9,9817,3817,6000,7.3,18.7,1662,3.2,37.4,0,513,513,3410
2003,18,f) 5,4689,5260,58434,58780,227,4.2,575,10.5,11422,2369,9053,4,19.4,12113,5561,6552,9.5,20.6,-691,-1.2,38.8,0,442,442,4841
2003,18,g) 6 to 10,18145,18968,199910,198815,777,4,1896,9.7,32420,6077,26343,3.1,16.3,30229,10774,19455,5.4,15.2,2191,1.1,30.4,0,1407,1407,7772
2003,18,h) 11 to 15,13189,14755,202825,204684,532,3.5,1224,8.1,28436,5336,23100,2.6,13.9,32154,11379,20775,5.6,15.7,-3718,-1.8,27.8,0,836,837,4909
2003,18,i) 16 to 20,10957,13227,215919,216735,455,3.4,823,6.1,28038,4586,23452,2.1,12.9,29670,7511,22159,3.5,13.7,-1632,-0.8,25.8,0,480,539,4209
2003,18,j) 21 to 25,7289,8875,161693,158645,262,2.9,452,5,22861,3694,19167,2.3,14.4,16766,4046,12720,2.6,10.6,6095,3.8,21.2,0,299,299,2615
2003,18,k) 26+,1695,3409,87287,86863,115,3.4,150,4.4,9641,1766,7875,2,11.1,8793,1545,7248,1.8,10.1,848,1,20.2,0,64,72,405
2003,18,l) Left Censored,16705,37729,1351653,1349778,1913,5.1,1596,4.2,145085,40520,104565,3,10.7,141337,35366,105971,2.6,10.5,3748,0.2,21,0,543,546,5944
2003,19,a) 0,4674,4734,27485,13743,4734,200,0,0,27485,27485,0,200,200,0,0,0,0,0,27485,200,0,0,,,
2003,19,b) 1,3594,3681,24221,26666,13,0.3,1103,25.7,4688,38,4650,0.1,17.6,9578,6792,2786,25.5,35.9,-4890,-18.3,35.2,0,770,770,5615
2003,19,c) 2,2953,3028,20637,21540,148,4.6,516,16,3287,397,2890,1.8,15.3,5093,2585,2508,12,23.6,-1806,-8.3,30.6,0,375,375,2160
2003,19,d) 3,2814,2876,24319,24342,154,5.1,455,15,4762,642,4120,2.6,19.6,4808,2401,2407,9.9,19.8,-46,-0.2,39.2,0,333,333,1888
2003,19,e) 4,2540,2678,22560,23063,116,4.1,364,12.9,2861,352,2509,1.5,12.4,3866,1589,2277,6.9,16.8,-1005,-4.4,24.8,0,254,254,1169
2003,19,f) 5,2454,2658,22042,21942,126,4.6,316,11.4,3675,795,2880,3.6,16.7,3475,1332,2143,6.1,15.8,200,0.9,31.6,0,218,218,946
2003,19,g) 6 to 10,10382,10734,87959,89614,479,4.3,1134,10.2,12450,2361,10089,2.6,13.9,15759,5844,9915,6.5,17.6,-3309,-3.7,27.8,0,738,738,4006
2003,19,h) 11 to 15,7357,7941,87086,88210,385,4.7,780,9.5,12557,1965,10592,2.2,14.2,14805,5821,8984,6.6,16.8,-2248,-2.6,28.4,0,488,488,3030
2003,19,i) 16 to 20,5941,7234,122750,124457,219,3,374,5.1,10933,1724,9209,1.4,8.8,14346,3029,11317,2.4,11.5,-3413,-2.7,17.6,0,230,231,1471
2003,19,j) 21 to 25,4736,6086,83816,84842,190,3.1,308,5,9001,2209,6792,2.6,10.6,11052,2094,8958,2.5,13,-2051,-2.4,21.2,0,198,198,1541
2003,19,k) 26+,1142,2208,38379,38808,99,4.5,109,4.9,3444,672,2772,1.7,8.9,4302,1370,2932,3.5,11.1,-858,-2.2,17.8,0,42,42,269
2003,19,l) Left Censored,11280,21349,671617,669391,1039,4.9,1072,5,65780,19588,46192,2.9,9.8,61328,10268,51060,1.5,9.2,4452,0.6,18.4,0,355,356,2853
2003,20,a) 0,4894,4914,28497,14249,4914,200,0,0,28497,28497,0,200,200,0,0,0,0,0,28497,200,0,0,,,
2003,20,b) 1,3729,3787,27939,29479,8,0.2,1134,25.7,5932,115,5817,0.4,20.1,9011,5456,3555,18.5,30.6,-3079,-10.5,40.2,0,871,871,4340
2003,20,c) 2,3131,3191,23276,24335,142,4.1,593,17.2,4138,475,3663,2,17,6255,3079,3176,12.7,25.7,-2117,-8.7,34,0,449,449,2503
2003,20,d) 3,2845,2915,26337,26667,128,4.1,473,15.2,4506,786,3720,2.9,16.9,5166,2238,2928,8.4,19.4,-660,-2.5,33.8,0,365,365,1673
2003,20,e) 4,2614,2722,21444,21603,138,4.8,363,12.7,3909,908,3001,4.2,18.1,4226,1497,2729,6.9,19.6,-317,-1.5,36.2,0,261,261,1132
2003,20,f) 5,2574,2850,26554,27163,136,4.6,309,10.5,3799,584,3215,2.1,14,5017,2032,2985,7.5,18.5,-1218,-4.5,28,0,230,230,1054
2003,20,g) 6 to 10,9457,9861,91785,92128,471,4.6,1016,10,15335,5157,10178,5.6,16.6,16020,4992,11028,5.4,17.4,-685,-0.8,33.2,0,743,744,3925
2003,20,h) 11 to 15,6701,7402,87683,88049,312,4.1,658,8.6,12129,2321,9808,2.6,13.8,12861,5212,7649,5.9,14.6,-732,-0.8,27.6,0,431,431,3301
2003,20,i) 16 to 20,5436,6315,87776,88217,242,3.8,429,6.7,10553,2521,8032,2.9,12,11434,2943,8491,3.3,13,-881,-1,24,0,283,283,1736
2003,20,j) 21 to 25,4173,5029,73761,72833,193,3.8,279,5.5,10588,3625,6963,5,14.5,8731,1973,6758,2.7,12,1857,2.5,24,0,185,186,1059
2003,20,k) 26+,937,1906,34787,34854,87,4.5,106,5.5,3726,704,3022,2,10.7,3859,1420,2439,4.1,11.1,-133,-0.4,21.4,0,39,48,221
2003,20,l) Left Censored,9123,18311,577926,575796,947,5.2,873,4.8,63845,23569,40276,4.1,11.1,59585,14974,44611,2.6,10.3,4260,0.8,20.6,0,322,322,2843
2003,21,a) 0,5418,5448,34369,17185,5448,200,0,0,34369,34369,0,200,200,0,0,0,0,0,34369,200,0,0,,,
2003,21,b) 1,4262,4334,34405,36674,24,0.5,1218,24.4,8236,299,7937,0.8,22.5,12774,7911,4863,21.6,34.8,-4538,-12.3,45,0,974,974,5719
2003,21,c) 2,3681,3738,27742,28871,179,4.5,647,16.2,5717,752,4965,2.6,19.8,7975,3704,4271,12.8,27.6,-2258,-7.8,39.6,0,550,550,3413
2003,21,d) 3,3324,3448,28185,29384,121,3.3,552,15,4852,703,4149,2.4,16.5,7250,3773,3477,12.8,24.7,-2398,-8.2,33,0,450,450,3441
2003,21,e) 4,3176,3371,36324,36387,134,3.8,417,11.8,6259,772,5487,2.1,17.2,6384,2448,3936,6.7,17.5,-125,-0.3,34.4,0,329,329,1552
2003,21,f) 5,3000,3332,31449,32425,138,4,405,11.6,5451,968,4483,3,16.8,7402,2281,5121,7,22.8,-1951,-6,33.6,0,299,299,1813
2003,21,g) 6 to 10,11294,11895,123246,123879,472,3.8,1219,9.9,20044,3233,16811,2.6,16.2,21310,7176,14134,5.8,17.2,-1266,-1,32.4,0,917,919,5816
2003,21,h) 11 to 15,8365,9312,119008,119993,331,3.5,771,8.1,18160,4391,13769,3.7,15.1,20129,5558,14571,4.6,16.8,-1969,-1.7,30.2,0,492,524,3037
2003,21,i) 16 to 20,6950,8174,131228,131719,273,3.3,484,5.8,15243,2011,13232,1.5,11.6,16225,4435,11790,3.4,12.3,-982,-0.7,23.2,0,337,339,2563
2003,21,j) 21 to 25,4370,5443,101091,101408,148,2.7,328,5.9,11190,1812,9378,1.8,11,11824,3512,8312,3.5,11.7,-634,-0.7,22,0,217,217,1525
2003,21,k) 26+,1039,2180,52569,52622,89,4.1,94,4.3,6190,917,5273,1.7,11.8,6296,1115,5181,2.1,12,-106,-0.2,23.6,0,32,32,114
2003,21,l) Left Censored,9960,22457,758945,756513,1258,5.6,941,4.2,77165,25328,51837,3.3,10.2,72300,15273,57027,2,9.6,4865,0.6,19.2,0,329,331,2940
2003,22,a) 0,6392,6433,44994,22497,6433,200,0,0,44994,44994,0,200,200,0,0,0,0,0,44994,200,0,0,,,
2003,22,b) 1,4933,5011,45492,46281,16,0.3,1457,25.1,11844,176,11668,0.4,25.6,13421,8567,4854,18.5,29,-1577,-3.4,51.2,0,1196,1196,7612
2003,22,c) 2,4241,4333,46781,44535,188,4.1,733,15.8,13152,880,12272,2,29.5,8660,3528,5132,7.9,19.4,4492,10.1,38.8,0,606,606,2993
2003,22,d) 3,3767,3932,46809,46910,164,3.9,567,13.6,8158,1555,6603,3.3,17.4,8359,2879,5480,6.1,17.8,-201,-0.4,34.8,0,467,467,2574
2003,22,e) 4,3439,3602,35588,35594,167,4.4,458,12.2,6424,1051,5373,3,18,6435,2700,3735,7.6,18.1,-11,-0.1,36,0,357,357,2028
2003,22,f) 5,3400,3718,37914,39052,157,4.1,417,10.8,6778,1082,5696,2.8,17.4,9054,3754,5300,9.6,23.2,-2276,-5.8,34.8,0,323,323,3042
2003,22,g) 6 to 10,13005,13419,156889,158669,534,3.9,1269,9.2,26145,3621,22524,2.3,16.5,29705,12469,17236,7.9,18.7,-3560,-2.2,33,0,976,978,10341
2003,22,h) 11 to 15,8799,9915,133090,133740,397,3.9,734,7.3,20237,2358,17879,1.8,15.1,21536,5257,16279,3.9,16.1,-1299,-1,30.2,0,507,508,2767
2003,22,i) 16 to 20,7796,9224,144123,143147,295,3.2,529,5.7,18058,2221,15837,1.6,12.6,16105,3509,12596,2.5,11.3,1953,1.3,22.6,0,382,383,2435
2003,22,j) 21 to 25,6292,7833,137488,134670,227,2.9,416,5.2,19959,3569,16390,2.7,14.8,14322,2480,11842,1.8,10.6,5637,4.2,21.2,0,278,279,1341
2003,22,k) 26+,1180,2208,42888,42529,97,4.4,80,3.6,5670,920,4750,2.2,13.3,4952,866,4086,2,11.6,718,1.7,23.2,0,44,45,233
2003,22,l) Left Censored,10858,23861,719298,719854,1330,5.6,1039,4.4,75245,23324,51921,3.2,10.5,76357,17012,59345,2.4,10.6,-1112,-0.1,21,0,358,359,2951
2003,23,a) 0,2505,2521,14109,7055,2521,200,0,0,14109,14109,0,200,200,0,0,0,0,0,14109,200,0,0,,,
2003,23,b) 1,2021,2042,13158,14247,5,0.2,583,24.8,2662,22,2640,0.2,18.7,4839,3064,1775,21.5,34,-2177,-15.3,37.4,0,413,413,2534
2003,23,c) 2,1815,1847,11021,11155,92,4.7,268,13.7,1961,260,1701,2.3,17.6,2228,977,1251,8.8,20,-267,-2.4,35.2,0,192,192,708
2003,23,d) 3,1595,1644,11252,11343,81,4.7,231,13.4,1815,206,1609,1.8,16,1997,999,998,8.8,17.6,-182,-1.6,32,0,174,175,897
2003,23,e) 4,1557,1618,12122,12429,73,4.3,183,10.9,1560,377,1183,3,12.6,2173,774,1399,6.2,17.5,-613,-4.9,25.2,0,137,137,620
2003,23,f) 5,1432,1606,13856,13582,65,3.9,193,11.5,2411,691,1720,5.1,17.8,1862,744,1118,5.5,13.7,549,4.1,27.4,0,137,137,610
2003,23,g) 6 to 10,5182,5308,42021,42285,225,4.1,496,9.1,6322,1200,5122,2.8,15,6849,2554,4295,6,16.2,-527,-1.2,30,0,351,351,2023
2003,23,h) 11 to 15,3761,4032,36977,37236,157,3.8,291,7.1,4455,632,3823,1.7,12,4973,1209,3764,3.2,13.4,-518,-1.4,24,0,189,189,804
2003,23,i) 16 to 20,3088,3600,47106,47544,146,4,229,6.3,4467,705,3762,1.5,9.4,5342,1295,4047,2.7,11.2,-875,-1.8,18.8,0,155,155,974
2003,23,j) 21 to 25,1967,2470,40369,41016,103,4.1,137,5.5,3765,966,2799,2.4,9.2,5059,1372,3687,3.3,12.3,-1294,-3.1,18.4,0,69,69,751
2003,23,k) 26+,440,990,20195,20390,62,6.4,33,3.4,1974,349,1625,1.7,9.7,2364,388,1976,1.9,11.6,-390,-1.9,19.4,0,13,15,198
2003,23,l) Left Censored,3993,7485,221227,222077,351,4.7,366,4.9,23063,6255,16808,2.8,10.4,24762,7141,17621,3.2,11.2,-1699,-0.8,20.8,0,114,114,826
2003,24,a) 0,8762,8803,57642,28821,8803,200,0,0,57642,57642,0,200,200,0,0,0,0,0,57642,200,0,0,,,
2003,24,b) 1,6996,7082,56625,58222,19,0.2,1886,23.3,12580,149,12431,0.3,21.6,15774,9480,6294,16.3,27.1,-3194,-5.5,43.2,0,1421,1421,7963
2003,24,c) 2,5793,5872,44042,44511,269,4.3,958,15.3,9940,1312,8628,2.9,22.3,10877,5078,5799,11.4,24.4,-937,-2.1,44.6,0,734,734,4362
2003,24,d) 3,5174,5366,45527,45313,255,4.5,694,12.4,8674,1536,7138,3.4,19.1,8245,3782,4463,8.3,18.2,429,0.9,36.4,0,517,517,2870
2003,24,e) 4,4806,5048,50567,51476,283,5.4,654,12.4,9054,2249,6805,4.4,17.6,10872,3559,7313,6.9,21.1,-1818,-3.5,35.2,0,493,493,3004
2003,24,f) 5,4555,4961,50140,50457,216,4.2,504,9.8,9124,2688,6436,5.3,18.1,9758,3319,6439,6.6,19.3,-634,-1.2,36.2,0,356,356,2173
2003,24,g) 6 to 10,16970,17505,188788,190104,712,3.9,1711,9.5,27996,3984,24012,2.1,14.7,30627,9633,20994,5.1,16.1,-2631,-1.4,29.4,0,1244,1244,7665
2003,24,h) 11 to 15,12440,13805,192947,193532,604,4.3,1064,7.6,29479,6761,22718,3.5,15.2,30649,8546,22103,4.4,15.8,-1170,-0.6,30.4,0,677,678,4602
2003,24,i) 16 to 20,9671,11175,179996,179271,399,3.5,704,6.2,22774,3815,18959,2.1,12.7,21323,6570,14753,3.7,11.9,1451,0.8,23.8,0,461,461,3651
2003,24,j) 21 to 25,6003,7421,141351,138003,262,3.5,393,5.2,21745,4243,17502,3.1,15.8,15048,3501,11547,2.5,10.9,6697,4.9,21.8,0,233,233,1530
2003,24,k) 26+,1339,2572,67251,67286,109,4.2,130,5,7191,1712,5479,2.5,10.7,7260,1712,5548,2.5,10.8,-69,-0.1,21.4,0,39,39,378
2003,24,l) Left Censored,12517,28339,1003535,1004348,1721,6.1,1365,4.8,111558,31746,79812,3.2,11.1,113184,24496,88688,2.4,11.3,-1626,-0.2,22.2,0,376,376,3274
2003,25,a) 0,11822,11885,62240,31120,11885,200,0,0,62240,62240,0,200,200,0,0,0,0,0,62240,200,0,0,,,
2003,25,b) 1,8415,8501,65558,67393,20,0.2,2153,22.3,15067,612,14455,0.9,22.4,18736,11016,7720,16.3,27.8,-3669,-5.4,44.8,0,1610,1610,9231
2003,25,c) 2,7385,7507,57316,58327,289,3.6,1283,15.9,10621,1156,9465,2,18.2,12643,6136,6507,10.5,21.7,-2022,-3.5,36.4,0,1022,1022,5307
2003,25,d) 3,6741,6976,54709,56073,303,4.1,1055,14.3,9142,1518,7624,2.7,16.3,11870,5078,6792,9.1,21.2,-2728,-4.9,32.6,0,810,810,4270
2003,25,e) 4,6744,6987,59200,60005,285,3.9,948,12.9,10749,2366,8383,3.9,17.9,12358,5206,7152,8.7,20.6,-1609,-2.7,35.8,0,711,711,4255
2003,25,f) 5,5663,6112,63982,64900,285,4.5,696,11,10947,2068,8879,3.2,16.9,12783,5045,7738,7.8,19.7,-1836,-2.8,33.8,0,524,524,4199
2003,25,g) 6 to 10,21457,21986,225900,230917,827,3.6,2159,9.5,32583,4605,27978,2,14.1,42616,13886,28730,6,18.5,-10033,-4.4,28.2,0,1603,1603,11510
2003,25,h) 11 to 15,15225,16744,233980,238418,584,3.4,1263,7.4,28211,4938,23273,2.1,11.8,37086,12373,24713,5.2,15.6,-8875,-3.8,23.6,0,820,820,7518
2003,25,i) 16 to 20,13709,16090,270323,273016,595,3.6,981,6,34139,8023,26116,2.9,12.5,39525,10448,29077,3.8,14.5,-5386,-2,25,0,612,625,4636
2003,25,j) 21 to 25,8904,10923,242903,242514,336,3,571,5.2,25987,5816,20171,2.4,10.7,25209,6305,18904,2.6,10.4,778,0.3,20.8,0,365,366,2623
2003,25,k) 26+,1900,3526,115057,114799,164,4.6,182,5.1,14454,4383,10071,3.8,12.6,13937,1678,12259,1.5,12.1,517,0.5,24.2,0,65,65,487
2003,25,l) Left Censored,20810,40296,1511884,1520875,2223,5.5,2493,6.2,170073,46004,124069,3,11.2,188055,58900,129155,3.9,12.4,-17982,-1.2,22.4,0,719,722,6456
2003,26,a) 0,13966,14079,103342,51671,14079,200,0,0,103342,103342,0,200,200,0,0,0,0,0,103342,200,0,0,,,
2003,26,b) 1,11137,11319,104158,107584,39,0.3,3289,25.1,25261,443,24818,0.4,23.5,32112,18362,13750,17.1,29.8,-6851,-6.3,47,0,2494,2494,15744
2003,26,c) 2,9174,9427,78888,86171,524,5.2,1739,17.2,16095,1785,14310,2.1,18.7,30660,16277,14383,18.9,35.6,-14565,-16.9,37.4,0,1328,1329,14784
2003,26,d) 3,8479,8728,77755,80624,420,4.5,1394,15.1,14368,1984,12384,2.5,17.8,20105,9503,10602,11.8,24.9,-5737,-7.1,35.6,0,1043,1043,8097
2003,26,e) 4,7835,8218,80813,83692,447,5.2,1151,13.3,15067,3311,11756,4,18,20824,8217,12607,9.8,24.9,-5757,-6.9,36,0,859,859,5906
2003,26,f) 5,7582,8350,87968,88613,397,4.6,1048,12,16312,2838,13474,3.2,18.4,17601,7958,9643,9,19.9,-1289,-1.5,36.8,0,776,776,6505
2003,26,g) 6 to 10,30089,31235,316934,320939,1296,4,3365,10.4,52252,8132,44120,2.5,16.3,60262,23500,36762,7.3,18.8,-8010,-2.5,32.6,0,2383,2383,19059
2003,26,h) 11 to 15,21598,24040,311770,311362,912,3.7,2042,8.3,48868,8994,39874,2.9,15.7,48054,14922,33132,4.8,15.4,814,0.3,30.8,0,1306,1306,9292
2003,26,i) 16 to 20,17465,20670,332611,335249,658,3.1,1449,6.9,40104,8668,31436,2.6,12,45379,13150,32229,3.9,13.5,-5275,-1.5,24,0,822,930,6853
2003,26,j) 21 to 25,11929,14661,248666,251772,445,3,836,5.6,30132,6429,23703,2.6,12,36344,9481,26863,3.8,14.4,-6212,-2.4,24,0,504,504,4466
2003,26,k) 26+,2503,4503,93839,96839,223,4.9,243,5.4,13087,2538,10549,2.6,13.5,19087,3081,16006,3.2,19.7,-6000,-6.2,27,0,95,95,680
2003,26,l) Left Censored,24270,53972,2015249,2023716,2911,5.4,2761,5.1,222764,72927,149837,3.6,11,239698,44985,194713,2.2,11.8,-16934,-0.8,22,0,829,839,8762
2003,27,a) 0,9624,9656,57206,28603,9656,200,0,0,57206,57206,0,200,200,0,0,0,0,0,57206,200,0,0,,,
2003,27,b) 1,7339,7454,63483,64014,27,0.3,2022,23.6,15971,476,15495,0.7,24.9,17033,10716,6317,16.7,26.6,-1062,-1.7,49.8,0,1322,1322,8932
2003,27,c) 2,6164,6275,48888,47955,304,4.6,1009,15.1,10975,2933,8042,6.1,22.9,9109,3877,5232,8.1,19,1866,3.9,38,0,708,708,2972
2003,27,d) 3,5638,5798,50924,51165,301,4.9,816,13.4,9243,1544,7699,3,18.1,9725,3609,6116,7.1,19,-482,-0.9,36.2,0,569,569,2918
2003,27,e) 4,5068,5336,52871,52849,286,5.1,693,12.4,8255,1652,6603,3.1,15.6,8210,3015,5195,5.7,15.5,45,0.1,31,0,470,470,2417
2003,27,f) 5,4977,5616,55484,55353,318,5.5,575,10,8804,1718,7086,3.1,15.9,8542,2975,5567,5.4,15.4,262,0.5,30.8,0,405,405,2355
2003,27,g) 6 to 10,18972,19753,198378,199148,885,4.3,2020,9.9,31471,5260,26211,2.6,15.8,33011,12277,20734,6.2,16.6,-1540,-0.8,31.6,0,1395,1395,9733
2003,27,h) 11 to 15,13054,14296,175417,176882,516,3.5,1164,7.9,22845,3194,19651,1.8,12.9,25774,8122,17652,4.6,14.6,-2929,-1.7,25.8,0,739,739,5092
2003,27,i) 16 to 20,9691,11816,218399,217702,421,3.5,761,6.3,30329,6812,23517,3.1,13.9,28935,9175,19760,4.2,13.3,1394,0.6,26.6,0,472,473,3874
2003,27,j) 21 to 25,6784,8596,166138,169042,371,4.3,459,5.3,18636,5979,12657,3.5,11,24443,4483,19960,2.7,14.5,-5807,-3.5,22,0,294,295,2411
2003,27,k) 26+,1620,2946,75673,75184,123,4.2,132,4.5,9017,1616,7401,2.1,12,8038,1144,6894,1.5,10.7,979,1.3,21.4,0,56,56,279
2003,27,l) Left Censored,14784,30814,1222705,1226091,1753,5.7,1613,5.2,143125,50050,93075,4.1,11.7,149896,38497,111399,3.1,12.2,-6771,-0.5,23.4,0,464,465,6702
2003,28,a) 0,4065,4097,25007,12504,4097,200,0,0,25007,25007,0,200,200,0,0,0,0,0,25007,200,0,0,,,
2003,28,b) 1,2978,3011,24903,26457,9,0.3,976,27.6,6291,137,6154,0.5,23.8,9399,6078,3321,23,35.5,-3108,-11.7,47.6,0,813,813,4985
2003,28,c) 2,2480,2532,20645,20879,120,4.4,468,17.2,4411,546,3865,2.6,21.1,4878,2342,2536,11.2,23.4,-467,-2.3,42.2,0,381,381,2043
2003,28,d) 3,2205,2313,18738,19049,112,4.6,345,14.1,3749,523,3226,2.7,19.7,4371,2351,2020,12.3,22.9,-622,-3.2,39.4,0,272,272,1816
2003,28,e) 4,2142,2277,19332,21050,114,4.8,301,12.6,3097,714,2383,3.4,14.7,6533,2835,3698,13.5,31,-3436,-16.3,29.4,0,246,246,2463
2003,28,f) 5,1996,2179,19323,19654,94,4.1,249,11,3139,630,2509,3.2,16,3801,1348,2453,6.9,19.3,-662,-3.3,32,0,193,193,1035
2003,28,g) 6 to 10,7553,7873,82569,84075,358,4.4,870,10.6,13350,2169,11181,2.6,15.9,16362,5499,10863,6.5,19.5,-3012,-3.6,31.8,0,682,682,4364
2003,28,h) 11 to 15,4939,5455,68517,67360,231,4.1,503,9,12735,6024,6711,8.9,18.9,10420,3318,7102,4.9,15.5,2315,3.4,31,0,355,355,2642
2003,28,i) 16 to 20,4472,5191,76392,75665,188,3.6,304,5.8,9379,1771,7608,2.3,12.4,7925,2298,5627,3,10.5,1454,1.9,21,0,210,213,1688
2003,28,j) 21 to 25,3183,3969,68443,68816,120,3,236,5.8,8574,1550,7024,2.3,12.5,9319,1911,7408,2.8,13.5,-745,-1,25,0,163,163,1102
2003,28,k) 26+,743,1219,35879,35394,54,4.4,52,4.3,4190,889,3301,2.5,11.8,3219,339,2880,1,9.1,971,2.7,18.2,0,33,33,171
2003,28,l) Left Censored,6584,14847,446144,446056,866,5.9,655,4.4,46770,11998,34772,2.7,10.5,46594,8236,38358,1.8,10.4,176,0.1,20.8,0,261,261,1620
2003,29,a) 0,10740,10795,60102,30051,10795,200,0,0,60102,60102,0,200,200,0,0,0,0,0,60102,200,0,0,,,
2003,29,b) 1,7810,7899,62192,64366,28,0.3,2439,26.5,14196,758,13438,1.2,22.1,18543,10393,8150,16.1,28.8,-4347,-6.7,44.2,0,1980,1982,8561
2003,29,c) 2,5895,6061,46097,45844,298,4.5,1169,17.8,10836,1187,9649,2.6,23.6,10329,4936,5393,10.8,22.5,507,1.1,45,0,930,930,4127
2003,29,d) 3,5703,5891,48896,49871,268,4.3,931,14.9,9074,1235,7839,2.5,18.2,11023,5146,5877,10.3,22.1,-1949,-3.9,36.4,0,729,729,4503
2003,29,e) 4,5076,5292,48155,48765,222,4,740,13.3,8773,1071,7702,2.2,18,9992,3797,6195,7.8,20.5,-1219,-2.5,36,0,585,585,3159
2003,29,f) 5,4744,5231,58172,56743,235,4.3,621,11.4,11992,1515,10477,2.7,21.1,9133,3545,5588,6.2,16.1,2859,5,32.2,0,485,485,3096
2003,29,g) 6 to 10,18384,19138,191466,192700,855,4.3,2095,10.6,30771,4923,25848,2.6,16,33238,11443,21795,5.9,17.2,-2467,-1.2,32,0,1573,1573,9227
2003,29,h) 11 to 15,12912,14277,177876,177607,628,4.3,1169,8,28526,6184,22342,3.5,16.1,27987,8320,19667,4.7,15.8,539,0.3,31.6,0,778,778,4974
2003,29,i) 16 to 20,11015,13049,231203,230461,469,3.5,842,6.3,25925,3366,22559,1.5,11.2,24440,6934,17506,3,10.6,1485,0.6,21.2,0,532,532,3652
2003,29,j) 21 to 25,7259,9110,162449,163307,303,3.3,485,5.3,19184,5034,14150,3.1,11.7,20900,5615,15285,3.4,12.8,-1716,-1.1,23.4,0,320,320,2179
2003,29,k) 26+,1614,3302,81585,82133,139,4.2,163,4.9,8624,1820,6804,2.2,10.5,9720,2423,7297,3,11.8,-1096,-1.3,21,0,67,70,461
2003,29,l) Left Censored,15700,34343,1212396,1207804,1919,5.6,1729,5,127850,29806,98044,2.5,10.6,118667,28318,90349,2.3,9.8,9183,0.8,19.6,0,573,576,6522
2003,30,a) 0,2460,2468,10924,5462,2468,200,0,0,10924,10924,0,200,200,0,0,0,0,0,10924,200,0,0,,,
2003,30,b) 1,1906,1936,10925,11171,13,0.6,528,23.7,2424,110,2314,1,21.7,2915,1686,1229,15.1,26.1,-491,-4.4,43.4,0,369,369,1349
2003,30,c) 2,1634,1644,8871,9003,94,5.3,294,16.7,1733,320,1413,3.6,19.2,1997,994,1003,11,22.2,-264,-3,38.4,0,199,199,780
2003,30,d) 3,1492,1520,10337,9864,98,6.2,207,13.1,2536,957,1579,9.7,25.7,1589,711,878,7.2,16.1,947,9.6,32.2,0,150,150,569
2003,30,e) 4,1339,1372,9585,9547,80,5.7,146,10.3,1645,193,1452,2,17.2,1568,621,947,6.5,16.4,77,0.8,32.8,0,112,112,505
2003,30,f) 5,1335,1461,12091,12118,81,5.4,163,10.8,1598,300,1298,2.5,13.2,1652,534,1118,4.4,13.6,-54,-0.4,26.4,0,113,113,430
2003,30,g) 6 to 10,4723,4832,35081,35614,241,4.9,450,9.1,5303,869,4434,2.4,14.9,6369,2512,3857,7.1,17.9,-1066,-3,29.8,0,297,297,2039
2003,30,h) 11 to 15,2911,3088,26543,27443,148,4.7,257,8.1,3443,790,2653,2.9,12.5,5243,1197,4046,4.4,19.1,-1800,-6.6,25,0,159,159,674
2003,30,i) 16 to 20,2286,2610,31630,31710,114,4.3,191,7.2,3896,906,2990,2.9,12.3,4056,974,3082,3.1,12.8,-160,-0.5,24.6,0,128,128,559
2003,30,j) 21 to 25,1767,2232,27692,27917,81,3.6,148,6.5,2991,618,2373,2.2,10.7,3441,860,2581,3.1,12.3,-450,-1.6,21.4,0,85,86,438
2003,30,k) 26+,376,604,9479,9256,22,3.6,36,5.9,1431,206,1225,2.2,15.5,985,223,762,2.4,10.6,446,4.9,21.2,0,19,19,81
2003,30,l) Left Censored,2934,5476,113573,113634,296,5.4,295,5.4,12099,4036,8063,3.6,10.6,12220,3061,9159,2.7,10.8,-121,-0.2,21.2,0,96,96,451
2003,31,a) 0,3117,3128,16938,8469,3128,200,0,0,16938,16938,0,200,200,0,0,0,0,0,16938,200,0,0,,,
2003,31,b) 1,2541,2602,16564,17026,17,0.6,686,23,4281,104,4177,0.6,25.1,5205,3045,2160,17.9,30.6,-924,-5.5,50.2,0,506,506,2570
2003,31,c) 2,2236,2283,17380,17534,107,4.4,384,15.7,3214,371,2843,2.1,18.3,3521,1536,1985,8.8,20.1,-307,-1.8,36.6,0,289,289,1276
2003,31,d) 3,1975,2018,13877,13762,103,4.9,279,13.2,2786,305,2481,2.2,20.2,2555,1056,1499,7.7,18.6,231,1.6,37.2,0,193,193,742
2003,31,e) 4,1779,1850,21782,21998,94,4.9,226,11.7,2365,493,1872,2.2,10.8,2796,759,2037,3.5,12.7,-431,-1.9,21.6,0,153,153,566
2003,31,f) 5,1727,1923,22263,22840,94,4.7,209,10.5,4031,1242,2789,5.4,17.6,5185,1015,4170,4.4,22.7,-1154,-5.1,35.2,0,155,155,846
2003,31,g) 6 to 10,6642,6887,55227,56305,294,4.1,706,9.9,7619,1162,6457,2.1,13.5,9775,3114,6661,5.5,17.4,-2156,-3.9,27,0,461,461,2149
2003,31,h) 11 to 15,4880,5350,60528,61204,260,4.7,490,8.9,7310,2425,4885,4,11.9,8661,2315,6346,3.8,14.2,-1351,-2.3,23.8,0,277,277,1376
2003,31,i) 16 to 20,3822,4405,73422,71685,136,3,252,5.6,11001,1142,9859,1.6,15.3,7526,2773,4753,3.9,10.5,3475,4.8,21,0,160,160,1009
2003,31,j) 21 to 25,2888,3519,57610,57836,110,3.1,220,6.1,7762,3227,4535,5.6,13.4,8214,1521,6693,2.6,14.2,-452,-0.8,26.8,0,142,142,787
2003,31,k) 26+,675,1236,24853,24983,49,4,56,4.5,2773,906,1867,3.6,11.1,3033,1005,2028,4,12.1,-260,-1,22.2,0,32,33,570
2003,31,l) Left Censored,6676,12337,382964,377620,653,5.3,573,4.7,48466,11138,37328,2.9,12.8,37777,8723,29054,2.3,10,10689,2.8,20,0,210,210,1411
2003,32,a) 0,5304,5366,38833,19417,5366,200,0,0,38833,38833,0,200,200,0,0,0,0,0,38833,200,0,0,,,
2003,32,b) 1,3670,3711,36397,36246,18,0.4,1205,27.7,10199,124,10075,0.3,28.1,9897,5741,4156,15.8,27.3,302,0.8,54.6,0,998,998,4582
2003,32,c) 2,2860,2921,30334,30307,157,4.9,614,19.3,7319,684,6635,2.3,24.1,7265,3260,4005,10.8,24,54,0.1,48,0,507,507,2828
2003,32,d) 3,2495,2555,31454,29999,137,5,434,16,8233,1420,6813,4.7,27.4,5323,2337,2986,7.8,17.7,2910,9.7,35.4,0,350,350,1771
2003,32,e) 4,2218,2316,28706,29069,139,5.7,334,13.8,5331,772,4559,2.7,18.3,6056,2558,3498,8.8,20.8,-725,-2.5,36.6,0,269,269,2263
2003,32,f) 5,1989,2194,31802,31533,108,4.7,283,12.3,5814,1051,4763,3.3,18.4,5276,2333,2943,7.4,16.7,538,1.7,33.4,0,227,227,1575
2003,32,g) 6 to 10,6086,6442,117106,118840,349,5.2,764,11.4,18652,3900,14752,3.3,15.7,22119,4871,17248,4.1,18.6,-3467,-2.9,31.4,0,598,598,3926
2003,32,h) 11 to 15,3580,4119,68471,67748,197,4.7,332,7.9,10552,2358,8194,3.5,15.6,9105,2661,6444,3.9,13.4,1447,2.2,26.8,0,229,229,1568
2003,32,i) 16 to 20,2553,3406,68690,67479,228,6.7,226,6.6,10736,2960,7776,4.4,15.9,8314,2031,6283,3,12.3,2422,3.6,24.6,0,129,129,1008
2003,32,j) 21 to 25,1966,2523,65296,63813,128,5,151,5.9,8644,2122,6522,3.3,13.5,5677,1489,4188,2.3,8.9,2967,4.6,17.8,0,100,101,855
2003,32,k) 26+,416,971,55436,56516,49,5.1,39,4,5265,711,4554,1.3,9.3,7424,326,7098,0.6,13.1,-2159,-3.8,18.6,0,9,13,63
2003,32,l) Left Censored,3362,8707,387932,389331,804,9.3,593,6.9,45090,16583,28507,4.3,11.6,47888,15747,32141,4,12.3,-2798,-0.7,23.2,0,87,89,2755
2003,33,a) 0,2410,2429,12276,6138,2429,200,0,0,12276,,,,200,0,0,0,0,0,12276,200,0,1,,,
2003,33,b) 1,1841,1853,13314,13653,1,0,499,23.6,2640,,,,19.3,3317,2110,1207,15.5,24.3,-677,-5,38.6,1,374,374,1784
2003,33,c) 2,1582,1624,13461,13925,75,4.3,309,17.6,2284,313,1971,2.2,16.4,3212,1784,1428,12.8,23.1,-928,-6.7,32.8,0,244,244,1481
2003,33,d) 3,1471,1507,11151,11393,56,3.5,249,15.4,1857,420,1437,3.7,16.3,2341,1110,1231,9.7,20.5,-484,-4.2,32.6,0,197,197,902
2003,33,e) 4,1325,1372,12122,12336,63,4.4,185,12.8,1954,255,1699,2.1,15.8,2382,811,1571,6.6,19.3,-428,-3.5,31.6,0,132,132,511
2003,33,f) 5,1368,1462,12970,12932,68,4.5,162,10.7,2022,515,1507,4,15.6,1946,621,1325,4.8,15,76,0.6,30,0,125,125,474
2003,33,g) 6 to 10,5218,5307,47509,47834,203,3.7,520,9.5,7277,1545,5732,3.2,15.2,7927,3255,4672,6.8,16.6,-650,-1.4,30.4,0,380,380,2752
2003,33,h) 11 to 15,3585,3826,46687,46508,122,3.1,322,8.2,6459,1321,5138,2.8,13.9,6101,1813,4288,3.9,13.1,358,0.8,26.2,0,223,223,1207
2003,33,i) 16 to 20,3232,3645,57482,57375,141,3.8,279,7.5,7116,1916,5200,3.3,12.4,6901,2447,4454,4.3,12,215,0.4,24,0,196,196,928
2003,33,j) 21 to 25,1732,2052,32239,32202,89,4.3,132,6.4,3949,1670,2279,5.2,12.3,3875,1061,2814,3.3,12,74,0.3,24,0,86,87,481
2003,33,k) 26+,416,841,20542,20838,45,5.3,46,5.5,1836,448,1388,2.1,8.8,2427,500,1927,2.4,11.6,-591,-2.8,17.6,0,21,21,62
2003,33,l) Left Censored,3969,7758,253265,256520,385,5,394,5.1,26114,8426,17688,3.3,10.2,32624,7384,25240,2.9,12.7,-6510,-2.5,20.4,0,115,115,1342
2003,34,a) 0,16283,16344,90338,45169,16344,200,0,0,90338,90338,0,200,200,0,0,0,0,0,90338,200,0,0,,,
2003,34,b) 1,12358,12444,92546,92333,27,0.2,3564,24.8,25706,1293,24413,1.4,27.8,25280,15016,10264,16.3,27.4,426,0.4,54.8,0,2712,2712,12361
2003,34,c) 2,10764,10932,94952,95380,483,4.1,1972,16.8,18478,2062,16416,2.2,19.4,19334,7333,12001,7.7,20.3,-856,-0.9,38.8,0,1519,1519,5808
2003,34,d) 3,9597,9719,77501,80795,412,4,1567,15.1,14070,1907,12163,2.4,17.4,20657,11234,9423,13.9,25.6,-6587,-8.2,34.8,0,1203,1203,9356
2003,34,e) 4,9124,9414,82647,84236,406,4.1,1322,13.3,14087,1562,12525,1.9,16.7,17264,7587,9677,9,20.5,-3177,-3.8,33.4,0,1014,1014,5736
2003,34,f) 5,8818,9282,93692,94254,430,4.4,1100,11.4,20143,7451,12692,7.9,21.4,21266,11904,9362,12.6,22.6,-1123,-1.2,42.8,0,834,834,11048
2003,34,g) 6 to 10,31308,32177,334711,339526,1247,3.7,3479,10.4,53447,8436,45011,2.5,15.7,63077,21132,41945,6.2,18.6,-9630,-2.9,31.4,0,2586,2586,16309
2003,34,h) 11 to 15,21353,22741,264185,267940,792,3.4,1976,8.4,36521,5950,30571,2.2,13.6,44030,15417,28613,5.8,16.4,-7509,-2.8,27.2,0,1416,1417,11118
2003,34,i) 16 to 20,17482,19733,318546,320017,627,3.1,1349,6.7,37703,8090,29613,2.5,11.8,40644,11410,29234,3.6,12.7,-2941,-0.9,23.6,0,918,925,6908
2003,34,j) 21 to 25,11767,13545,246041,249760,391,2.8,925,6.7,27094,6521,20573,2.6,10.8,34533,6936,27597,2.8,13.8,-7439,-3,21.6,0,602,604,3252
2003,34,k) 26+,2576,3948,118905,120775,197,5,229,5.8,12199,2578,9621,2.1,10.1,15938,3459,12479,2.9,13.2,-3739,-3.1,20.2,0,114,114,1011
2003,34,l) Left Censored,24409,48172,1744640,1752064,3275,6.8,3554,7.3,228199,72051,156148,4.1,13,243048,63893,179155,3.6,13.9,-14849,-0.9,26,0,1037,1041,9132
2003,35,a) 0,2911,2923,18748,9374,2923,200,0,0,18748,18748,0,200,200,0,0,0,0,0,18748,200,0,0,,,
2003,35,b) 1,2285,2305,20722,21157,9,0.3,680,25.4,4108,41,4067,0.2,19.4,4977,3096,1881,14.6,23.5,-869,-4.1,38.8,0,533,533,2606
2003,35,c) 2,1982,2080,17264,17866,123,5.6,358,16.2,3964,559,3405,3.1,22.2,5167,3256,1911,18.2,28.9,-1203,-6.7,44.4,0,268,268,2688
2003,35,d) 3,1700,1746,16039,16454,91,4.9,277,15,3007,345,2662,2.1,18.3,3837,1393,2444,8.5,23.3,-830,-5,36.6,0,224,224,1168
2003,35,e) 4,1536,1583,15083,14799,101,6.1,224,13.5,2840,458,2382,3.1,19.2,2272,1072,1200,7.2,15.4,568,3.8,30.8,0,182,182,922
2003,35,f) 5,1498,1600,16411,16629,82,5,161,9.7,2096,335,1761,2,12.6,2532,779,1753,4.7,15.2,-436,-2.6,25.2,0,115,115,601
2003,35,g) 6 to 10,5821,6066,60051,60142,316,5.1,607,9.7,10641,2133,8508,3.5,17.7,10823,3387,7436,5.6,18,-182,-0.3,35.4,0,448,449,2589
2003,35,h) 11 to 15,3896,4365,53019,52756,213,4.8,372,8.3,7351,1259,6092,2.4,13.9,6826,2180,4646,4.1,12.9,525,1,25.8,0,226,226,1059
2003,35,i) 16 to 20,3238,3885,69328,68825,200,5.1,256,6.5,8994,1495,7499,2.2,13.1,7988,2574,5414,3.7,11.6,1006,1.5,23.2,0,159,159,1235
2003,35,j) 21 to 25,2382,2955,41961,41783,118,3.9,185,6.2,5392,1286,4106,3.1,12.9,5036,1479,3557,3.5,12.1,356,0.8,24.2,0,123,127,666
2003,35,k) 26+,525,1067,25434,24158,47,4.3,75,6.9,4699,2419,2280,10,19.5,2146,840,1306,3.5,8.9,2553,10.6,17.8,0,24,25,88
2003,35,l) Left Censored,3948,8489,221554,220280,558,6.6,473,5.6,29082,10511,18571,4.8,13.2,26534,7763,18771,3.5,12,2548,1.2,24,0,100,100,739
2003,36,a) 0,36888,37031,196829,98415,37031,200,0,0,196829,196829,0,200,200,0,0,0,0,0,196829,200,0,0,,,
2003,36,b) 1,27791,28075,195321,200956,53,0.2,7667,23.8,46385,494,45891,0.2,23.1,57655,36284,21371,18.1,28.7,-11270,-5.6,46.2,0,5867,5870,31046
2003,36,c) 2,23796,24023,179528,177763,1087,4.2,4608,17.7,44679,5188,39491,2.9,25.1,41149,21095,20054,11.9,23.1,3530,2,46.2,0,3716,3716,17577
2003,36,d) 3,20857,21201,165073,173777,914,4,3502,15.5,30852,3711,27141,2.1,17.8,48260,17758,30502,10.2,27.8,-17408,-10,35.6,0,2754,2754,14795
2003,36,e) 4,18857,19460,170407,175368,807,3.9,2830,13.8,26190,3194,22996,1.8,14.9,36111,14890,21221,8.5,20.6,-9921,-5.7,29.8,0,2191,2191,12623
2003,36,f) 5,18048,19299,179906,184030,841,4.2,2319,11.5,32275,5110,27165,2.8,17.5,40523,12435,28088,6.8,22,-8248,-4.5,35,0,1791,1791,10745
2003,36,g) 6 to 10,64054,65726,643772,660514,2449,3.6,7013,10.3,100281,18022,82259,2.7,15.2,133765,42948,90817,6.5,20.3,-33484,-5.1,30.4,0,5305,5305,32774
2003,36,h) 11 to 15,45593,48164,549692,548189,1662,3.4,3853,7.8,79566,13461,66105,2.5,14.5,76559,24241,52318,4.4,14,3007,0.5,28,0,2699,2701,17198
2003,36,i) 16 to 20,37297,41610,653126,649079,1310,3.1,2702,6.4,80056,16787,63269,2.6,12.3,71962,20664,51298,3.2,11.1,8094,1.2,22.2,0,1872,1877,14182
2003,36,j) 21 to 25,23953,28512,521284,519507,810,2.8,1690,5.8,62803,12670,50133,2.4,12.1,59248,13398,45850,2.6,11.4,3555,0.7,22.8,0,1168,1179,8526
2003,36,k) 26+,4940,8801,225710,225382,482,5.5,432,4.9,29686,7178,22508,3.2,13.2,29030,5015,24015,2.2,12.9,656,0.3,25.8,0,200,207,1422
2003,36,l) Left Censored,52997,101131,3688155,3679209,5585,5.5,6432,6.3,424850,111820,313030,3,11.5,406959,106105,300854,2.9,11.1,17891,0.4,22.2,0,2166,2175,20304
2003,37,a) 0,14019,14087,85763,42882,14087,200,0,0,85763,85763,0,200,200,0,0,0,0,0,85763,200,0,0,,,
2003,37,b) 1,10520,10739,79969,83635,71,0.6,3231,25.9,21606,618,20988,0.7,25.8,28937,18750,10187,22.4,34.6,-7331,-8.8,51.6,0,2552,2559,16492
2003,37,c) 2,9579,9826,78172,77808,554,5.3,1737,16.5,17059,2691,14368,3.5,21.9,16331,8186,8145,10.5,21,728,0.9,42,0,1357,1357,6567
2003,37,d) 3,8435,8759,75970,76925,405,4.4,1321,14.2,14088,1626,12462,2.1,18.3,15997,7295,8702,9.5,20.8,-1909,-2.5,36.6,0,1042,1042,6168
2003,37,e) 4,7883,8335,81457,81476,402,4.6,1130,12.9,16502,2271,14231,2.8,20.3,16540,6249,10291,7.7,20.3,-38,0,40.6,0,872,872,5222
2003,37,f) 5,7225,7934,92541,89384,370,4.5,911,11,22098,11651,10447,13,24.7,15783,6808,8975,7.6,17.7,6315,7,35.4,0,710,710,3811
2003,37,g) 6 to 10,25812,27101,269345,281388,1172,4.2,2936,10.4,43266,8101,35165,2.9,15.4,67352,18876,48476,6.7,23.9,-24086,-8.5,30.8,0,2158,2158,14534
2003,37,h) 11 to 15,17437,19433,264412,264925,751,3.8,1508,7.6,39339,6747,32592,2.5,14.8,40364,11735,28629,4.4,15.2,-1025,-0.4,29.6,0,1071,1076,6686
2003,37,i) 16 to 20,15734,18817,293366,293293,767,4,1066,5.6,36881,10310,26571,3.5,12.6,36734,7688,29046,2.6,12.5,147,0.1,25,0,678,688,3880
2003,37,j) 21 to 25,9175,11950,230701,228031,444,3.7,649,5.4,28678,6029,22649,2.6,12.6,23337,4972,18365,2.2,10.2,5341,2.4,20.4,0,409,409,2284
2003,37,k) 26+,1977,3987,96217,95745,212,5.3,161,4.1,9864,2069,7795,2.2,10.3,8920,1658,7262,1.7,9.3,944,1,18.6,0,78,78,529
2003,37,l) Left Censored,18317,46516,1691279,1701525,3016,6.5,2414,5.2,198230,73638,124592,4.3,11.7,218721,60459,158262,3.6,12.9,-20491,-1.2,23.4,0,606,606,5385
2003,38,a) 0,1249,1258,5765,2883,1258,200,0,0,5765,5765,0,200,200,0,0,0,0,0,5765,200,0,0,,,
2003,38,b) 1,965,983,5737,6093,0,0,291,25.3,1209,0,1209,0,19.8,1920,1105,815,18.1,31.5,-711,-11.7,39.6,0,160,160,692
2003,38,c) 2,820,842,5830,5854,41,4.5,156,17.1,1200,97,1103,1.7,20.5,1247,716,531,12.2,21.3,-47,-0.8,41,0,110,110,640
2003,38,d) 3,728,739,4888,5036,39,5,118,15.1,794,67,727,1.3,15.8,1089,423,666,8.4,21.6,-295,-5.8,31.6,0,77,77,350
2003,38,e) 4,641,661,4584,4710,32,4.6,76,11,665,63,602,1.3,14.1,917,523,394,11.1,19.5,-252,-5.4,28.2,0,48,48,473
2003,38,f) 5,672,734,7151,7199,38,5,76,10,992,117,875,1.6,13.8,1087,385,702,5.3,15.1,-95,-1.3,27.6,0,46,46,197
2003,38,g) 6 to 10,2834,2878,22521,22634,143,4.8,307,10.3,3262,540,2722,2.4,14.4,3487,1444,2043,6.4,15.4,-225,-1,28.8,0,180,180,952
2003,38,h) 11 to 15,2101,2253,20327,20264,120,5.2,209,9.1,2904,699,2205,3.4,14.3,2777,721,2056,3.6,13.7,127,0.6,27.4,0,114,114,397
2003,38,i) 16 to 20,1712,1959,20669,21027,62,3.1,107,5.4,2263,363,1900,1.7,10.8,2979,1206,1773,5.7,14.2,-716,-3.4,21.6,0,75,75,616
2003,38,j) 21 to 25,1356,1585,21150,20739,47,2.9,90,5.6,3037,1206,1831,5.8,14.6,2214,493,1721,2.4,10.7,823,3.9,21.4,0,63,63,375
2003,38,k) 26+,300,462,8697,8502,18,3.8,31,6.6,1326,226,1100,2.7,15.6,936,476,460,5.6,11,390,4.6,22,0,13,13,65
2003,38,l) Left Censored,3034,5242,133840,132107,199,3.8,193,3.7,13041,2835,10206,2.1,9.9,9575,1664,7911,1.3,7.2,3466,2.7,14.4,0,77,77,338
2003,39,a) 0,14285,14368,103422,51711,14368,200,0,0,103422,103422,0,200,200,0,0,0,0,0,103422,200,0,0,,,
2003,39,b) 1,11502,11789,108056,110812,64,0.5,3187,23.6,27702,3013,24689,2.7,25,33213,21949,11264,19.8,30,-5511,-5,50,0,2463,2465,19324
2003,39,c) 2,9722,9991,79688,81958,519,4.8,1807,16.9,16201,2388,13813,2.9,19.8,20740,10463,10277,12.8,25.3,-4539,-5.5,39.6,0,1426,1426,8891
2003,39,d) 3,8899,9190,87962,89294,431,4.4,1360,14,18081,3755,14326,4.2,20.2,20744,9381,11363,10.5,23.2,-2663,-3,40.4,0,1052,1052,8154
2003,39,e) 4,8469,9030,100302,99286,396,4.2,1110,11.8,18224,2170,16054,2.2,18.4,16191,6118,10073,6.2,16.3,2033,2.1,32.6,0,812,812,4959
2003,39,f) 5,8110,9105,90867,91791,387,4.1,1053,11.1,13936,2238,11698,2.4,15.2,15783,6177,9606,6.7,17.2,-1847,-2,30.4,0,786,788,4661
2003,39,g) 6 to 10,32525,34328,361258,368595,1287,3.6,3375,9.5,54950,9351,45599,2.5,14.9,69624,23493,46131,6.4,18.9,-14674,-4,29.8,0,2479,2482,16010
2003,39,h) 11 to 15,23620,26484,363671,362023,905,3.3,2095,7.7,54433,8253,46180,2.3,15,51136,14219,36917,3.9,14.1,3297,0.9,28.2,0,1375,1375,8246
2003,39,i) 16 to 20,19753,23765,389426,389570,853,3.5,1408,5.8,44607,9559,35048,2.5,11.5,44895,11166,33729,2.9,11.5,-288,0,23,0,919,952,6894
2003,39,j) 21 to 25,14217,17854,317087,317646,529,2.9,1086,6,37811,9197,28614,2.9,11.9,38929,9641,29288,3,12.3,-1118,-0.4,23.8,0,668,679,5948
2003,39,k) 26+,3159,6279,159400,160164,240,3.8,308,4.9,19921,4577,15344,2.9,12.4,21449,4257,17192,2.7,13.4,-1528,-1,24.8,0,104,109,770
2003,39,l) Left Censored,32873,73254,2594661,2603221,3968,5.4,3533,4.8,278986,76672,202314,2.9,10.7,296106,61672,234434,2.4,11.4,-17120,-0.7,21.4,0,1169,1182,9898
2003,40,a) 0,5798,5814,30412,15206,5814,200,0,0,30412,30412,0,200,200,0,0,0,0,0,30412,200,0,0,,,
2003,40,b) 1,4490,4575,33232,35901,27,0.5,1474,27.4,8536,480,8056,1.3,23.8,13873,9014,4859,25.1,38.6,-5337,-14.8,47.6,0,1201,1203,7699
2003,40,c) 2,3711,3780,26714,27731,184,4.5,743,18.1,5613,1207,4406,4.4,20.2,7646,3808,3838,13.7,27.6,-2033,-7.4,40.4,0,616,616,3386
2003,40,d) 3,3350,3488,30152,29942,164,4.4,529,14.3,6449,1141,5308,3.8,21.5,6029,2612,3417,8.7,20.1,420,1.4,40.2,0,416,416,2238
2003,40,e) 4,3105,3208,31363,31968,123,3.6,433,12.8,6332,494,5838,1.5,19.8,7541,2429,5112,7.6,23.6,-1209,-3.8,39.6,0,350,350,1873
2003,40,f) 5,2979,3310,30228,31639,150,4.4,364,10.6,4450,618,3832,2,14.1,7272,2098,5174,6.6,23,-2822,-8.9,28.2,0,284,284,1338
2003,40,g) 6 to 10,10873,11464,105586,107086,547,4.6,1185,10,17362,3085,14277,2.9,16.2,20363,6774,13589,6.3,19,-3001,-2.8,32.4,0,911,911,5557
2003,40,h) 11 to 15,7598,8240,102166,102189,348,4.1,687,8.1,15960,3205,12755,3.1,15.6,16005,5059,10946,5,15.7,-45,-0.1,31.2,0,495,495,3063
2003,40,i) 16 to 20,6652,7668,108966,110351,302,3.9,453,5.8,11403,2040,9363,1.8,10.3,14173,3644,10529,3.3,12.8,-2770,-2.5,20.6,0,321,321,1783
2003,40,j) 21 to 25,5176,6275,108349,110131,195,3.1,337,5.3,11277,2299,8978,2.1,10.2,14840,3657,11183,3.3,13.5,-3563,-3.3,20.4,0,248,249,1604
2003,40,k) 26+,951,1836,38157,38984,72,3.9,85,4.6,4091,753,3338,1.9,10.5,5744,1010,4734,2.6,14.7,-1653,-4.2,21,0,42,42,209
2003,40,l) Left Censored,8452,18665,529384,533641,958,5.1,831,4.5,58227,16283,41944,3.1,10.9,66743,13543,53200,2.5,12.5,-8516,-1.6,21.8,0,281,282,2309
2003,41,a) 0,7411,7487,35066,17533,7487,200,0,0,35066,35066,0,200,200,0,0,0,0,0,35066,200,0,0,,,
2003,41,b) 1,5595,5691,34719,36424,21,0.3,1537,23.5,7981,97,7884,0.3,21.9,11391,6747,4644,18.5,31.3,-3410,-9.4,43.8,0,1160,1162,5579
2003,41,c) 2,4881,4979,32818,33280,287,5.4,842,15.9,6882,957,5925,2.9,20.7,7805,3643,4162,10.9,23.5,-923,-2.8,41.4,0,658,658,2996
2003,41,d) 3,4278,4382,31924,32084,232,5,680,14.6,6924,965,5959,3,21.6,7243,3493,3750,10.9,22.6,-319,-1,43.2,0,534,534,3062
2003,41,e) 4,3957,4102,30021,30369,234,5.5,540,12.6,5367,971,4396,3.2,17.7,6062,2621,3441,8.6,20,-695,-2.3,35.4,0,399,399,2126
2003,41,f) 5,3744,4034,34163,34246,223,5.3,459,11,5682,1052,4630,3.1,16.6,5847,2313,3534,6.8,17.1,-165,-0.5,33.2,0,327,327,1693
2003,41,g) 6 to 10,14129,14674,141448,143411,731,4.8,1600,10.5,20611,3533,17078,2.5,14.4,24537,8435,16102,5.9,17.1,-3926,-2.7,28.8,0,1188,1188,6289
2003,41,h) 11 to 15,9235,10125,118949,118487,496,4.8,823,8,19172,3390,15782,2.9,16.2,18248,5259,12989,4.4,15.4,924,0.8,30.8,0,540,540,3818
2003,41,i) 16 to 20,6916,8421,130815,130816,330,3.9,578,6.7,17678,2996,14682,2.3,13.5,17679,5954,11725,4.6,13.5,-1,0,27,0,378,378,3409
2003,41,j) 21 to 25,5335,6487,101229,101548,193,2.9,355,5.4,11321,1928,9393,1.9,11.1,11958,2527,9431,2.5,11.8,-637,-0.7,22.2,0,239,239,1779
2003,41,k) 26+,1094,2020,51314,51800,87,4.3,81,4,5653,912,4741,1.8,10.9,6624,1479,5145,2.9,12.8,-971,-1.9,21.8,0,31,31,117
2003,41,l) Left Censored,8577,19061,597172,595716,1120,5.9,1092,5.7,72324,16392,55932,2.8,12.1,69411,20238,49173,3.4,11.7,2913,0.4,23.4,0,296,299,2583
2003,42,a) 0,16259,16349,106896,53448,16349,200,0,0,106896,106896,0,200,200,0,0,0,0,0,106896,200,0,0,,,
2003,42,b) 1,13235,13447,117123,118398,36,0.2,3351,22,30606,325,30281,0.3,25.9,33155,20448,12707,17.3,28,-2549,-2.1,51.8,0,2538,2542,17621
2003,42,c) 2,11537,11727,117317,119239,487,3.9,1890,15.1,19152,2442,16710,2,16.1,22995,11905,11090,10,19.3,-3843,-3.2,32.2,0,1469,1469,10350
2003,42,d) 3,10498,10749,100568,101282,431,3.8,1512,13.3,17122,2350,14772,2.3,16.9,18549,8668,9881,8.6,18.3,-1427,-1.4,33.8,0,1159,1159,6673
2003,42,e) 4,9736,10225,106935,103788,450,4.2,1190,11.2,23559,2717,20842,2.6,22.7,17264,5960,11304,5.7,16.6,6295,6.1,33.2,0,882,889,4694
2003,42,f) 5,9303,10516,110875,111549,433,4,1117,10.2,17678,3771,13907,3.4,15.8,19025,5861,13164,5.3,17.1,-1347,-1.3,31.6,0,832,832,4660
2003,42,g) 6 to 10,34943,36426,372086,376272,1322,3.5,3442,9.1,53749,10524,43225,2.8,14.3,62121,20011,42110,5.3,16.5,-8372,-2.2,28.6,0,2550,2551,15100
2003,42,h) 11 to 15,28092,30500,362900,368810,1039,3.3,2353,7.5,49795,8952,40843,2.4,13.5,61615,16308,45307,4.4,16.7,-11820,-3.2,27,0,1648,1650,10561
2003,42,i) 16 to 20,23978,28196,455814,457583,976,3.4,1775,6.2,46684,10892,35792,2.4,10.2,50222,14169,36053,3.1,11,-3538,-0.8,20.4,0,1169,1191,8160
2003,42,j) 21 to 25,15618,18949,334930,335103,593,3.1,1100,5.7,38049,9090,28959,2.7,11.4,38394,9016,29378,2.7,11.5,-345,-0.1,22.8,0,748,752,5394
2003,42,k) 26+,3489,6546,172702,168610,307,4.7,283,4.3,29223,5302,23921,3.1,17.3,21038,4277,16761,2.5,12.5,8185,4.8,25,0,111,113,1031
2003,42,l) Left Censored,35939,77388,2702721,2716371,4114,5.3,3818,4.9,309809,91282,218527,3.4,11.4,337111,73542,263569,2.7,12.4,-27302,-1,22.8,0,1298,1320,11953
2003,44,a) 0,1866,1872,11625,5813,1872,200,0,0,11625,11625,0,200,200,0,0,0,0,0,11625,200,0,0,,,
2003,44,b) 1,1417,1424,9056,9084,5,0.3,390,23.9,2415,27,2388,0.3,26.6,2470,1609,861,17.7,27.2,-55,-0.6,53.2,0,273,273,1300
2003,44,c) 2,1204,1216,8260,8270,56,4.3,202,15.6,1582,208,1374,2.5,19.1,1601,746,855,9,19.4,-19,-0.3,38.2,0,141,141,494
2003,44,d) 3,1048,1071,7761,9766,46,4.1,158,14,1219,99,1120,1,12.5,5228,535,4693,5.5,53.5,-4009,-41,25,0,116,116,455
2003,44,e) 4,1016,1045,8464,8567,56,5.2,118,10.9,1353,187,1166,2.2,15.8,1559,433,1126,5.1,18.2,-206,-2.4,31.6,0,83,83,362
2003,44,f) 5,1008,1100,8319,8514,47,4.1,128,11.2,1140,150,990,1.8,13.4,1529,663,866,7.8,18,-389,-4.6,26.8,0,98,98,579
2003,44,g) 6 to 10,3667,3710,34216,34081,154,4,381,9.9,5788,1419,4369,4.2,17,5517,1871,3646,5.5,16.2,271,0.8,32.4,0,263,264,1477
2003,44,h) 11 to 15,2805,2934,37363,37454,84,2.8,231,7.6,4756,644,4112,1.7,12.7,4938,1552,3386,4.1,13.2,-182,-0.5,25.4,0,135,135,1050
2003,44,i) 16 to 20,2411,2684,37431,37546,103,3.8,174,6.4,4753,889,3864,2.4,12.7,4982,1652,3330,4.4,13.3,-229,-0.6,25.4,0,101,108,813
2003,44,j) 21 to 25,1515,1722,28417,28232,58,3.3,96,5.5,3848,1080,2768,3.8,13.6,3478,882,2596,3.1,12.3,370,1.3,24.6,0,66,66,550
2003,44,k) 26+,395,544,11768,11759,16,2.9,26,4.7,1248,226,1022,1.9,10.6,1229,115,1114,1,10.5,19,0.1,21,0,15,15,50
2003,44,l) Left Censored,4070,6341,217765,216755,344,5.4,337,5.3,22424,4343,18081,2,10.3,20404,5225,15179,2.4,9.4,2020,0.9,18.8,0,128,128,1100
2003,45,a) 0,6874,6915,50997,25499,6915,200,0,0,50997,50997,0,200,200,0,0,0,0,0,50997,200,0,0,,,
2003,45,b) 1,5353,5455,40944,43467,27,0.4,1523,24.3,9592,181,9411,0.4,22.1,14637,8460,6177,19.5,33.7,-5045,-11.6,44.2,0,1229,1229,7235
2003,45,c) 2,4446,4546,41138,42466,254,5.2,881,18,8101,994,7107,2.3,19.1,10756,4983,5773,11.7,25.3,-2655,-6.2,38.2,0,723,723,4398
2003,45,d) 3,4072,4213,37625,37496,212,4.8,623,14,7803,1218,6585,3.2,20.8,7544,3542,4002,9.4,20.1,259,0.7,40.2,0,498,498,2899
2003,45,e) 4,3758,3962,42376,43116,179,4.3,523,12.6,6588,1145,5443,2.7,15.3,8067,4287,3780,9.9,18.7,-1479,-3.4,30.6,0,424,424,3899
2003,45,f) 5,3448,3712,38109,38074,165,4.3,451,11.6,6833,1138,5695,3,17.9,6762,2729,4033,7.2,17.8,71,0.1,35.6,0,357,357,2213
2003,45,g) 6 to 10,12234,12722,147955,148156,578,4.4,1312,10,25004,4709,20295,3.2,16.9,25406,8048,17358,5.4,17.1,-402,-0.2,33.8,0,1021,1021,6313
2003,45,h) 11 to 15,8358,9554,123966,123425,397,4.1,743,7.6,20167,5187,14980,4.2,16.3,19085,5643,13442,4.6,15.5,1082,0.8,31,0,529,531,3087
2003,45,i) 16 to 20,7280,8903,134941,136586,306,3.4,514,5.7,17376,4418,12958,3.2,12.7,20665,4274,16391,3.1,15.1,-3289,-2.4,25.4,0,363,364,2353
2003,45,j) 21 to 25,4368,5743,100416,100343,202,3.5,291,5,11652,2819,8833,2.8,11.6,11505,3013,8492,3,11.5,147,0.1,23,0,198,199,1827
2003,45,k) 26+,971,2010,34278,33745,93,4.7,66,3.3,4533,831,3702,2.5,13.4,3467,520,2947,1.5,10.3,1066,3.1,20.6,0,38,38,304
2003,45,l) Left Censored,9073,21758,744226,752193,1322,6.1,1039,4.8,77193,27379,49814,3.6,10.3,93127,23059,70068,3.1,12.4,-15934,-2.1,20.6,0,287,288,1971
2003,46,a) 0,1742,1752,8363,4182,1752,200,0,0,8363,,,,200,0,0,0,0,0,8363,200,0,1,,,
2003,46,b) 1,1429,1447,8444,8660,2,0.1,405,24,1957,,,,22.6,2389,1439,950,16.6,27.6,-432,-5,45.2,1,269,269,1124
2003,46,c) 2,1113,1140,7449,7355,48,3.9,197,16,1722,168,1554,2.3,23.4,1534,761,773,10.3,20.9,188,2.5,41.8,0,147,147,573
2003,46,d) 3,992,1027,7992,7917,48,4.4,140,13,1468,290,1178,3.7,18.5,1318,471,847,5.9,16.6,150,1.9,33.2,0,99,99,356
2003,46,e) 4,900,926,7070,7217,49,5,130,13.4,995,160,835,2.2,13.8,1288,537,751,7.4,17.8,-293,-4,27.6,0,96,96,436
2003,46,f) 5,888,938,7118,7107,47,4.8,127,13,1210,119,1091,1.7,17,1187,486,701,6.8,16.7,23,0.3,33.4,0,79,79,338
2003,46,g) 6 to 10,3386,3483,27452,27573,148,4.1,371,10.2,3873,506,3367,1.8,14,4114,1609,2505,5.8,14.9,-241,-0.9,28,0,229,229,1087
2003,46,h) 11 to 15,2405,2555,24229,24527,130,4.9,264,10,3091,589,2502,2.4,12.6,3686,1570,2116,6.4,15,-595,-2.4,25.2,0,154,154,726
2003,46,i) 16 to 20,1794,2046,24776,27803,69,3.3,124,6,3080,591,2489,2.1,11.1,9133,6418,2715,23.1,32.8,-6053,-21.7,22.2,0,61,61,422
2003,46,j) 21 to 25,1341,1568,19896,20053,58,3.7,80,5.1,2161,396,1765,2,10.8,2474,879,1595,4.4,12.3,-313,-1.5,21.6,0,59,59,454
2003,46,k) 26+,296,496,8478,8629,15,3,19,3.8,682,103,579,1.2,7.9,983,63,920,0.7,11.4,-301,-3.5,15.8,0,10,10,23
2003,46,l) Left Censored,3117,5392,145859,146947,236,4.3,301,5.5,13367,3827,9540,2.6,9.1,15543,4163,11380,2.8,10.6,-2176,-1.5,18.2,0,98,98,920
2003,47,a) 0,8313,8358,58877,29439,8358,200,0,0,58877,58877,0,200,200,0,0,0,0,0,58877,200,0,0,,,
2003,47,b) 1,6088,6239,51677,56549,58,0.8,2043,27.9,12439,753,11686,1.3,22,22182,13882,8300,24.5,39.2,-9743,-17.2,44,0,1700,1700,12100
2003,47,c) 2,5102,5212,43905,45015,262,4.7,984,17.5,9153,1139,8014,2.5,20.3,11373,6162,5211,13.7,25.3,-2220,-5,40.6,0,826,826,5104
2003,47,d) 3,4505,4673,45906,46001,252,5.1,749,15.1,9574,1818,7756,4,20.8,9764,4536,5228,9.9,21.2,-190,-0.4,41.6,0,621,621,3540
2003,47,e) 4,4256,4651,49037,49679,225,4.6,615,12.6,7612,984,6628,2,15.3,8895,3381,5514,6.8,17.9,-1283,-2.6,30.6,0,501,501,2903
2003,47,f) 5,4163,4731,53149,52610,229,4.6,581,11.8,11138,1968,9170,3.7,21.2,10060,3991,6069,7.6,19.1,1078,2.1,38.2,0,442,442,3331
2003,47,g) 6 to 10,15808,16718,184295,183518,775,4.5,1800,10.4,33064,5819,27245,3.2,18,31510,11977,19533,6.5,17.2,1554,0.8,34.4,0,1365,1365,8676
2003,47,h) 11 to 15,11147,12678,179571,180840,489,3.8,1062,8.2,25038,6259,18779,3.5,13.8,27575,8506,19069,4.7,15.2,-2537,-1.4,27.6,0,772,772,5100
2003,47,i) 16 to 20,10148,12180,205674,205547,432,3.5,717,5.8,24497,4283,20214,2.1,11.9,24244,4531,19713,2.2,11.8,253,0.1,23.6,0,506,506,2958
2003,47,j) 21 to 25,6260,7944,147011,146816,279,3.5,487,6,18997,5627,13370,3.8,12.9,18606,4168,14438,2.8,12.7,391,0.2,25.4,0,320,323,2430
2003,47,k) 26+,1500,3717,103335,103394,217,5.8,318,8.4,18493,7274,11219,7,17.9,18611,5178,13433,5,18,-118,-0.1,35.8,0,52,55,251
2003,47,l) Left Censored,13010,32079,1172992,1174361,2037,6.4,1577,4.9,135667,43253,92414,3.7,11.6,138406,27792,110614,2.4,11.8,-2739,-0.2,23.2,0,463,469,3518
2003,48,a) 0,35823,36117,256482,128241,36117,200,0,0,256482,256482,0,200,200,0,0,0,0,0,256482,200,0,0,,,
2003,48,b) 1,26590,27274,266122,280312,145,0.5,8230,25.9,62545,2276,60269,0.8,22.3,90924,52389,38535,18.7,32.4,-28379,-10.1,44.6,0,6812,6814,45112
2003,48,c) 2,22034,22664,207765,214046,1066,4.4,4346,17.7,43546,5024,38522,2.3,20.3,56108,28116,27992,13.1,26.2,-12562,-5.9,40.6,0,3614,3614,22206
2003,48,d) 3,19385,20176,197743,200548,932,4.3,3302,15.3,40907,6208,34699,3.1,20.4,46517,20389,26128,10.2,23.2,-5610,-2.8,40.8,0,2701,2702,16742
2003,48,e) 4,17566,18563,212703,216684,869,4.4,2603,13.3,40027,6737,33290,3.1,18.5,47988,22199,25789,10.2,22.1,-7961,-3.6,37,0,2113,2113,17517
2003,48,f) 5,16247,18098,220583,222415,873,4.6,2261,12,41139,8016,33123,3.6,18.5,44803,21376,23427,9.6,20.1,-3664,-1.6,37,0,1791,1791,18428
2003,48,g) 6 to 10,60727,64827,777626,788811,3057,4.5,7228,10.7,138899,29014,109885,3.7,17.6,161269,56701,104568,7.2,20.4,-22370,-2.8,35.2,0,5531,5533,43017
2003,48,h) 11 to 15,41020,46749,697579,702895,2097,4.4,4187,8.7,113435,27819,85616,4,16.1,124066,44314,79752,6.3,17.7,-10631,-1.6,32.2,0,2820,2832,22453
2003,48,i) 16 to 20,32311,40257,712694,714307,1730,4.2,2659,6.5,91243,17370,73873,2.4,12.8,94468,24279,70189,3.4,13.2,-3225,-0.4,25.6,0,1763,1793,13948
2003,48,j) 21 to 25,24177,31525,564767,558021,1239,3.9,1880,5.9,84795,25918,58877,4.6,15.2,71303,20140,51163,3.6,12.8,13492,2.4,25.6,0,1210,1226,10114
2003,48,k) 26+,4293,9532,213165,209865,675,7.1,488,5.2,33513,10255,23258,4.9,16,26912,6663,20249,3.2,12.8,6601,3.2,25.6,0,181,200,2235
2003,48,l) Left Censored,32895,102049,3628564,3658950,7522,7.4,6451,6.3,464205,167501,296704,4.6,12.7,524978,154536,370442,4.2,14.3,-60773,-1.6,25.4,0,1297,1366,14482
2003,49,a) 0,5652,5667,34063,17032,5667,200,0,0,34063,34063,0,200,200,0,0,0,0,0,34063,200,0,0,,,
2003,49,b) 1,4006,4070,29665,32030,21,0.4,1416,29.3,7121,224,6897,0.7,22.2,11851,7711,4140,24.1,37,-4730,-14.8,44.4,0,1071,1072,6542
2003,49,c) 2,3201,3262,24425,25340,196,5.6,677,19.2,5194,779,4415,3.1,20.5,7023,3393,3630,13.4,27.7,-1829,-7.2,41,0,512,512,2795
2003,49,d) 3,2708,2765,24260,24660,144,4.9,469,15.9,5473,1652,3821,6.7,22.2,6273,2588,3685,10.5,25.4,-800,-3.2,44.4,0,354,356,2134
2003,49,e) 4,2404,2472,23126,25580,143,5.5,409,15.6,4795,1257,3538,4.9,18.7,9702,4030,5672,15.8,37.9,-4907,-19.2,37.4,0,296,296,3591
2003,49,f) 5,2146,2303,22190,22343,122,5.1,307,12.8,3694,555,3139,2.5,16.5,4000,1560,2440,7,17.9,-306,-1.4,33,0,229,229,1300
2003,49,g) 6 to 10,7600,7895,96203,97814,436,5.3,891,10.9,17389,6122,11267,6.3,17.8,20610,5254,15356,5.4,21.1,-3221,-3.3,35.6,0,648,649,4307
2003,49,h) 11 to 15,4224,4749,83505,86032,222,4.6,434,8.9,11939,3185,8754,3.7,13.9,16993,7644,9349,8.9,19.8,-5054,-5.9,27.8,0,291,291,5607
2003,49,i) 16 to 20,2949,3670,71061,70315,218,5.9,275,7.4,13333,4205,9128,6,19,11840,3972,7868,5.6,16.8,1493,2.2,33.6,0,165,165,1720
2003,49,j) 21 to 25,2385,2929,59283,59183,131,4.4,184,6.2,7646,2191,5455,3.7,12.9,7446,1657,5789,2.8,12.6,200,0.3,25.2,0,116,119,854
2003,49,k) 26+,568,965,19698,19655,43,4.4,69,7.1,2391,628,1763,3.2,12.2,2304,768,1536,3.9,11.7,87,0.5,23.4,0,16,16,144
2003,49,l) Left Censored,4287,10464,417830,419829,812,7.8,786,7.5,48244,16087,32157,3.8,11.5,52243,14244,37999,3.4,12.4,-3999,-0.9,23,0,145,146,2484
2003,50,a) 0,1310,1321,6622,3311,1321,200,0,0,6622,6622,0,200,200,0,0,0,0,0,6622,200,0,0,,,
2003,50,b) 1,996,1005,6160,6381,4,0.3,256,22.3,1115,29,1086,0.5,17.5,1556,954,602,15,24.4,-441,-6.9,35,0,177,177,767
2003,50,c) 2,875,882,5183,5517,37,3.9,146,15.5,839,130,709,2.4,15.2,1506,834,672,15.1,27.3,-667,-12.1,30.4,0,103,103,731
2003,50,d) 3,827,854,8050,7627,41,4.5,128,14.2,1861,412,1449,5.4,24.4,1014,449,565,5.9,13.3,847,11.1,26.6,0,90,90,311
2003,50,e) 4,778,805,5462,5442,38,4.5,100,11.9,1033,141,892,2.6,19,993,356,637,6.5,18.2,40,0.8,36.4,0,70,70,280
2003,50,f) 5,781,840,6400,6535,40,4.6,93,10.7,1049,349,700,5.3,16.1,1318,412,906,6.3,20.2,-269,-4.1,32.2,0,72,72,349
2003,50,g) 6 to 10,2948,3033,22759,23189,112,3.6,306,9.7,2978,323,2655,1.4,12.8,3838,1481,2357,6.4,16.6,-860,-3.8,25.6,0,216,216,1144
2003,50,h) 11 to 15,2422,2527,21434,21812,95,3.7,202,7.8,2646,554,2092,2.5,12.1,3401,1060,2341,4.9,15.6,-755,-3.5,24.2,0,127,127,580
2003,50,i) 16 to 20,1981,2206,32647,32193,80,3.6,127,5.7,4221,945,3276,2.9,13.1,3313,1270,2043,3.9,10.3,908,2.8,20.6,0,85,85,1073
2003,50,j) 21 to 25,1208,1420,18080,18315,36,2.5,66,4.6,1890,306,1584,1.7,10.3,2359,444,1915,2.4,12.9,-469,-2.6,20.6,0,42,42,306
2003,50,k) 26+,273,430,10196,9818,20,4.7,13,3,1319,106,1213,1.1,13.4,563,54,509,0.6,5.7,756,7.7,11.4,0,6,6,14
2003,50,l) Left Censored,2413,4079,114416,117044,233,5.7,187,4.6,10716,2875,7841,2.5,9.2,15972,4526,11446,3.9,13.6,-5256,-4.4,18.4,0,65,66,787
2003,51,a) 0,12218,12274,71217,35609,12274,200,0,0,71217,71217,0,200,200,0,0,0,0,0,71217,200,0,0,,,
2003,51,b) 1,9297,9424,65738,70809,34,0.3,2669,24.5,16403,154,16249,0.2,23.2,26545,14554,11991,20.6,37.5,-10142,-14.3,46.4,0,2071,2071,12163
2003,51,c) 2,7758,8033,61135,61813,484,5.6,1426,16.6,13715,1839,11876,3,22.2,15070,6768,8302,10.9,24.4,-1355,-2.2,44.4,0,1117,1117,5738
2003,51,d) 3,7051,7239,57092,57556,350,4.6,1111,14.5,11793,2193,9600,3.8,20.5,12721,5978,6743,10.4,22.1,-928,-1.6,41,0,857,857,4603
2003,51,e) 4,6392,6695,62743,62116,323,4.6,816,11.7,11552,1225,10327,2,18.6,10298,4162,6136,6.7,16.6,1254,2,33.2,0,648,648,3425
2003,51,f) 5,6231,6886,72791,74473,361,5.1,724,10.2,10660,1901,8759,2.6,14.3,14024,5219,8805,7,18.8,-3364,-4.5,28.6,0,539,539,4330
2003,51,g) 6 to 10,23042,24012,259054,259382,1031,4.2,2311,9.3,43194,9295,33899,3.6,16.7,43850,15784,28066,6.1,16.9,-656,-0.2,33.4,0,1647,1670,11500
2003,51,h) 11 to 15,16348,18072,258728,258972,675,3.7,1350,7.3,36005,5352,30653,2.1,13.9,36492,13062,23430,5,14.1,-487,-0.2,27.8,0,894,896,7580
2003,51,i) 16 to 20,13352,16115,279477,278081,623,3.8,961,5.9,37101,7424,29677,2.7,13.3,34309,9464,24845,3.4,12.3,2792,1,24.6,0,601,603,4239
2003,51,j) 21 to 25,8131,10478,206920,204961,373,3.5,523,4.9,24956,4990,19966,2.4,12.2,21038,4314,16724,2.1,10.3,3918,1.9,20.6,0,328,329,2664
2003,51,k) 26+,1743,3573,77439,79657,221,6.2,160,4.5,10304,2553,7751,3.2,12.9,14740,4344,10396,5.5,18.5,-4436,-5.6,25.8,0,66,66,272
2003,51,l) Left Censored,15850,41533,1432127,1438647,2837,6.9,2149,5.2,157624,54358,103266,3.8,11,170664,41087,129577,2.9,11.9,-13040,-0.9,22,0,497,521,6145
2003,53,a) 0,12543,12572,68721,34361,12572,200,0,0,68721,68721,0,200,200,0,0,0,0,0,68721,200,0,0,,,
2003,53,b) 1,9270,9417,57670,60157,25,0.2,2867,26.1,14166,366,13800,0.6,23.5,19140,12482,6658,20.7,31.8,-4974,-8.3,47,0,2109,2109,9643
2003,53,c) 2,7822,7962,54869,55898,485,5.7,1555,18.1,11482,1778,9704,3.2,20.5,13539,6400,7139,11.4,24.2,-2057,-3.7,41,0,1205,1205,5053
2003,53,d) 3,7034,7264,53722,53891,441,5.7,1194,15.5,11218,2067,9151,3.8,20.8,11556,5305,6251,9.8,21.4,-338,-0.6,41.6,0,908,908,4433
2003,53,e) 4,6590,6934,59638,60512,388,5.4,944,13,11066,1377,9689,2.3,18.3,12813,5162,7651,8.5,21.2,-1747,-2.9,36.6,0,712,712,4389
2003,53,f) 5,6028,6502,61414,61964,366,5.4,858,12.6,9931,1803,8128,2.9,16,11031,4716,6315,7.6,17.8,-1100,-1.8,32,0,630,630,3897
2003,53,g) 6 to 10,22425,23338,214105,215599,1268,5.3,2584,10.7,34666,5841,28825,2.7,16.1,37654,12565,25089,5.8,17.5,-2988,-1.4,32.2,0,1874,1881,9721
2003,53,h) 11 to 15,14972,16277,187654,188560,794,4.8,1477,8.8,29017,4647,24370,2.5,15.4,30829,12522,18307,6.6,16.3,-1812,-0.9,30.8,0,977,977,6118
2003,53,i) 16 to 20,11242,13636,219075,217291,594,4.3,1020,7.3,29257,5700,23557,2.6,13.5,25688,7577,18111,3.5,11.8,3569,1.7,23.6,0,601,609,3372
2003,53,j) 21 to 25,7920,9791,187939,186688,356,3.6,613,6.2,23771,6634,17137,3.6,12.7,21268,7521,13747,4,11.4,2503,1.3,22.8,0,390,390,2819
2003,53,k) 26+,1655,3203,76435,75706,164,5.1,157,4.9,9598,2013,7585,2.7,12.7,8140,1910,6230,2.5,10.8,1458,1.9,21.6,0,74,74,493
2003,53,l) Left Censored,12748,29957,965556,973789,1905,6.4,1645,5.5,109970,32798,77172,3.4,11.3,126437,31657,94780,3.3,13,-16467,-1.7,22.6,0,420,422,3590
2003,54,a) 0,2144,2157,13049,6525,2157,200,0,0,13049,13049,0,200,200,0,0,0,0,0,13049,200,0,0,,,
2003,54,b) 1,1702,1744,12084,12284,4,0.2,492,24.4,3090,7,3083,0.1,25.2,3490,2006,1484,16.3,28.4,-400,-3.2,50.4,0,383,383,1548
2003,54,c) 2,1424,1454,11356,11516,75,4.8,260,16.7,2173,364,1809,3.2,18.9,2493,1343,1150,11.7,21.6,-320,-2.7,37.8,0,201,201,866
2003,54,d) 3,1385,1435,10636,10905,71,4.7,212,14,1786,416,1370,3.8,16.4,2324,791,1533,7.3,21.3,-538,-4.9,32.8,0,164,164,670
2003,54,e) 4,1263,1334,11830,11817,64,4.6,169,12.1,2060,265,1795,2.2,17.4,2033,737,1296,6.2,17.2,27,0.2,34.4,0,126,126,542
2003,54,f) 5,1195,1420,12415,12807,54,3.7,159,10.8,1796,280,1516,2.2,14,2580,1078,1502,8.4,20.1,-784,-6.1,28,0,118,118,910
2003,54,g) 6 to 10,4846,4985,42327,42907,214,4.1,521,10.1,6837,878,5959,2,15.9,7997,2285,5712,5.3,18.6,-1160,-2.7,31.8,0,382,382,1785
2003,54,h) 11 to 15,3652,3888,45181,45434,183,4.6,360,9,6463,1318,5145,2.9,14.2,6968,2257,4711,5,15.3,-505,-1.1,28.4,0,253,254,1405
2003,54,i) 16 to 20,3331,3843,56080,54642,119,3,215,5.5,8489,4633,3856,8.5,15.5,5612,1265,4347,2.3,10.3,2877,5.2,20.6,0,157,158,936
2003,54,j) 21 to 25,2260,2707,37327,38086,65,2.4,163,5.9,3728,604,3124,1.6,9.8,5245,1017,4228,2.7,13.8,-1517,-4,19.6,0,116,116,841
2003,54,k) 26+,563,1209,23787,23708,49,4,54,4.5,3140,959,2181,4,13.2,2981,365,2616,1.5,12.6,159,0.6,25.2,0,16,16,44
2003,54,l) Left Censored,5413,10660,279631,282381,569,5.4,474,4.5,26099,9004,17095,3.2,9.2,31598,6440,25158,2.3,11.2,-5499,-2,18.4,0,196,199,2331
2003,55,a) 0,8214,8266,53507,26754,8266,200,0,0,53507,53507,0,200,200,0,0,0,0,0,53507,200,0,0,,,
2003,55,b) 1,6717,6846,50149,52387,23,0.3,1845,23.5,10739,195,10544,0.4,20.5,15215,9701,5514,18.5,29,-4476,-8.5,41,0,1335,1335,7800
2003,55,c) 2,5589,5796,53228,53278,297,4.8,932,15.1,12687,1149,11538,2.2,23.8,12786,4893,7893,9.2,24,-99,-0.2,47.6,0,708,708,3774
2003,55,d) 3,5213,5374,46133,45996,241,4.2,796,14,8416,1023,7393,2.2,18.3,8142,3691,4451,8,17.7,274,0.6,35.4,0,586,587,2813
2003,55,e) 4,4814,5185,53152,53443,237,4.4,668,12.3,9596,2268,7328,4.2,18,10178,3209,6969,6,19,-582,-1,36,0,490,490,2668
2003,55,f) 5,4632,5066,51661,51133,199,3.8,576,10.9,9022,1239,7783,2.4,17.6,7965,2601,5364,5.1,15.6,1057,2,31.2,0,417,417,1962
2003,55,g) 6 to 10,18440,19133,180754,181538,736,3.7,1910,9.6,26469,3742,22727,2.1,14.6,28036,10521,17515,5.8,15.4,-1567,-0.8,29.2,0,1362,1362,7671
2003,55,h) 11 to 15,14088,15218,167964,169863,574,3.7,1337,8.5,21033,4262,16771,2.5,12.4,24830,8941,15889,5.3,14.6,-3797,-2.2,24.8,0,828,835,5351
2003,55,i) 16 to 20,10596,12613,206071,208689,373,2.9,798,6.2,21093,3450,17643,1.7,10.1,26329,6888,19441,3.3,12.6,-5236,-2.5,20.2,0,541,541,3379
2003,55,j) 21 to 25,7241,8859,158189,159741,267,3,553,6.1,16680,3701,12979,2.3,10.4,19783,4537,15246,2.8,12.4,-3103,-2,20.8,0,357,357,2477
2003,55,k) 26+,1674,3390,78786,77424,175,5.2,171,5,10199,2483,7716,3.2,13.2,7474,1272,6202,1.6,9.7,2725,3.5,19.4,0,59,59,354
2003,55,l) Left Censored,17191,34151,1286177,1282744,1638,4.8,1561,4.6,131675,38763,92912,3,10.3,124808,26445,98363,2.1,9.7,6867,0.6,19.4,0,579,596,6818
2003,56,a) 0,1398,1399,6009,3005,1399,200,0,0,6009,,,,200,0,0,0,0,0,6009,200,0,1,,,
2003,56,b) 1,1187,1193,7032,7285,2,0.1,361,25.9,1605,,,,22,2111,1293,818,17.7,29,-506,-7,44,1,265,265,1090
2003,56,c) 2,899,905,5204,5460,41,4.2,184,18.7,958,106,852,1.9,17.5,1469,650,819,11.9,26.9,-511,-9.4,35,0,143,143,540
2003,56,d) 3,863,881,5142,5347,55,5.9,129,14,885,227,658,4.2,16.6,1295,442,853,8.3,24.2,-410,-7.6,33.2,0,94,94,339
2003,56,e) 4,710,730,4907,4973,34,4.4,97,12.7,806,158,648,3.2,16.2,938,359,579,7.2,18.9,-132,-2.7,32.4,0,75,75,254
2003,56,f) 5,723,792,6604,6819,37,4.5,96,11.6,794,100,694,1.5,11.6,1223,345,878,5.1,17.9,-429,-6.3,23.2,0,68,68,253
2003,56,g) 6 to 10,2578,2643,20287,20577,135,4.9,272,10,3317,588,2729,2.9,16.1,3896,1334,2562,6.5,18.9,-579,-2.8,32.2,0,175,175,933
2003,56,h) 11 to 15,1629,1743,17978,18206,61,3.4,149,8.3,2026,210,1816,1.2,11.1,2482,549,1933,3,13.6,-456,-2.5,22.2,0,91,91,373
2003,56,i) 16 to 20,1274,1434,16522,16466,57,3.9,113,7.7,2739,430,2309,2.6,16.6,2627,1215,1412,7.4,16,112,0.6,32,0,68,71,567
2003,56,j) 21 to 25,1164,1350,16570,16605,45,3.3,94,6.8,1806,217,1589,1.3,10.9,1876,334,1542,2,11.3,-70,-0.4,21.8,0,67,69,245
2003,56,k) 26+,231,394,6706,6489,20,5.1,17,4.3,1002,97,905,1.5,15.4,567,76,491,1.2,8.7,435,6.7,17.4,0,6,6,11
2003,56,l) Left Censored,1882,3277,64601,64441,198,6.1,167,5.1,7688,2211,5477,3.4,11.9,7368,1993,5375,3.1,11.4,320,0.5,22.8,0,48,48,520
2004,01,a) 0,6529,6552,40018,20082,6526,199.2,0,0,39872,39872,0,198.5,198.5,0,0,0,0,0,39872,198.5,0,0,,,
2004,01,b) 1,4964,5003,41610,41547,16,0.3,1373,23.8,11508,102,11406,0.2,27.7,11382,7028,4354,16.9,27.4,126,0.3,54.8,0,1154,1154,6380
2004,01,c) 2,4112,4209,37265,37181,154,3.4,751,16.6,8111,769,7342,2.1,21.8,7943,3607,4336,9.7,21.4,168,0.4,42.8,0,618,618,2972
2004,01,d) 3,3580,3729,34140,34241,169,4.3,576,14.6,6640,1393,5247,4.1,19.4,6841,2882,3959,8.4,20,-201,-0.6,38.8,0,474,474,2106
2004,01,e) 4,3331,3475,35156,35308,150,4.1,433,11.9,6393,706,5687,2,18.1,6696,2296,4400,6.5,19,-303,-0.9,36.2,0,353,353,1952
2004,01,f) 5,3293,3475,35972,36352,120,3.3,380,10.5,6050,586,5464,1.6,16.6,6809,2281,4528,6.3,18.7,-759,-2.1,33.2,0,292,292,1631
2004,01,g) 6 to 10,13142,13963,150000,150686,478,3.3,1385,9.6,24490,3521,20969,2.3,16.3,25862,9771,16091,6.5,17.2,-1372,-0.9,32.6,0,1099,1102,6701
2004,01,h) 11 to 15,8688,9639,126699,128306,338,3.4,784,7.9,18670,2810,15860,2.2,14.6,21884,7001,14883,5.5,17.1,-3214,-2.5,29.2,0,575,575,5474
2004,01,i) 16 to 20,7723,9176,181088,179222,278,3,572,6.1,24780,8677,16103,4.8,13.8,21048,6706,14342,3.7,11.7,3732,2.1,23.4,0,377,387,2736
2004,01,j) 21 to 25,4717,5975,117665,116143,194,3.2,353,5.8,15156,2511,12645,2.2,13,12112,3725,8387,3.2,10.4,3044,2.6,20.8,0,227,227,1903
2004,01,k) 26+,2033,3820,67150,67569,173,4.5,172,4.5,7135,1977,5158,2.9,10.6,7972,1683,6289,2.5,11.8,-837,-1.2,21.2,0,98,98,552
2004,01,l) Left Censored,9357,23057,748004,748957,1205,5.2,1527,6.6,85541,22216,63325,3,11.4,87446,27918,59528,3.7,11.7,-1905,-0.3,22.8,0,346,348,3192
2004,02,a) 0,1342,1343,5901,2959,1338,199.3,0,0,5885,5885,0,198.9,198.9,0,0,0,0,0,5885,198.9,0,0,,,
2004,02,b) 1,910,930,7388,7339,4,0.4,320,29.1,1871,,,,25.5,1773,1009,764,13.7,24.2,98,1.3,48.4,1,213,213,794
2004,02,c) 2,889,917,6460,6492,66,6.8,165,16.9,1495,,,,23,1558,742,816,11.4,24,-63,-1,46,1,121,121,524
2004,02,d) 3,687,703,4790,4767,44,5.9,121,16.3,1198,122,1076,2.6,25.1,1152,491,661,10.3,24.2,46,0.9,48.4,0,84,84,366
2004,02,e) 4,694,727,6976,6404,42,5.6,89,11.8,1991,134,1857,2.1,31.1,847,289,558,4.5,13.2,1144,17.9,26.4,0,59,59,209
2004,02,f) 5,556,594,4661,4613,33,5.3,89,14.3,978,153,825,3.3,21.2,882,406,476,8.8,19.1,96,2.1,38.2,0,59,59,296
2004,02,g) 6 to 10,2389,2500,22178,22581,128,4.9,297,11.5,3246,434,2812,1.9,14.4,4051,1443,2608,6.4,17.9,-805,-3.5,28.8,0,195,195,1115
2004,02,h) 11 to 15,1539,1634,14443,14735,72,4.3,168,10,1975,266,1709,1.8,13.4,2558,885,1673,6,17.4,-583,-4,26.8,0,103,103,618
2004,02,i) 16 to 20,1409,1618,23691,24392,53,3.2,89,5.4,2537,337,2200,1.4,10.4,3938,2000,1938,8.2,16.1,-1401,-5.7,20.8,0,49,49,212
2004,02,j) 21 to 25,999,1287,21840,22122,45,3.5,65,5,2409,262,2147,1.2,10.9,2972,341,2631,1.5,13.4,-563,-2.5,21.8,0,39,39,171
2004,02,k) 26+,409,740,14745,14553,35,4.8,26,3.5,1628,341,1287,2.3,11.2,1243,170,1073,1.2,8.5,385,2.7,17,0,15,15,75
2004,02,l) Left Censored,1426,3098,90197,88961,184,5.9,173,5.6,10615,2701,7914,3,11.9,8143,2280,5863,2.6,9.2,2472,2.7,18.4,0,35,35,652
2004,04,a) 0,10184,10237,63892,32093,10187,199,0,0,63599,63599,0,198.2,198.2,0,0,0,0,0,63599,198.2,0,0,,,
2004,04,b) 1,7372,7448,62886,64263,21,0.2,2128,24.6,18089,450,17639,0.7,28.1,20843,11890,8953,18.5,32.4,-2754,-4.3,56.2,0,1717,1717,10581
2004,04,c) 2,6194,6303,61805,61821,248,3.6,1164,17.1,12999,1693,11306,2.7,21,13031,6565,6466,10.6,21.1,-32,-0.1,42,0,915,915,5434
2004,04,d) 3,5392,5589,52070,52487,220,3.7,854,14.4,8911,1182,7729,2.3,17,9744,3852,5892,7.3,18.6,-833,-1.6,34,0,665,665,3024
2004,04,e) 4,4736,4896,71805,70013,203,3.9,668,12.9,13186,1817,11369,2.6,18.8,9601,4319,5282,6.2,13.7,3585,5.1,27.4,0,500,506,3240
2004,04,f) 5,4388,4644,63139,66118,216,4.4,628,12.9,10999,2137,8862,3.2,16.6,16956,11362,5594,17.2,25.6,-5957,-9,33.2,0,472,472,10500
2004,04,g) 6 to 10,16087,17177,220379,222736,735,4.1,1820,10.2,35261,7058,28203,3.2,15.8,39975,15061,24914,6.8,17.9,-4714,-2.1,31.6,0,1352,1357,11679
2004,04,h) 11 to 15,9421,10944,171902,168689,437,3.9,960,8.5,28520,5030,23490,3,16.9,22094,8301,13793,4.9,13.1,6426,3.8,26.2,0,649,649,4642
2004,04,i) 16 to 20,7471,9514,194596,197554,400,4.1,668,6.9,24181,3542,20639,1.8,12.2,30096,9686,20410,4.9,15.2,-5915,-3,24.4,0,410,414,3050
2004,04,j) 21 to 25,5020,6891,148143,148408,260,3.7,449,6.4,16994,3592,13402,2.4,11.5,17524,5802,11722,3.9,11.8,-530,-0.3,23,0,241,241,1787
2004,04,k) 26+,1665,3254,88669,95122,195,6,154,4.8,14737,4770,9967,5,15.5,27643,1828,25815,1.9,29.1,-12906,-13.6,31,0,71,71,317
2004,04,l) Left Censored,6819,21213,815228,800537,1784,8.5,1458,6.9,119348,38161,81187,4.8,14.9,89966,25849,64117,3.2,11.2,29382,3.7,22.4,0,192,192,2577
2004,05,a) 0,4537,4553,24773,12405,4538,199.3,0,0,24736,24736,0,199.4,199.4,0,0,0,0,0,24736,199.4,0,0,,,
2004,05,b) 1,3409,3426,22376,22784,12,0.3,979,24.7,6466,187,6279,0.8,28.4,7282,4855,2427,21.3,32,-816,-3.6,56.8,0,809,809,4345
2004,05,c) 2,2898,2948,23872,24478,107,3.3,584,18.2,4611,600,4011,2.5,18.8,5822,2992,2830,12.2,23.8,-1211,-5,37.6,0,485,485,2502
2004,05,d) 3,2454,2544,19140,19358,85,3.1,390,14.4,3248,370,2878,1.9,16.8,3684,1678,2006,8.7,19,-436,-2.2,33.6,0,324,324,1493
2004,05,e) 4,2266,2346,19583,19684,98,4,297,12.1,3782,593,3189,3,19.2,3984,1695,2289,8.6,20.2,-202,-1,38.4,0,236,236,1263
2004,05,f) 5,2176,2315,17843,18238,73,3,245,10.2,2778,379,2399,2.1,15.2,3567,1311,2256,7.2,19.6,-789,-4.4,30.4,0,190,190,1006
2004,05,g) 6 to 10,8332,8941,86478,87160,370,4,932,10.1,13120,2042,11078,2.3,15.1,14483,5278,9205,6.1,16.6,-1363,-1.5,30.2,0,720,720,4067
2004,05,h) 11 to 15,5786,6264,66300,66424,217,3.4,558,8.7,9429,1663,7766,2.5,14.2,9676,3218,6458,4.8,14.6,-247,-0.4,28.4,0,389,389,1759
2004,05,i) 16 to 20,4657,5551,104715,104077,209,3.7,324,5.8,11011,1957,9054,1.9,10.6,9735,2559,7176,2.5,9.4,1276,1.2,18.8,0,237,237,1588
2004,05,j) 21 to 25,3279,4101,69241,69319,146,3.5,221,5.3,8036,1234,6802,1.8,11.6,8192,2022,6170,2.9,11.8,-156,-0.2,23.2,0,161,161,1324
2004,05,k) 26+,1354,2013,46324,45912,67,3.3,95,4.7,4626,1137,3489,2.5,10.1,3801,866,2935,1.9,8.3,825,1.8,16.6,0,60,60,261
2004,05,l) Left Censored,6278,14192,495568,494855,633,4.4,825,5.8,50790,11306,39484,2.3,10.3,49366,11437,37929,2.3,10,1424,0.3,20,0,236,242,1565
2004,06,a) 0,65413,65639,442159,221479,65358,199.1,0,0,441360,441360,0,199.3,199.3,0,0,0,0,0,441360,199.3,0,0,,,
2004,06,b) 1,49477,49932,407749,416695,101,0.2,14161,24.5,109600,1679,107921,0.4,26.3,127492,72700,54792,17.4,30.6,-17892,-4.3,52.6,0,11134,11134,59578
2004,06,c) 2,41623,42662,386399,399273,1685,3.6,8150,17.6,77443,9285,68158,2.3,19.4,103190,56143,47047,14.1,25.8,-25747,-6.4,38.8,0,6480,6481,48628
2004,06,d) 3,35580,36827,338540,348637,1592,4,6131,15.6,62588,8845,53743,2.5,18,82783,36091,46692,10.4,23.7,-20195,-5.7,36,0,4712,4715,29303
2004,06,e) 4,31354,32480,339920,347952,1317,3.8,4851,14.1,58058,7373,50685,2.1,16.7,74123,33820,40303,9.7,21.3,-16065,-4.6,33.4,0,3729,3730,27113
2004,06,f) 5,28105,29710,327899,336103,1198,3.8,4132,13.2,53699,7135,46564,2.1,16,70107,31379,38728,9.3,20.9,-16408,-4.9,32,0,3124,3127,25588
2004,06,g) 6 to 10,102613,109157,1388865,1423014,4605,4.1,12660,11.1,205347,32938,172409,2.3,14.4,273644,102547,171097,7.2,19.2,-68297,-4.8,28.8,0,9584,9590,72037
2004,06,h) 11 to 15,70992,78489,1129616,1137239,3105,3.8,7542,9.3,174311,37384,136927,3.3,15.3,189556,66090,123466,5.8,16.7,-15245,-1.4,30.6,0,5212,5239,40515
2004,06,i) 16 to 20,59006,71466,1315547,1318055,2680,3.7,5546,7.6,169529,41747,127782,3.2,12.9,174545,50493,124052,3.8,13.2,-5016,-0.3,25.8,0,3615,3623,26201
2004,06,j) 21 to 25,41933,53117,1027777,1032607,1881,3.5,3764,6.9,124411,29832,94579,2.9,12,134071,40658,93413,3.9,13,-9660,-1,24,0,2246,2258,19764
2004,06,k) 26+,14636,25692,674160,687202,1003,3.9,1444,5.6,79537,21623,57914,3.1,11.6,105621,30843,74778,4.5,15.4,-26084,-3.8,23.2,0,740,751,17080
2004,06,l) Left Censored,53054,139890,5329943,5291105,8770,6.2,9904,7,715770,215871,499899,4.1,13.5,638094,190663,447431,3.6,12.1,77676,1.4,24.2,0,2297,2339,28701
2004,08,a) 0,11732,11788,59150,29649,11733,199.1,0,0,59003,59003,0,199,199,0,0,0,0,0,59003,199,0,0,,,
2004,08,b) 1,8727,8815,61413,63732,21,0.2,2687,26.1,15790,225,15565,0.4,24.8,20428,11467,8961,18,32.1,-4638,-7.3,49.6,0,2014,2014,9861
2004,08,c) 2,7418,7549,51064,52937,369,4.5,1539,18.8,9796,1254,8542,2.4,18.5,13542,7689,5853,14.5,25.6,-3746,-7.1,37,0,1170,1170,6657
2004,08,d) 3,6587,6753,51881,53078,290,4,1137,15.8,9538,1178,8360,2.2,18,11931,6428,5503,12.1,22.5,-2393,-4.5,36,0,837,844,5398
2004,08,e) 4,5869,6045,54686,54821,294,4.6,884,13.8,10037,1217,8820,2.2,18.3,10306,4244,6062,7.7,18.8,-269,-0.5,36.6,0,634,634,3531
2004,08,f) 5,5277,5491,45459,46590,255,4.4,746,12.9,7596,1306,6290,2.8,16.3,9858,4523,5335,9.7,21.2,-2262,-4.9,32.6,0,542,542,2882
2004,08,g) 6 to 10,20065,21120,210411,211650,928,4.2,2394,10.9,32116,5079,27037,2.4,15.2,34594,12464,22130,5.9,16.3,-2478,-1.1,30.4,0,1693,1693,8644
2004,08,h) 11 to 15,12055,13141,162228,164789,538,4,1188,8.8,20178,3777,16401,2.3,12.2,25300,8777,16523,5.3,15.4,-5122,-3.2,24.4,0,757,758,4916
2004,08,i) 16 to 20,8773,10448,171011,175514,421,4,690,6.5,21122,5457,15665,3.1,12,30127,9538,20589,5.4,17.2,-9005,-5.2,24,0,425,428,3405
2004,08,j) 21 to 25,6104,8087,164955,166023,343,4.2,503,6.2,20429,6249,14180,3.8,12.3,22564,5692,16872,3.4,13.6,-2135,-1.3,24.6,0,261,272,1996
2004,08,k) 26+,2204,3821,87362,88240,164,4.3,193,5,11282,3533,7749,4,12.8,13038,2246,10792,2.5,14.8,-1756,-2,25.6,0,71,71,553
2004,08,l) Left Censored,8942,22851,764065,754225,1581,6.9,1583,6.9,102160,44258,57902,5.9,13.5,82481,22097,60384,2.9,10.9,19679,2.6,21.8,0,268,268,3260
2004,09,a) 0,5250,5263,27482,13765,5246,199.4,0,0,27434,27434,0,199.3,199.3,0,0,0,0,0,27434,199.3,0,0,,,
2004,09,b) 1,3831,3853,26795,27118,12,0.3,931,21.3,6994,,,,25.8,7640,4389,3251,16.2,28.2,-646,-2.4,51.6,1,707,707,3702
2004,09,c) 2,3596,3670,30793,31312,137,3.5,597,15.2,5360,,,,17.1,6398,2710,3688,8.7,20.4,-1038,-3.3,34.2,1,468,468,2252
2004,09,d) 3,3107,3172,25289,25959,111,3.3,438,13.1,3979,562,3417,2.2,15.3,5319,2375,2944,9.1,20.5,-1340,-5.2,30.6,0,355,355,2056
2004,09,e) 4,2943,3044,30134,29971,124,3.9,407,12.7,4165,500,3665,1.7,13.9,3839,1553,2286,5.2,12.8,326,1.1,25.6,0,308,308,1226
2004,09,f) 5,2717,2820,33560,33213,114,3.9,325,11.1,4932,1073,3859,3.2,14.8,4237,1788,2449,5.4,12.8,695,2,25.6,0,241,241,1504
2004,09,g) 6 to 10,11229,11652,112535,116886,375,3.1,1095,9.1,14712,1769,12943,1.5,12.6,23413,10215,13198,8.7,20,-8701,-7.4,25.2,0,776,776,5181
2004,09,h) 11 to 15,8567,8995,108306,114122,260,2.8,691,7.5,13580,1760,11820,1.5,11.9,25211,15724,9487,13.8,22.1,-11631,-10.2,23.8,0,490,490,14301
2004,09,i) 16 to 20,8026,9028,127442,128038,280,3,564,6.1,13246,2625,10621,2.1,10.3,14438,4249,10189,3.3,11.3,-1192,-1,20.6,0,357,361,2111
2004,09,j) 21 to 25,5189,6140,98895,98632,206,3.3,325,5.2,9551,1646,7905,1.7,9.7,9024,2072,6952,2.1,9.1,527,0.6,18.2,0,222,229,1269
2004,09,k) 26+,1948,2864,58265,57763,99,3.4,157,5.4,6491,1510,4981,2.6,11.2,5487,1099,4388,1.9,9.5,1004,1.7,19,0,97,97,622
2004,09,l) Left Censored,11848,22205,843863,852770,1183,5.3,1277,5.7,80590,22794,57796,2.7,9.5,98405,28060,70345,3.3,11.5,-17815,-2,19,0,371,371,2535
2004,10,a) 0,1676,1689,9032,4532,1683,199.3,0,0,9001,9001,0,198.6,198.6,0,0,0,0,0,9001,198.6,0,0,,,
2004,10,b) 1,1359,1361,9443,9794,1,0.1,316,20.7,2248,,,,23,2950,1912,1038,19.5,30.1,-702,-7.1,46,1,242,242,1720
2004,10,c) 2,1094,1120,7943,8245,40,3.3,194,16.2,1598,,,,19.4,2202,707,1495,8.6,26.7,-604,-7.3,38.8,1,154,154,607
2004,10,d) 3,1062,1073,6276,6378,31,2.8,119,10.6,997,95,902,1.5,15.6,1201,525,676,8.2,18.8,-204,-3.2,31.2,0,93,93,469
2004,10,e) 4,966,983,7722,7595,39,3.7,149,14.3,1485,175,1310,2.3,19.6,1230,507,723,6.7,16.2,255,3.4,32.4,0,117,117,411
2004,10,f) 5,834,871,7660,7645,39,4.3,106,11.7,1368,171,1197,2.2,17.9,1338,507,831,6.6,17.5,30,0.4,35,0,87,87,470
2004,10,g) 6 to 10,3060,3206,37071,37213,124,3.7,340,10.2,4267,808,3459,2.2,11.5,4550,1605,2945,4.3,12.2,-283,-0.7,23,0,262,262,1400
2004,10,h) 11 to 15,2059,2168,22825,23276,82,3.7,152,6.9,3327,474,2853,2,14.3,4229,1447,2782,6.2,18.2,-902,-3.9,28.6,0,109,109,639
2004,10,i) 16 to 20,1614,1857,25736,25465,78,4.1,120,6.4,2918,511,2407,2,11.5,2376,733,1643,2.9,9.3,542,2.2,18.6,0,73,78,415
2004,10,j) 21 to 25,1044,1267,26612,26348,46,3.6,69,5.4,2584,569,2015,2.2,9.8,2056,457,1599,1.7,7.8,528,2,15.6,0,43,45,225
2004,10,k) 26+,469,710,28160,28608,39,5.5,30,4.2,1577,396,1181,1.4,5.5,2472,262,2210,0.9,8.6,-895,-3.1,11,0,13,13,122
2004,10,l) Left Censored,2964,6138,198379,198856,493,8.1,400,6.6,24943,8231,16712,4.1,12.5,25897,9281,16616,4.7,13,-954,-0.5,25,0,71,71,602
2004,11,a) 0,567,567,5142,2575,561,197.9,0,0,5134,5134,0,199.4,199.4,0,0,0,0,0,5134,199.4,0,0,,,
2004,11,b) 1,724,733,6050,6210,1,0.1,144,17.7,1443,,,,23.2,1762,1070,692,17.2,28.4,-319,-5.2,46.4,1,119,119,984
2004,11,c) 2,790,801,9764,9703,23,2.7,132,15.3,1538,,,,15.9,1415,796,619,8.2,14.6,123,1.3,29.2,1,100,100,720
2004,11,d) 3,694,709,8586,8570,25,3.4,97,13,1032,102,930,1.2,12,999,299,700,3.5,11.7,33,0.3,23.4,0,74,74,250
2004,11,e) 4,609,622,7685,7653,19,2.9,76,11.6,1106,260,846,3.4,14.5,1041,474,567,6.2,13.6,65,0.9,27.2,0,60,60,299
2004,11,f) 5,598,636,10406,10101,19,2.9,70,10.5,1680,118,1562,1.2,16.6,1069,459,610,4.5,10.6,611,6,21.2,0,55,57,413
2004,11,g) 6 to 10,2412,2531,32542,32165,79,3,204,7.8,5067,539,4528,1.7,15.8,4312,1233,3079,3.8,13.4,755,2.4,26.8,0,160,161,1093
2004,11,h) 11 to 15,1713,1840,34079,34647,77,4.1,145,7.7,4298,993,3305,2.9,12.4,5434,1442,3992,4.2,15.7,-1136,-3.3,24.8,0,115,115,930
2004,11,i) 16 to 20,1559,1777,29381,29558,48,2.6,113,6.2,2924,656,2268,2.2,9.9,3278,711,2567,2.4,11.1,-354,-1.2,19.8,0,66,68,493
2004,11,j) 21 to 25,1226,1422,28290,28458,64,4.4,119,8.2,2873,780,2093,2.7,10.1,3208,1018,2190,3.6,11.3,-335,-1.2,20.2,0,61,61,238
2004,11,k) 26+,529,805,33995,32157,46,5.7,40,5,5349,775,4574,2.4,16.6,1672,514,1158,1.6,5.2,3677,11.4,10.4,0,15,15,198
2004,11,l) Left Censored,3225,5671,232519,230397,438,7.7,409,7.2,26091,7615,18476,3.3,11.3,21847,5411,16436,2.3,9.5,4244,1.8,19,0,82,82,616
2004,12,a) 0,49923,50114,251442,126232,49884,199.1,0,0,250420,250420,0,198.4,198.4,0,0,0,0,0,250420,198.4,0,0,,,
2004,12,b) 1,31490,31698,239408,243187,68,0.2,10022,26.9,65614,1266,64348,0.5,27,73171,46809,26362,19.2,30.1,-7557,-3.1,54,0,8047,8047,40763
2004,12,c) 2,24671,25080,193121,197551,1038,3.8,5297,19.4,49951,5263,44688,2.7,25.3,58810,35023,23787,17.7,29.8,-8859,-4.5,50.6,0,4293,4293,30641
2004,12,d) 3,20432,20883,191690,180981,909,4.1,3493,15.7,57837,4540,53297,2.5,32,36419,18399,18020,10.2,20.1,21418,11.9,40.2,0,2729,2731,14676
2004,12,e) 4,17752,18328,173657,173304,829,4.3,2650,13.7,39648,7818,31830,4.5,22.9,38942,19898,19044,11.5,22.5,706,0.4,45,0,2014,2014,12321
2004,12,f) 5,16313,17247,165282,169239,754,4.2,2361,13,32893,4176,28717,2.5,19.4,40806,21984,18822,13,24.1,-7913,-4.7,38.8,0,1758,1798,17974
2004,12,g) 6 to 10,60029,63241,732890,745898,2794,4.3,7106,10.8,137764,33074,104690,4.4,18.5,163780,52431,111349,7,22,-26016,-3.5,37,0,5335,5340,42219
2004,12,h) 11 to 15,39997,44234,593710,589377,1678,3.7,3906,8.6,94382,19078,75304,3.2,16,85716,33380,52336,5.7,14.5,8666,1.5,29,0,2813,2835,21920
2004,12,i) 16 to 20,28495,34107,637414,691328,1339,3.8,2567,7.4,82836,18567,64269,2.7,12,190664,92374,98290,13.4,27.6,-107828,-15.6,24,0,1679,1722,10649
2004,12,j) 21 to 25,17540,22315,440581,439785,988,4.4,1614,7.1,59961,11314,48647,2.6,13.6,58369,14818,43551,3.4,13.3,1592,0.3,26.6,0,1011,1035,6922
2004,12,k) 26+,5835,10622,224911,224684,450,4.2,617,5.8,30511,9544,20967,4.2,13.6,30057,6827,23230,3,13.4,454,0.2,26.8,0,311,316,2642
2004,12,l) Left Censored,22579,73680,2662899,2660250,5518,7.5,5513,7.5,359757,109842,249915,4.1,13.5,354459,149248,205211,5.6,13.3,5298,0.2,26.6,0,894,965,9704
2004,13,a) 0,16840,16943,98967,49626,16865,199.1,0,0,98682,98682,0,198.9,198.9,0,0,0,0,0,98682,198.9,0,0,,,
2004,13,b) 1,12259,12350,90395,95805,39,0.3,3636,25.4,24638,693,23945,0.7,25.7,35458,21011,14447,21.9,37,-10820,-11.3,51.4,0,2910,2910,18118
2004,13,c) 2,10365,10601,90679,90728,490,4.3,1949,17.1,18709,2149,16560,2.4,20.6,18807,9510,9297,10.5,20.7,-98,-0.1,41.2,0,1558,1558,8257
2004,13,d) 3,8831,9096,83247,82597,366,3.8,1351,14,16868,2616,14252,3.2,20.4,15568,6138,9430,7.4,18.8,1300,1.6,37.6,0,1048,1048,4995
2004,13,e) 4,8134,8552,80385,79345,380,4.2,1116,12.5,16071,2421,13650,3.1,20.3,13991,5963,8028,7.5,17.6,2080,2.7,35.2,0,868,868,4716
2004,13,f) 5,7414,7820,84528,84952,334,4.1,985,12,14275,2199,12076,2.6,16.8,15122,6465,8657,7.6,17.8,-847,-1,33.6,0,725,730,5295
2004,13,g) 6 to 10,27713,29286,341516,341672,1240,4.1,3061,10.1,59270,9420,49850,2.8,17.3,59581,21727,37854,6.4,17.4,-311,-0.1,34.6,0,2227,2246,17011
2004,13,h) 11 to 15,16823,18895,270710,269419,705,3.6,1578,8.1,41082,8909,32173,3.3,15.2,38500,13227,25273,4.9,14.3,2582,0.9,28.6,0,1095,1096,7208
2004,13,i) 16 to 20,13380,16147,298920,303827,574,3.5,1010,6.2,37346,10461,26885,3.4,12.3,47160,9571,37589,3.2,15.5,-9814,-3.2,24.6,0,639,645,4445
2004,13,j) 21 to 25,8204,10896,219680,219009,404,3.7,654,5.9,25981,4675,21306,2.1,11.9,24639,6420,18219,2.9,11.3,1342,0.6,22.6,0,382,382,2377
2004,13,k) 26+,3196,5687,143824,140747,270,4.7,283,5,21881,6124,15757,4.4,15.5,15727,4456,11271,3.2,11.2,6154,4.3,22.4,0,136,138,2329
2004,13,l) Left Censored,14663,42133,1616487,1608001,2759,6.6,2701,6.4,207291,63541,143750,4,12.9,190319,57612,132707,3.6,11.8,16972,1.1,23.6,0,493,499,4615
2004,15,a) 0,2018,2036,12166,6094,2024,198.8,0,0,12145,12145,0,199.3,199.3,0,0,0,0,0,12145,199.3,0,0,,,
2004,15,b) 1,1553,1655,12851,13526,25,1.4,364,19.7,2915,429,2486,3.2,21.6,4265,2204,2061,16.3,31.5,-1350,-9.9,43.2,0,296,296,1837
2004,15,c) 2,1350,1385,11468,11919,42,2.8,228,15.3,2135,179,1956,1.5,17.9,3036,1782,1254,15,25.5,-901,-7.6,35.8,0,179,179,1417
2004,15,d) 3,1102,1133,10536,10515,45,3.7,172,14.3,1918,393,1525,3.7,18.2,1876,945,931,9,17.8,42,0.4,35.6,0,133,133,835
2004,15,e) 4,1017,1081,10878,10964,35,3.1,158,13.8,1777,226,1551,2.1,16.2,1949,756,1193,6.9,17.8,-172,-1.6,32.4,0,124,124,571
2004,15,f) 5,913,958,10079,10203,33,3.3,89,9,1378,136,1242,1.3,13.5,1625,575,1050,5.6,15.9,-247,-2.4,27,0,63,63,450
2004,15,g) 6 to 10,3687,3847,45181,45270,132,3.3,335,8.5,5005,439,4566,1,11.1,5182,1635,3547,3.6,11.4,-177,-0.3,22.2,0,253,253,1274
2004,15,h) 11 to 15,2773,3039,36821,36984,129,4.2,237,7.6,4483,885,3598,2.4,12.1,4808,1360,3448,3.7,13,-325,-0.9,24.2,0,160,160,901
2004,15,i) 16 to 20,2341,2818,46204,46066,92,3.2,138,4.8,4564,1333,3231,2.9,9.9,4288,1357,2931,2.9,9.3,276,0.6,18.6,0,109,109,906
2004,15,j) 21 to 25,2004,2527,42454,42412,73,2.8,145,5.7,4048,449,3599,1.1,9.5,3963,1333,2630,3.1,9.3,85,0.2,18.6,0,88,88,586
2004,15,k) 26+,748,1150,16143,16159,38,3.3,58,5,1782,572,1210,3.5,11,1813,375,1438,2.3,11.2,-31,-0.2,22,0,22,22,68
2004,15,l) Left Censored,3432,6991,217952,214819,354,5.1,358,5.1,24368,5466,18902,2.5,11.3,18102,4141,13961,1.9,8.4,6266,2.9,16.8,0,101,101,705
2004,16,a) 0,3466,3476,18242,9140,3460,199.1,0,0,18205,18205,0,199.2,199.2,0,0,0,0,0,18205,199.2,0,0,,,
2004,16,b) 1,2398,2437,15924,16273,7,0.2,805,27.9,3997,,,,24.6,4695,2719,1976,16.7,28.9,-698,-4.3,49.2,1,582,582,2158
2004,16,c) 2,2049,2092,19511,19618,81,3.6,363,16.2,2927,500,2427,2.5,14.9,3140,1422,1718,7.2,16,-213,-1.1,29.8,0,249,249,1085
2004,16,d) 3,1810,1866,14994,14944,103,5.3,271,13.8,2809,439,2370,2.9,18.8,2708,1332,1376,8.9,18.1,101,0.7,36.2,0,200,200,997
2004,16,e) 4,1626,1688,14570,15593,70,3.9,226,12.7,2214,346,1868,2.2,14.2,4260,954,3306,6.1,27.3,-2046,-13.1,28.4,0,174,174,834
2004,16,f) 5,1532,1605,13437,13230,78,4.7,204,12.2,2552,304,2248,2.3,19.3,2138,970,1168,7.3,16.2,414,3.1,32.4,0,153,153,800
2004,16,g) 6 to 10,5802,6058,54498,54531,288,4.6,584,9.4,7623,1224,6399,2.2,14,7688,2710,4978,5,14.1,-65,-0.1,28,0,403,407,2042
2004,16,h) 11 to 15,3597,3827,38077,38140,196,5,360,9.2,5492,886,4606,2.3,14.4,5617,2411,3206,6.3,14.7,-125,-0.3,28.8,0,196,200,1134
2004,16,i) 16 to 20,2363,2742,48250,44424,104,3.7,186,6.7,14204,,,,32,6552,1727,4825,3.9,14.7,7652,17.3,29.4,1,107,107,663
2004,16,j) 21 to 25,1747,2250,44704,44718,89,3.9,102,4.5,4044,845,3199,1.9,9,4072,1103,2969,2.5,9.1,-28,-0.1,18,0,54,54,326
2004,16,k) 26+,692,1032,21359,20519,49,4.7,53,5.1,3851,1269,2582,6.2,18.8,2171,450,1721,2.2,10.6,1680,8.2,21.2,0,27,27,112
2004,16,l) Left Censored,3139,6738,186222,186090,397,5.9,393,5.8,20904,7618,13286,4.1,11.2,20642,6663,13979,3.6,11.1,262,0.1,22.2,0,82,82,579
2004,17,a) 0,19918,19990,121480,60955,19886,199,0,0,121050,121050,0,198.6,198.6,0,0,0,0,0,121050,198.6,0,0,,,
2004,17,b) 1,14807,15069,115988,118147,70,0.4,4043,23.5,30205,902,29303,0.8,25.6,34523,19741,14782,16.7,29.2,-4318,-3.6,51.2,0,2916,2916,16496
2004,17,c) 2,12658,12898,108742,112764,480,3.5,2279,16.4,18878,1711,17167,1.5,16.7,26921,13471,13450,11.9,23.9,-8043,-7.2,33.4,0,1707,1707,10814
2004,17,d) 3,11116,11425,93416,95417,479,4,1628,13.5,15976,2881,13095,3,16.7,19977,9694,10283,10.2,20.9,-4001,-4.2,33.4,0,1180,1180,8533
2004,17,e) 4,10516,10835,103737,105517,441,3.9,1360,12,18859,2122,16737,2,17.9,22419,7386,15033,7,21.2,-3560,-3.3,35.8,0,989,991,5617
2004,17,f) 5,9670,10188,112019,113467,389,3.7,1192,11.2,16064,1337,14727,1.2,14.2,18959,6693,12266,5.9,16.7,-2895,-2.5,28.4,0,851,851,4904
2004,17,g) 6 to 10,40085,41932,468667,468574,1602,3.7,4381,10.1,74946,9897,65049,2.1,16,74759,27911,46848,6,16,187,0,32,0,3049,3060,21791
2004,17,h) 11 to 15,29308,31570,396574,401670,1164,3.6,2655,8.2,54179,8257,45922,2.1,13.5,64370,18159,46211,4.5,16,-10191,-2.5,27,0,1689,1694,10754
2004,17,i) 16 to 20,22922,26642,485493,488511,826,3,1833,6.7,50248,8962,41286,1.8,10.3,56283,14943,41340,3.1,11.5,-6035,-1.2,20.6,0,1121,1186,8990
2004,17,j) 21 to 25,15801,19375,401506,404316,568,2.9,1093,5.6,41171,9802,31369,2.4,10.2,46790,10138,36652,2.5,11.6,-5619,-1.4,20.4,0,667,667,4974
2004,17,k) 26+,6138,9964,223885,223667,323,3.2,481,4.8,23362,4606,18756,2.1,10.4,22926,5263,17663,2.4,10.3,436,0.1,20.6,0,241,244,1561
2004,17,l) Left Censored,32589,70024,2588100,2595930,3727,5.3,4393,6.2,287202,73696,213506,2.8,11.1,302861,82812,220049,3.2,11.7,-15659,-0.6,22.2,0,1195,1202,12733
2004,18,a) 0,8857,8900,56240,28182,8853,198.9,0,0,56116,56116,0,199.1,199.1,0,0,0,0,0,56116,199.1,0,0,,,
2004,18,b) 1,6487,6586,54950,56734,29,0.4,1915,25.2,13302,592,12710,1,23.4,16870,10595,6275,18.7,29.7,-3568,-6.3,46.8,0,1504,1504,9204
2004,18,c) 2,6003,6106,55619,55782,199,3,1058,16.1,11066,936,10130,1.7,19.8,11391,5663,5728,10.2,20.4,-325,-0.6,39.6,0,862,862,4918
2004,18,d) 3,5042,5296,46369,46338,209,3.7,763,13.7,8167,842,7325,1.8,17.6,8105,3562,4543,7.7,17.5,62,0.1,35,0,594,594,2912
2004,18,e) 4,4732,4911,46572,47545,207,4,638,12.4,7691,1236,6455,2.6,16.2,9637,4157,5480,8.7,20.3,-1946,-4.1,32.4,0,491,491,3158
2004,18,f) 5,4417,4663,51198,52393,148,3.1,504,10.4,8094,964,7130,1.8,15.4,10483,4382,6101,8.4,20,-2389,-4.6,30.8,0,366,366,2502
2004,18,g) 6 to 10,18259,19503,213717,215985,709,3.5,1929,9.6,30847,5079,25768,2.4,14.3,35382,15017,20365,7,16.4,-4535,-2.1,28.6,0,1460,1460,10617
2004,18,h) 11 to 15,13346,14765,191821,190569,431,2.8,1145,7.6,27620,3476,24144,1.8,14.5,25116,7945,17171,4.2,13.2,2504,1.3,26.4,0,768,768,5333
2004,18,i) 16 to 20,11039,13439,226877,229228,417,3.1,725,5.3,23011,4579,18432,2,10,27713,7541,20172,3.3,12.1,-4702,-2.1,20,0,490,491,4066
2004,18,j) 21 to 25,7321,8894,167165,166447,290,3.2,467,5.2,17833,3300,14533,2,10.7,16397,4301,12096,2.6,9.9,1436,0.8,19.8,0,298,299,2279
2004,18,k) 26+,2906,5082,116776,114692,349,6.9,258,5.1,15930,7778,8152,6.8,13.9,11762,2890,8872,2.5,10.3,4168,3.6,20.6,0,128,130,1215
2004,18,l) Left Censored,16110,37182,1351140,1346267,1755,4.7,1770,4.8,141682,35455,106227,2.6,10.5,131937,32300,99637,2.4,9.8,9745,0.7,19.6,0,460,463,4291
2004,19,a) 0,4695,4712,25158,12627,4679,198.6,0,0,25063,25063,0,198.5,198.5,0,0,0,0,0,25063,198.5,0,0,,,
2004,19,b) 1,3560,3621,25299,26081,6,0.1,1007,24.1,5547,61,5486,0.2,21.3,7111,4164,2947,16,27.3,-1564,-6,42.6,0,737,737,3294
2004,19,c) 2,3118,3206,23367,23778,139,4,583,16.9,4389,432,3957,1.8,18.5,5211,2688,2523,11.3,21.9,-822,-3.4,37,0,441,441,2292
2004,19,d) 3,2666,2747,19901,20192,125,4.3,375,13,3209,342,2867,1.7,15.9,3791,1549,2242,7.7,18.8,-582,-2.9,31.8,0,275,275,1110
2004,19,e) 4,2558,2624,24559,24359,130,4.7,361,13.1,3947,675,3272,2.8,16.2,3546,1540,2006,6.3,14.6,401,1.6,29.2,0,252,252,1231
2004,19,f) 5,2348,2479,21869,22157,108,4.2,288,11.2,2905,289,2616,1.3,13.1,3481,1371,2110,6.2,15.7,-576,-2.6,26.2,0,210,210,1017
2004,19,g) 6 to 10,10431,10956,95633,95398,487,4.3,1098,9.7,14544,3044,11500,3.2,15.2,14074,5147,8927,5.4,14.8,470,0.4,29.6,0,742,744,3555
2004,19,h) 11 to 15,7470,8001,81202,81661,342,4.2,717,8.7,10381,1711,8670,2.1,12.7,11299,3676,7623,4.5,13.8,-918,-1.1,25.4,0,411,417,2188
2004,19,i) 16 to 20,5952,6990,119293,119921,205,2.9,462,6.5,9995,1206,8789,1,8.3,11251,3215,8036,2.7,9.4,-1256,-1.1,16.6,0,301,301,1897
2004,19,j) 21 to 25,4475,5841,87366,87045,177,3,307,5.2,9693,1598,8095,1.8,11.1,9050,2601,6449,3,10.4,643,0.7,20.8,0,203,203,910
2004,19,k) 26+,2015,3475,56875,56219,136,3.9,149,4.3,6958,2551,4407,4.5,12.4,5646,1977,3669,3.5,10,1312,2.4,20,0,79,79,353
2004,19,l) Left Censored,10883,20844,660446,663148,785,3.7,1114,5.3,64068,14033,50035,2.1,9.7,69471,20034,49437,3,10.5,-5403,-0.8,19.4,0,341,342,2989
2004,20,a) 0,4889,4907,27072,13565,4877,198.8,0,0,27014,27014,0,199.1,199.1,0,0,0,0,0,27014,199.1,0,0,,,
2004,20,b) 1,3746,3778,27471,27877,16,0.4,1036,23.8,7628,511,7117,1.8,27.4,8440,5519,2921,19.8,30.3,-812,-2.9,54.8,0,793,793,4157
2004,20,c) 2,3209,3269,24516,26131,131,3.7,614,17.4,3617,402,3215,1.5,13.8,6846,3782,3064,14.5,26.2,-3229,-12.4,27.6,0,497,497,2464
2004,20,d) 3,2829,2895,21602,22367,106,3.5,387,12.7,3681,500,3181,2.2,16.5,5210,2788,2422,12.5,23.3,-1529,-6.8,33,0,303,303,2556
2004,20,e) 4,2548,2618,24398,24681,98,3.5,364,13.2,3671,547,3124,2.2,14.9,4237,1931,2306,7.8,17.2,-566,-2.3,29.8,0,274,274,1455
2004,20,f) 5,2381,2493,20421,20938,123,4.7,328,12.6,2916,535,2381,2.6,13.9,3950,1688,2262,8.1,18.9,-1034,-5,27.8,0,240,240,1281
2004,20,g) 6 to 10,9693,10309,101689,102420,374,3.5,1015,9.5,15312,4006,11306,3.9,15,16774,5908,10866,5.8,16.4,-1462,-1.4,30,0,747,747,4554
2004,20,h) 11 to 15,6835,7396,84284,84886,329,4.3,676,8.9,10705,2373,8332,2.8,12.6,11909,3349,8560,3.9,14,-1204,-1.4,25.2,0,387,388,1770
2004,20,i) 16 to 20,5413,6195,88263,89140,179,2.8,406,6.4,7288,1156,6132,1.3,8.2,9041,2531,6510,2.8,10.1,-1753,-1.9,16.4,0,275,275,1729
2004,20,j) 21 to 25,4094,5070,73175,73409,214,4.2,275,5.4,8912,2576,6336,3.5,12.1,9379,2800,6579,3.8,12.8,-467,-0.7,24.2,0,184,184,1391
2004,20,k) 26+,1655,2898,52621,52357,118,4.1,96,3.3,5312,2014,3298,3.8,10.1,4783,699,4084,1.3,9.1,529,1,18.2,0,44,44,267
2004,20,l) Left Censored,8845,17888,563441,568665,827,4.6,1007,5.6,54286,14428,39858,2.5,9.5,64735,15527,49208,2.7,11.4,-10449,-1.9,19,0,251,252,2108
2004,21,a) 0,5641,5673,39154,19630,5645,199,0,0,39048,39048,0,198.9,198.9,0,0,0,0,0,39048,198.9,0,0,,,
2004,21,b) 1,4134,4173,31991,33013,16,0.3,1191,24.8,8429,184,8245,0.6,25.5,10472,6517,3955,19.7,31.7,-2043,-6.2,51,0,969,969,5785
2004,21,c) 2,3637,3711,32647,33252,129,3.2,728,18.1,7078,711,6367,2.1,21.3,8287,4349,3938,13.1,24.9,-1209,-3.6,42.6,0,584,584,3747
2004,21,d) 3,3264,3337,25977,26715,119,3.4,482,13.6,4409,647,3762,2.4,16.5,5885,2724,3161,10.2,22,-1476,-5.5,33,0,396,396,2077
2004,21,e) 4,3012,3148,26806,27397,116,3.5,401,12.2,4112,427,3685,1.6,15,5294,2529,2765,9.2,19.3,-1182,-4.3,30,0,321,321,2054
2004,21,f) 5,2884,3086,33664,34582,103,3.2,363,11.3,4752,631,4121,1.8,13.7,6588,3201,3387,9.3,19.1,-1836,-5.4,27.4,0,294,294,2911
2004,21,g) 6 to 10,11498,12288,128817,129814,446,3.5,1165,9.2,19512,3930,15582,3,15,21505,8587,12918,6.6,16.6,-1993,-1.6,30,0,899,899,6864
2004,21,h) 11 to 15,8330,9251,113325,114591,291,3.1,757,8,14308,2193,12115,1.9,12.5,16839,5872,10967,5.1,14.7,-2531,-2.2,25,0,489,490,3096
2004,21,i) 16 to 20,7134,8360,142438,143589,246,2.9,497,5.8,13783,2390,11393,1.7,9.6,16087,3469,12618,2.4,11.2,-2304,-1.6,19.2,0,307,307,1993
2004,21,j) 21 to 25,4348,5342,99324,99081,164,3,329,6.1,10697,1890,8807,1.9,10.8,10211,3075,7136,3.1,10.3,486,0.5,20.6,0,198,198,1126
2004,21,k) 26+,1769,3180,67405,67960,132,4.2,126,4,6677,1580,5097,2.3,9.8,7787,2106,5681,3.1,11.5,-1110,-1.7,19.6,0,70,70,661
2004,21,l) Left Censored,9630,22083,748763,742822,1139,5.1,1185,5.4,84870,24242,60628,3.3,11.4,72987,19812,53175,2.7,9.8,11883,1.6,19.6,0,281,286,1953
2004,22,a) 0,6550,6597,46208,23171,6563,199,0,0,46075,46075,0,198.8,198.8,0,0,0,0,0,46075,198.8,0,0,,,
2004,22,b) 1,4933,4993,42541,43370,22,0.4,1334,23.3,11501,148,11353,0.3,26.5,13159,7278,5881,16.8,30.3,-1658,-3.8,53,0,1094,1094,6389
2004,22,c) 2,4295,4388,45541,45254,149,3.2,740,15.7,9846,953,8893,2.1,21.8,9272,3559,5713,7.9,20.5,574,1.3,41,0,602,602,3054
2004,22,d) 3,3779,3884,41581,43925,123,3,557,13.5,7590,431,7159,1,17.3,12278,7931,4347,18.1,28,-4688,-10.7,34.6,0,438,438,7430
2004,22,e) 4,3407,3587,45532,45972,105,2.8,433,11.5,7159,506,6653,1.1,15.6,8039,3489,4550,7.6,17.5,-880,-1.9,31.2,0,345,345,2662
2004,22,f) 5,3133,3296,35125,35024,111,3.2,377,10.9,6163,691,5472,2,17.6,5961,2046,3915,5.8,17,202,0.6,34,0,308,308,1794
2004,22,g) 6 to 10,13270,13932,159898,160216,469,3.3,1247,8.7,25007,2774,22233,1.7,15.6,25642,8426,17216,5.3,16,-635,-0.4,31.2,0,992,1009,6863
2004,22,h) 11 to 15,9060,10077,131468,133948,320,3.1,770,7.5,17363,2668,14695,2,13,22323,6289,16034,4.7,16.7,-4960,-3.7,26,0,549,549,4028
2004,22,i) 16 to 20,7519,8877,146893,146780,247,2.7,537,5.9,16890,2020,14870,1.4,11.5,16664,4284,12380,2.9,11.4,226,0.1,22.8,0,366,366,2138
2004,22,j) 21 to 25,6343,7931,140972,141294,199,2.5,409,5.1,18086,1665,16421,1.2,12.8,18729,3960,14769,2.8,13.3,-643,-0.5,25.6,0,259,259,1860
2004,22,k) 26+,2152,3375,59216,59137,114,3.4,152,4.5,7377,1575,5802,2.7,12.5,7219,1218,6001,2.1,12.2,158,0.3,24.4,0,96,96,415
2004,22,l) Left Censored,10452,23349,710717,715896,1176,5,1404,6,70489,16534,53955,2.3,9.8,80846,23484,57362,3.3,11.3,-10357,-1.5,19.6,0,345,345,2231
2004,23,a) 0,2626,2627,11844,5929,2616,199.2,0,0,11830,11830,0,199.5,199.5,0,0,0,0,0,11830,199.5,0,0,,,
2004,23,b) 1,1887,1904,12206,13168,3,0.1,565,25.5,2537,29,2508,0.2,19.3,4461,3117,1344,23.7,33.9,-1924,-14.6,38.6,0,427,427,2726
2004,23,c) 2,1753,1780,11772,12450,76,4,316,16.5,1989,397,1592,3.2,16,3345,1950,1395,15.7,26.9,-1356,-10.9,32,0,229,229,950
2004,23,d) 3,1643,1679,10599,10788,73,4.1,225,12.8,1610,218,1392,2,14.9,1988,774,1214,7.2,18.4,-378,-3.5,29.8,0,173,173,582
2004,23,e) 4,1449,1500,10645,10865,57,3.6,187,11.9,1516,242,1274,2.2,14,1956,717,1239,6.6,18,-440,-4,28,0,138,138,540
2004,23,f) 5,1408,1468,11798,11894,50,3.2,188,12.2,1634,204,1430,1.7,13.7,1826,814,1012,6.8,15.4,-192,-1.7,27.4,0,130,130,691
2004,23,g) 6 to 10,5377,5645,46371,46707,207,3.5,576,9.9,6633,1065,5568,2.3,14.2,7305,2726,4579,5.8,15.6,-672,-1.4,28.4,0,405,414,2086
2004,23,h) 11 to 15,3644,3874,37474,37693,132,3.3,296,7.5,4634,1175,3459,3.1,12.3,5071,1752,3319,4.6,13.5,-437,-1.2,24.6,0,201,201,856
2004,23,i) 16 to 20,3267,3729,46771,46996,127,3.3,259,6.8,4350,872,3478,1.9,9.3,4799,1837,2962,3.9,10.2,-449,-0.9,18.6,0,169,169,1165
2004,23,j) 21 to 25,1938,2405,40081,40646,65,2.7,137,5.6,3129,355,2774,0.9,7.7,4258,1477,2781,3.6,10.5,-1129,-2.8,15.4,0,66,72,905
2004,23,k) 26+,791,1496,26376,26143,48,3.2,45,3,2541,263,2278,1,9.7,2074,443,1631,1.7,7.9,467,1.8,15.8,0,26,26,104
2004,23,l) Left Censored,3887,7412,220429,219983,344,4.6,330,4.5,19263,3361,15902,1.5,8.8,18370,4180,14190,1.9,8.4,893,0.4,16.8,0,102,102,823
2004,24,a) 0,9249,9280,52557,26345,9233,199,0,0,52425,52425,0,199,199,0,0,0,0,0,52425,199,0,0,,,
2004,24,b) 1,6745,6799,51248,53818,22,0.3,1859,23.8,14011,349,13662,0.6,26,19150,12730,6420,23.7,35.6,-5139,-9.6,52,0,1442,1442,11568
2004,24,c) 2,6154,6254,55043,55487,254,3.8,1017,15.2,11149,1599,9550,2.9,20.1,12037,6822,5215,12.3,21.7,-888,-1.6,40.2,0,788,788,5511
2004,24,d) 3,5243,5342,44278,44066,222,4,718,12.8,8681,1159,7522,2.6,19.7,8256,3947,4309,9,18.7,425,1,37.4,0,550,550,3300
2004,24,e) 4,4757,4918,44821,44619,182,3.6,558,10.9,8438,944,7494,2.1,18.9,8034,3480,4554,7.8,18,404,0.9,36,0,421,421,2756
2004,24,f) 5,4440,4685,53359,51814,187,3.8,519,10.7,11634,1234,10400,2.4,22.5,8543,3366,5177,6.5,16.5,3091,6,33,0,368,368,2385
2004,24,g) 6 to 10,17556,18407,201446,200762,706,3.7,1697,9,30187,4496,25691,2.2,15,28818,10457,18361,5.2,14.4,1369,0.6,28.8,0,1236,1239,8196
2004,24,h) 11 to 15,12359,13552,195550,192905,452,3.3,1000,7.2,27561,3537,24024,1.8,14.3,22271,6971,15300,3.6,11.5,5290,2.8,23,0,620,620,4088
2004,24,i) 16 to 20,10070,11703,196898,195824,383,3.2,729,6.1,23855,4598,19257,2.3,12.2,21707,5833,15874,3,11.1,2148,1.1,22.2,0,461,475,3269
2004,24,j) 21 to 25,6127,7601,140060,141928,249,3.2,402,5.2,15632,2783,12849,2,11,19367,3227,16140,2.3,13.6,-3735,-2.6,22,0,230,230,1762
2004,24,k) 26+,2294,3804,93436,92197,141,3.7,179,4.7,10911,3111,7800,3.4,11.8,8432,1736,6696,1.9,9.1,2479,2.7,18.2,0,112,112,943
2004,24,l) Left Censored,12043,27739,1004646,999644,1565,5.6,1718,6.2,119094,37314,81780,3.7,11.9,109091,33773,75318,3.4,10.9,10003,1,21.8,0,402,402,3794
2004,25,a) 0,10715,10769,59899,30011,10734,199.3,0,0,59777,59777,0,199.2,199.2,0,0,0,0,0,59777,199.2,0,0,,,
2004,25,b) 1,8106,8181,57113,59077,23,0.2,3523,35.1,15825,477,15348,0.8,26.8,19752,10805,8947,18.3,33.4,-3927,-6.6,53.6,0,3004,3004,9358
2004,25,c) 2,7118,7231,61188,63325,295,3.8,1494,19,9489,1217,8272,1.9,15,13762,6709,7053,10.6,21.7,-4273,-6.7,30,0,1233,1233,5725
2004,25,d) 3,6278,6418,54811,55757,244,3.5,1266,18.2,9047,1311,7736,2.4,16.2,10938,4745,6193,8.5,19.6,-1891,-3.4,32.4,0,1051,1051,4028
2004,25,e) 4,5881,6084,55287,54890,266,4.1,1070,16.4,10739,1556,9183,2.8,19.6,9945,4568,5377,8.3,18.1,794,1.5,36.2,0,866,866,3728
2004,25,f) 5,5655,5901,56724,57684,202,3.1,1251,19.4,9509,2936,6573,5.1,16.5,11429,5567,5862,9.7,19.8,-1920,-3.3,33,0,1072,1072,4424
2004,25,g) 6 to 10,22094,22957,235492,240425,797,3.4,2166,9.1,29379,4214,25165,1.8,12.2,39244,13272,25972,5.5,16.3,-9865,-4.1,24.4,0,1612,1612,10338
2004,25,h) 11 to 15,14745,15896,209551,209538,488,3,1190,7.3,28147,6077,22070,2.9,13.4,28120,8469,19651,4,13.4,27,0,26.8,0,835,835,4979
2004,25,i) 16 to 20,14193,16635,283783,286044,590,3.5,1055,6.2,28521,6792,21729,2.4,10,33043,10056,22987,3.5,11.6,-4522,-1.6,20,0,668,671,4205
2004,25,j) 21 to 25,8956,11042,255566,253649,297,2.6,650,5.8,27784,4257,23527,1.7,11,23950,6032,17918,2.4,9.4,3834,1.6,18.8,0,367,385,2339
2004,25,k) 26+,3402,5541,151655,152252,170,3,235,4.2,14021,2993,11028,2,9.2,15215,3323,11892,2.2,10,-1194,-0.8,18.4,0,121,121,950
2004,25,l) Left Censored,20073,39306,1483962,1493632,1859,4.7,2351,5.9,150208,45712,104496,3.1,10.1,169549,45510,124039,3,11.4,-19341,-1.3,20.2,0,667,671,7039
2004,26,a) 0,14178,14252,116237,58267,14179,199,0,0,115941,115941,0,199,199,0,0,0,0,0,115941,199,0,0,,,
2004,26,b) 1,10726,10862,97020,106881,33,0.3,2968,23.8,23894,483,23411,0.5,22.4,43615,16543,27072,15.5,40.8,-19721,-18.4,44.8,0,2217,2222,13715
2004,26,c) 2,9612,9808,99790,101952,366,3.5,1754,16.6,17858,2813,15045,2.8,17.5,22181,10887,11294,10.7,21.8,-4323,-4.3,35,0,1342,1342,8996
2004,26,d) 3,8106,8365,69111,73732,324,3.6,1321,14.8,12301,1961,10340,2.7,16.7,21542,12687,8855,17.2,29.2,-9241,-12.5,33.4,0,983,983,11577
2004,26,e) 4,7603,7837,76181,76103,320,3.9,1126,13.6,14787,2395,12392,3.1,19.4,14630,6585,8045,8.7,19.2,157,0.2,38.4,0,832,832,5325
2004,26,f) 5,7089,7392,75958,78292,295,3.8,951,12.3,11974,1430,10544,1.8,15.3,16641,6861,9780,8.8,21.3,-4667,-6,30.6,0,711,711,4970
2004,26,g) 6 to 10,30296,31814,337522,342778,1288,3.9,3450,10.5,48452,7027,41425,2.1,14.1,58963,21209,37754,6.2,17.2,-10511,-3.1,28.2,0,2457,2459,16242
2004,26,h) 11 to 15,21387,23495,295154,296198,768,3.2,2019,8.4,46621,10722,35899,3.6,15.7,48708,16879,31829,5.7,16.4,-2087,-0.7,31.4,0,1296,1297,7869
2004,26,i) 16 to 20,17713,21180,347302,349067,806,3.8,1334,6.2,39646,9650,29996,2.8,11.4,43176,13815,29361,4,12.4,-3530,-1,22.8,0,800,810,6937
2004,26,j) 21 to 25,11795,14509,250992,251899,430,2.9,868,5.9,31028,6624,24404,2.6,12.3,32841,10771,22070,4.3,13,-1813,-0.7,24.6,0,504,522,3597
2004,26,k) 26+,4521,6947,136278,135800,198,2.8,467,6.6,16534,3463,13071,2.6,12.2,15577,3263,12314,2.4,11.5,957,0.7,23,0,199,208,1193
2004,26,l) Left Censored,23298,52320,1950325,1965364,2440,4.6,3380,6.4,182058,43635,138423,2.2,9.3,212135,57781,154354,2.9,10.8,-30077,-1.5,18.6,0,822,846,9272
2004,27,a) 0,9791,9825,55803,27971,9787,199.2,0,0,55665,55665,0,199,199,0,0,0,0,0,55665,199,0,0,,,
2004,27,b) 1,7314,7369,50338,53106,26,0.3,2059,24.2,12363,546,11817,1,23.3,17898,11973,5925,22.5,33.7,-5535,-10.4,46.6,0,1405,1405,10085
2004,27,c) 2,6415,6534,55768,59434,274,3.9,1107,15.8,8536,863,7673,1.5,14.4,15868,6498,9370,10.9,26.7,-7332,-12.3,28.8,0,807,808,5512
2004,27,d) 3,5567,5691,46591,47397,275,4.6,816,13.6,7901,1216,6685,2.6,16.7,9512,4630,4882,9.8,20.1,-1611,-3.4,33.4,0,607,607,3907
2004,27,e) 4,5130,5283,49056,49641,208,3.8,681,12.3,7002,728,6274,1.5,14.1,8171,3383,4788,6.8,16.5,-1169,-2.4,28.2,0,449,450,2398
2004,27,f) 5,4707,4953,53770,53284,253,4.9,594,11.6,8559,941,7618,1.8,16.1,7587,3006,4581,5.6,14.2,972,1.9,28.4,0,366,368,2142
2004,27,g) 6 to 10,19426,20600,209080,211079,829,3.9,2029,9.5,27084,4379,22705,2.1,12.8,31081,11067,20014,5.2,14.7,-3997,-1.9,25.6,0,1369,1369,8011
2004,27,h) 11 to 15,13213,14419,172923,175421,588,4,1155,7.8,19301,3497,15804,2,11,24296,7450,16846,4.2,13.9,-4995,-2.9,22,0,734,736,4575
2004,27,i) 16 to 20,10010,11962,211816,213406,388,3.2,663,5.5,22594,4774,17820,2.2,10.6,25773,6171,19602,2.9,12.1,-3179,-1.5,21.2,0,426,427,3279
2004,27,j) 21 to 25,6583,8453,166683,168945,310,3.6,485,5.7,16882,3784,13098,2.2,10,21406,6841,14565,4,12.7,-4524,-2.7,20,0,287,287,2469
2004,27,k) 26+,2808,4576,106125,106215,145,3.1,269,5.8,10936,2330,8606,2.2,10.3,11115,4088,7027,3.8,10.5,-179,-0.2,20.6,0,121,128,1382
2004,27,l) Left Censored,14369,30563,1207768,1213347,1598,5.2,1626,5.3,124703,30244,94459,2.5,10.3,135860,40013,95847,3.3,11.2,-11157,-0.9,20.6,0,378,379,4713
2004,28,a) 0,3999,4014,25790,13021,3988,198.7,0,0,25538,25538,0,196.1,196.1,0,0,0,0,0,25538,196.1,0,0,,,
2004,28,b) 1,3052,3092,23921,24236,11,0.3,928,25.8,6910,132,6778,0.5,28.5,7539,4951,2588,20.4,31.1,-629,-2.6,57,0,758,758,4422
2004,28,c) 2,2524,2560,23821,24229,85,3.1,502,18,4405,614,3791,2.5,18.2,5220,2670,2550,11,21.5,-815,-3.3,36.4,0,422,422,2421
2004,28,d) 3,2231,2290,20142,20281,80,3.3,308,12.8,3711,543,3168,2.7,18.3,3989,1649,2340,8.1,19.7,-278,-1.4,36.6,0,245,245,1289
2004,28,e) 4,1990,2064,17671,18066,92,4.2,277,12.8,2733,443,2290,2.5,15.1,3522,1357,2165,7.5,19.5,-789,-4.4,30.2,0,226,226,1175
2004,28,f) 5,1963,2107,19924,19616,86,3.9,239,10.9,4040,1077,2963,5.5,20.6,3423,1345,2078,6.9,17.5,617,3.1,35,0,194,194,1069
2004,28,g) 6 to 10,7660,8122,81525,82133,292,3.5,851,10.1,12194,1642,10552,2,14.8,13410,5114,8296,6.2,16.3,-1216,-1.5,29.6,0,684,684,4187
2004,28,h) 11 to 15,5058,5530,70116,68228,215,3.8,476,8.4,13503,5465,8038,8,19.8,9727,3304,6423,4.8,14.3,3776,5.5,28.6,0,343,343,2042
2004,28,i) 16 to 20,4470,5139,78361,79273,166,3.2,287,5.5,8226,1405,6821,1.8,10.4,10049,2122,7927,2.7,12.7,-1823,-2.3,20.8,0,181,185,871
2004,28,j) 21 to 25,3113,3886,67464,67697,152,3.9,232,5.9,7715,1247,6468,1.8,11.4,8180,2426,5754,3.6,12.1,-465,-0.7,22.8,0,155,155,842
2004,28,k) 26+,1281,1945,46949,46790,76,3.9,111,5.7,5281,2202,3079,4.7,11.3,4963,1494,3469,3.2,10.6,318,0.7,21.2,0,58,58,400
2004,28,l) Left Censored,6345,14679,448069,448851,715,4.9,804,5.5,45749,13189,32560,2.9,10.2,47313,14558,32755,3.2,10.5,-1564,-0.3,20.4,0,193,200,993
2004,29,a) 0,11726,11770,63008,31549,11729,199.3,0,0,62918,62918,0,199.4,199.4,0,0,0,0,0,62918,199.4,0,0,,,
2004,29,b) 1,7966,8039,53202,56127,24,0.3,2564,27.2,13193,295,12898,0.5,23.5,19043,11997,7046,21.4,33.9,-5850,-10.4,47,0,2087,2087,10328
2004,29,c) 2,6678,6780,59503,61210,241,3.3,1293,17.6,9741,774,8967,1.3,15.9,13154,6446,6708,10.5,21.5,-3413,-5.6,31.8,0,1060,1060,5740
2004,29,d) 3,5210,5373,44725,45069,221,3.9,858,15,9016,1127,7889,2.5,20,9703,4126,5577,9.2,21.5,-687,-1.5,40,0,673,673,3302
2004,29,e) 4,5155,5353,46701,47575,223,4,699,12.5,7346,690,6656,1.5,15.4,9094,3586,5508,7.5,19.1,-1748,-3.7,30.8,0,549,549,3108
2004,29,f) 5,4676,4894,49821,49364,195,3.8,565,11.1,9269,1291,7978,2.6,18.8,8355,3200,5155,6.5,16.9,914,1.9,33.8,0,450,450,2664
2004,29,g) 6 to 10,18649,19789,215164,215469,780,3.8,2059,10,33989,4627,29362,2.1,15.8,34598,13238,21360,6.1,16.1,-609,-0.3,31.6,0,1560,1560,10220
2004,29,h) 11 to 15,12787,13968,166726,167733,500,3.5,1239,8.6,23817,3336,20481,2,14.2,25831,8425,17406,5,15.4,-2014,-1.2,28.4,0,859,860,5029
2004,29,i) 16 to 20,11104,13095,216198,218746,417,3.1,863,6.5,22610,3344,19266,1.5,10.3,27706,7987,19719,3.7,12.7,-5096,-2.4,20.6,0,592,593,4452
2004,29,j) 21 to 25,7155,9157,182815,182625,327,3.5,510,5.5,22482,8101,14381,4.4,12.3,22102,9256,12846,5.1,12.1,380,0.2,24.2,0,327,327,2802
2004,29,k) 26+,2832,4890,111995,111195,163,3.3,244,4.9,13429,3336,10093,3,12.1,11828,3599,8229,3.2,10.6,1601,1.5,21.2,0,123,123,1388
2004,29,l) Left Censored,15070,33565,1187355,1192351,1686,5,2010,6,123883,35776,88107,3,10.4,133875,38028,95847,3.2,11.2,-9992,-0.8,20.8,0,514,515,4624
2004,30,a) 0,2802,2811,11321,5685,2802,199.4,0,0,11273,11273,0,198.3,198.3,0,0,0,0,0,11273,198.3,0,0,,,
2004,30,b) 1,1856,1870,9487,10120,6,0.3,539,24.8,2520,,,,24.9,3785,1566,2219,15.5,37.4,-1265,-12.5,49.8,1,363,363,1199
2004,30,c) 2,1676,1709,10457,10663,73,4,285,15.6,1810,223,1587,2.1,17,2222,1112,1110,10.4,20.8,-412,-3.8,34,0,206,206,837
2004,30,d) 3,1461,1472,8573,8676,67,4.3,221,14.2,1480,181,1299,2.1,17.1,1685,825,860,9.5,19.4,-205,-2.3,34.2,0,161,161,634
2004,30,e) 4,1339,1366,10229,10176,54,3.8,188,13.1,1623,119,1504,1.2,15.9,1516,690,826,6.8,14.9,107,1,29.8,0,127,127,513
2004,30,f) 5,1216,1251,9193,9278,37,2.8,143,10.9,1261,97,1164,1,13.6,1431,561,870,6,15.4,-170,-1.8,27.2,0,102,102,392
2004,30,g) 6 to 10,5009,5212,40134,40302,245,4.6,499,9.3,5399,840,4559,2.1,13.4,5735,2094,3641,5.2,14.2,-336,-0.8,26.8,0,335,335,1420
2004,30,h) 11 to 15,2972,3159,27023,26975,139,4.3,293,9,4101,613,3488,2.3,15.2,4004,1587,2417,5.9,14.8,97,0.4,29.6,0,170,170,872
2004,30,i) 16 to 20,2275,2562,32181,32151,109,4.2,194,7.4,3542,,,,11,3481,1302,2179,4,10.8,61,0.2,21.6,1,117,117,966
2004,30,j) 21 to 25,1743,2218,28232,28290,67,3,144,6.4,2889,254,2635,0.9,10.2,3004,988,2016,3.5,10.6,-115,-0.4,20.4,0,70,70,426
2004,30,k) 26+,674,979,12950,12924,50,5.1,56,5.7,1472,281,1191,2.2,11.4,1420,690,730,5.3,11,52,0.4,22,0,40,40,253
2004,30,l) Left Censored,2841,5361,114675,113811,278,5.2,334,6.2,12313,2790,9523,2.5,10.8,10584,4133,6451,3.6,9.3,1729,1.5,18.6,0,94,95,824
2004,31,a) 0,3181,3193,17510,8775,3174,198.8,0,0,17470,17470,0,199.1,199.1,0,0,0,0,0,17470,199.1,0,0,,,
2004,31,b) 1,2410,2430,15661,16044,5,0.2,624,22.4,3768,71,3697,0.4,23.5,4534,3073,1461,19.2,28.3,-766,-4.8,47,0,454,454,2730
2004,31,c) 2,2205,2265,16058,16293,78,3.2,396,16.3,2768,254,2514,1.6,17,3237,1650,1587,10.1,19.9,-469,-2.9,34,0,280,280,1256
2004,31,d) 3,1962,2015,16262,16687,76,3.5,314,14.6,2520,290,2230,1.7,15.1,3369,1388,1981,8.3,20.2,-849,-5.1,30.2,0,233,233,1096
2004,31,e) 4,1788,1831,12751,13231,77,4,248,12.9,1943,445,1498,3.4,14.7,2902,1399,1503,10.6,21.9,-959,-7.2,29.4,0,189,189,1030
2004,31,f) 5,1606,1673,20395,20932,69,3.9,224,12.7,1771,308,1463,1.5,8.5,2845,1136,1709,5.4,13.6,-1074,-5.1,17,0,163,163,712
2004,31,g) 6 to 10,6853,7281,67766,67456,326,4.4,649,8.7,9721,1886,7835,2.8,14.4,9100,2961,6139,4.4,13.5,621,0.9,27,0,444,444,2302
2004,31,h) 11 to 15,4943,5360,57918,57385,254,4.6,434,7.9,7832,2076,5756,3.6,13.6,6765,2127,4638,3.7,11.8,1067,1.8,23.6,0,284,284,1220
2004,31,i) 16 to 20,3820,4364,76510,76827,137,3.1,269,6.1,6800,1671,5129,2.2,8.9,7434,1804,5630,2.3,9.7,-634,-0.8,17.8,0,179,179,929
2004,31,j) 21 to 25,2828,3471,50849,50815,118,3.4,179,5.1,5778,1049,4729,2.1,11.4,5709,1281,4428,2.5,11.2,69,0.2,22.4,0,106,106,582
2004,31,k) 26+,1193,1943,41219,41332,56,2.9,86,4.4,4093,1455,2638,3.5,9.9,4318,936,3382,2.3,10.4,-225,-0.5,19.8,0,44,44,149
2004,31,l) Left Censored,6468,12034,383875,381838,479,4,649,5.4,35319,8743,26576,2.3,9.2,31247,6436,24811,1.7,8.2,4072,1,16.4,0,184,205,1078
2004,32,a) 0,5562,5581,37891,18971,5560,199.2,0,0,37840,37840,0,199.5,199.5,0,0,0,0,0,37840,199.5,0,0,,,
2004,32,b) 1,3927,3999,33983,34126,21,0.4,1262,27,10448,595,9853,1.7,30.6,10734,6325,4409,18.5,31.5,-286,-0.9,61.2,0,1005,1005,5474
2004,32,c) 2,3097,3141,33800,35063,120,3.5,647,18.9,6109,632,5477,1.8,17.4,8634,4341,4293,12.4,24.6,-2525,-7.2,34.8,0,530,530,3425
2004,32,d) 3,2524,2592,30466,31076,126,4.6,432,15.7,5564,489,5075,1.6,17.9,6783,2176,4607,7,21.8,-1219,-3.9,35.8,0,328,328,1775
2004,32,e) 4,2201,2261,30091,30311,97,4,367,15.3,5927,867,5060,2.9,19.6,6367,2802,3565,9.2,21,-440,-1.4,39.2,0,290,290,2440
2004,32,f) 5,1981,2085,29829,29335,104,4.7,303,13.8,5204,699,4505,2.4,17.7,4215,1573,2642,5.4,14.4,989,3.3,28.8,0,239,239,1223
2004,32,g) 6 to 10,6642,7145,121264,121463,327,4.4,799,10.8,17610,2668,14942,2.2,14.5,18007,6207,11800,5.1,14.8,-397,-0.3,29,0,622,622,5136
2004,32,h) 11 to 15,3646,4125,72482,72018,193,4.6,343,8.1,11043,2030,9013,2.8,15.3,10115,3615,6500,5,14,928,1.3,28,0,244,245,3002
2004,32,i) 16 to 20,2597,3384,71741,70270,158,4.6,248,7.2,10800,1777,9023,2.5,15.4,7857,2545,5312,3.6,11.2,2943,4.2,22.4,0,158,159,1354
2004,32,j) 21 to 25,1925,2630,69354,68572,157,6,151,5.7,9177,2447,6730,3.6,13.4,7612,1754,5858,2.6,11.1,1565,2.3,22.2,0,87,87,941
2004,32,k) 26+,769,1386,69241,67195,95,6.8,116,8.3,8588,2702,5886,4,12.8,4496,1556,2940,2.3,6.7,4092,6.1,13.4,0,37,37,615
2004,32,l) Left Censored,3291,8785,411944,403514,822,9.5,645,7.4,61792,18086,43706,4.5,15.3,44931,15314,29617,3.8,11.1,16861,4.2,22.2,0,78,95,1261
2004,33,a) 0,2619,2626,11796,5911,2614,199.1,0,0,11771,11771,0,199.1,199.1,0,0,0,0,0,11771,199.1,0,0,,,
2004,33,b) 1,1842,1865,11216,11635,6,0.3,520,24.2,2874,23,2851,0.2,24.7,3712,2354,1358,20.2,31.9,-838,-7.2,49.4,0,383,383,2004
2004,33,c) 2,1616,1630,13043,13167,68,3.9,278,16,2213,248,1965,1.9,16.8,2460,1057,1403,8,18.7,-247,-1.9,33.6,0,222,222,798
2004,33,d) 3,1400,1441,11449,11645,52,3.4,220,14.4,1872,141,1731,1.2,16.1,2264,987,1277,8.5,19.4,-392,-3.3,32.2,0,176,176,659
2004,33,e) 4,1333,1368,10884,10912,51,3.6,173,12.1,1682,234,1448,2.1,15.4,1738,719,1019,6.6,15.9,-56,-0.5,30.8,0,139,139,642
2004,33,f) 5,1226,1274,11232,11652,52,3.9,144,10.9,1484,149,1335,1.3,12.7,2323,829,1494,7.1,19.9,-839,-7.2,25.4,0,109,109,686
2004,33,g) 6 to 10,5361,5538,51105,51688,197,3.4,579,10.1,6706,883,5823,1.7,13,7872,3470,4402,6.7,15.2,-1166,-2.2,26,0,426,426,2536
2004,33,h) 11 to 15,3463,3664,43172,43434,134,3.6,278,7.4,5494,975,4519,2.2,12.6,6018,2642,3376,6.1,13.9,-524,-1.3,25.2,0,204,204,1540
2004,33,i) 16 to 20,3421,3848,61691,61293,120,3.1,237,6.1,6574,1195,5379,1.9,10.7,5777,1664,4113,2.7,9.4,797,1.3,18.8,0,157,157,976
2004,33,j) 21 to 25,1770,2070,32265,32486,67,3.2,115,5.5,2526,290,2236,0.9,7.8,2967,888,2079,2.7,9.1,-441,-1.3,15.6,0,66,76,333
2004,33,k) 26+,719,1219,26725,26550,44,3.6,63,5.1,2764,849,1915,3.2,10.4,2414,386,2028,1.5,9.1,350,1.3,18.2,0,29,29,230
2004,33,l) Left Censored,3843,7669,256393,255352,395,5.2,379,4.9,24069,5752,18317,2.3,9.4,21987,5879,16108,2.3,8.6,2082,0.8,17.2,0,109,116,2096
2004,34,a) 0,16912,16945,89251,44717,16875,199.2,0,0,89069,89069,0,199.2,199.2,0,0,0,0,0,89069,199.2,0,0,,,
2004,34,b) 1,12475,12552,88329,88596,26,0.2,3465,24,24108,282,23826,0.3,27.2,24642,13418,11224,15.1,27.8,-534,-0.6,54.4,0,2652,2652,11051
2004,34,c) 2,10681,10770,85428,88602,404,3.5,1945,16.8,17151,1326,15825,1.5,19.4,23498,12003,11495,13.5,26.5,-6347,-7.1,38.8,0,1553,1553,10634
2004,34,d) 3,9693,9868,92244,90806,448,4.3,1420,13.7,17536,1592,15944,1.8,19.3,14659,5622,9037,6.2,16.1,2877,3.2,32.2,0,1102,1102,4704
2004,34,e) 4,8631,8759,78347,77817,359,3.9,1251,13.5,14180,1390,12790,1.8,18.2,13120,5926,7194,7.6,16.9,1060,1.3,33.8,0,943,943,4890
2004,34,f) 5,8291,8581,81409,82185,335,3.7,1083,12,11684,1565,10119,1.9,14.2,13236,5844,7392,7.1,16.1,-1552,-1.9,28.4,0,843,848,4909
2004,34,g) 6 to 10,32595,33829,359775,362236,1215,3.5,3575,10.2,56209,6536,49673,1.8,15.5,61131,18717,42414,5.2,16.9,-4922,-1.4,31,0,2715,2715,15155
2004,34,h) 11 to 15,20911,21980,256137,259607,709,3.1,1784,7.9,32224,5535,26689,2.1,12.4,39163,11675,27488,4.5,15.1,-6939,-2.7,24.8,0,1255,1256,8616
2004,34,i) 16 to 20,18023,20328,334407,337338,627,3,1440,6.9,36641,7010,29631,2.1,10.9,42502,13936,28566,4.1,12.6,-5861,-1.7,21.8,0,971,974,7333
2004,34,j) 21 to 25,11867,13824,252297,253022,466,3.3,880,6.3,27256,5748,21508,2.3,10.8,28706,8260,20446,3.3,11.3,-1450,-0.5,21.6,0,602,613,4221
2004,34,k) 26+,4412,6113,160006,159237,216,3.5,364,5.9,15994,4729,11265,3,10,14455,3574,10881,2.2,9.1,1539,0.9,18.2,0,203,206,1823
2004,34,l) Left Censored,23265,45750,1710313,1707984,2501,5.4,4360,9.3,222686,57677,165009,3.4,13,218028,68357,149671,4,12.8,4658,0.2,25.6,0,1010,1018,11474
2004,35,a) 0,3106,3130,19298,9693,3107,198.5,0,0,19210,19210,0,198.2,198.2,0,0,0,0,0,19210,198.2,0,0,,,
2004,35,b) 1,2191,2210,17175,17612,7,0.3,637,24.8,4380,26,4354,0.1,24.9,5253,3241,2012,18.4,29.8,-873,-4.9,49.8,0,515,515,2983
2004,35,c) 2,1957,1986,18530,18694,87,4.1,377,17.6,3114,335,2779,1.8,16.7,3441,1607,1834,8.6,18.4,-327,-1.7,33.4,0,295,295,1304
2004,35,d) 3,1767,1872,16500,16974,76,3.8,265,13.4,2783,598,2185,3.5,16.4,3730,1584,2146,9.3,22,-947,-5.6,32.8,0,207,207,1323
2004,35,e) 4,1532,1584,15603,15803,61,3.7,212,12.7,2644,235,2409,1.5,16.7,3043,1089,1954,6.9,19.3,-399,-2.6,33.4,0,163,163,850
2004,35,f) 5,1393,1447,14010,14393,58,3.8,175,11.6,1867,364,1503,2.5,13,2633,841,1792,5.8,18.3,-766,-5.3,26,0,125,125,647
2004,35,g) 6 to 10,5970,6286,65694,66207,269,4.2,609,9.4,10155,1828,8327,2.8,15.3,11181,3466,7715,5.2,16.9,-1026,-1.6,30.6,0,452,452,2689
2004,35,h) 11 to 15,4004,4415,48185,48828,171,3.8,358,7.9,6541,1460,5081,3,13.4,7828,2643,5185,5.4,16,-1287,-2.6,26.8,0,229,229,1613
2004,35,i) 16 to 20,3096,3691,65384,66529,124,3.3,253,6.7,5816,733,5083,1.1,8.7,8105,1847,6258,2.8,12.2,-2289,-3.5,17.4,0,169,169,1081
2004,35,j) 21 to 25,2438,3097,46981,47164,106,3.4,189,6,5291,1236,4055,2.6,11.2,5657,1544,4113,3.3,12,-366,-0.8,22.4,0,121,121,669
2004,35,k) 26+,906,1569,32198,32262,89,5.7,65,4.2,4791,1750,3041,5.4,14.9,4918,2338,2580,7.2,15.2,-127,-0.3,29.8,0,33,33,147
2004,35,l) Left Censored,3831,8282,221783,220875,431,5.2,530,6.4,27888,6841,21047,3.1,12.6,26071,9433,16638,4.3,11.8,1817,0.8,23.6,0,94,94,985
2004,36,a) 0,37788,37885,197682,99043,37702,199,0,0,197278,197278,0,199.2,199.2,0,0,0,0,0,197278,199.2,0,0,,,
2004,36,b) 1,28280,28458,182253,189516,56,0.2,7982,24.4,45802,1339,44463,0.7,24.2,60328,35619,24709,18.8,31.8,-14526,-7.6,48.4,0,6146,6146,29973
2004,36,c) 2,23778,24068,195804,195414,909,3.5,4744,18.2,44244,8099,36145,4.1,22.6,43463,23158,20305,11.9,22.2,781,0.4,44.4,0,3738,3741,19093
2004,36,d) 3,20853,21106,167654,173961,796,3.5,3591,15.9,29571,4609,24962,2.6,17,42185,18118,24067,10.4,24.2,-12614,-7.2,34,0,2807,2807,15305
2004,36,e) 4,18658,19018,153127,159086,722,3.6,2812,14,23195,3049,20146,1.9,14.6,35113,16436,18677,10.3,22.1,-11918,-7.5,29.2,0,2215,2219,13056
2004,36,f) 5,17116,17737,161365,165720,611,3.3,2217,11.9,24504,2479,22025,1.5,14.8,33214,13716,19498,8.3,20,-8710,-5.2,29.6,0,1708,1708,11678
2004,36,g) 6 to 10,66480,69017,688431,699092,2265,3.2,7381,10.3,89100,11491,77609,1.6,12.7,110421,43256,67165,6.2,15.8,-21321,-3.1,25.4,0,5588,5591,33530
2004,36,h) 11 to 15,44406,46727,533284,537863,1369,2.8,3794,7.9,63908,8025,55883,1.5,11.9,73066,21921,51145,4.1,13.6,-9158,-1.7,23.8,0,2691,2691,15884
2004,36,i) 16 to 20,38216,42338,675533,671042,1266,2.9,2799,6.5,75755,15731,60024,2.3,11.3,66773,18600,48173,2.8,10,8982,1.3,20,0,1924,1927,12044
2004,36,j) 21 to 25,24268,28777,528329,532677,756,2.6,1769,6,48132,7568,40564,1.4,9,56827,14800,42027,2.8,10.7,-8695,-1.7,18,0,1177,1200,8523
2004,36,k) 26+,8828,13661,325516,322100,424,3.1,735,5.3,37844,7910,29934,2.5,11.7,31011,6508,24503,2,9.6,6833,2.1,19.2,0,391,395,2447
2004,36,l) Left Censored,50684,98932,3598539,3617883,6490,6.5,7572,7.6,415270,102947,312323,2.8,11.5,453959,112962,340997,3.1,12.5,-38689,-1,23,0,2103,2125,20396
2004,37,a) 0,14748,14813,89551,44884,14733,198.9,0,0,89334,89334,0,199,199,0,0,0,0,0,89334,199,0,0,,,
2004,37,b) 1,10825,10920,83926,84196,43,0.3,2893,23.1,23791,832,22959,1,28.3,24330,14560,9770,17.3,28.9,-539,-0.6,56.6,0,2291,2291,12829
2004,37,c) 2,9156,9375,75766,77279,375,3.7,1641,16.3,15580,1903,13677,2.5,20.2,18606,8771,9835,11.3,24.1,-3026,-3.9,40.4,0,1288,1288,7601
2004,37,d) 3,8567,8853,77389,77447,363,3.9,1262,13.5,13921,1768,12153,2.3,18,14036,6444,7592,8.3,18.1,-115,-0.1,36,0,1029,1029,5367
2004,37,e) 4,7558,7921,75159,75547,291,3.5,1070,12.8,12381,1429,10952,1.9,16.4,13156,4881,8275,6.5,17.4,-775,-1,32.8,0,824,824,3969
2004,37,f) 5,7217,7669,80076,80139,310,3.9,900,11.3,12503,1958,10545,2.4,15.6,12628,5219,7409,6.5,15.8,-125,-0.2,31.2,0,667,673,4087
2004,37,g) 6 to 10,27172,28939,307860,311268,1153,3.9,2860,9.6,47212,6826,40386,2.2,15.2,54028,18309,35719,5.9,17.4,-6816,-2.2,30.4,0,2064,2083,14744
2004,37,h) 11 to 15,17237,19148,242437,242980,678,3.5,1572,8,34447,7160,27287,2.9,14.2,35533,11527,24006,4.7,14.6,-1086,-0.4,28.4,0,1122,1123,8457
2004,37,i) 16 to 20,15952,19071,314588,316252,618,3.2,1161,6,35588,6773,28815,2.1,11.3,38915,12349,26566,3.9,12.3,-3327,-1,22.6,0,770,783,6357
2004,37,j) 21 to 25,9125,11918,224848,226114,410,3.4,662,5.5,23204,4731,18473,2.1,10.3,25735,5559,20176,2.5,11.4,-2531,-1.1,20.6,0,422,422,2852
2004,37,k) 26+,3544,6074,142433,140338,299,4.9,292,4.8,21122,5655,15467,4,15.1,16931,6053,10878,4.3,12.1,4191,3,24.2,0,157,157,1472
2004,37,l) Left Censored,17587,45502,1630943,1647487,2445,5.4,2672,5.9,171364,42141,129223,2.6,10.4,204452,55536,148916,3.4,12.4,-33088,-2,20.8,0,584,586,5888
2004,38,a) 0,1351,1358,6512,3272,1342,197.6,0,0,6481,6481,0,198.1,198.1,0,0,0,0,0,6481,198.1,0,0,,,
2004,38,b) 1,936,947,5530,5582,5,0.5,267,24.2,1531,20,1511,0.4,27.4,1635,1025,610,18.4,29.3,-104,-1.9,54.8,0,167,167,865
2004,38,c) 2,837,857,5719,5767,45,4.9,164,17.8,1133,102,1031,1.8,19.6,1229,596,633,10.3,21.3,-96,-1.7,39.2,0,112,112,498
2004,38,d) 3,733,753,5668,5661,36,4.5,118,14.8,810,65,745,1.1,14.3,795,358,437,6.3,14,15,0.3,28,0,76,76,260
2004,38,e) 4,692,703,4629,4742,42,5.8,72,10,817,103,714,2.2,17.2,1043,494,549,10.4,22,-226,-4.8,34.4,0,47,47,435
2004,38,f) 5,602,622,4596,4591,27,4.2,65,10.1,625,68,557,1.5,13.6,614,255,359,5.6,13.4,11,0.2,26.8,0,43,43,197
2004,38,g) 6 to 10,2798,2904,23552,23824,166,5.6,313,10.5,2820,444,2376,1.9,11.8,3363,1266,2097,5.3,14.1,-543,-2.3,23.6,0,189,189,986
2004,38,h) 11 to 15,2203,2333,21143,21024,135,5.7,219,9.2,2701,463,2238,2.2,12.8,2462,968,1494,4.6,11.7,239,1.1,23.4,0,127,127,527
2004,38,i) 16 to 20,1690,1885,20678,20553,58,3,103,5.4,2234,551,1683,2.7,10.9,1983,574,1409,2.8,9.6,251,1.3,19.2,0,80,80,483
2004,38,j) 21 to 25,1340,1653,21737,22110,38,2.3,82,4.9,2006,99,1907,0.4,9.1,2751,1349,1402,6.1,12.4,-745,-3.3,18.2,0,54,54,209
2004,38,k) 26+,529,707,10220,11052,20,2.8,38,5.3,988,229,759,2.1,8.9,2651,1460,1191,13.2,24,-1663,-15.1,17.8,0,18,18,164
2004,38,l) Left Censored,2945,5105,135318,134112,153,3,219,4.3,12155,2410,9745,1.8,9.1,9742,3563,6179,2.7,7.3,2413,1.8,14.6,0,68,68,405
2004,39,a) 0,14507,14582,99227,49729,14509,199,0,0,98997,98997,0,199.1,199.1,0,0,0,0,0,98997,199.1,0,0,,,
2004,39,b) 1,10950,11103,91836,96895,47,0.4,3043,23.9,22783,919,21864,0.9,23.5,32901,20192,12709,20.8,34,-10118,-10.5,47,0,2388,2388,17684
2004,39,c) 2,9928,10272,100357,103329,395,3.6,1825,16.5,18410,2994,15416,2.9,17.8,24354,11307,13047,10.9,23.6,-5944,-5.8,35.6,0,1431,1433,9548
2004,39,d) 3,8730,9045,76388,77813,336,3.5,1237,13,13371,1618,11753,2.1,17.2,16220,6951,9269,8.9,20.8,-2849,-3.6,34.4,0,977,977,5807
2004,39,e) 4,8043,8382,90519,89123,348,4,1101,12.5,18044,2324,15720,2.6,20.2,15252,6181,9071,6.9,17.1,2792,3.1,34.2,0,827,827,4862
2004,39,f) 5,7720,8305,97050,98705,313,3.6,972,11.2,12762,1746,11016,1.8,12.9,16071,6512,9559,6.6,16.3,-3309,-3.4,25.8,0,733,733,5062
2004,39,g) 6 to 10,32599,34961,369128,373902,1284,3.5,3470,9.6,52848,8318,44530,2.2,14.1,62396,26147,36249,7,16.7,-9548,-2.6,28.2,0,2565,2572,21634
2004,39,h) 11 to 15,23461,26035,332907,337978,810,3,2071,7.7,41306,6191,35115,1.8,12.2,51447,21088,30359,6.2,15.2,-10141,-3,24.4,0,1412,1412,15133
2004,39,i) 16 to 20,20175,24295,399018,401976,752,3,1469,5.9,39835,6761,33074,1.7,9.9,45751,11655,34096,2.9,11.4,-5916,-1.5,19.8,0,944,949,7506
2004,39,j) 21 to 25,13745,17327,324581,327528,609,3.5,996,5.7,33522,7163,26359,2.2,10.2,39416,10469,28947,3.2,12,-5894,-1.8,20.4,0,599,605,4930
2004,39,k) 26+,5675,9455,208208,208670,335,3.5,447,4.7,19834,6288,13546,3,9.5,20758,4831,15927,2.3,9.9,-924,-0.4,19,0,215,235,2084
2004,39,l) Left Censored,31650,72142,2551984,2563295,3676,5.1,3841,5.3,256806,69119,187687,2.7,10,279429,76336,203093,3,10.9,-22623,-0.9,20,0,1061,1072,10723
2004,40,a) 0,5801,5827,32785,16428,5807,199.3,0,0,32715,32715,0,199.1,199.1,0,0,0,0,0,32715,199.1,0,0,,,
2004,40,b) 1,4388,4408,27965,29032,8,0.2,1294,25.3,7553,25,7528,0.1,26,9687,5846,3841,20.1,33.4,-2134,-7.4,52,0,1069,1069,5335
2004,40,c) 2,3843,3925,34064,33730,144,3.4,756,17.8,7929,1156,6773,3.4,23.5,7260,3535,3725,10.5,21.5,669,2,43,0,601,607,2957
2004,40,d) 3,3314,3434,25475,26018,170,4.7,484,13.4,4759,610,4149,2.3,18.3,5845,2626,3219,10.1,22.5,-1086,-4.2,36.6,0,406,406,2396
2004,40,e) 4,2998,3113,27673,28804,107,3.2,457,13.9,4497,798,3699,2.8,15.6,6758,3001,3757,10.4,23.5,-2261,-7.9,31.2,0,334,338,1945
2004,40,f) 5,2836,2944,30112,30597,117,3.8,359,11.7,5820,673,5147,2.2,19,6790,2509,4281,8.2,22.2,-970,-3.2,38,0,271,271,2097
2004,40,g) 6 to 10,11218,12027,116432,116118,524,4.2,1202,9.7,20606,4610,15996,4,17.7,19977,7143,12834,6.2,17.2,629,0.5,34.4,0,893,894,5648
2004,40,h) 11 to 15,7832,8466,96178,97394,315,3.6,675,7.8,11936,2267,9669,2.3,12.3,14367,4245,10122,4.4,14.8,-2431,-2.5,24.6,0,450,450,2351
2004,40,i) 16 to 20,6409,7383,108922,109116,222,3,429,5.7,12344,1852,10492,1.7,11.3,12732,2781,9951,2.5,11.7,-388,-0.4,22.6,0,292,293,1512
2004,40,j) 21 to 25,5240,6323,107453,106646,182,2.8,340,5.3,11868,2341,9527,2.2,11.1,10253,2399,7854,2.2,9.6,1615,1.5,19.2,0,214,214,936
2004,40,k) 26+,1777,2959,59489,58483,172,5.9,110,3.8,8939,3904,5035,6.7,15.3,6926,1302,5624,2.2,11.8,2013,3.5,23.6,0,63,63,697
2004,40,l) Left Censored,8170,18327,517628,521538,914,5,1017,5.5,54076,14841,39235,2.8,10.4,61897,15087,46810,2.9,11.9,-7821,-1.5,20.8,0,290,312,2097
2004,41,a) 0,7622,7672,41294,20692,7632,199,0,0,41205,41205,0,199.1,199.1,0,0,0,0,0,41205,199.1,0,0,,,
2004,41,b) 1,5586,5686,33303,34019,23,0.3,1667,25.3,9153,267,8886,0.8,26.9,10585,6105,4480,17.9,31.1,-1432,-4.2,53.8,0,1268,1268,4981
2004,41,c) 2,4875,4975,33705,34077,204,3.8,871,16.3,6849,1170,5679,3.4,20.1,7593,3852,3741,11.3,22.3,-744,-2.2,40.2,0,671,671,3160
2004,41,d) 3,4333,4450,31514,32067,196,4.2,689,14.6,5175,655,4520,2,16.1,6281,3253,3028,10.1,19.6,-1106,-3.5,32.2,0,505,505,2558
2004,41,e) 4,3862,3973,32373,32214,179,4.3,560,13.4,5808,531,5277,1.6,18,5490,2262,3228,7,17,318,1,34,0,434,434,1802
2004,41,f) 5,3673,3822,29516,29562,174,4.4,430,10.9,4859,1057,3802,3.6,16.4,4950,2246,2704,7.6,16.7,-91,-0.3,32.8,0,307,307,1626
2004,41,g) 6 to 10,14651,15439,154410,154665,714,4.5,1561,9.8,21110,4099,17011,2.7,13.6,21619,8299,13320,5.4,14,-509,-0.4,27.2,0,1108,1113,6649
2004,41,h) 11 to 15,9320,10096,109597,111656,375,3.6,935,9,14649,2163,12486,1.9,13.1,18766,8980,9786,8,16.8,-4117,-3.7,26.2,0,610,610,5120
2004,41,i) 16 to 20,7012,8312,127782,128364,299,3.5,629,7.4,13512,2223,11289,1.7,10.5,14676,3698,10978,2.9,11.4,-1164,-0.9,21,0,411,412,2424
2004,41,j) 21 to 25,5173,6542,107939,108736,224,3.4,352,5.3,10888,2118,8770,1.9,10,12482,4305,8177,4,11.5,-1594,-1.5,20,0,205,205,1426
2004,41,k) 26+,2015,3162,66829,68065,139,4.4,143,4.5,6276,2217,4059,3.3,9.2,8747,2360,6387,3.5,12.9,-2471,-3.7,18.4,0,79,79,465
2004,41,l) Left Censored,8267,18879,584983,587664,1157,6.1,1089,5.8,60318,16162,44156,2.8,10.3,65681,21180,44501,3.6,11.2,-5363,-0.9,20.6,0,279,283,1787
2004,42,a) 0,17014,17163,106910,53555,17086,199.1,0,0,106710,106710,0,199.3,199.3,0,0,0,0,0,106710,199.3,0,0,,,
2004,42,b) 1,12797,12914,104764,106207,33,0.2,3181,21.7,25407,397,25010,0.4,23.9,28293,17171,11122,16.2,26.6,-2886,-2.7,47.8,0,2464,2464,14929
2004,42,c) 2,11661,11903,119018,118009,443,3.5,1886,14.9,28185,1797,26388,1.5,23.9,26166,10547,15619,8.9,22.2,2019,1.7,44.4,0,1476,1476,8678
2004,42,d) 3,10437,10682,89917,102327,417,3.7,1393,12.4,14914,2579,12335,2.5,14.6,39733,30453,9280,29.8,38.8,-24819,-24.2,29.2,0,1110,1110,29358
2004,42,e) 4,9635,9908,96856,97677,401,3.9,1153,11.2,15629,2640,12989,2.7,16,17270,7188,10082,7.4,17.7,-1641,-1.7,32,0,888,888,6050
2004,42,f) 5,8991,9497,96038,96030,323,3.3,979,9.9,14216,2323,11893,2.4,14.8,14199,5748,8451,6,14.8,17,0,29.6,0,730,730,4395
2004,42,g) 6 to 10,36019,38376,414881,415875,1289,3.3,3519,8.9,59638,8810,50828,2.1,14.3,61625,23350,38275,5.6,14.8,-1987,-0.5,28.6,0,2611,2611,17269
2004,42,h) 11 to 15,27007,29139,354456,356295,854,2.9,2283,7.6,48080,7920,40160,2.2,13.5,51757,18016,33741,5.1,14.5,-3677,-1,27,0,1605,1605,10099
2004,42,i) 16 to 20,24719,28974,458814,462100,851,2.9,1823,6.2,43426,9470,33956,2,9.4,49997,15967,34030,3.5,10.8,-6571,-1.4,18.8,0,1199,1203,7684
2004,42,j) 21 to 25,15472,18820,341717,346754,781,4.1,997,5.3,36557,8157,28400,2.4,10.5,46631,17838,28793,5.1,13.4,-10074,-2.9,21,0,634,644,4486
2004,42,k) 26+,6148,10123,232293,232015,324,3.2,453,4.4,22464,5021,17443,2.2,9.7,21908,4629,17279,2,9.4,556,0.3,18.8,0,245,245,1927
2004,42,l) Left Censored,34572,75406,2672651,2672007,3381,4.5,4368,5.8,285471,71581,213890,2.7,10.7,284183,82981,201202,3.1,10.6,1288,0.1,21.2,0,1220,1224,10963
2004,44,a) 0,2099,2107,11544,5776,2102,199.5,0,0,11537,11537,0,199.7,199.7,0,0,0,0,0,11537,199.7,0,0,,,
2004,44,b) 1,1464,1471,10719,11101,2,0.1,375,22.4,2355,,,,21.2,3118,2022,1096,18.2,28.1,-763,-6.9,42.4,1,279,279,1780
2004,44,c) 2,1231,1241,8667,8771,60,4.5,232,17.4,1623,,,,18.5,1831,770,1061,8.8,20.9,-208,-2.4,37,1,176,176,592
2004,44,d) 3,1104,1123,8139,8145,57,4.9,142,12.1,1348,228,1120,2.8,16.6,1359,483,876,5.9,16.7,-11,-0.1,33.2,0,106,106,351
2004,44,e) 4,956,988,8019,7950,34,3.3,120,11.6,1294,99,1195,1.2,16.3,1156,484,672,6.1,14.5,138,1.8,29,0,81,81,401
2004,44,f) 5,938,970,8659,8551,35,3.5,100,9.9,1389,97,1292,1.1,16.2,1173,419,754,4.9,13.7,216,2.5,27.4,0,66,66,291
2004,44,g) 6 to 10,3795,3924,38279,37727,122,3,331,8.2,5672,587,5085,1.6,15,4568,1310,3258,3.5,12.1,1104,2.9,24.2,0,252,252,1110
2004,44,h) 11 to 15,2765,2880,33443,33470,110,3.8,197,6.7,4672,1060,3612,3.2,14,4725,1386,3339,4.1,14.1,-53,-0.1,28,0,142,142,1197
2004,44,i) 16 to 20,2521,2811,39956,40121,96,3.4,184,6.4,4134,602,3532,1.5,10.3,4463,1582,2881,3.9,11.1,-329,-0.8,20.6,0,124,124,896
2004,44,j) 21 to 25,1493,1714,28311,28336,47,2.7,113,6.5,3353,587,2766,2.1,11.8,3403,1108,2295,3.9,12,-50,-0.2,23.6,0,82,83,881
2004,44,k) 26+,663,845,17022,17167,16,1.9,34,4,1447,193,1254,1.1,8.4,1736,246,1490,1.4,10.1,-289,-1.7,16.8,0,24,24,152
2004,44,l) Left Censored,3939,6239,219741,218113,269,4.3,313,5,22988,4428,18560,2,10.5,19733,5706,14027,2.6,9,3255,1.5,18,0,125,125,1349
2004,45,a) 0,7047,7088,43658,21896,7064,199.3,0,0,43524,43524,0,198.8,198.8,0,0,0,0,0,43524,198.8,0,0,,,
2004,45,b) 1,5300,5341,45798,47985,14,0.2,1438,23.5,12203,146,12057,0.3,25.4,16577,7074,9503,14.7,34.5,-4374,-9.1,50.8,0,1143,1143,6236
2004,45,c) 2,4641,4751,36641,38676,171,3.3,822,16.1,6942,532,6410,1.4,17.9,11012,5933,5079,15.3,28.5,-4070,-10.6,35.8,0,678,678,5307
2004,45,d) 3,3930,4066,40065,40766,178,4.1,645,15,6531,887,5644,2.2,16,7933,3504,4429,8.6,19.5,-1402,-3.5,32,0,520,520,3042
2004,45,e) 4,3700,3852,37105,37580,156,3.9,482,11.9,6653,1642,5011,4.4,17.7,7603,3337,4266,8.9,20.2,-950,-2.5,35.4,0,403,403,2886
2004,45,f) 5,3417,3618,39564,40183,135,3.6,447,11.8,5890,779,5111,1.9,14.7,7127,2812,4315,7,17.7,-1237,-3,29.4,0,326,326,2161
2004,45,g) 6 to 10,12834,13520,157453,160521,525,3.8,1383,9.9,21881,3402,18479,2.1,13.6,28017,10327,17690,6.4,17.5,-6136,-3.9,27.2,0,1057,1057,7728
2004,45,h) 11 to 15,8286,9339,116582,117575,323,3.4,709,7.4,17063,4155,12908,3.5,14.5,19048,7082,11966,6,16.2,-1985,-1.7,29,0,496,497,2810
2004,45,i) 16 to 20,7450,9174,140365,140624,292,3.1,539,5.8,15124,2641,12483,1.9,10.8,15641,3998,11643,2.8,11.1,-517,-0.3,21.6,0,361,361,1867
2004,45,j) 21 to 25,4289,5495,97930,98553,213,3.8,311,5.6,10407,3161,7246,3.2,10.6,11652,2946,8706,3,11.8,-1245,-1.2,21.2,0,194,194,1238
2004,45,k) 26+,1755,3133,53650,53404,119,3.8,138,4.4,7623,2986,4637,5.6,14.3,7131,2215,4916,4.1,13.4,492,0.9,26.8,0,76,76,445
2004,45,l) Left Censored,8758,21492,731084,733719,1207,5.6,1184,5.5,75129,21677,53452,3,10.2,80400,21138,59262,2.9,11,-5271,-0.8,20.4,0,286,286,2657
2004,46,a) 0,1756,1759,7340,3691,1743,198.2,0,0,7298,7298,0,197.7,197.7,0,0,0,0,0,7298,197.7,0,0,,,
2004,46,b) 1,1298,1315,7428,7669,11,0.7,403,26.3,1865,90,1775,1.2,24.3,2346,1526,820,19.9,30.6,-481,-6.3,48.6,0,293,293,1289
2004,46,c) 2,1260,1275,7966,8139,59,4.3,211,15.5,1265,137,1128,1.7,15.5,1610,703,907,8.6,19.8,-345,-4.3,31,0,147,147,517
2004,46,d) 3,996,1026,6663,7050,41,3.8,159,14.7,1084,168,916,2.4,15.4,1857,1084,773,15.4,26.3,-773,-10.9,30.8,0,129,129,724
2004,46,e) 4,910,943,7742,7864,38,3.9,114,11.6,997,212,785,2.7,12.7,1241,468,773,6,15.8,-244,-3.1,25.4,0,74,74,327
2004,46,f) 5,826,852,7013,7017,30,3.4,89,10,961,76,885,1.1,13.7,968,320,648,4.6,13.8,-7,-0.1,27.4,0,66,66,271
2004,46,g) 6 to 10,3542,3681,30430,30331,165,4.4,324,8.6,4228,680,3548,2.2,13.9,4029,1487,2542,4.9,13.3,199,0.6,26.6,0,229,229,1095
2004,46,h) 11 to 15,2446,2588,23651,23579,135,5.1,232,8.8,3332,918,2414,3.9,14.1,3188,833,2355,3.5,13.5,144,0.6,27,0,149,149,621
2004,46,i) 16 to 20,1825,2029,25950,25487,56,2.7,119,5.8,3732,369,3363,1.4,14.6,2805,961,1844,3.8,11,927,3.6,22,0,80,80,834
2004,46,j) 21 to 25,1271,1572,20350,20399,55,3.5,82,5.2,2086,459,1627,2.3,10.2,2183,648,1535,3.2,10.7,-97,-0.5,20.4,0,48,48,245
2004,46,k) 26+,554,794,12587,12586,23,2.9,35,4.4,1517,386,1131,3.1,12.1,1514,816,698,6.5,12,3,0.1,24,0,22,22,184
2004,46,l) Left Censored,2999,5239,147458,146087,200,3.8,300,5.7,16915,3789,13126,2.6,11.6,14172,4597,9575,3.1,9.7,2743,1.9,19.4,0,95,95,539
2004,47,a) 0,8670,8712,58513,29315,8675,199.2,0,0,58396,58396,0,199.2,199.2,0,0,0,0,0,58396,199.2,0,0,,,
2004,47,b) 1,6239,6305,53113,55731,28,0.4,1885,25.7,13675,294,13381,0.5,24.5,18910,11552,7358,20.7,33.9,-5235,-9.4,49,0,1557,1557,10251
2004,47,c) 2,5213,5370,50049,50743,200,3.4,1022,17.6,10164,1412,8752,2.8,20,11551,6474,5077,12.8,22.8,-1387,-2.8,40,0,852,852,5668
2004,47,d) 3,4505,4638,41281,41712,176,3.6,710,14.4,7587,868,6719,2.1,18.2,8448,3447,5001,8.3,20.3,-861,-2.1,36.4,0,593,593,2996
2004,47,e) 4,4059,4203,45275,45573,169,3.8,582,13.1,8129,820,7309,1.8,17.8,8725,4145,4580,9.1,19.1,-596,-1.3,35.6,0,457,457,3311
2004,47,f) 5,3878,4295,50523,50180,184,4.1,500,11.2,10291,1332,8959,2.7,20.5,9605,4027,5578,8,19.1,686,1.4,38.2,0,390,390,2968
2004,47,g) 6 to 10,16083,17342,202978,203566,710,4,1750,9.8,31597,5263,26334,2.6,15.5,32773,12642,20131,6.2,16.1,-1176,-0.6,31,0,1336,1336,9835
2004,47,h) 11 to 15,11184,12645,172881,171766,423,3.3,998,7.7,25808,4935,20873,2.9,15,23577,8098,15479,4.7,13.7,2231,1.3,27.4,0,711,712,4880
2004,47,i) 16 to 20,10313,12305,204107,207258,421,3.4,725,5.8,21388,4646,16742,2.2,10.3,27690,5665,22025,2.7,13.4,-6302,-3.1,20.6,0,481,483,3048
2004,47,j) 21 to 25,6138,7802,148718,148606,271,3.4,421,5.3,15689,3687,12002,2.5,10.6,15465,3642,11823,2.5,10.4,224,0.2,20.8,0,289,289,1985
2004,47,k) 26+,2682,5245,134549,133531,168,3.2,197,3.7,15819,5734,10085,4.3,11.8,13783,2286,11497,1.7,10.3,2036,1.5,20.6,0,87,87,538
2004,47,l) Left Censored,12544,31712,1175437,1168816,1836,5.8,1839,5.8,135580,37192,98388,3.2,11.6,122338,37657,84681,3.2,10.5,13242,1.1,21,0,398,412,4492
2004,48,a) 0,36385,36620,259128,130632,36460,199.1,0,0,256992,256992,0,196.7,196.7,0,0,0,0,0,256992,196.7,0,0,,,
2004,48,b) 1,26749,27122,232468,242377,105,0.3,8289,26.2,61113,1072,60041,0.4,25.2,80931,48388,32543,20,33.4,-19818,-8.2,50.4,0,6790,6795,42574
2004,48,c) 2,22479,23180,244011,253988,831,3.3,4610,18.3,44428,4513,39915,1.8,17.5,64384,34063,30321,13.4,25.3,-19956,-7.8,35,0,3846,3848,30438
2004,48,d) 3,19260,20014,197542,202095,812,3.8,3249,15.2,37573,4939,32634,2.4,18.6,46679,22731,23948,11.2,23.1,-9106,-4.5,37.2,0,2617,2627,19272
2004,48,e) 4,17211,18000,187178,191107,696,3.7,2665,14,32944,4644,28300,2.4,17.2,40802,17341,23461,9.1,21.4,-7858,-4.2,34.4,0,2130,2130,13871
2004,48,f) 5,15812,16852,204595,208221,586,3.3,2163,12.2,35404,6816,28588,3.3,17,42656,16674,25982,8,20.5,-7252,-3.5,34,0,1743,1744,12849
2004,48,g) 6 to 10,61842,67050,827257,839624,2674,3.8,7086,10.2,127944,21935,106009,2.6,15.2,152677,56583,96094,6.7,18.2,-24733,-3,30.4,0,5451,5473,42464
2004,48,h) 11 to 15,41677,46751,662707,673175,1880,3.9,4247,8.8,95705,22636,73069,3.4,14.2,116641,37152,79489,5.5,17.3,-20936,-3.1,28.4,0,2843,2843,20105
2004,48,i) 16 to 20,31807,39629,702912,712934,1381,3.4,2640,6.5,88940,17664,71276,2.5,12.5,108984,25136,83848,3.5,15.3,-20044,-2.8,25,0,1758,1783,13611
2004,48,j) 21 to 25,24423,31992,604767,598183,1157,3.6,2068,6.4,94380,33504,60876,5.6,15.8,81214,24801,56413,4.1,13.6,13166,2.2,27.2,0,1253,1254,9088
2004,48,k) 26+,7747,14391,321643,321124,609,4.2,742,5.1,39467,12737,26730,4,12.3,38428,8120,30308,2.5,12,1039,0.3,24,0,359,380,2418
2004,48,l) Left Censored,31568,101174,3597116,3589369,7452,7.4,6830,6.8,467520,167907,299613,4.7,13,452026,143270,308756,4,12.6,15494,0.4,25.2,0,1194,1195,10983
2004,49,a) 0,5804,5834,32465,16301,5805,199,0,0,32328,32328,0,198.3,198.3,0,0,0,0,0,32328,198.3,0,0,,,
2004,49,b) 1,4195,4221,34785,34078,14,0.3,1314,26.6,12093,147,11946,0.4,35.5,10679,7036,3643,20.6,31.3,1414,4.2,62.6,0,983,983,6067
2004,49,c) 2,3429,3492,28945,29152,172,4.5,698,18.5,6227,613,5614,2.1,21.4,6641,3254,3387,11.2,22.8,-414,-1.4,42.8,0,535,536,2781
2004,49,d) 3,2795,2873,24748,24489,139,4.5,493,16.1,5423,531,4892,2.2,22.1,4904,2563,2341,10.5,20,519,2.1,40,0,361,361,2124
2004,49,e) 4,2449,2502,22727,23367,132,5,362,13.8,3774,494,3280,2.1,16.2,5053,2467,2586,10.6,21.6,-1279,-5.4,32.4,0,273,273,2075
2004,49,f) 5,2178,2247,20864,21747,114,4.8,311,13.2,3461,607,2854,2.8,15.9,5226,1818,3408,8.4,24,-1765,-8.1,31.8,0,234,234,1523
2004,49,g) 6 to 10,8088,8484,106369,105628,383,4.4,863,9.9,18387,2516,15871,2.4,17.4,16905,4713,12192,4.5,16,1482,1.4,32,0,597,597,3381
2004,49,h) 11 to 15,4381,4747,79649,81109,171,3.5,452,9.2,12416,2426,9990,3,15.3,15336,3809,11527,4.7,18.9,-2920,-3.6,30.6,0,264,264,2256
2004,49,i) 16 to 20,2977,3672,81652,77710,132,3.5,268,7.1,17074,1401,15673,1.8,22,9190,2700,6490,3.5,11.8,7884,10.2,23.6,0,159,159,1308
2004,49,j) 21 to 25,2285,2974,56271,56693,166,5.5,203,6.8,7181,2211,4970,3.9,12.7,8024,2944,5080,5.2,14.2,-843,-1.5,25.4,0,120,120,1051
2004,49,k) 26+,967,1477,36428,34602,66,4.4,83,5.6,6568,3060,3508,8.8,19,2915,995,1920,2.9,8.4,3653,10.6,16.8,0,38,38,273
2004,49,l) Left Censored,4137,10363,417265,412947,728,7,689,6.7,50989,18062,32927,4.4,12.3,42353,12135,30218,2.9,10.3,8636,2,20.6,0,132,132,1021
2004,50,a) 0,1315,1319,6681,3346,1316,199.5,0,0,6671,6671,0,199.4,199.4,0,0,0,0,0,6671,199.4,0,0,,,
2004,50,b) 1,1030,1043,6025,6118,3,0.3,248,21,1237,11,1226,0.2,20.2,1422,688,734,11.2,23.2,-185,-3,40.4,0,169,169,561
2004,50,c) 2,884,895,5703,5940,45,4.7,149,15.7,735,137,598,2.3,12.4,1209,617,592,10.4,20.4,-474,-8,24.8,0,114,114,543
2004,50,d) 3,790,797,4808,4970,31,3.7,105,12.5,743,67,676,1.3,14.9,1067,419,648,8.4,21.5,-324,-6.6,29.8,0,78,78,351
2004,50,e) 4,781,800,6675,7216,39,4.7,77,9.4,756,119,637,1.6,10.5,1837,313,1524,4.3,25.5,-1081,-15,21,0,56,56,267
2004,50,f) 5,723,750,5319,5391,28,3.6,78,10,742,144,598,2.7,13.8,885,322,563,6,16.4,-143,-2.6,27.6,0,51,51,208
2004,50,g) 6 to 10,3002,3138,23929,24687,110,3.4,295,9.1,2509,290,2219,1.2,10.2,4024,1754,2270,7.1,16.3,-1515,-6.1,20.4,0,228,228,1478
2004,50,h) 11 to 15,2388,2489,21158,21385,87,3.4,194,7.6,2228,285,1943,1.3,10.4,2682,861,1821,4,12.5,-454,-2.1,20.8,0,116,116,557
2004,50,i) 16 to 20,2078,2284,32307,32305,72,3.1,135,5.8,2654,239,2415,0.7,8.2,2650,410,2240,1.3,8.2,4,0,16.4,0,84,84,296
2004,50,j) 21 to 25,1215,1436,19212,19554,39,2.7,83,5.7,1669,436,1233,2.2,8.5,2353,1054,1299,5.4,12,-684,-3.5,17,0,52,52,579
2004,50,k) 26+,475,669,12938,13128,13,1.9,28,4.1,867,66,801,0.5,6.6,1247,235,1012,1.8,9.5,-380,-2.9,13.2,0,18,18,60
2004,50,l) Left Censored,2346,3990,110399,111387,158,3.9,187,4.7,7853,1723,6130,1.5,7.1,9828,2056,7772,1.8,8.8,-1975,-1.7,14.2,0,53,53,363
2004,51,a) 0,13496,13525,79366,39751,13460,199,0,0,79230,79230,0,199.3,199.3,0,0,0,0,0,79230,199.3,0,0,,,
2004,51,b) 1,9402,9479,67840,69135,32,0.3,2595,23.9,19153,456,18697,0.7,27.7,21742,14457,7285,20.9,31.4,-2589,-3.7,55.4,0,2059,2059,12302
2004,51,c) 2,8139,8288,63502,63777,330,3.7,1343,15.2,13442,1815,11627,2.8,21.1,13991,7337,6654,11.5,21.9,-549,-0.8,42.2,0,1074,1074,6485
2004,51,d) 3,6981,7287,61141,61068,306,4,1001,13.1,13133,1528,11605,2.5,21.5,12987,7205,5782,11.8,21.3,146,0.2,42.6,0,782,782,6337
2004,51,e) 4,6440,6669,59727,58499,286,4.1,821,11.8,12315,1451,10864,2.5,21.1,9858,4026,5832,6.9,16.9,2457,4.2,33.8,0,604,606,3210
2004,51,f) 5,5918,6260,65413,64448,222,3.4,649,10,10674,1087,9587,1.7,16.6,8744,3467,5277,5.4,13.6,1930,3,27.2,0,481,481,2477
2004,51,g) 6 to 10,23976,25341,288807,285800,982,3.8,2281,8.8,45399,7081,38318,2.5,15.9,39386,13231,26155,4.6,13.8,6013,2.1,27.6,0,1637,1639,10571
2004,51,h) 11 to 15,16358,17844,243912,244353,625,3.4,1292,7.1,33050,6170,26880,2.5,13.5,33931,12276,21655,5,13.9,-881,-0.4,27,0,861,861,4972
2004,51,i) 16 to 20,13900,16773,294264,294908,501,2.9,978,5.7,33702,6140,27562,2.1,11.4,34990,9676,25314,3.3,11.9,-1288,-0.5,22.8,0,616,620,4615
2004,51,j) 21 to 25,8195,10570,218575,215660,449,4.2,525,4.9,26012,4978,21034,2.3,12.1,20182,4837,15345,2.2,9.4,5830,2.7,18.8,0,329,329,2769
2004,51,k) 26+,3053,5411,114885,113075,207,3.8,230,4.2,14947,4880,10067,4.3,13.2,11327,2013,9314,1.8,10,3620,3.2,20,0,127,127,929
2004,51,l) Left Censored,15341,41137,1457819,1438729,2526,6.2,2324,5.7,192136,55022,137114,3.8,13.4,153956,36305,117651,2.5,10.7,38180,2.7,21.4,0,481,492,4976
2004,53,a) 0,12956,12997,67074,33648,12910,198.7,0,0,66853,66853,0,198.7,198.7,0,0,0,0,0,66853,198.7,0,0,,,
2004,53,b) 1,9213,9256,61979,64502,21,0.2,2986,27.4,16281,439,15842,0.7,25.2,21326,10211,11115,15.8,33.1,-5045,-7.9,50.4,0,2203,2203,8308
2004,53,c) 2,8077,8238,56944,57025,386,4.4,1462,16.6,12394,1691,10703,3,21.7,12556,6637,5919,11.6,22,-162,-0.3,43.4,0,1135,1135,5594
2004,53,d) 3,6962,7132,53645,54277,324,4.3,1101,14.6,9707,1439,8268,2.7,17.9,10970,5172,5798,9.5,20.2,-1263,-2.3,35.8,0,870,870,4411
2004,53,e) 4,6380,6615,54821,55033,339,4.9,935,13.5,9873,1336,8537,2.4,17.9,10296,4520,5776,8.2,18.7,-423,-0.8,35.8,0,693,693,3455
2004,53,f) 5,5990,6324,57962,58443,271,4.1,798,12.1,8799,1225,7574,2.1,15.1,9760,4046,5714,6.9,16.7,-961,-1.6,30.2,0,580,580,3274
2004,53,g) 6 to 10,23119,24287,230454,232407,1104,4.4,2569,10.2,35021,6835,28186,2.9,15.1,38926,13850,25076,6,16.7,-3905,-1.6,30.2,0,1844,1844,10846
2004,53,h) 11 to 15,15238,16503,182206,184829,752,4.4,1587,9.4,24755,4313,20442,2.3,13.4,30000,10725,19275,5.8,16.2,-5245,-2.8,26.8,0,1020,1020,5400
2004,53,i) 16 to 20,11353,13504,217816,218656,500,3.6,925,6.7,22389,4794,17595,2.2,10.2,24069,6242,17827,2.9,11,-1680,-0.8,20.4,0,594,596,4042
2004,53,j) 21 to 25,7800,9952,191871,192849,456,4.5,580,5.8,19927,3873,16054,2,10.3,21882,6051,15831,3.1,11.3,-1955,-1,20.6,0,359,363,2038
2004,53,k) 26+,3057,4976,109299,107634,202,4,295,5.9,13089,3082,10007,2.9,12.2,9759,2655,7104,2.5,9.1,3330,3.1,18.2,0,138,138,673
2004,53,l) Left Censored,12286,29734,979346,969539,1798,6.1,1678,5.7,122810,37306,85504,3.8,12.7,103196,24196,79000,2.5,10.6,19614,2.1,21.2,0,396,397,4648
2004,54,a) 0,2334,2354,12543,6290,2344,199.2,0,0,12506,12506,0,198.8,198.8,0,0,0,0,0,12506,198.8,0,0,,,
2004,54,b) 1,1641,1668,13145,13053,15,0.8,462,24.2,3469,101,3368,0.8,26.6,3284,1938,1346,14.8,25.2,185,1.4,50.4,0,368,368,1640
2004,54,c) 2,1473,1506,11827,11927,59,3.6,274,16.9,2401,340,2061,2.9,20.1,2600,1433,1167,12,21.8,-199,-1.7,40.2,0,216,216,1269
2004,54,d) 3,1274,1304,11213,11196,50,3.6,185,13.4,1973,178,1795,1.6,17.6,1939,909,1030,8.1,17.3,34,0.3,34.6,0,153,153,826
2004,54,e) 4,1283,1334,10764,10690,57,4.1,155,11.2,1855,160,1695,1.5,17.4,1707,743,964,7,16,148,1.4,32,0,120,120,565
2004,54,f) 5,1166,1240,11901,11829,55,4.3,141,11,2143,438,1705,3.7,18.1,1999,844,1155,7.1,16.9,144,1.2,33.8,0,113,113,586
2004,54,g) 6 to 10,4902,5248,48291,48047,229,4.2,504,9.3,8143,1362,6781,2.8,16.9,7654,2383,5271,5,15.9,489,1,31.8,0,384,384,1900
2004,54,h) 11 to 15,3600,3827,40044,40695,126,3.2,327,8.3,4517,491,4026,1.2,11.1,5819,2162,3657,5.3,14.3,-1302,-3.2,22.2,0,234,234,1505
2004,54,i) 16 to 20,3332,3835,59467,60180,118,3,237,6.1,5255,697,4558,1.2,8.7,6680,1553,5127,2.6,11.1,-1425,-2.4,17.4,0,168,168,1029
2004,54,j) 21 to 25,2237,2522,35471,35359,62,2.4,154,6,4311,516,3795,1.5,12.2,4087,1307,2780,3.7,11.6,224,0.6,23.2,0,97,114,766
2004,54,k) 26+,945,1815,32204,32146,84,4.6,78,4.3,3798,1081,2717,3.4,11.8,3681,845,2836,2.6,11.5,117,0.3,23,0,42,43,150
2004,54,l) Left Censored,5188,10451,274690,274820,428,4.1,512,4.9,25039,5882,19157,2.1,9.1,25298,5395,19903,2,9.2,-259,-0.1,18.2,0,182,182,1017
2004,55,a) 0,8353,8401,57286,28690,8364,199.1,0,0,57193,57193,0,199.3,199.3,0,0,0,0,0,57193,199.3,0,0,,,
2004,55,b) 1,6330,6393,48834,50703,17,0.2,1706,23.3,11190,134,11056,0.3,22.1,14927,9906,5021,19.5,29.4,-3737,-7.3,44.2,0,1274,1274,8297
2004,55,c) 2,5921,6053,48430,49046,226,3.5,971,15.1,8951,1387,7564,2.8,18.3,10182,4786,5396,9.8,20.8,-1231,-2.5,36.6,0,730,730,3979
2004,55,d) 3,5041,5255,52672,52945,197,3.6,712,12.9,7166,635,6531,1.2,13.5,7712,3579,4133,6.8,14.6,-546,-1.1,27,0,543,543,2764
2004,55,e) 4,4823,4984,45435,45433,193,3.7,531,10.3,6992,914,6078,2,15.4,6988,2631,4357,5.8,15.4,4,0,30.8,0,377,377,1991
2004,55,f) 5,4455,4819,53638,53501,194,3.9,523,10.5,7728,958,6770,1.8,14.4,7453,3074,4379,5.7,13.9,275,0.5,27.8,0,379,380,1818
2004,55,g) 6 to 10,18594,19567,194636,195651,681,3.4,1801,8.9,25931,3497,22434,1.8,13.3,27960,9021,18939,4.6,14.3,-2029,-1,26.6,0,1283,1292,7290
2004,55,h) 11 to 15,14323,15424,172050,172179,583,3.7,1240,7.9,21750,3868,17882,2.2,12.6,22008,7670,14338,4.5,12.8,-258,-0.2,25.2,0,811,817,5327
2004,55,i) 16 to 20,10850,12862,207971,207151,354,2.7,754,5.8,24951,4018,20933,1.9,12,23311,6731,16580,3.2,11.3,1640,0.7,22.6,0,477,482,3549
2004,55,j) 21 to 25,7005,8486,151362,151687,233,2.7,447,5.2,14981,2435,12546,1.6,9.9,15630,4269,11361,2.8,10.3,-649,-0.4,19.8,0,274,278,2878
2004,55,k) 26+,3024,5224,111820,111385,201,3.8,202,3.9,11286,2412,8874,2.2,10.1,10415,2876,7539,2.6,9.4,871,0.7,18.8,0,115,120,792
2004,55,l) Left Censored,16637,33721,1292246,1285054,1551,4.6,1563,4.6,132150,35593,96557,2.8,10.3,117766,31152,86614,2.4,9.2,14384,1.1,18.4,0,494,500,4728
2004,56,a) 0,1399,1403,6073,3041,1396,199,0,0,6064,6064,0,199.4,199.4,0,0,0,0,0,6064,199.4,0,0,,,
2004,56,b) 1,1063,1065,6268,6031,4,0.3,294,23.9,1990,29,1961,0.5,33,1516,1009,507,16.7,25.1,474,7.9,50.2,0,210,210,724
2004,56,c) 2,1033,1041,6977,6932,53,4.7,185,16.6,1514,137,1377,2,21.8,1424,681,743,9.8,20.5,90,1.3,41,0,134,134,520
2004,56,d) 3,805,812,5010,5104,26,3,115,13.4,929,111,818,2.2,18.2,1117,485,632,9.5,21.9,-188,-3.7,36.4,0,81,81,392
2004,56,e) 4,791,809,5201,5151,32,3.8,98,11.6,927,108,819,2.1,18,827,406,421,7.9,16.1,100,1.9,32.2,0,73,73,331
2004,56,f) 5,637,655,4329,4597,21,3,87,12.6,633,123,510,2.7,13.8,1168,481,687,10.5,25.4,-535,-11.6,27.6,0,62,62,345
2004,56,g) 6 to 10,2727,2836,22766,22745,126,4.3,278,9.5,3551,374,3177,1.6,15.6,3508,1235,2273,5.4,15.4,43,0.2,30.8,0,198,198,895
2004,56,h) 11 to 15,1678,1785,18639,18756,74,4,163,8.9,2368,364,2004,1.9,12.6,2601,882,1719,4.7,13.9,-233,-1.3,25.2,0,103,103,477
2004,56,i) 16 to 20,1276,1396,16535,16329,40,2.8,84,5.9,1884,216,1668,1.3,11.5,1472,333,1139,2,9,412,2.5,18,0,58,58,239
2004,56,j) 21 to 25,1122,1349,17404,17204,46,3.4,79,5.8,2196,497,1699,2.9,12.8,1795,333,1462,1.9,10.4,401,2.4,20.8,0,54,54,245
2004,56,k) 26+,445,646,10325,10079,33,5.1,25,3.9,1450,365,1085,3.6,14.4,957,145,812,1.4,9.5,493,4.9,19,0,15,15,109
2004,56,l) Left Censored,1836,3250,65496,64866,210,6.5,206,6.3,7540,2186,5354,3.4,11.6,6280,1781,4499,2.7,9.7,1260,1.9,19.4,0,41,41,265
2005,01,a) 0,6691,6770,45007,22624,6729,198.8,0,0,44767,44767,0,197.9,197.9,0,0,0,0,0,44767,197.9,0,0,,,
2005,01,b) 1,5030,5067,39037,39156,19,0.3,1342,23.1,10933,90,10843,0.2,27.9,11171,6630,4541,16.9,28.5,-238,-0.6,55.8,0,1130,1130,5849
2005,01,c) 2,4255,4295,37461,39463,137,2.9,809,17.4,7337,613,6724,1.6,18.6,11341,5985,5356,15.2,28.7,-4004,-10.1,37.2,0,695,695,5613
2005,01,d) 3,3665,3766,34951,35714,123,3.1,536,13.4,6637,637,6000,1.8,18.6,8163,3613,4550,10.1,22.9,-1526,-4.3,37.2,0,454,454,3295
2005,01,e) 4,3192,3364,33649,33849,125,3.5,450,12.7,6688,635,6053,1.9,19.8,7087,2521,4566,7.4,20.9,-399,-1.1,39.6,0,366,371,2200
2005,01,f) 5,3026,3171,33975,34468,114,3.4,389,11.7,5967,841,5126,2.4,17.3,6953,2489,4464,7.2,20.2,-986,-2.9,34.6,0,322,322,2011
2005,01,g) 6 to 10,13254,14187,154761,156587,534,3.7,1364,9.3,24901,4409,20492,2.8,15.9,28552,9133,19419,5.8,18.2,-3651,-2.3,31.8,0,1054,1054,6814
2005,01,h) 11 to 15,8824,9651,125867,127598,330,3.3,845,8.5,17877,2508,15369,2,14,21339,6539,14800,5.1,16.7,-3462,-2.7,28,0,634,635,5195
2005,01,i) 16 to 20,6990,8427,161914,163868,280,3.3,498,5.8,18265,3500,14765,2.1,11.1,22172,6519,15653,4,13.5,-3907,-2.4,22.2,0,348,348,2750
2005,01,j) 21 to 25,5534,6738,129123,128170,172,2.5,300,4.4,13975,2185,11790,1.7,10.9,12068,2783,9285,2.2,9.4,1907,1.5,18.8,0,219,219,1275
2005,01,k) 26+,2846,5078,97219,96243,201,3.9,241,4.7,13508,4503,9005,4.7,14,11556,2556,9000,2.7,12,1952,2,24,0,130,140,1256
2005,01,l) Left Censored,9065,23065,767938,755829,1460,6.4,1131,4.9,102241,29171,73070,3.9,13.5,78022,16140,61882,2.1,10.3,24219,3.2,20.6,0,293,294,1982
2005,02,a) 0,1280,1283,6047,3045,1272,198.3,0,0,6004,,,,197.2,0,0,0,0,0,6004,197.2,0,1,,,
2005,02,b) 1,963,970,5309,5520,6,0.5,335,29,1534,,,,27.8,1956,942,1014,17.1,35.4,-422,-7.6,55.6,1,223,223,707
2005,02,c) 2,790,821,5489,5593,57,6.5,144,16.5,1359,149,1210,2.7,24.3,1567,508,1059,9.1,28,-208,-3.7,48.6,0,107,107,395
2005,02,d) 3,808,839,6527,6497,43,4.9,120,13.7,1361,148,1213,2.3,20.9,1301,550,751,8.5,20,60,0.9,40,0,85,85,427
2005,02,e) 4,629,647,5131,4951,43,6.4,94,13.9,1186,161,1025,3.3,24,825,387,438,7.8,16.7,361,7.3,33.4,0,69,69,261
2005,02,f) 5,645,677,9000,8793,28,4,72,10.2,2041,104,1937,1.2,23.2,1626,412,1214,4.7,18.5,415,4.7,37,0,48,48,274
2005,02,g) 6 to 10,2425,2580,23521,23603,150,5.7,262,9.9,3888,410,3478,1.7,16.5,4052,1165,2887,4.9,17.2,-164,-0.7,33,0,181,181,900
2005,02,h) 11 to 15,1640,1737,14961,15036,91,5.2,139,7.9,2343,311,2032,2.1,15.6,2493,877,1616,5.8,16.6,-150,-1,31.2,0,91,91,596
2005,02,i) 16 to 20,1288,1451,21547,21667,52,3.5,89,6.1,2276,484,1792,2.2,10.5,2515,419,2096,1.9,11.6,-239,-1.1,21,0,66,66,350
2005,02,j) 21 to 25,1079,1372,24368,23909,29,2.1,73,5.2,2969,343,2626,1.4,12.4,2050,318,1732,1.3,8.6,919,3.8,17.2,0,44,44,235
2005,02,k) 26+,553,970,18576,18398,39,4,46,4.7,1994,326,1668,1.8,10.8,1637,290,1347,1.6,8.9,357,1.9,17.8,0,23,23,233
2005,02,l) Left Censored,1388,3110,89463,89277,182,5.9,120,3.9,8844,2284,6560,2.6,9.9,8472,1404,7068,1.6,9.5,372,0.4,19,0,24,24,236
2005,04,a) 0,11186,11341,79074,39690,11264,198.6,0,0,78768,78768,0,198.5,198.5,0,0,0,0,0,78768,198.5,0,0,,,
2005,04,b) 1,7861,7952,64127,63290,47,0.5,2062,22.7,18529,906,17623,1.4,29.3,16854,9722,7132,15.4,26.6,1675,2.7,53.2,0,1637,1637,8233
2005,04,c) 2,6341,6451,64692,63516,253,3.6,1172,16.9,16838,1758,15080,2.8,26.5,14485,6815,7670,10.7,22.8,2353,3.7,45.6,0,988,988,6074
2005,04,d) 3,5535,5648,62486,62727,214,3.6,827,13.8,12133,1245,10888,2,19.3,12614,5513,7101,8.8,20.1,-481,-0.8,38.6,0,671,671,4790
2005,04,e) 4,4884,5091,51642,51796,218,4.1,648,12.1,8752,1232,7520,2.4,16.9,9060,3486,5574,6.7,17.5,-308,-0.6,33.8,0,505,505,2605
2005,04,f) 5,4312,4482,75489,73691,177,3.8,543,11.6,12297,1213,11084,1.6,16.7,8700,3797,4903,5.2,11.8,3597,4.9,23.6,0,427,427,2929
2005,04,g) 6 to 10,16656,17949,247567,245351,835,4.5,1819,9.8,42407,5966,36441,2.4,17.3,37974,14486,23488,5.9,15.5,4433,1.8,31,0,1401,1401,12105
2005,04,h) 11 to 15,9787,10700,171574,170283,452,4.1,893,8.2,27567,6034,21533,3.5,16.2,24985,7724,17261,4.5,14.7,2582,1.5,29.4,0,664,664,6371
2005,04,i) 16 to 20,7313,9738,194065,192990,437,4.4,635,6.4,26637,7052,19585,3.7,13.8,24487,8074,16413,4.2,12.7,2150,1.1,25.4,0,395,398,5382
2005,04,j) 21 to 25,5305,7468,154554,150885,347,4.6,437,5.8,22966,9094,13872,6,15.2,15628,4101,11527,2.7,10.4,7338,4.8,20.8,0,249,249,2357
2005,04,k) 26+,2431,4535,131306,127718,312,6.9,255,5.7,25605,13076,12529,10.2,20,18428,3850,14578,3,14.4,7177,5.6,28.8,0,113,114,989
2005,04,l) Left Censored,6595,21616,845709,830409,2021,9.5,1200,5.7,131665,48518,83147,5.8,15.9,101065,29232,71833,3.5,12.2,30600,3.7,24.4,0,212,212,2792
2005,05,a) 0,4662,4697,26550,13318,4662,198.5,0,0,26464,,,,198.7,0,0,0,0,0,26464,198.7,0,1,,,
2005,05,b) 1,3387,3411,21690,23093,10,0.3,1054,26.5,5390,,,,23.3,8196,5332,2864,23.1,35.5,-2806,-12.2,46.6,1,871,871,4814
2005,05,c) 2,2903,2924,20660,21448,104,3.3,580,18.3,3861,286,3575,1.3,18,5436,2291,3145,10.7,25.3,-1575,-7.3,36,0,487,487,2037
2005,05,d) 3,2547,2609,22282,22980,94,3.4,415,14.9,3712,428,3284,1.9,16.2,5107,1980,3127,8.6,22.2,-1395,-6,32.4,0,339,339,1785
2005,05,e) 4,2194,2274,18268,18496,86,3.6,325,13.6,3365,381,2984,2.1,18.2,3820,1318,2502,7.1,20.7,-455,-2.5,36.4,0,268,268,1082
2005,05,f) 5,2039,2124,17797,18589,71,3.2,271,12.1,2882,517,2365,2.8,15.5,4465,1929,2536,10.4,24,-1583,-8.5,31,0,216,216,1711
2005,05,g) 6 to 10,8414,9137,85606,87756,333,3.5,894,9.5,12801,3008,9793,3.4,14.6,17101,5963,11138,6.8,19.5,-4300,-4.9,29.2,0,708,708,4904
2005,05,h) 11 to 15,5991,6490,65273,66692,259,3.9,583,8.8,9050,2089,6961,3.1,13.6,11888,3987,7901,6,17.8,-2838,-4.2,27.2,0,441,443,2425
2005,05,i) 16 to 20,4116,4979,98377,98812,135,2.7,307,6.1,9252,1746,7506,1.8,9.4,10122,3724,6398,3.8,10.2,-870,-0.8,18.8,0,230,232,1831
2005,05,j) 21 to 25,3619,4339,72553,72275,111,2.5,245,5.6,8360,810,7550,1.1,11.6,7803,2125,5678,2.9,10.8,557,0.8,21.6,0,180,180,1255
2005,05,k) 26+,1926,2860,60300,60015,89,3.1,124,4.3,6389,1848,4541,3.1,10.6,5819,1261,4558,2.1,9.7,570,0.9,19.4,0,81,81,636
2005,05,l) Left Censored,6081,14327,507907,501568,843,5.9,558,3.9,53431,16482,36949,3.3,10.7,40753,8207,32546,1.6,8.1,12678,2.6,16.2,0,181,183,2101
2005,06,a) 0,70034,71594,464348,233418,71121,198.7,0,0,461860,461860,0,197.9,197.9,0,0,0,0,0,461860,197.9,0,0,,,
2005,06,b) 1,50168,50559,415410,418258,215,0.4,13777,23.7,117124,2423,114701,0.6,28,122821,67932,54889,16.2,29.4,-5697,-1.4,56,0,11004,11004,55552
2005,06,c) 2,42459,43012,378117,383893,1858,4,8266,17.8,91057,10810,80247,2.8,23.7,102609,52986,49623,13.8,26.7,-11552,-3,47.4,0,6771,6788,46483
2005,06,d) 3,36883,37940,360558,372629,1600,4,5999,14.9,64591,9288,55303,2.5,17.3,88732,42341,46391,11.4,23.8,-24141,-6.5,34.6,0,4831,4841,32424
2005,06,e) 4,32011,33285,315215,323302,1483,4.2,4684,13.4,56336,9824,46512,3,17.4,72509,33618,38891,10.4,22.4,-16173,-5,34.8,0,3675,3681,26238
2005,06,f) 5,28528,29651,323873,330160,1298,4.2,3850,12.4,53262,8151,45111,2.5,16.1,65837,26117,39720,7.9,19.9,-12575,-3.8,32.2,0,3008,3008,20642
2005,06,g) 6 to 10,105905,113533,1418509,1432730,5024,4.3,12342,10.5,245352,40409,204943,2.8,17.1,273794,104702,169092,7.3,19.1,-28442,-2,34.2,0,9498,9516,80043
2005,06,h) 11 to 15,69352,76132,1109089,1117400,3281,4.2,6986,8.9,171561,38417,133144,3.4,15.4,188183,62127,126056,5.6,16.8,-16622,-1.4,30.8,0,5178,5188,41572
2005,06,i) 16 to 20,58089,69887,1246163,1261092,2946,4.1,5501,7.7,140561,31555,109006,2.5,11.1,170419,55861,114558,4.4,13.5,-29858,-2.4,22.2,0,3740,3756,30698
2005,06,j) 21 to 25,42787,55097,1063899,1079138,1943,3.5,3524,6.3,122522,27353,95169,2.5,11.4,152999,42677,110322,4,14.2,-30477,-2.8,22.8,0,2266,2280,21556
2005,06,k) 26+,21095,34727,874364,876217,1607,4.6,2238,6.4,127238,50212,77026,5.7,14.5,130943,24568,106375,2.8,14.9,-3705,-0.4,29,0,1123,1135,9950
2005,06,l) Left Censored,50773,139274,5357777,5345867,9311,6.7,7932,5.7,628462,195671,432791,3.7,11.8,604642,150962,453680,2.8,11.3,23820,0.5,22.6,0,2257,2302,31032
2005,08,a) 0,12668,12766,66898,33566,12671,198.5,0,0,66665,66665,0,198.6,198.6,0,0,0,0,0,66665,198.6,0,0,,,
2005,08,b) 1,8745,8815,53364,55687,29,0.3,2711,26.3,14581,372,14209,0.7,26.2,19226,12370,6856,22.2,34.5,-4645,-8.3,52.4,0,2022,2022,10485
2005,08,c) 2,7493,7594,50654,55428,346,4.2,1458,17.8,9779,1162,8617,2.1,17.6,19326,13072,6254,23.6,34.9,-9547,-17.3,35.2,0,1161,1161,11637
2005,08,d) 3,6540,6680,48313,49491,302,4.2,1105,15.5,8238,783,7455,1.6,16.6,10594,4436,6158,9,21.4,-2356,-4.8,33.2,0,834,834,3652
2005,08,e) 4,5968,6159,49470,50539,310,4.8,848,13.1,8090,1203,6887,2.4,16,10227,4538,5689,9,20.2,-2137,-4.2,32,0,632,632,3993
2005,08,f) 5,5365,5519,51833,52771,272,4.7,746,12.9,7950,1044,6906,2,15.1,9826,4260,5566,8.1,18.6,-1876,-3.5,30.2,0,532,538,3495
2005,08,g) 6 to 10,20379,21512,203716,208867,946,4.3,2326,10.5,32307,6061,26246,2.9,15.5,42608,16453,26155,7.9,20.4,-10301,-4.9,31,0,1693,1693,13383
2005,08,h) 11 to 15,12773,13727,163332,164886,566,4,1213,8.6,21910,5297,16613,3.2,13.3,25017,7725,17292,4.7,15.2,-3107,-1.9,26.6,0,797,808,4985
2005,08,i) 16 to 20,8523,10084,162968,164450,373,3.6,694,6.8,18659,4493,14166,2.7,11.3,21622,6077,15545,3.7,13.1,-2963,-1.8,22.6,0,420,420,2879
2005,08,j) 21 to 25,6390,8538,164349,165758,386,4.5,475,5.5,18592,4166,14426,2.5,11.2,21410,4897,16513,3,12.9,-2818,-1.7,22.4,0,283,284,2231
2005,08,k) 26+,3229,5307,122987,120442,266,5,303,5.7,17701,5217,12484,4.3,14.7,12610,3768,8842,3.1,10.5,5091,4.2,21,0,152,159,892
2005,08,l) Left Censored,8648,22964,781109,772883,1777,7.8,1397,6.1,94634,35941,58693,4.7,12.2,78183,22537,55646,2.9,10.1,16451,2.1,20.2,0,264,271,3620
2005,09,a) 0,5561,5619,36594,18341,5586,198.8,0,0,36506,36506,0,199,199,0,0,0,0,0,36506,199,0,0,,,
2005,09,b) 1,4062,4082,25072,25855,6,0.1,1069,22.9,7160,37,7123,0.1,27.7,8726,4824,3902,18.7,33.7,-1566,-6,55.4,0,819,819,4067
2005,09,c) 2,3309,3339,25571,26127,115,3.2,608,16.9,4563,894,3669,3.4,17.5,5675,2464,3211,9.4,21.7,-1112,-4.2,35,0,498,498,2113
2005,09,d) 3,3261,3341,28299,29545,120,3.4,444,12.7,3815,494,3321,1.7,12.9,6306,2215,4091,7.5,21.3,-2491,-8.4,25.8,0,361,361,1997
2005,09,e) 4,2861,2927,24308,24707,116,3.8,351,11.5,4022,562,3460,2.3,16.3,4819,1716,3103,6.9,19.5,-797,-3.2,32.6,0,286,286,1531
2005,09,f) 5,2712,2824,29094,29567,117,4,332,11.3,3834,342,3492,1.2,13,4779,1689,3090,5.7,16.2,-945,-3.2,26,0,253,253,1328
2005,09,g) 6 to 10,11238,11758,127393,126562,460,3.8,1130,9.3,27853,15517,12336,12.3,22,26190,11019,15171,8.7,20.7,1663,1.3,41.4,0,840,840,9661
2005,09,h) 11 to 15,8223,8645,92972,94312,269,3,646,7.3,10404,1530,8874,1.6,11,13083,3413,9670,3.6,13.9,-2679,-2.9,22,0,459,459,2578
2005,09,i) 16 to 20,7877,8777,132599,133146,267,3,622,6.9,17169,2977,14192,2.2,12.9,18263,6134,12129,4.6,13.7,-1094,-0.8,25.8,0,414,414,4074
2005,09,j) 21 to 25,5508,6595,100973,102485,201,3,344,5.2,9383,1395,7988,1.4,9.2,12407,4274,8133,4.2,12.1,-3024,-2.9,18.4,0,229,230,2542
2005,09,k) 26+,2785,3965,79093,79092,156,3.9,215,5.4,9257,3643,5614,4.6,11.7,9255,3463,5792,4.4,11.7,2,0,23.4,0,109,109,781
2005,09,l) Left Censored,11476,21785,820231,829246,1261,5.8,1354,6.2,78595,31166,47429,3.8,9.5,96625,34702,61923,4.2,11.7,-18030,-2.2,19,0,349,351,4615
2005,10,a) 0,1652,1655,9664,4840,1645,198.8,0,0,9649,9649,0,199.4,199.4,0,0,0,0,0,9649,199.4,0,0,,,
2005,10,b) 1,1308,1320,8523,8409,3,0.2,329,21.9,2185,10,2175,0.1,26,1956,990,966,11.8,23.3,229,2.7,46.6,0,259,259,811
2005,10,c) 2,1209,1211,8453,8928,36,2.8,173,13.5,1378,110,1268,1.2,15.4,2327,1358,969,15.2,26.1,-949,-10.7,30.8,0,141,141,1132
2005,10,d) 3,995,1022,7313,7628,34,3.2,125,11.7,1376,101,1275,1.3,18,2005,1379,626,18.1,26.3,-629,-8.3,36,0,100,100,1302
2005,10,e) 4,944,954,6030,6132,29,2.9,139,13.7,889,60,829,1,14.5,1093,516,577,8.4,17.8,-204,-3.3,29,0,107,108,442
2005,10,f) 5,877,898,7218,7416,37,3.9,114,12.1,859,98,761,1.3,11.6,1254,663,591,8.9,16.9,-395,-5.3,23.2,0,82,82,490
2005,10,g) 6 to 10,3144,3305,35499,36580,128,3.7,348,10.2,4864,898,3966,2.5,13.3,7025,2925,4100,8,19.2,-2161,-5.9,26.6,0,272,272,2687
2005,10,h) 11 to 15,2032,2181,22728,23688,87,3.9,165,7.4,3197,935,2262,3.9,13.5,5116,2508,2608,10.6,21.6,-1919,-8.1,27,0,128,128,1862
2005,10,i) 16 to 20,1637,1883,25779,26014,58,3,127,6.6,2851,882,1969,3.4,11,3320,629,2691,2.4,12.8,-469,-1.8,22,0,86,86,423
2005,10,j) 21 to 25,1094,1314,25264,25705,44,3.3,72,5.4,2048,402,1646,1.6,8,2929,807,2122,3.1,11.4,-881,-3.4,16,0,42,42,296
2005,10,k) 26+,653,955,33173,33053,44,4.6,57,5.9,2439,480,1959,1.5,7.4,2198,322,1876,1,6.6,241,0.8,13.2,0,27,27,142
2005,10,l) Left Censored,2874,5863,200465,199682,369,6.2,531,8.9,24787,7092,17695,3.6,12.4,23220,9861,13359,4.9,11.6,1567,0.8,23.2,0,48,50,355
2005,11,a) 0,1513,1513,9715,4912,1509,199.5,0,0,9606,9606,0,195.6,195.6,0,0,0,0,0,9606,195.6,0,0,,,
2005,11,b) 1,457,457,5716,5414,3,0.6,102,19.9,1527,10,1517,0.2,28.2,923,427,496,7.9,17,604,11.2,34,0,77,77,387
2005,11,c) 2,657,668,5865,5878,22,3.1,85,12.1,1395,497,898,8.5,23.7,1420,581,839,9.9,24.2,-25,-0.5,47.4,0,72,72,533
2005,11,d) 3,722,734,9116,8631,32,4.2,102,13.3,2085,307,1778,3.6,24.2,1115,359,756,4.2,12.9,970,11.3,25.8,0,79,79,298
2005,11,e) 4,645,663,8497,8542,30,4.4,64,9.3,1241,181,1060,2.1,14.5,1330,713,617,8.3,15.6,-89,-1.1,29,0,49,49,675
2005,11,f) 5,573,585,7729,7698,23,3.8,54,9,1399,128,1271,1.7,18.2,1337,391,946,5.1,17.4,62,0.8,34.8,0,43,43,211
2005,11,g) 6 to 10,2418,2564,37891,37677,94,3.6,226,8.6,5101,654,4447,1.7,13.5,4673,1094,3579,2.9,12.4,428,1.1,24.8,0,161,161,830
2005,11,h) 11 to 15,1708,1818,32750,32640,54,2.9,134,7.2,3553,1003,2550,3.1,10.9,3333,793,2540,2.4,10.2,220,0.7,20.4,0,94,94,492
2005,11,i) 16 to 20,1509,1748,29021,29467,102,5.8,112,6.4,3195,1210,1985,4.1,10.8,4087,780,3307,2.6,13.9,-892,-3.1,21.6,0,62,62,394
2005,11,j) 21 to 25,1301,1524,27880,27713,75,4.9,78,5.1,3174,1153,2021,4.2,11.5,2840,571,2269,2.1,10.2,334,1.3,20.4,0,47,47,250
2005,11,k) 26+,718,1010,42019,41102,52,5.1,92,8.9,4723,705,4018,1.7,11.5,2889,968,1921,2.4,7,1834,4.5,14,0,23,29,239
2005,11,l) Left Censored,3171,5706,230098,231446,442,7.8,351,6.2,22161,7117,15044,3.1,9.6,24857,5697,19160,2.5,10.7,-2696,-1.1,19.2,0,64,64,691
2005,12,a) 0,50388,50699,254471,128033,50334,198.6,0,0,252876,252876,0,197.5,197.5,0,0,0,0,0,252876,197.5,0,0,,,
2005,12,b) 1,37627,37857,232291,238785,71,0.2,11092,25.2,62851,831,62020,0.3,26.3,75839,48238,27601,20.2,31.8,-12988,-5.5,52.6,0,8847,8847,41710
2005,12,c) 2,26855,27075,205619,216264,1148,3.9,5440,18.5,44808,4865,39943,2.2,20.7,66098,40058,26040,18.5,30.6,-21290,-9.9,41.4,0,4426,4426,33592
2005,12,d) 3,21774,22226,187848,192772,928,3.9,3594,15.2,35606,4409,31197,2.3,18.5,45454,19764,25690,10.3,23.6,-9848,-5.1,37,0,2887,2890,15747
2005,12,e) 4,18360,18853,190123,189793,872,4.4,2716,13.7,46699,5765,40934,3,24.6,46039,19795,26244,10.4,24.3,660,0.3,48.6,0,2142,2143,16290
2005,12,f) 5,16123,16725,150858,160835,697,4,2174,12.4,25136,4628,20508,2.9,15.6,45089,17362,27727,10.8,28,-19953,-12.4,31.2,0,1660,1660,14658
2005,12,g) 6 to 10,61443,65229,706577,719351,2810,4.2,6830,10.1,123910,34275,89635,4.8,17.2,149458,52586,96872,7.3,20.8,-25548,-3.6,34.4,0,5143,5192,42640
2005,12,h) 11 to 15,40786,44337,628010,631058,1775,3.9,3776,8.3,104575,28824,75751,4.6,16.6,110670,34742,75928,5.5,17.5,-6095,-0.9,33.2,0,2780,2790,19951
2005,12,i) 16 to 20,28822,34694,616564,623543,1492,4.2,2508,7.1,83321,20418,62903,3.3,13.4,97279,22530,74749,3.6,15.6,-13958,-2.2,26.8,0,1668,1682,12476
2005,12,j) 21 to 25,18833,24160,441145,451041,1045,4.3,1417,5.8,57154,15532,41622,3.4,12.7,76945,39793,37152,8.8,17.1,-19791,-4.4,25.4,0,961,961,34618
2005,12,k) 26+,8369,14877,345335,337662,721,4.8,738,5,51536,13880,37656,4.1,15.3,36190,7105,29085,2.1,10.7,15346,4.6,21.4,0,424,433,2895
2005,12,l) Left Censored,21648,74497,2776785,2712450,7278,9.9,5003,6.8,423139,182549,240590,6.7,15.6,294469,91809,202660,3.4,10.9,128670,4.7,21.8,0,894,919,15454
2005,13,a) 0,17693,17862,112675,56489,17758,198.8,0,0,112373,112373,0,198.9,198.9,0,0,0,0,0,112373,198.9,0,0,,,
2005,13,b) 1,12818,12972,96400,97211,57,0.4,3661,24.5,28269,959,27310,1,29.1,29890,19210,10680,19.8,30.7,-1621,-1.6,58.2,0,2928,2928,16888
2005,13,c) 2,10527,10649,81613,84976,420,3.7,1982,17.2,17602,2869,14733,3.4,20.7,24327,11378,12949,13.4,28.6,-6725,-7.9,41.4,0,1621,1621,10368
2005,13,d) 3,9198,9444,85506,87923,400,4,1487,14.8,13524,1926,11598,2.2,15.4,18357,9161,9196,10.4,20.9,-4833,-5.5,30.8,0,1177,1177,7776
2005,13,e) 4,8007,8291,84917,83573,362,4.2,1105,12.7,21948,1706,20242,2,26.3,19260,8968,10292,10.7,23,2688,3.3,46,0,886,887,8178
2005,13,f) 5,7387,7824,74989,76247,295,3.6,958,11.7,13233,1430,11803,1.9,17.4,15748,6267,9481,8.2,20.7,-2515,-3.3,34.8,0,730,730,5559
2005,13,g) 6 to 10,28493,30329,360136,361366,1305,4.2,3081,9.8,69592,10072,59520,2.8,19.3,72051,28901,43150,8,19.9,-2459,-0.6,38.6,0,2338,2338,24542
2005,13,h) 11 to 15,17393,19225,259356,262939,713,3.6,1623,8.2,38320,11008,27312,4.2,14.6,45485,11610,33875,4.4,17.3,-7165,-2.7,29.2,0,1150,1150,7884
2005,13,i) 16 to 20,12759,15624,294824,297147,605,3.8,1111,7,33518,8854,24664,3,11.3,38163,10436,27727,3.5,12.8,-4645,-1.5,22.6,0,704,709,5352
2005,13,j) 21 to 25,9171,11936,212494,213957,435,3.6,694,5.7,23765,6051,17714,2.8,11.1,26690,5705,20985,2.7,12.5,-2925,-1.4,22.2,0,436,437,3204
2005,13,k) 26+,4501,7693,208135,206798,370,4.8,416,5.4,25955,6812,19143,3.3,12.6,23281,7208,16073,3.5,11.3,2674,1.3,22.6,0,192,193,1593
2005,13,l) Left Censored,14120,42197,1612608,1608396,3254,7.8,2390,5.7,184155,59423,124732,3.7,11.4,175730,45501,130229,2.8,10.9,8425,0.5,21.8,0,478,483,4880
2005,15,a) 0,2040,2047,14612,7334,2026,197.9,0,0,14556,14556,0,198.5,198.5,0,0,0,0,0,14556,198.5,0,0,,,
2005,15,b) 1,1592,1624,12114,12087,12,0.7,378,20.7,3071,96,2975,0.8,25.4,3017,1693,1324,14,25,54,0.4,50,0,310,310,1508
2005,15,c) 2,1348,1464,13243,13004,46,2.9,218,14,2666,460,2206,3.5,20.5,2188,1050,1138,8.1,16.8,478,3.7,33.6,0,176,176,893
2005,15,d) 3,1206,1247,11116,11263,52,4,177,13.4,1872,388,1484,3.4,16.6,2165,1013,1152,9,19.2,-293,-2.6,33.2,0,145,145,824
2005,15,e) 4,1038,1075,10340,10431,43,3.9,96,8.7,1493,220,1273,2.1,14.3,1674,735,939,7,16,-181,-1.7,28.6,0,76,76,634
2005,15,f) 5,943,1011,10672,10761,38,3.6,103,9.9,1386,165,1221,1.5,12.9,1563,404,1159,3.8,14.5,-177,-1.6,25.8,0,88,88,357
2005,15,g) 6 to 10,3770,3964,42764,43289,154,3.8,335,8.2,5595,915,4680,2.1,12.9,6645,2011,4634,4.6,15.4,-1050,-2.5,25.8,0,260,260,1637
2005,15,h) 11 to 15,2714,2980,39821,40745,92,3,223,7.3,4656,389,4267,1,11.4,6504,2476,4028,6.1,16,-1848,-4.6,22.8,0,161,161,2054
2005,15,i) 16 to 20,2398,2813,42940,43525,79,2.8,154,5.4,4147,705,3442,1.6,9.5,5316,1223,4093,2.8,12.2,-1169,-2.7,19,0,95,100,738
2005,15,j) 21 to 25,1932,2460,40435,39557,65,2.6,121,4.9,5925,2123,3802,5.4,15,4168,779,3389,2,10.5,1757,4.5,21,0,65,79,386
2005,15,k) 26+,1100,1579,29704,28834,39,2.4,74,4.6,4333,506,3827,1.8,15,2593,655,1938,2.3,9,1740,6,18,0,31,37,233
2005,15,l) Left Censored,3329,7028,220734,218999,410,5.9,299,4.3,24094,9185,14909,4.2,11,20624,6371,14253,2.9,9.4,3470,1.6,18.8,0,97,97,2655
2005,16,a) 0,3960,3973,19080,9582,3939,198.3,0,0,18997,18997,0,198.3,198.3,0,0,0,0,0,18997,198.3,0,0,,,
2005,16,b) 1,2640,2652,18959,18427,6,0.2,738,24.1,6117,50,6067,0.3,33.2,5053,3130,1923,17,27.4,1064,5.8,54.8,0,573,573,2690
2005,16,c) 2,2137,2186,15918,15910,133,5.8,359,15.5,3907,573,3334,3.6,24.6,3890,2011,1879,12.6,24.5,17,0.1,49,0,290,290,1812
2005,16,d) 3,1865,1898,19510,19447,97,4.9,274,13.7,3380,853,2527,4.4,17.4,3253,1322,1931,6.8,16.7,127,0.7,33.4,0,187,187,736
2005,16,e) 4,1680,1747,14728,14830,103,5.7,212,11.8,2553,430,2123,2.9,17.2,2756,949,1807,6.4,18.6,-203,-1.4,34.4,0,171,171,780
2005,16,f) 5,1516,1574,14841,14630,63,3.9,167,10.3,2511,189,2322,1.3,17.2,2088,763,1325,5.2,14.3,423,2.9,28.6,0,123,123,575
2005,16,g) 6 to 10,6078,6402,60024,59752,330,5,573,8.8,9950,2054,7896,3.4,16.7,9406,3485,5921,5.8,15.7,544,1,31.4,0,416,418,2835
2005,16,h) 11 to 15,3855,4047,39543,38882,226,5.5,334,8.1,6948,2299,4649,5.9,17.9,5625,1565,4060,4,14.5,1323,3.4,29,0,212,212,1073
2005,16,i) 16 to 20,2309,2728,50984,50110,119,4.3,180,6.5,6567,1069,5498,2.1,13.1,4819,2048,2771,4.1,9.6,1748,3.5,19.2,0,134,134,1606
2005,16,j) 21 to 25,1780,2257,35148,34597,72,3.2,111,4.9,4663,401,4262,1.2,13.5,3561,848,2713,2.5,10.3,1102,3.2,20.6,0,66,66,334
2005,16,k) 26+,1035,1480,36638,36765,51,3.4,82,5.5,3983,480,3503,1.3,10.8,4237,707,3530,1.9,11.5,-254,-0.7,21.6,0,41,41,335
2005,16,l) Left Censored,3057,6772,192530,189712,468,7,357,5.3,27255,13722,13533,7.2,14.4,21620,9247,12373,4.9,11.4,5635,3,22.8,0,70,70,761
2005,17,a) 0,20696,20875,132206,66813,20752,198.8,0,0,130786,130786,0,195.7,195.7,0,0,0,0,0,130786,195.7,0,0,,,
2005,17,b) 1,15437,15538,109556,114497,45,0.3,4062,22.9,26191,452,25739,0.4,22.9,36072,19596,16476,17.1,31.5,-9881,-8.6,45.8,0,2978,2978,15919
2005,17,c) 2,12871,13221,106882,111181,605,4.3,2347,16.6,20167,2787,17380,2.5,18.1,28764,14914,13850,13.4,25.9,-8597,-7.8,36.2,0,1825,1825,13263
2005,17,d) 3,11361,11630,101912,104588,490,4,1709,13.9,16757,2451,14306,2.3,16,22109,9954,12155,9.5,21.1,-5352,-5.1,32,0,1331,1331,8847
2005,17,e) 4,10068,10422,90444,91489,393,3.6,1332,12.2,16916,1650,15266,1.8,18.5,19006,7182,11824,7.9,20.8,-2090,-2.3,37,0,1021,1021,6045
2005,17,f) 5,9651,10011,102138,102594,407,3.9,1167,11.2,15878,2155,13723,2.1,15.5,16789,6203,10586,6,16.4,-911,-0.9,31,0,846,847,4949
2005,17,g) 6 to 10,40150,42355,478692,486471,1714,3.9,4245,9.7,73350,15293,58057,3.1,15.1,88908,26284,62624,5.4,18.3,-15558,-3.2,30.2,0,3016,3016,19959
2005,17,h) 11 to 15,29269,31317,383731,388932,1223,3.8,2583,8.1,50681,11752,38929,3,13,61083,16466,44617,4.2,15.7,-10402,-2.7,26,0,1742,1750,11021
2005,17,i) 16 to 20,22285,25977,459082,467031,953,3.6,1761,6.7,48920,12729,36191,2.7,10.5,64817,20484,44333,4.4,13.9,-15897,-3.4,21,0,1128,1129,13704
2005,17,j) 21 to 25,16826,20454,406613,411615,617,3,1227,5.9,36537,7542,28995,1.8,8.9,46541,8842,37699,2.1,11.3,-10004,-2.4,17.8,0,755,755,5030
2005,17,k) 26+,8581,13238,297487,294681,505,3.8,691,5.2,37661,9056,28605,3.1,12.8,32049,7007,25042,2.4,10.9,5612,1.9,21.8,0,385,387,3440
2005,17,l) Left Censored,31319,69041,2565338,2574051,4416,6.4,4236,6.1,266659,86716,179943,3.4,10.4,284085,80720,203365,3.1,11,-17426,-0.6,20.8,0,1187,1219,18281
2005,18,a) 0,8825,8918,64104,32139,8853,198.5,0,0,63931,63931,0,198.9,198.9,0,0,0,0,0,63931,198.9,0,0,,,
2005,18,b) 1,6793,6843,49886,52702,18,0.2,1884,24,12117,122,11995,0.2,23,17749,10004,7745,19,33.7,-5632,-10.7,46,0,1481,1481,8828
2005,18,c) 2,5575,5684,47653,50291,238,3.9,1048,17.1,9962,1414,8548,2.8,19.8,15237,8509,6728,16.9,30.3,-5275,-10.5,39.6,0,839,839,7687
2005,18,d) 3,5288,5398,50629,52697,183,3.2,855,14.9,7926,973,6953,1.8,15,12062,5939,6123,11.3,22.9,-4136,-7.9,30,0,686,686,5458
2005,18,e) 4,4547,4835,45838,45790,202,4,620,12.3,8100,1165,6935,2.5,17.7,8003,3114,4889,6.8,17.5,97,0.2,35,0,499,499,2668
2005,18,f) 5,4268,4464,43095,44777,156,3.3,576,12.3,6593,865,5728,1.9,14.7,9957,4885,5072,10.9,22.2,-3364,-7.5,29.4,0,448,448,4205
2005,18,g) 6 to 10,18166,19496,221171,220554,713,3.5,1857,9.2,36011,9834,26177,4.5,16.3,34776,11483,23293,5.2,15.8,1235,0.5,31.6,0,1416,1419,9257
2005,18,h) 11 to 15,13409,14605,175990,179593,531,3.5,1252,8.4,22811,4184,18627,2.3,12.7,30017,10821,19196,6,16.7,-7206,-4,25.4,0,899,899,6248
2005,18,i) 16 to 20,10290,12646,229324,230812,390,3,797,6.2,25211,6296,18915,2.7,10.9,28186,6575,21611,2.8,12.2,-2975,-1.3,21.8,0,516,523,3501
2005,18,j) 21 to 25,8147,9958,179408,178262,267,2.6,496,4.9,19588,3647,15941,2,11,17295,3559,13736,2,9.7,2293,1.3,19.4,0,347,351,2584
2005,18,k) 26+,4129,6730,142978,143434,276,4.1,315,4.7,14980,3719,11261,2.6,10.4,15892,3222,12670,2.2,11.1,-912,-0.7,20.8,0,164,172,1646
2005,18,l) Left Censored,15598,36842,1354624,1353322,1912,5.2,1770,4.8,129514,40399,89115,3,9.6,126910,27440,99470,2,9.4,2604,0.2,18.8,0,493,507,6337
2005,19,a) 0,4861,4886,28334,14205,4844,198.3,0,0,28259,28259,0,198.9,198.9,0,0,0,0,0,28259,198.9,0,0,,,
2005,19,b) 1,3606,3633,22442,23572,14,0.3,973,23.3,5240,158,5082,0.7,22.2,7500,4571,2929,19.4,31.8,-2260,-9.6,44.4,0,733,733,3929
2005,19,c) 2,3085,3154,22051,23534,138,4.1,570,16.8,4115,377,3738,1.6,17.5,7080,3974,3106,16.9,30.1,-2965,-12.6,35,0,459,459,3490
2005,19,d) 3,2811,2901,22216,22807,144,4.7,446,14.6,3128,383,2745,1.7,13.7,4309,1893,2416,8.3,18.9,-1181,-5.2,27.4,0,364,364,1706
2005,19,e) 4,2471,2566,19738,19790,125,4.7,308,11.6,3259,599,2660,3,16.5,3363,1412,1951,7.1,17,-104,-0.5,33,0,237,237,1156
2005,19,f) 5,2359,2423,24765,24966,105,4.2,296,11.7,4150,653,3497,2.6,16.6,4551,1194,3357,4.8,18.2,-401,-1.6,33.2,0,211,212,962
2005,19,g) 6 to 10,10298,10898,100941,100764,466,4.2,1061,9.5,14774,2454,12320,2.4,14.7,14420,4787,9633,4.8,14.3,354,0.4,28.6,0,748,748,3905
2005,19,h) 11 to 15,7769,8221,79522,79933,398,4.8,654,7.8,10647,1977,8670,2.5,13.3,11469,3211,8258,4,14.3,-822,-1,26.6,0,425,425,2144
2005,19,i) 16 to 20,5367,6392,112219,112367,213,3.3,441,6.8,9913,1635,8278,1.5,8.8,10209,3040,7169,2.7,9.1,-296,-0.3,17.6,0,291,305,1801
2005,19,j) 21 to 25,4945,6091,82506,83773,150,2.4,302,4.9,7494,1082,6412,1.3,8.9,10027,2741,7286,3.3,12,-2533,-3.1,17.8,0,206,206,1774
2005,19,k) 26+,2769,4720,76547,77478,186,3.9,205,4.3,7709,2227,5482,2.9,9.9,9571,1715,7856,2.2,12.4,-1862,-2.5,19.8,0,117,117,777
2005,19,l) Left Censored,10544,20544,667711,663388,799,3.9,866,4.2,58999,13801,45198,2.1,8.9,50353,11309,39044,1.7,7.6,8646,1.3,15.2,0,319,324,2491
2005,20,a) 0,5000,5019,29154,14632,4976,198.3,0,0,29044,29044,0,198.5,198.5,0,0,0,0,0,29044,198.5,0,0,,,
2005,20,b) 1,3738,3768,26657,26642,20,0.5,1045,24.1,7320,325,6995,1.2,27.5,7289,4784,2505,18,27.4,31,0.1,54.8,0,839,839,4273
2005,20,c) 2,3200,3237,25872,26537,123,3.5,614,17.5,4568,407,4161,1.5,17.2,5898,3102,2796,11.7,22.2,-1330,-5,34.4,0,498,498,2724
2005,20,d) 3,2883,2949,23703,24274,119,3.8,432,13.9,3784,391,3393,1.6,15.6,4926,2440,2486,10.1,20.3,-1142,-4.7,31.2,0,340,340,1850
2005,20,e) 4,2554,2618,20480,21008,95,3.4,340,12.3,3279,842,2437,4,15.6,4334,1768,2566,8.4,20.6,-1055,-5,31.2,0,261,261,1435
2005,20,f) 5,2362,2426,23759,23877,118,4.7,301,12,3951,721,3230,3,16.5,4187,1513,2674,6.3,17.5,-236,-1,33,0,232,232,1088
2005,20,g) 6 to 10,9891,10548,111345,110685,436,4,971,9,17923,2350,15573,2.1,16.2,16602,6119,10483,5.5,15,1321,1.2,30,0,725,725,3894
2005,20,h) 11 to 15,6952,7391,80149,81223,321,4.2,616,8.2,11178,3087,8091,3.8,13.8,13326,3311,10015,4.1,16.4,-2148,-2.6,27.6,0,425,425,2263
2005,20,i) 16 to 20,5012,5860,86385,85771,207,3.5,352,5.9,10320,4042,6278,4.7,12,9091,3062,6029,3.6,10.6,1229,1.4,21.2,0,248,255,2137
2005,20,j) 21 to 25,4419,5314,72518,72561,182,3.4,270,5,7441,1562,5879,2.2,10.3,7527,1901,5626,2.6,10.4,-86,-0.1,20.6,0,190,190,1221
2005,20,k) 26+,2344,3953,72075,70828,216,5.5,185,4.7,9092,1924,7168,2.7,12.8,6598,1615,4983,2.3,9.3,2494,3.5,18.6,0,90,90,970
2005,20,l) Left Censored,8519,17593,550937,555236,748,4.2,807,4.6,54046,15913,38133,2.9,9.7,62645,20058,42587,3.6,11.3,-8599,-1.6,19.4,0,263,267,1371
2005,21,a) 0,5887,5924,40608,20528,5888,198.8,0,0,40160,40160,0,195.6,195.6,0,0,0,0,0,40160,195.6,0,0,,,
2005,21,b) 1,4353,4390,33075,35901,14,0.3,1192,23.7,8650,26,8624,0.1,24.1,14302,6392,7910,17.8,39.8,-5652,-15.7,48.2,0,984,984,5232
2005,21,c) 2,3512,3556,29137,30359,114,3,687,17.8,5050,504,4546,1.7,16.6,7493,3500,3993,11.5,24.7,-2443,-8.1,33.2,0,561,561,3107
2005,21,d) 3,3155,3240,30953,31212,107,3.1,536,15.4,6538,629,5909,2,20.9,7055,3675,3380,11.8,22.6,-517,-1.7,41.8,0,437,437,3277
2005,21,e) 4,2963,3039,25561,25735,94,3,389,12.2,4845,817,4028,3.2,18.8,5192,2119,3073,8.2,20.2,-347,-1.4,37.6,0,324,324,1883
2005,21,f) 5,2785,2920,26578,26502,111,3.7,313,10.3,4508,725,3783,2.7,17,4356,1708,2648,6.4,16.4,152,0.6,32.8,0,246,251,1298
2005,21,g) 6 to 10,11564,12504,137496,138771,445,3.4,1197,9.3,23301,4215,19086,3,16.8,25851,10696,15155,7.7,18.6,-2550,-1.8,33.6,0,943,943,9248
2005,21,h) 11 to 15,8260,9053,109734,108902,351,3.8,805,8.7,17037,2922,14115,2.7,15.6,15372,4543,10829,4.2,14.1,1665,1.5,28.2,0,596,600,3220
2005,21,i) 16 to 20,6575,7882,136818,137339,257,3.2,488,6.1,15097,3193,11904,2.3,11,16138,4448,11690,3.2,11.8,-1041,-0.8,22,0,347,348,2127
2005,21,j) 21 to 25,5053,6061,102889,103221,178,2.9,324,5.3,10548,2378,8170,2.3,10.2,11212,2224,8988,2.2,10.9,-664,-0.7,20.4,0,229,229,1442
2005,21,k) 26+,2505,4255,95657,94478,211,5,184,4.3,11202,2951,8251,3.1,11.9,8844,2055,6789,2.2,9.4,2358,2.5,18.8,0,99,99,609
2005,21,l) Left Censored,9278,21832,740972,743310,1107,5.1,1039,4.8,72305,18094,54211,2.4,9.7,76981,13548,63433,1.8,10.4,-4676,-0.7,19.4,0,320,331,3127
2005,22,a) 0,6405,6460,42887,21500,6425,198.9,0,0,42774,42774,0,198.9,198.9,0,0,0,0,0,42774,198.9,0,0,,,
2005,22,b) 1,4922,4993,40542,43036,26,0.4,1436,24.8,10811,587,10224,1.4,25.1,15798,7815,7983,18.2,36.7,-4987,-11.6,50.2,0,1179,1179,6698
2005,22,c) 2,4218,4281,37277,39724,137,3,797,17.2,6730,536,6194,1.3,16.9,11623,6202,5421,15.6,29.3,-4893,-12.4,33.8,0,671,671,5522
2005,22,d) 3,3825,3928,38988,42220,138,3.3,560,13.5,7046,1566,5480,3.7,16.7,13510,8514,4996,20.2,32,-6464,-15.3,33.4,0,459,459,7746
2005,22,e) 4,3430,3545,37449,39460,132,3.6,434,11.7,5764,981,4783,2.5,14.6,9786,4212,5574,10.7,24.8,-4022,-10.2,29.2,0,360,360,4018
2005,22,f) 5,3127,3292,42110,43402,99,2.9,342,10,5788,643,5145,1.5,13.3,8372,4231,4141,9.7,19.3,-2584,-6,26.6,0,278,278,3741
2005,22,g) 6 to 10,13078,13758,157615,161584,417,2.9,1339,9.4,22338,3672,18666,2.3,13.8,30275,8747,21528,5.4,18.7,-7937,-4.9,27.6,0,1043,1048,7454
2005,22,h) 11 to 15,9337,10235,132585,135093,323,3.1,814,7.7,17297,3066,14231,2.3,12.8,22313,5511,16802,4.1,16.5,-5016,-3.7,25.6,0,610,610,3664
2005,22,i) 16 to 20,6765,8150,139975,140522,240,2.9,500,6,16051,3693,12358,2.6,11.4,17145,4168,12977,3,12.2,-1094,-0.8,22.8,0,337,337,2755
2005,22,j) 21 to 25,6628,8108,135636,135701,234,2.8,440,5.3,16573,3142,13431,2.3,12.2,16703,3303,13400,2.4,12.3,-130,-0.1,24.4,0,305,305,1522
2005,22,k) 26+,3205,4919,90484,90670,153,3.1,272,5.5,11349,2581,8768,2.8,12.5,11720,3071,8649,3.4,12.9,-371,-0.4,25,0,171,172,1323
2005,22,l) Left Censored,10018,23056,703648,701746,1241,5.4,1165,5.1,85830,24684,61146,3.5,12.2,82025,26406,55619,3.8,11.7,3805,0.5,23.4,0,363,378,3006
2005,23,a) 0,2728,2733,11708,5866,2721,199.1,0,0,11684,,,,199.2,0,0,0,0,0,11684,199.2,0,1,,,
2005,23,b) 1,2045,2048,11280,11489,2,0.1,524,22.4,2473,,,,21.5,2891,1593,1298,13.9,25.2,-418,-3.7,43,1,366,366,1278
2005,23,c) 2,1605,1629,13566,12865,76,4.3,335,19,4326,267,4059,2.1,33.6,2924,1545,1379,12,22.7,1402,10.9,45.4,0,261,261,1387
2005,23,d) 3,1617,1649,11736,11766,65,3.8,194,11.3,1866,268,1598,2.3,15.9,1926,698,1228,5.9,16.4,-60,-0.5,31.8,0,145,145,607
2005,23,e) 4,1483,1523,10054,10302,59,3.7,211,13.2,1552,181,1371,1.8,15.1,2048,848,1200,8.2,19.9,-496,-4.8,30.2,0,146,146,660
2005,23,f) 5,1332,1373,9728,10185,60,4.2,181,12.6,1136,158,978,1.6,11.2,2050,950,1100,9.3,20.1,-914,-8.9,22.4,0,121,121,593
2005,23,g) 6 to 10,5564,5881,48345,49446,222,3.7,549,9.1,6019,1418,4601,2.9,12.2,8221,2912,5309,5.9,16.6,-2202,-4.4,24.4,0,393,393,1946
2005,23,h) 11 to 15,3515,3765,36223,36526,163,4.3,286,7.5,3839,869,2970,2.4,10.5,4445,1312,3133,3.6,12.2,-606,-1.7,21,0,214,214,1099
2005,23,i) 16 to 20,3303,3743,46242,46455,118,3.1,240,6.3,4616,1068,3548,2.3,9.9,5042,1181,3861,2.5,10.9,-426,-1,19.8,0,164,164,861
2005,23,j) 21 to 25,2082,2573,41929,41745,71,2.7,110,4.2,4154,866,3288,2.1,10,3785,708,3077,1.7,9.1,369,0.9,18.2,0,68,68,190
2005,23,k) 26+,1135,1905,32888,33076,63,3.3,101,5.2,3163,956,2207,2.9,9.6,3538,914,2624,2.8,10.7,-375,-1.1,19.2,0,52,54,542
2005,23,l) Left Censored,3756,7345,218087,218316,352,4.8,346,4.7,18931,5579,13352,2.6,8.7,19388,3779,15609,1.7,8.9,-457,-0.2,17.4,0,115,115,921
2005,24,a) 0,9679,9738,54619,27427,9658,198.4,0,0,54385,54385,0,198.3,198.3,0,0,0,0,0,54385,198.3,0,0,,,
2005,24,b) 1,7196,7244,51016,51763,22,0.3,1872,22.7,14497,91,14406,0.2,28,15990,7714,8276,14.9,30.9,-1493,-2.9,56,0,1417,1417,6487
2005,24,c) 2,5940,6007,49922,51834,256,4,986,15.4,9180,1177,8003,2.3,17.7,13004,5025,7979,9.7,25.1,-3824,-7.4,35.4,0,786,786,4352
2005,24,d) 3,5572,5678,52414,53394,214,3.6,776,13,8667,969,7698,1.8,16.2,10626,4409,6217,8.3,19.9,-1959,-3.7,32.4,0,609,609,3788
2005,24,e) 4,4804,4909,41791,42797,192,3.7,585,11.4,7146,1139,6007,2.7,16.7,9157,3255,5902,7.6,21.4,-2011,-4.7,33.4,0,420,424,2110
2005,24,f) 5,4335,4498,42739,43549,144,3.1,528,11.2,6286,927,5359,2.1,14.4,7906,3240,4666,7.4,18.2,-1620,-3.8,28.8,0,394,394,2779
2005,24,g) 6 to 10,17914,18944,203722,210459,728,3.7,1776,9.1,27271,4238,23033,2,13,40745,17655,23090,8.4,19.4,-13474,-6.4,26,0,1277,1285,10792
2005,24,h) 11 to 15,12245,13282,178039,179303,467,3.4,1004,7.4,23080,4268,18812,2.4,12.9,25607,6529,19078,3.6,14.3,-2527,-1.4,25.8,0,681,681,4334
2005,24,i) 16 to 20,10156,11804,207982,207099,482,4,744,6.2,26447,5662,20785,2.7,12.8,24681,6496,18185,3.1,11.9,1766,0.9,23.8,0,490,491,3882
2005,24,j) 21 to 25,6543,8180,140713,142989,272,3.3,492,5.9,14882,3407,11475,2.4,10.4,19434,5174,14260,3.6,13.6,-4552,-3.2,20.8,0,303,305,3495
2005,24,k) 26+,3244,5120,124952,125341,198,3.8,288,5.6,14031,4687,9344,3.7,11.2,14808,4252,10556,3.4,11.8,-777,-0.6,22.4,0,139,148,1038
2005,24,l) Left Censored,11543,27323,1001481,1000648,1777,6.5,1676,6.1,105243,35745,69498,3.6,10.5,103578,28595,74983,2.9,10.4,1665,0.1,20.8,0,432,432,4505
2005,25,a) 0,10669,10715,57978,29078,10654,198.9,0,0,57801,57801,0,198.8,198.8,0,0,0,0,0,57801,198.8,0,0,,,
2005,25,b) 1,7966,8033,56627,57819,24,0.3,2531,26.9,12533,159,12374,0.3,21.7,14917,9016,5901,15.6,25.8,-2384,-4.1,43.4,0,2015,2015,7748
2005,25,c) 2,6773,6854,53112,54859,237,3.2,1503,20,10279,744,9535,1.4,18.7,13772,7487,6285,13.6,25.1,-3493,-6.4,37.4,0,1219,1219,6610
2005,25,d) 3,6293,6418,59444,59690,238,3.5,1005,14.7,9940,1540,8400,2.6,16.7,10431,4299,6132,7.2,17.5,-491,-0.8,33.4,0,811,811,3231
2005,25,e) 4,5704,5845,51902,52893,226,3.7,767,12.5,8415,1105,7310,2.1,15.9,10396,5018,5378,9.5,19.7,-1981,-3.8,31.8,0,599,599,3743
2005,25,f) 5,5349,5549,52414,54126,215,3.7,731,12.6,7598,1333,6265,2.5,14,11022,4447,6575,8.2,20.4,-3424,-6.4,28,0,568,578,3798
2005,25,g) 6 to 10,22092,23186,241492,247139,827,3.4,2483,10.3,32826,6162,26664,2.5,13.3,44120,14862,29258,6,17.9,-11294,-4.6,26.6,0,1915,1915,10779
2005,25,h) 11 to 15,14685,15725,202686,203498,487,3,1197,7.4,24753,5152,19601,2.5,12.2,26376,8306,18070,4.1,13,-1623,-0.8,24.4,0,885,885,6307
2005,25,i) 16 to 20,13995,16157,271882,271938,528,3.2,1034,6.3,29959,7949,22010,2.9,11,30070,7955,22115,2.9,11.1,-111,-0.1,22,0,697,697,4838
2005,25,j) 21 to 25,9404,11883,264006,265657,336,2.8,671,5.6,25309,5534,19775,2.1,9.5,28610,9416,19194,3.5,10.8,-3301,-1.3,19,0,430,435,4714
2005,25,k) 26+,4778,7399,188201,187459,345,4.6,381,5.1,20863,9134,11729,4.9,11.1,19379,5054,14325,2.7,10.3,1484,0.8,20.6,0,216,218,1826
2005,25,l) Left Censored,19316,38638,1480254,1478216,2107,5.4,2249,5.8,147793,45584,102209,3.1,10,143718,38749,104969,2.6,9.7,4075,0.3,19.4,0,699,704,5803
2005,26,a) 0,14577,14689,110171,55295,14563,198.3,0,0,109752,109752,0,198.5,198.5,0,0,0,0,0,109752,198.5,0,0,,,
2005,26,b) 1,10757,10832,104312,108982,22,0.2,3091,24.7,24165,508,23657,0.5,22.2,33505,14212,19293,13,30.7,-9340,-8.5,44.4,0,2337,2337,12058
2005,26,c) 2,9142,9298,86659,91167,363,3.6,1818,18,15977,2723,13254,3,17.5,24993,11863,13130,13,27.4,-9016,-9.9,35,0,1467,1467,10608
2005,26,d) 3,8579,8769,89082,94471,324,3.5,1355,14.6,14135,1522,12613,1.6,15,24912,8602,16310,9.1,26.4,-10777,-11.4,30,0,1049,1049,7435
2005,26,e) 4,7357,7640,62543,65560,375,4.7,1070,13.4,9706,1558,8148,2.4,14.8,15739,6396,9343,9.8,24,-6033,-9.2,29.6,0,819,819,5303
2005,26,f) 5,6898,7168,68464,72169,301,4,919,12.3,10068,2014,8054,2.8,14,17477,6076,11401,8.4,24.2,-7409,-10.2,28,0,715,715,5022
2005,26,g) 6 to 10,29932,31568,324931,337910,1236,3.8,3364,10.3,48153,11169,36984,3.3,14.3,74110,28527,45583,8.4,21.9,-25957,-7.6,28.6,0,2415,2419,23332
2005,26,h) 11 to 15,21279,23113,278800,285771,876,3.7,1954,8.2,37614,10281,27333,3.6,13.2,51556,12081,39475,4.2,18,-13942,-4.8,26.4,0,1311,1311,8709
2005,26,i) 16 to 20,17079,20416,309390,318852,726,3.5,1376,6.6,30596,7471,23125,2.3,9.6,49520,12670,36850,4,15.5,-18924,-5.9,19.2,0,877,883,7437
2005,26,j) 21 to 25,12571,15695,260161,265212,488,3.1,889,5.6,28616,8634,19982,3.3,10.8,38718,10111,28607,3.8,14.6,-10102,-3.8,21.6,0,554,567,5223
2005,26,k) 26+,6524,9504,186325,188586,303,3.1,530,5.5,19357,5890,13467,3.1,10.3,23878,5905,17973,3.1,12.7,-4521,-2.4,20.6,0,260,261,2313
2005,26,l) Left Censored,22425,51306,1870884,1906571,2632,5.1,2846,5.5,164000,44162,119838,2.3,8.6,235373,47854,187519,2.5,12.3,-71373,-3.7,17.2,0,791,836,11845
2005,27,a) 0,9853,9922,59943,30078,9849,198.5,0,0,59731,59731,0,198.6,198.6,0,0,0,0,0,59731,198.6,0,0,,,
2005,27,b) 1,7455,7505,50945,52875,24,0.3,2121,24.5,13230,215,13015,0.4,25,17090,10457,6633,19.8,32.3,-3860,-7.3,50,0,1490,1490,8737
2005,27,c) 2,6379,6447,47033,48387,289,4.2,1158,16.8,9292,1140,8152,2.4,19.2,12000,6759,5241,14,24.8,-2708,-5.6,38.4,0,867,867,5328
2005,27,d) 3,5807,5928,50269,50960,272,4.4,855,13.7,8071,966,7105,1.9,15.8,9453,4469,4984,8.8,18.5,-1382,-2.7,31.6,0,614,614,3701
2005,27,e) 4,5101,5230,43385,44786,234,4.3,648,11.9,6605,1029,5576,2.3,14.7,9407,3116,6291,7,21,-2802,-6.3,29.4,0,435,435,2472
2005,27,f) 5,4759,4918,47782,48219,222,4.4,541,10.6,6250,807,5443,1.7,13,7123,2439,4684,5.1,14.8,-873,-1.8,26,0,391,391,2042
2005,27,g) 6 to 10,19439,20736,212508,215655,843,3.9,2063,9.6,27577,4764,22813,2.2,12.8,33870,11244,22626,5.2,15.7,-6293,-2.9,25.6,0,1420,1420,8875
2005,27,h) 11 to 15,13666,14815,178337,177232,585,3.9,1134,7.5,25726,5480,20246,3.1,14.5,23515,7023,16492,4,13.3,2211,1.2,26.6,0,757,757,4849
2005,27,i) 16 to 20,9713,11577,200132,200662,391,3.3,694,5.9,21666,6143,15523,3.1,10.8,22725,5628,17097,2.8,11.3,-1059,-0.5,21.6,0,455,455,3762
2005,27,j) 21 to 25,7092,9136,179856,179807,268,2.9,439,4.8,17638,3093,14545,1.7,9.8,17540,4081,13459,2.3,9.8,98,0,19.6,0,258,258,1672
2005,27,k) 26+,3956,6030,142461,140512,230,3.8,277,4.6,19328,7754,11574,5.5,13.8,15430,2918,12512,2.1,11,3898,2.8,22,0,149,150,1386
2005,27,l) Left Censored,13930,30258,1221962,1214453,1486,4.9,1454,4.8,129825,40116,89709,3.3,10.7,114807,28061,86746,2.3,9.5,15018,1.2,19,0,402,407,4580
2005,28,a) 0,3966,4002,25604,12833,3980,198.9,0,0,25543,25543,0,199,199,0,0,0,0,0,25543,199,0,0,,,
2005,28,b) 1,2953,2977,21375,23289,13,0.4,926,26.5,5652,247,5405,1.1,24.3,9479,5932,3547,25.5,40.7,-3827,-16.4,48.6,0,770,770,5372
2005,28,c) 2,2597,2634,21494,22639,100,3.5,530,18.5,3620,373,3247,1.6,16,5909,3038,2871,13.4,26.1,-2289,-10.1,32,0,443,443,2657
2005,28,d) 3,2222,2259,21005,22165,78,3.2,363,15.1,3484,617,2867,2.8,15.7,5804,2344,3460,10.6,26.2,-2320,-10.5,31.4,0,307,307,1943
2005,28,e) 4,1997,2054,17750,18666,77,3.6,282,13,2563,462,2101,2.5,13.7,4395,1991,2404,10.7,23.5,-1832,-9.8,27.4,0,239,239,1737
2005,28,f) 5,1814,1888,16696,17168,62,3.1,229,11.6,2552,677,1875,3.9,14.9,3496,1219,2277,7.1,20.4,-944,-5.5,29.8,0,175,175,1026
2005,28,g) 6 to 10,7630,8226,81244,83495,331,3.9,853,10,12055,2765,9290,3.3,14.4,16556,6382,10174,7.6,19.8,-4501,-5.4,28.8,0,684,685,5472
2005,28,h) 11 to 15,5258,5734,71287,73122,223,3.8,499,8.5,9247,1637,7610,2.2,12.6,12916,4005,8911,5.5,17.7,-3669,-5.1,25.2,0,370,370,2065
2005,28,i) 16 to 20,3822,4395,72233,73097,128,2.8,360,8,6723,1124,5599,1.5,9.2,8450,2313,6137,3.2,11.6,-1727,-2.4,18.4,0,229,239,1309
2005,28,j) 21 to 25,3558,4337,67095,67143,135,3.1,200,4.6,7957,1953,6004,2.9,11.9,8052,1289,6763,1.9,12,-95,-0.1,23.8,0,138,138,774
2005,28,k) 26+,1824,2675,52328,52460,82,3,123,4.5,6664,2043,4621,3.9,12.7,6927,1427,5500,2.7,13.2,-263,-0.5,25.4,0,79,79,696
2005,28,l) Left Censored,6092,14634,454738,453401,886,6.1,727,5,45950,13762,32188,3,10.1,43276,9155,34121,2,9.5,2674,0.6,19,0,213,215,1539
2005,29,a) 0,11906,11994,68743,34520,11931,198.9,0,0,68447,68447,0,198.3,198.3,0,0,0,0,0,68447,198.3,0,0,,,
2005,29,b) 1,8700,8761,56531,58604,25,0.2,2787,27.2,13801,229,13572,0.4,23.5,17947,11487,6460,19.6,30.6,-4146,-7.1,47,0,2318,2318,10358
2005,29,c) 2,6725,6812,46959,49089,269,3.6,1406,18.9,8719,1075,7644,2.2,17.8,12979,5917,7062,12.1,26.4,-4260,-8.6,35.6,0,1184,1184,5319
2005,29,d) 3,5912,6024,53285,56130,215,3.4,946,14.8,7378,885,6493,1.6,13.1,13067,5191,7876,9.2,23.3,-5689,-10.2,26.2,0,794,794,4682
2005,29,e) 4,4788,4970,43625,44182,213,4.1,595,11.5,7946,829,7117,1.9,18,9060,2762,6298,6.3,20.5,-1114,-2.5,36,0,487,487,2451
2005,29,f) 5,4762,4965,45439,46346,213,4.1,565,11,7469,1598,5871,3.4,16.1,9283,3583,5700,7.7,20,-1814,-3.9,32.2,0,430,430,3152
2005,29,g) 6 to 10,18649,19866,210096,218553,799,3.9,2056,10,29578,4718,24860,2.2,13.5,46491,15466,31025,7.1,21.3,-16913,-7.8,27,0,1577,1578,12631
2005,29,h) 11 to 15,12910,14009,158690,162480,471,3.3,1146,8,20250,3682,16568,2.3,12.5,27830,9506,18324,5.9,17.1,-7580,-4.6,25,0,848,848,7806
2005,29,i) 16 to 20,10520,12652,215375,216289,506,3.9,835,6.5,25323,5942,19381,2.7,11.7,27150,8378,18772,3.9,12.6,-1827,-0.9,23.4,0,568,576,6378
2005,29,j) 21 to 25,7791,9768,172762,173682,266,2.7,542,5.5,15389,3504,11885,2,8.9,17229,4032,13197,2.3,9.9,-1840,-1,17.8,0,354,354,2434
2005,29,k) 26+,4042,6682,155039,154882,361,5.4,370,5.5,18773,7216,11557,4.7,12.1,18458,3415,15043,2.2,11.9,315,0.2,23.8,0,184,185,1140
2005,29,l) Left Censored,14531,33291,1180852,1181345,1895,5.7,1627,4.9,110812,37869,72943,3.2,9.4,111798,25872,85926,2.2,9.5,-986,-0.1,18.8,0,475,477,6836
2005,30,a) 0,2890,2896,12444,6246,2876,198.6,0,0,12397,12397,0,198.5,198.5,0,0,0,0,0,12397,198.5,0,0,,,
2005,30,b) 1,2149,2160,10913,10998,4,0.2,574,23.1,2697,32,2665,0.3,24.5,2866,1567,1299,14.2,26.1,-169,-1.6,49,0,395,395,1177
2005,30,c) 2,1636,1654,9122,9266,97,5.5,295,16.8,1819,321,1498,3.5,19.6,2107,987,1120,10.7,22.7,-288,-3.1,39.2,0,220,220,777
2005,30,d) 3,1525,1567,10042,10212,73,4.5,200,12.2,1679,240,1439,2.4,16.4,2018,775,1243,7.6,19.8,-339,-3.4,32.8,0,157,157,686
2005,30,e) 4,1350,1365,8006,8281,64,4.5,167,11.8,1346,232,1114,2.8,16.3,1895,764,1131,9.2,22.9,-549,-6.6,32.6,0,131,131,647
2005,30,f) 5,1264,1294,10375,10246,73,5.5,134,10.1,1636,245,1391,2.4,16,1377,542,835,5.3,13.4,259,2.6,26.8,0,97,97,431
2005,30,g) 6 to 10,5076,5298,42178,43079,227,4.1,533,9.7,5649,844,4805,2,13.1,7450,2685,4765,6.2,17.3,-1801,-4.2,26.2,0,379,385,1848
2005,30,h) 11 to 15,3173,3303,27118,27565,158,4.7,277,8.2,3353,799,2554,2.9,12.2,4247,1289,2958,4.7,15.4,-894,-3.2,24.4,0,182,182,912
2005,30,i) 16 to 20,2100,2362,28170,28330,92,3.8,186,7.7,4046,1779,2267,6.3,14.3,4365,929,3436,3.3,15.4,-319,-1.1,28.6,0,130,130,682
2005,30,j) 21 to 25,1778,2140,29018,29009,60,2.8,114,5.3,2474,265,2209,0.9,8.5,2455,500,1955,1.7,8.5,19,0,17,0,78,78,325
2005,30,k) 26+,1022,1578,20761,20540,73,4.6,85,5.4,2272,656,1616,3.2,11.1,1830,469,1361,2.3,8.9,442,2.2,17.8,0,34,34,96
2005,30,l) Left Censored,2771,5339,115005,114278,230,4.3,217,4.1,9811,2153,7658,1.9,8.6,8356,1290,7066,1.1,7.3,1455,1.3,14.6,0,75,75,258
2005,31,a) 0,3252,3272,18189,9121,3245,198.3,0,0,18136,18136,0,198.8,198.8,0,0,0,0,0,18136,198.8,0,0,,,
2005,31,b) 1,2468,2487,16648,17040,10,0.4,619,21.8,3991,34,3957,0.2,23.4,4775,3092,1683,18.1,28,-784,-4.6,46.8,0,463,463,2404
2005,31,c) 2,2112,2136,13606,14743,90,3.9,369,16.2,2157,259,1898,1.8,14.6,4431,2780,1651,18.9,30.1,-2274,-15.5,29.2,0,306,306,2581
2005,31,d) 3,1990,2056,15236,15547,101,4.7,301,13.9,2604,441,2163,2.8,16.7,3226,1326,1900,8.5,20.7,-622,-4,33.4,0,226,226,1141
2005,31,e) 4,1814,1867,15702,15901,85,4.4,221,11.4,2391,331,2060,2.1,15,2789,1268,1521,8,17.5,-398,-2.5,30,0,169,169,1090
2005,31,f) 5,1657,1697,12680,12682,71,4,191,10.8,1861,222,1639,1.8,14.7,1865,567,1298,4.5,14.7,-4,0,29.4,0,148,148,472
2005,31,g) 6 to 10,6832,7289,76148,76519,274,3.6,678,9,9492,987,8505,1.3,12.4,10234,3430,6804,4.5,13.4,-742,-1,24.8,0,482,482,2793
2005,31,h) 11 to 15,5096,5445,48392,49346,244,4.4,417,7.5,5799,1476,4323,3,11.8,7706,2589,5117,5.2,15.6,-1907,-3.8,23.6,0,281,281,1726
2005,31,i) 16 to 20,3555,4110,87616,85607,104,2.5,262,6.2,13265,1981,11284,2.3,15.5,9246,1622,7624,1.9,10.8,4019,4.7,21.6,0,181,191,991
2005,31,j) 21 to 25,3064,3709,50749,51519,96,2.6,176,4.7,4878,1309,3569,2.5,9.5,6418,1461,4957,2.8,12.5,-1540,-3,19,0,123,123,953
2005,31,k) 26+,1647,2537,49586,50114,102,4,135,5.3,5166,1087,4079,2.2,10.3,6221,1417,4804,2.8,12.4,-1055,-2.1,20.6,0,75,75,432
2005,31,l) Left Censored,6281,11911,373333,376604,538,4.5,520,4.4,38846,9957,28889,2.6,10.3,45388,6984,38404,1.9,12.1,-6542,-1.8,20.6,0,167,167,1414
2005,32,a) 0,5991,6066,49766,24921,6029,198.8,0,0,49690,49690,0,199.4,199.4,0,0,0,0,0,49690,199.4,0,0,,,
2005,32,b) 1,4162,4190,42402,40551,19,0.4,1300,26.6,15101,125,14976,0.3,37.2,11398,7264,4134,17.9,28.1,3703,9.1,56.2,0,1048,1048,5886
2005,32,c) 2,3342,3431,36160,35057,178,4.8,715,19.2,9238,1308,7930,3.7,26.4,7032,3241,3791,9.2,20.1,2206,6.3,40.2,0,569,569,2625
2005,32,d) 3,2696,2739,35317,34660,108,3.7,479,16.3,7026,464,6562,1.3,20.3,5712,2949,2763,8.5,16.5,1314,3.8,33,0,384,384,2425
2005,32,e) 4,2228,2298,32057,31123,106,4.3,379,15.5,7187,583,6604,1.9,23.1,5318,2607,2711,8.4,17.1,1869,6,34.2,0,312,312,2303
2005,32,f) 5,1984,2037,28980,29680,97,4.5,310,14.4,6336,1650,4686,5.6,21.3,7735,4842,2893,16.3,26.1,-1399,-4.8,42.6,0,240,240,4092
2005,32,g) 6 to 10,7117,7699,121596,122572,371,4.7,835,10.5,20285,2532,17753,2.1,16.5,22237,10205,12032,8.3,18.1,-1952,-1.6,33,0,653,654,8965
2005,32,h) 11 to 15,3683,4023,79013,77841,193,4.7,379,9.2,12224,2227,9997,2.9,15.7,9879,3849,6030,4.9,12.7,2345,3,25.4,0,283,283,2469
2005,32,i) 16 to 20,2632,3444,74680,74080,154,4.4,255,7.3,9881,1823,8058,2.5,13.3,8680,2269,6411,3.1,11.7,1201,1.6,23.4,0,177,177,1341
2005,32,j) 21 to 25,1914,2732,74202,74113,186,6.8,185,6.8,11352,3713,7639,5,15.3,11173,4784,6389,6.5,15.1,179,0.2,30.2,0,110,110,809
2005,32,k) 26+,1129,1956,59898,58325,129,6.7,89,4.6,7795,2381,5414,4.1,13.4,4649,738,3911,1.3,8,3146,5.4,16,0,38,38,188
2005,32,l) Left Censored,3219,8944,438618,437079,792,9,475,5.4,52079,15194,36885,3.5,11.9,49000,19150,29850,4.4,11.2,3079,0.7,22.4,0,81,82,4336
2005,33,a) 0,2643,2666,14852,7440,2650,198.8,0,0,14824,,,,199.2,0,0,0,0,0,14824,199.2,0,1,,,
2005,33,b) 1,1995,2007,11204,11426,7,0.3,569,24.6,2780,,,,24.3,3224,1859,1365,16.3,28.2,-444,-3.9,48.6,1,442,442,1543
2005,33,c) 2,1599,1632,10558,10799,73,4.2,306,17.5,1974,339,1635,3.1,18.3,2456,1119,1337,10.4,22.7,-482,-4.4,36.6,0,257,257,1026
2005,33,d) 3,1429,1445,12203,12524,49,3.2,227,14.8,1914,289,1625,2.3,15.3,2555,1246,1309,9.9,20.4,-641,-5.1,30.6,0,186,186,1015
2005,33,e) 4,1263,1308,10611,10990,64,4.7,188,13.7,1646,381,1265,3.5,15,2403,881,1522,8,21.9,-757,-6.9,30,0,146,146,700
2005,33,f) 5,1247,1280,10570,10742,51,3.9,126,9.5,1465,130,1335,1.2,13.6,1808,573,1235,5.3,16.8,-343,-3.2,27.2,0,96,96,352
2005,33,g) 6 to 10,5290,5517,50971,51704,219,3.8,552,9.7,6950,1649,5301,3.2,13.4,8416,3740,4676,7.2,16.3,-1466,-2.9,26.8,0,428,428,3340
2005,33,h) 11 to 15,3553,3720,41358,41753,119,3.1,230,6.1,4754,938,3816,2.2,11.4,5543,1427,4116,3.4,13.3,-789,-1.9,22.8,0,173,173,1062
2005,33,i) 16 to 20,3332,3747,59317,59134,121,3.2,234,6.1,6977,1697,5280,2.9,11.8,6611,1761,4850,3,11.2,366,0.6,22.4,0,175,175,997
2005,33,j) 21 to 25,1923,2310,39136,39283,62,2.6,140,5.9,3558,368,3190,0.9,9.1,3851,1151,2700,2.9,9.8,-293,-0.7,18.2,0,103,103,944
2005,33,k) 26+,1032,1591,33628,33254,67,4.2,74,4.6,3460,1072,2388,3.2,10.4,2711,535,2176,1.6,8.2,749,2.2,16.4,0,36,36,140
2005,33,l) Left Censored,3729,7635,259274,256953,477,6.3,413,5.4,25675,8864,16811,3.4,10,21033,5760,15273,2.2,8.2,4642,1.8,16.4,0,116,117,2214
2005,34,a) 0,17810,17904,95596,48093,17770,198.5,0,0,95007,95007,0,197.5,197.5,0,0,0,0,0,95007,197.5,0,0,,,
2005,34,b) 1,12917,12970,82167,85056,30,0.2,3630,24.3,22331,361,21970,0.4,26.3,28109,17985,10124,21.1,33,-5778,-6.7,52.6,0,2868,2868,15618
2005,34,c) 2,10747,10840,80655,82751,429,3.7,2039,17.4,14632,1390,13242,1.7,17.7,18823,10175,8648,12.3,22.7,-4191,-5,35.4,0,1627,1627,9002
2005,34,d) 3,9397,9501,81872,83434,353,3.5,1581,15.6,14144,1912,12232,2.3,17,17267,8905,8362,10.7,20.7,-3123,-3.7,34,0,1249,1249,7510
2005,34,e) 4,8769,8964,78304,80327,356,3.8,1219,12.9,11267,1383,9884,1.7,14,15313,5886,9427,7.3,19.1,-4046,-5.1,28,0,949,949,4993
2005,34,f) 5,7881,8012,73147,75449,330,3.9,1030,12.3,9766,1298,8468,1.7,12.9,14370,6664,7706,8.8,19,-4604,-6.1,25.8,0,798,798,5821
2005,34,g) 6 to 10,33283,34701,358825,369914,1323,3.7,3626,10.1,44914,7158,37756,1.9,12.1,67092,25580,41512,6.9,18.1,-22178,-6,24.2,0,2794,2794,20018
2005,34,h) 11 to 15,20686,21630,250755,253901,688,3.1,1765,7.9,33100,5448,27652,2.1,13,39392,10898,28494,4.3,15.5,-6292,-2.5,26,0,1288,1288,7878
2005,34,i) 16 to 20,17861,19879,298424,299898,581,2.9,1484,7.3,32287,4173,28114,1.4,10.8,35235,10012,25223,3.3,11.7,-2948,-0.9,21.6,0,1009,1009,6040
2005,34,j) 21 to 25,12271,14389,269584,273834,439,3,900,6.1,24259,3488,20771,1.3,8.9,32759,6620,26139,2.4,12,-8500,-3.1,17.8,0,624,630,4120
2005,34,k) 26+,6281,8695,204229,204240,357,4.1,513,5.8,25089,7080,18009,3.5,12.3,25111,9179,15932,4.5,12.3,-22,0,24.6,0,298,299,3451
2005,34,l) Left Censored,22306,44848,1680616,1698150,2987,6.6,3257,7.2,188877,68341,120536,4,11.1,223944,69288,154656,4.1,13.2,-35067,-2.1,22.2,0,937,942,11619
2005,35,a) 0,3173,3193,19320,9696,3175,198.9,0,0,19248,19248,0,198.5,198.5,0,0,0,0,0,19248,198.5,0,0,,,
2005,35,b) 1,2348,2398,18388,18404,31,1.1,680,24.6,5587,678,4909,3.7,30.4,5618,3561,2057,19.3,30.5,-31,-0.1,60.8,0,545,545,3223
2005,35,c) 2,1902,1926,14261,14932,84,4.1,351,17,3057,297,2760,2,20.5,4399,2306,2093,15.4,29.5,-1342,-9,41,0,283,290,2115
2005,35,d) 3,1752,1783,17530,17955,67,3.6,260,13.8,2695,601,2094,3.3,15,3545,1630,1915,9.1,19.7,-850,-4.7,30,0,218,218,1482
2005,35,e) 4,1607,1716,15895,15885,68,3.8,201,11.2,2557,297,2260,1.9,16.1,2536,988,1548,6.2,16,21,0.1,32,0,152,152,766
2005,35,f) 5,1431,1488,14442,15044,62,4,151,9.8,1978,239,1739,1.6,13.1,3182,873,2309,5.8,21.2,-1204,-8.1,26.2,0,115,115,683
2005,35,g) 6 to 10,5902,6218,66864,67856,284,4.4,653,10.2,10011,1999,8012,2.9,14.8,11994,3403,8591,5,17.7,-1983,-2.9,29.6,0,490,490,2673
2005,35,h) 11 to 15,4113,4494,51319,51251,173,3.8,371,8.1,7882,2022,5860,3.9,15.4,7746,1777,5969,3.5,15.1,136,0.3,30.2,0,248,248,1289
2005,35,i) 16 to 20,2938,3529,65211,63086,114,3.2,239,6.6,10735,1494,9241,2.4,17,6485,1522,4963,2.4,10.3,4250,6.7,20.6,0,148,150,737
2005,35,j) 21 to 25,2576,3295,47855,48252,107,3.2,158,4.8,4813,820,3993,1.7,10,5607,912,4695,1.9,11.6,-794,-1.6,20,0,111,112,680
2005,35,k) 26+,1309,2114,40883,41111,106,5,105,5,4836,921,3915,2.2,11.8,5291,1143,4148,2.8,12.9,-455,-1.1,23.6,0,49,49,299
2005,35,l) Left Censored,3707,8240,225601,224111,472,5.8,394,4.8,28138,8680,19458,3.9,12.6,25158,6243,18915,2.8,11.2,2980,1.4,22.4,0,93,93,1588
2005,36,a) 0,38731,38915,216429,108439,38705,198.9,0,0,215981,215981,0,199.2,199.2,0,0,0,0,0,215981,199.2,0,0,,,
2005,36,b) 1,29181,29315,177866,184660,52,0.2,7982,23.8,42398,539,41859,0.3,23,55985,32506,23479,17.6,30.3,-13587,-7.3,46,0,6237,6237,27037
2005,36,c) 2,24419,24612,161947,168742,939,3.5,4589,17.3,28634,3429,25205,2,17,42224,21296,20928,12.6,25,-13590,-8,34,0,3748,3748,18250
2005,36,d) 3,21123,21430,172084,180354,866,3.8,3392,14.9,25524,3099,22425,1.7,14.2,42063,19530,22533,10.8,23.3,-16539,-9.1,28.4,0,2723,2723,13432
2005,36,e) 4,18774,19042,152426,157834,767,3.8,2729,13.6,22295,3289,19006,2.1,14.1,33110,14906,18204,9.4,21,-10815,-6.9,28.2,0,2163,2164,13115
2005,36,f) 5,16896,17291,147049,150660,629,3.5,2260,12.5,21584,2771,18813,1.8,14.3,28806,12082,16724,8,19.1,-7222,-4.8,28.6,0,1766,1766,9941
2005,36,g) 6 to 10,67563,70586,700622,715863,2383,3.2,7632,10.4,92146,14208,77938,2,12.9,122627,49037,73590,6.9,17.1,-30481,-4.2,25.8,0,5911,5912,41212
2005,36,h) 11 to 15,43599,45736,520583,528693,1428,3,3660,7.8,61812,9170,52642,1.7,11.7,78032,24586,53446,4.7,14.8,-16220,-3.1,23.4,0,2741,2743,18994
2005,36,i) 16 to 20,37971,41774,640340,651528,1273,3,2837,6.7,59451,13247,46204,2,9.1,81827,22888,58939,3.5,12.6,-22376,-3.5,18.2,0,1985,1996,15076
2005,36,j) 21 to 25,25775,30470,532355,536089,787,2.5,1737,5.6,52806,9568,43238,1.8,9.9,60273,15023,45250,2.8,11.2,-7467,-1.3,19.8,0,1238,1254,11730
2005,36,k) 26+,12527,18462,426436,426797,670,3.6,998,5.4,46375,12159,34216,2.8,10.9,47097,9959,37138,2.3,11,-722,-0.1,21.8,0,614,619,4219
2005,36,l) Left Censored,48540,94951,3568018,3580250,4995,5.2,7865,8.2,394385,135368,259017,3.8,11,418848,119114,299734,3.3,11.7,-24463,-0.7,22,0,2070,2074,25899
2005,37,a) 0,15960,16089,97753,48994,15995,198.8,0,0,97518,97518,0,199,199,0,0,0,0,0,97518,199,0,0,,,
2005,37,b) 1,11396,11490,83807,85538,48,0.4,3006,22.9,24010,1171,22839,1.4,28.1,27471,14086,13385,16.5,32.1,-3461,-4,56.2,0,2387,2387,12351
2005,37,c) 2,9378,9493,78080,80124,342,3.4,1663,16.3,16092,1543,14549,1.9,20.1,20179,10563,9616,13.2,25.2,-4087,-5.1,40.2,0,1372,1372,9338
2005,37,d) 3,8138,8385,72104,74291,344,3.9,1268,14.3,13271,1686,11585,2.3,17.9,17645,7467,10178,10.1,23.8,-4374,-5.9,35.8,0,1037,1037,6768
2005,37,e) 4,7731,8035,72643,74835,292,3.5,1091,12.9,11386,1150,10236,1.5,15.2,15769,5242,10527,7,21.1,-4383,-5.9,30.4,0,891,891,4477
2005,37,f) 5,6975,7327,71570,73059,296,3.9,833,10.9,11199,1707,9492,2.3,15.3,14176,4761,9415,6.5,19.4,-2977,-4.1,30.6,0,633,633,3799
2005,37,g) 6 to 10,28176,30283,329979,331566,1269,4.1,2952,9.5,56080,8756,47324,2.6,16.9,59254,19798,39456,6,17.9,-3174,-1,33.8,0,2279,2289,16726
2005,37,h) 11 to 15,17250,18837,233237,235772,726,3.8,1597,8.3,33747,6892,26855,2.9,14.3,38816,11612,27204,4.9,16.5,-5069,-2.2,28.6,0,1134,1134,8024
2005,37,i) 16 to 20,14354,17256,305524,306486,579,3.3,1104,6.3,34930,5360,29570,1.7,11.4,36853,9422,27431,3.1,12,-1923,-0.6,22.8,0,740,751,5546
2005,37,j) 21 to 25,10949,13854,225412,226614,431,3.1,768,5.5,25452,4972,20480,2.2,11.2,27856,7690,20166,3.4,12.3,-2404,-1.1,22.4,0,471,486,2654
2005,37,k) 26+,5100,8694,202028,199078,379,4.4,389,4.5,25674,6913,18761,3.5,12.9,19773,4517,15256,2.3,9.9,5901,3,19.8,0,235,235,2354
2005,37,l) Left Censored,16941,45131,1636889,1629353,2779,6.2,2378,5.3,190975,75673,115302,4.6,11.7,175903,41137,134766,2.5,10.8,15072,0.9,21.6,0,606,609,6402
2005,38,a) 0,1385,1394,7299,3666,1383,198.4,0,0,7266,7266,0,198.2,198.2,0,0,0,0,0,7266,198.2,0,0,,,
2005,38,b) 1,1013,1027,6562,6491,7,0.6,295,24.7,1528,84,1444,1.3,23.5,1386,724,662,11.2,21.4,142,2.1,42.8,0,168,168,510
2005,38,c) 2,812,828,4955,5217,51,5.8,164,18.5,915,106,809,2,17.5,1438,544,894,10.4,27.6,-523,-10.1,35,0,121,121,463
2005,38,d) 3,781,803,5365,5548,45,5.4,100,12,824,122,702,2.2,14.9,1190,359,831,6.5,21.4,-366,-6.5,29.8,0,70,70,306
2005,38,e) 4,698,716,5265,5472,43,5.9,75,10.2,603,94,509,1.7,11,1017,257,760,4.7,18.6,-414,-7.6,22,0,50,50,213
2005,38,f) 5,648,660,4560,4586,37,5.4,74,10.9,726,80,646,1.7,15.8,778,234,544,5.1,17,-52,-1.2,31.6,0,57,57,197
2005,38,g) 6 to 10,2687,2815,24647,24176,155,5.4,309,10.7,4095,864,3231,3.6,16.9,3152,1149,2003,4.8,13,943,3.9,26,0,184,184,894
2005,38,h) 11 to 15,2340,2429,21972,21939,151,6.1,247,10,2816,408,2408,1.9,12.8,2750,905,1845,4.1,12.5,66,0.3,25,0,142,142,648
2005,38,i) 16 to 20,1556,1759,19349,19472,58,3.3,95,5.3,2016,445,1571,2.3,10.4,2262,616,1646,3.2,11.6,-246,-1.2,20.8,0,60,60,247
2005,38,j) 21 to 25,1417,1694,22121,21862,43,2.5,100,5.8,2661,218,2443,1,12.2,2143,415,1728,1.9,9.8,518,2.4,19.6,0,61,61,281
2005,38,k) 26+,757,1049,17482,16227,68,6.5,58,5.5,3714,2192,1522,13.5,22.9,1204,199,1005,1.2,7.4,2510,15.5,14.8,0,26,26,73
2005,38,l) Left Censored,2859,5063,133325,134009,208,4.1,214,4.2,11028,2655,8373,2,8.2,12396,5362,7034,4,9.3,-1368,-1.1,16.4,0,85,85,798
2005,39,a) 0,14752,14919,114414,57369,14824,198.7,0,0,114091,114091,0,198.9,198.9,0,0,0,0,0,114091,198.9,0,0,,,
2005,39,b) 1,11107,11205,92287,94868,35,0.3,3095,24,22486,373,22113,0.4,23.7,27648,15902,11746,16.8,29.1,-5162,-5.4,47.4,0,2439,2439,13538
2005,39,c) 2,9388,9563,82048,86553,364,3.5,1835,17.8,15954,2864,13090,3.3,18.4,24964,14556,10408,16.8,28.8,-9010,-10.4,36.8,0,1503,1503,12996
2005,39,d) 3,8869,9244,91858,95014,358,3.7,1334,13.7,14214,1547,12667,1.6,15,20526,8579,11947,9,21.6,-6312,-6.6,30,0,1060,1060,7703
2005,39,e) 4,7853,8175,72423,74464,279,3.2,1083,12.6,11189,1366,9823,1.8,15,15271,5977,9294,8,20.5,-4082,-5.5,30,0,864,864,5045
2005,39,f) 5,7301,7629,80962,82985,278,3.5,946,11.8,11536,1559,9977,1.9,13.9,15581,6622,8959,8,18.8,-4045,-4.9,27.8,0,719,719,5603
2005,39,g) 6 to 10,32180,34820,380112,390019,1282,3.6,3470,9.6,50790,9080,41710,2.3,13,70603,25362,45241,6.5,18.1,-19813,-5.1,26,0,2592,2593,19240
2005,39,h) 11 to 15,23509,25900,325616,327139,871,3.3,1896,7.2,44362,8530,35832,2.6,13.6,47408,12366,35042,3.8,14.5,-3046,-0.9,27.2,0,1361,1362,9600
2005,39,i) 16 to 20,19371,23508,401769,407637,791,3.3,1520,6.4,41230,10419,30811,2.6,10.1,52966,13797,39169,3.4,13,-11736,-2.9,20.2,0,968,988,8237
2005,39,j) 21 to 25,14561,18376,309726,312287,505,2.7,932,5,32474,8782,23692,2.8,10.4,37596,10465,27131,3.4,12,-5122,-1.6,20.8,0,630,630,8263
2005,39,k) 26+,8113,12861,290901,287372,529,4.1,621,4.8,35664,11474,24190,4,12.4,28605,6811,21794,2.4,10,7059,2.4,20,0,323,333,2358
2005,39,l) Left Censored,30425,70833,2505885,2514180,3577,5,3816,5.4,272695,78387,194308,3.1,10.8,289284,73235,216049,2.9,11.5,-16589,-0.7,21.6,0,1149,1150,16519
2005,40,a) 0,6212,6284,38278,19235,6241,198.6,0,0,38087,38087,0,198,198,0,0,0,0,0,38087,198,0,0,,,
2005,40,b) 1,4354,4380,30208,31198,10,0.2,1307,25.6,8129,34,8095,0.1,26.1,10108,6904,3204,22.1,32.4,-1979,-6.3,52.2,0,1082,1090,6392
2005,40,c) 2,3742,3769,27086,27342,125,3.1,723,17.7,6026,627,5399,2.3,22,6537,3460,3077,12.7,23.9,-511,-1.9,44,0,601,601,3170
2005,40,d) 3,3426,3508,29533,31483,136,3.7,523,14.1,4954,687,4267,2.2,15.7,8853,5122,3731,16.3,28.1,-3899,-12.4,31.4,0,430,430,4516
2005,40,e) 4,2998,3117,25000,25009,108,3.3,401,12.3,4556,562,3994,2.2,18.2,4574,2054,2520,8.2,18.3,-18,-0.1,36.4,0,321,321,1858
2005,40,f) 5,2708,2908,26753,26899,203,6.8,381,12.7,5067,1022,4045,3.8,18.8,5358,2327,3031,8.7,19.9,-291,-1.1,37.6,0,310,310,2012
2005,40,g) 6 to 10,11251,12108,119554,121849,486,3.9,1226,9.8,16779,2091,14688,1.7,13.8,21369,8732,12637,7.2,17.5,-4590,-3.7,27.6,0,944,944,6611
2005,40,h) 11 to 15,8005,8680,95086,95025,367,4.1,705,8,14025,3606,10419,3.8,14.8,13903,4724,9179,5,14.6,122,0.2,29.2,0,512,512,3187
2005,40,i) 16 to 20,5725,6626,98800,102096,266,4,449,6.7,11292,3223,8069,3.2,11.1,17883,6927,10956,6.8,17.5,-6591,-6.4,22.2,0,325,325,2351
2005,40,j) 21 to 25,5762,6895,103266,104204,205,2.9,328,4.7,11306,2071,9235,2,10.8,13182,3235,9947,3.1,12.7,-1876,-1.9,21.6,0,232,232,2547
2005,40,k) 26+,2641,4301,93396,90826,269,6.3,177,4.2,14067,5038,9029,5.5,15.5,8926,1288,7638,1.4,9.8,5141,5.7,19.6,0,108,109,682
2005,40,l) Left Censored,7886,17968,521129,519367,852,4.7,920,5.1,53549,17980,35569,3.5,10.3,50025,12966,37059,2.5,9.6,3524,0.7,19.2,0,253,253,2728
2005,41,a) 0,8599,8685,43397,21778,8626,198.6,0,0,43239,43239,0,198.5,198.5,0,0,0,0,0,43239,198.5,0,0,,,
2005,41,b) 1,5811,5878,39905,40289,23,0.3,1642,24.2,10348,314,10034,0.8,25.7,11115,7007,4108,17.4,27.6,-767,-1.9,51.4,0,1260,1260,6084
2005,41,c) 2,4919,5032,32159,32476,238,4.4,849,15.8,6978,949,6029,2.9,21.5,7612,3728,3884,11.5,23.4,-634,-1.9,43,0,698,698,3188
2005,41,d) 3,4391,4498,32757,32964,203,4.3,643,13.6,6046,1173,4873,3.6,18.3,6460,3296,3164,10,19.6,-414,-1.3,36.6,0,508,508,2775
2005,41,e) 4,4007,4118,31392,31628,214,5,511,11.9,5583,932,4651,2.9,17.7,6055,2687,3368,8.5,19.1,-472,-1.4,35.4,0,380,380,1600
2005,41,f) 5,3551,3655,31787,31900,161,4.2,443,11.6,6141,2202,3939,6.9,19.3,6367,2363,4004,7.4,20,-226,-0.7,38.6,0,342,342,1917
2005,41,g) 6 to 10,14932,15835,159145,158972,762,4.7,1462,9,22097,3898,18199,2.5,13.9,21751,6969,14782,4.4,13.7,346,0.2,27.4,0,1087,1087,5350
2005,41,h) 11 to 15,9950,10757,118899,117416,465,4.2,887,8.1,18918,3378,15540,2.9,16.1,15952,5327,10625,4.5,13.6,2966,2.5,27.2,0,613,613,3786
2005,41,i) 16 to 20,6814,7962,117542,116280,342,4.2,499,6.2,15113,2933,12180,2.5,13,12588,4386,8202,3.8,10.8,2525,2.2,21.6,0,344,344,3140
2005,41,j) 21 to 25,5251,6781,122935,120876,259,3.8,373,5.4,15184,4084,11100,3.4,12.6,11066,3259,7807,2.7,9.2,4118,3.4,18.4,0,229,229,1785
2005,41,k) 26+,2930,4391,91281,88432,195,4.4,219,5,11875,3451,8424,3.9,13.4,6177,1479,4698,1.7,7,5698,6.4,14,0,124,124,660
2005,41,l) Left Censored,7929,18563,591248,585337,1130,6.1,1176,6.3,68243,25325,42918,4.3,11.7,56421,17711,38710,3,9.6,11822,2.1,19.2,0,269,274,4572
2005,42,a) 0,17998,18176,129447,64928,18078,198.9,0,0,129039,129039,0,198.7,198.7,0,0,0,0,0,129039,198.7,0,0,,,
2005,42,b) 1,13281,13462,99167,102426,41,0.3,3424,22.4,24010,400,23610,0.4,23.4,30527,16084,14443,15.7,29.8,-6517,-6.4,46.8,0,2642,2642,13640
2005,42,c) 2,11150,11296,98533,101364,392,3.2,1921,15.9,17105,2029,15076,2,16.9,22766,10658,12108,10.5,22.5,-5661,-5.6,33.8,0,1582,1582,9637
2005,42,d) 3,10566,10824,111064,114002,384,3.4,1402,12.3,17139,2114,15025,1.9,15,23015,11521,11494,10.1,20.2,-5876,-5.2,30,0,1143,1143,10751
2005,42,e) 4,9503,9802,86769,88026,346,3.4,1193,11.7,13293,1973,11320,2.2,15.1,15807,6340,9467,7.2,18,-2514,-2.9,30.2,0,954,954,5213
2005,42,f) 5,8810,9088,92629,93903,300,3.2,1063,11.2,13013,2034,10979,2.2,13.9,15560,6250,9310,6.7,16.6,-2547,-2.7,27.8,0,804,805,4680
2005,42,g) 6 to 10,36608,39325,426142,431971,1313,3.2,3576,8.8,55463,9702,45761,2.2,12.8,67120,24954,42166,5.8,15.5,-11657,-2.7,25.6,0,2703,2705,18375
2005,42,h) 11 to 15,25975,27909,336617,340251,895,3.1,2145,7.5,42384,6729,35655,2,12.5,49651,16918,32733,5,14.6,-7267,-2.1,25,0,1590,1606,13329
2005,42,i) 16 to 20,23874,27541,434774,438757,804,2.9,1789,6.4,43204,9131,34073,2.1,9.8,51169,17690,33479,4,11.7,-7965,-1.9,19.6,0,1217,1220,8679
2005,42,j) 21 to 25,16859,20900,374753,373889,688,3.3,1133,5.4,40403,7947,32456,2.1,10.8,38676,9716,28960,2.6,10.3,1727,0.5,20.6,0,742,751,4558
2005,42,k) 26+,8710,13624,294409,294110,511,3.7,683,5,33952,11701,22251,4,11.5,33354,7287,26067,2.5,11.3,598,0.2,22.6,0,401,405,3507
2005,42,l) Left Censored,33175,74297,2591268,2623862,4263,5.7,4276,5.8,244238,78978,165260,3,9.3,309425,88188,221237,3.4,11.8,-65187,-2.5,18.6,0,1257,1269,18171
2005,44,a) 0,1990,1995,11171,5633,1975,198,0,0,11077,11077,0,196.6,196.6,0,0,0,0,0,11077,196.6,0,0,,,
2005,44,b) 1,1586,1598,10495,10990,7,0.4,483,26.1,2252,60,2192,0.5,20.5,3241,1648,1593,15,29.5,-989,-9,41,0,364,364,1347
2005,44,c) 2,1253,1261,9000,9391,42,3.1,239,17.5,1366,198,1168,2.1,14.5,2148,875,1273,9.3,22.9,-782,-8.4,29,0,189,189,776
2005,44,d) 3,1110,1117,7718,8003,49,4.2,163,13.9,1261,340,921,4.2,15.8,1830,942,888,11.8,22.9,-569,-7.1,31.6,0,126,126,765
2005,44,e) 4,1014,1033,7301,7664,36,3.3,120,11.2,1192,154,1038,2,15.6,1918,1071,847,14,25,-726,-9.4,31.2,0,91,91,1001
2005,44,f) 5,893,925,7844,7946,40,4.2,99,10.4,1097,176,921,2.2,13.8,1301,403,898,5.1,16.4,-204,-2.6,27.6,0,71,71,351
2005,44,g) 6 to 10,3782,3948,37859,38542,137,3.4,406,9.9,5049,939,4110,2.4,13.1,6415,2210,4205,5.7,16.6,-1366,-3.5,26.2,0,295,295,1791
2005,44,h) 11 to 15,2671,2784,30914,31652,107,3.8,221,7.8,3800,1023,2777,3.2,12,5275,1792,3483,5.7,16.7,-1475,-4.7,24,0,155,155,1571
2005,44,i) 16 to 20,2536,2773,39910,39892,83,2.9,179,6.3,3957,920,3037,2.3,9.9,3921,1177,2744,3,9.8,36,0.1,19.6,0,126,126,928
2005,44,j) 21 to 25,1609,1897,31004,30882,47,2.4,103,5.3,3641,819,2822,2.7,11.8,3397,886,2511,2.9,11,244,0.8,22,0,64,64,456
2005,44,k) 26+,924,1162,23442,23088,57,4.9,48,4.2,2501,491,2010,2.1,10.8,1792,313,1479,1.4,7.8,709,3,15.6,0,28,28,137
2005,44,l) Left Censored,3807,6193,219898,219615,348,5.6,339,5.5,18841,5995,12846,2.7,8.6,18275,3541,14734,1.6,8.3,566,0.3,16.6,0,127,127,845
2005,45,a) 0,7588,7673,47324,23728,7622,198.7,0,0,47193,47193,0,198.9,198.9,0,0,0,0,0,47193,198.9,0,0,,,
2005,45,b) 1,5429,5503,40862,41326,42,0.7,1508,24,11917,563,11354,1.4,28.8,12845,8042,4803,19.5,31.1,-928,-2.3,57.6,0,1244,1244,6768
2005,45,c) 2,4595,4653,43297,44366,179,3.6,836,16.7,9469,968,8501,2.2,21.3,11606,5502,6104,12.4,26.2,-2137,-4.9,42.6,0,703,703,4973
2005,45,d) 3,4105,4226,33768,35225,147,3.3,653,14.5,5672,859,4813,2.4,16.1,8586,3562,5024,10.1,24.4,-2914,-8.3,32.2,0,523,523,3148
2005,45,e) 4,3584,3729,39223,39433,147,3.8,464,11.9,5646,591,5055,1.5,14.3,6066,2416,3650,6.1,15.4,-420,-1.1,28.6,0,376,376,2072
2005,45,f) 5,3404,3562,35456,35785,129,3.5,406,11,6466,975,5491,2.7,18.1,7124,2476,4648,6.9,19.9,-658,-1.8,36.2,0,322,322,1943
2005,45,g) 6 to 10,13240,14074,167222,168135,583,4,1395,9.6,25805,5411,20394,3.2,15.3,27631,9283,18348,5.5,16.4,-1826,-1.1,30.6,0,1083,1084,6680
2005,45,h) 11 to 15,8399,9227,115922,116968,407,4.3,742,7.9,16953,3281,13672,2.8,14.5,19045,5330,13715,4.6,16.3,-2092,-1.8,29,0,555,555,3856
2005,45,i) 16 to 20,6755,8551,133327,134186,320,3.7,617,7.1,15825,3368,12457,2.5,11.8,17542,4868,12674,3.6,13.1,-1717,-1.3,23.6,0,411,416,2548
2005,45,j) 21 to 25,5150,6417,103471,102888,193,3,289,4.5,11972,2981,8991,2.9,11.6,10805,2346,8459,2.3,10.5,1167,1.1,21,0,188,188,1678
2005,45,k) 26+,2466,4273,83398,82598,183,4.3,155,3.6,10755,3582,7173,4.3,13,9154,1603,7551,1.9,11.1,1601,1.9,22.2,0,88,88,383
2005,45,l) Left Censored,8501,21558,731606,727736,1393,6.5,964,4.5,73545,24668,48877,3.4,10.1,65804,11375,54429,1.6,9,7741,1.1,18,0,268,275,1855
2005,46,a) 0,1824,1840,8147,4114,1812,197,0,0,8067,8067,0,196.1,196.1,0,0,0,0,0,8067,196.1,0,0,,,
2005,46,b) 1,1321,1329,8384,7843,5,0.3,382,24.7,3140,14,3126,0.2,40,2058,1372,686,17.5,26.2,1082,13.8,52.4,0,274,274,1111
2005,46,c) 2,1152,1169,7011,7113,50,4,182,14.7,1427,113,1314,1.6,20.1,1630,650,980,9.1,22.9,-203,-2.8,40.2,0,142,142,562
2005,46,d) 3,1145,1161,7799,7885,48,3.9,161,13.2,1256,132,1124,1.7,15.9,1427,537,890,6.8,18.1,-171,-2.2,31.8,0,125,125,468
2005,46,e) 4,916,947,6702,6684,42,4.3,119,12.1,1176,173,1003,2.6,17.6,1140,452,688,6.8,17.1,36,0.5,34.2,0,85,85,364
2005,46,f) 5,864,896,7685,7712,41,4.5,81,8.8,1160,216,944,2.8,15,1213,483,730,6.3,15.7,-53,-0.7,30,0,56,56,282
2005,46,g) 6 to 10,3536,3692,30465,30762,141,3.7,326,8.6,4094,585,3509,1.9,13.3,4687,1365,3322,4.4,15.2,-593,-1.9,26.6,0,222,222,1031
2005,46,h) 11 to 15,2546,2652,24867,25056,125,4.6,242,8.9,2805,575,2230,2.3,11.2,3182,979,2203,3.9,12.7,-377,-1.5,22.4,0,145,145,730
2005,46,i) 16 to 20,1698,1870,25830,25902,65,3.4,111,5.9,3019,419,2600,1.6,11.7,3163,768,2395,3,12.2,-144,-0.5,23.4,0,78,78,286
2005,46,j) 21 to 25,1409,1739,19718,20070,51,2.9,94,5.3,2032,609,1423,3,10.1,2736,782,1954,3.9,13.6,-704,-3.5,20.2,0,64,64,465
2005,46,k) 26+,784,1086,16532,16582,45,4.1,49,4.5,1763,592,1171,3.6,10.6,1862,326,1536,2,11.2,-99,-0.6,21.2,0,32,32,90
2005,46,l) Left Censored,2942,5209,147591,146945,245,4.7,240,4.6,13119,2566,10553,1.7,8.9,11827,3100,8727,2.1,8,1292,0.9,16,0,68,68,493
2005,47,a) 0,8919,9013,60686,30435,8968,199,0,0,60502,60502,0,198.8,198.8,0,0,0,0,0,60502,198.8,0,0,,,
2005,47,b) 1,6500,6576,51772,54452,38,0.5,1955,25.6,15298,258,15040,0.5,28.1,20658,12675,7983,23.3,37.9,-5360,-9.8,56.2,0,1667,1667,11293
2005,47,c) 2,5334,5412,45485,49084,182,3.1,1027,17.5,9157,1247,7910,2.5,18.7,16355,6105,10250,12.4,33.3,-7198,-14.6,37.4,0,880,880,5582
2005,47,d) 3,4603,4770,46917,48492,157,3.1,750,14.8,7796,770,7026,1.6,16.1,10946,5440,5506,11.2,22.6,-3150,-6.5,32.2,0,634,634,5086
2005,47,e) 4,4015,4151,39079,39970,145,3.3,596,13.6,6329,953,5376,2.4,15.8,8111,3304,4807,8.3,20.3,-1782,-4.5,31.6,0,487,488,2805
2005,47,f) 5,3715,3875,41952,43409,159,3.9,464,11.5,6077,1263,4814,2.9,14,8990,2960,6030,6.8,20.7,-2913,-6.7,28,0,381,381,2590
2005,47,g) 6 to 10,16034,17543,212737,213069,713,3.9,1691,9.4,36024,6693,29331,3.1,16.9,36687,11601,25086,5.4,17.2,-663,-0.3,33.8,0,1318,1318,9538
2005,47,h) 11 to 15,11213,12524,166995,169864,494,3.9,1022,8,21265,3686,17579,2.2,12.5,27002,7988,19014,4.7,15.9,-5737,-3.4,25,0,770,770,5998
2005,47,i) 16 to 20,9227,11224,193630,193139,403,3.5,790,6.9,24871,7709,17162,4,12.9,23889,8497,15392,4.4,12.4,982,0.5,24.8,0,537,544,5456
2005,47,j) 21 to 25,7270,9025,160668,159247,280,3.1,457,5,18881,3243,15638,2,11.9,16039,4941,11098,3.1,10.1,2842,1.8,20.2,0,326,326,2468
2005,47,k) 26+,3739,6764,171193,170575,210,3.1,377,5.5,19991,6055,13936,3.5,11.7,18754,3854,14900,2.3,11,1237,0.7,22,0,165,166,1034
2005,47,l) Left Censored,12060,31592,1177981,1173815,2086,6.6,1673,5.3,130780,35597,95183,3,11.1,122449,26044,96405,2.2,10.4,8331,0.7,20.8,0,440,444,3059
2005,48,a) 0,37226,37909,286798,144561,37655,198.7,0,0,284474,284474,0,196.8,196.8,0,0,0,0,0,284474,196.8,0,0,,,
2005,48,b) 1,27383,27710,228185,241726,102,0.3,8064,25.1,61498,1369,60129,0.6,25.4,88581,50980,37601,21.1,36.6,-27083,-11.2,50.8,0,6759,6759,46334
2005,48,c) 2,22835,23270,212663,219024,908,3.6,4464,17.7,46774,6500,40274,3,21.4,59496,30494,29002,13.9,27.2,-12722,-5.8,42.8,0,3774,3776,27278
2005,48,d) 3,19736,20513,221709,230029,722,3.3,3239,14.8,42160,5961,36199,2.6,18.3,58801,29772,29029,12.9,25.6,-16641,-7.3,36.6,0,2780,2780,27866
2005,48,e) 4,17274,18087,183936,188871,748,3.9,2524,13.3,31183,5538,25645,2.9,16.5,41053,18446,22607,9.8,21.7,-9870,-5.2,33,0,2038,2067,15908
2005,48,f) 5,15600,16388,178265,182376,586,3.4,2071,12.1,29610,4915,24695,2.7,16.2,37831,14571,23260,8,20.7,-8221,-4.5,32.4,0,1639,1660,12251
2005,48,g) 6 to 10,62338,67993,872665,880561,2856,4.1,7098,10.1,144669,34285,110384,3.9,16.4,160461,57463,102998,6.5,18.2,-15792,-1.8,32.8,0,5514,5540,45239
2005,48,h) 11 to 15,42586,47573,644175,652615,1976,4.1,4080,8.4,97054,19819,77235,3,14.9,113934,33952,79982,5.2,17.5,-16880,-2.6,29.8,0,2961,2969,25317
2005,48,i) 16 to 20,29722,37126,678749,683067,1661,4.4,2750,7.3,86713,25902,60811,3.8,12.7,95349,28225,67124,4.1,14,-8636,-1.3,25.4,0,1748,1753,15205
2005,48,j) 21 to 25,26074,34144,599928,607883,1241,3.6,1855,5.4,75383,21370,54013,3.5,12.4,91294,17636,73658,2.9,15,-15911,-2.6,24.8,0,1236,1242,10692
2005,48,k) 26+,11525,20464,468528,463871,882,4.3,1051,5.1,62080,15915,46165,3.4,13.4,52765,13630,39135,2.9,11.4,9315,2,22.8,0,540,546,5629
2005,48,l) Left Censored,30354,101049,3653841,3615475,7558,7.6,5670,5.7,451476,158255,293221,4.4,12.5,374743,99757,274986,2.8,10.4,76733,2.1,20.8,0,1120,1136,11074
2005,49,a) 0,6183,6215,36071,18097,6176,198.7,0,0,35949,35949,0,198.6,198.6,0,0,0,0,0,35949,198.6,0,0,,,
2005,49,b) 1,4279,4313,33842,32883,11,0.2,1390,27.4,12279,237,12042,0.7,37.3,10360,6791,3569,20.7,31.5,1919,5.8,63,0,1050,1050,5599
2005,49,c) 2,3612,3650,34281,34298,198,5,735,18.7,8703,1176,7527,3.4,25.4,8737,5036,3701,14.7,25.5,-34,-0.1,50.8,0,583,583,4550
2005,49,d) 3,3103,3170,27865,28206,140,4.2,439,13.2,5323,426,4897,1.5,18.9,6004,2540,3464,9,21.3,-681,-2.4,37.8,0,351,351,2297
2005,49,e) 4,2592,2674,24610,24542,130,4.7,318,11.5,4786,626,4160,2.6,19.5,4650,2090,2560,8.5,18.9,136,0.6,37.8,0,252,252,1501
2005,49,f) 5,2224,2282,22249,22341,95,4,287,12,4095,613,3482,2.7,18.3,4279,2033,2246,9.1,19.2,-184,-0.9,36.6,0,215,215,1885
2005,49,g) 6 to 10,8418,8834,107426,109845,396,4.3,945,10.4,15076,3014,12062,2.7,13.7,19915,6412,13503,5.8,18.1,-4839,-4.4,27.4,0,692,692,5097
2005,49,h) 11 to 15,4700,5072,88316,85520,220,4.3,369,7.2,18038,2885,15153,3.4,21.1,12446,4673,7773,5.5,14.6,5592,6.5,29.2,0,249,249,3663
2005,49,i) 16 to 20,2971,3618,72456,71534,136,3.7,226,6.2,9520,2139,7381,3,13.3,7676,2433,5243,3.4,10.7,1844,2.6,21.4,0,154,154,1624
2005,49,j) 21 to 25,2304,2996,63924,66098,112,3.7,177,5.8,6723,1319,5404,2,10.2,11071,1803,9268,2.7,16.7,-4348,-6.5,20.4,0,112,116,1121
2005,49,k) 26+,1384,2126,49408,48946,87,4.1,96,4.5,5580,1453,4127,3,11.4,4656,608,4048,1.2,9.5,924,1.9,19,0,50,50,275
2005,49,l) Left Censored,4007,10328,413251,412511,969,9.5,774,7.6,54313,18463,35850,4.5,13.2,52833,15273,37560,3.7,12.8,1480,0.4,25.6,0,105,111,1101
2005,50,a) 0,1315,1319,6547,3282,1312,198.9,0,0,6531,,,,199,0,0,0,0,0,6531,199,0,1,,,
2005,50,b) 1,1027,1034,6392,6166,3,0.3,257,21.9,2078,,,,33.7,1625,976,649,15.8,26.4,453,7.3,52.8,1,176,176,585
2005,50,c) 2,905,913,5495,5742,38,3.9,161,16.5,988,72,916,1.3,17.2,1482,696,786,12.1,25.8,-494,-8.6,34.4,0,133,133,583
2005,50,d) 3,787,798,5423,5555,26,3.1,111,13.1,752,64,688,1.2,13.5,1015,450,565,8.1,18.3,-263,-4.8,27,0,78,78,348
2005,50,e) 4,732,739,4755,4803,25,3.3,87,11.3,809,223,586,4.6,16.8,904,353,551,7.3,18.8,-95,-2,33.6,0,69,69,318
2005,50,f) 5,725,746,8422,7549,30,3.9,84,10.9,2979,67,2912,0.9,39.5,1232,474,758,6.3,16.3,1747,23.2,32.6,0,70,70,432
2005,50,g) 6 to 10,2992,3116,24309,24485,105,3.3,286,8.9,3395,425,2970,1.7,13.9,3747,1351,2396,5.5,15.3,-352,-1.4,27.8,0,208,208,1127
2005,50,h) 11 to 15,2305,2429,19400,19517,85,3.4,168,6.8,2351,447,1904,2.3,12,2584,812,1772,4.2,13.2,-233,-1.2,24,0,120,120,672
2005,50,i) 16 to 20,2061,2205,24751,24844,77,3.4,165,7.3,2552,387,2165,1.6,10.3,2737,1048,1689,4.2,11,-185,-0.7,20.6,0,103,103,730
2005,50,j) 21 to 25,1374,1658,28013,28135,29,1.7,91,5.4,2081,306,1775,1.1,7.4,2324,683,1641,2.4,8.3,-243,-0.9,14.8,0,62,62,426
2005,50,k) 26+,658,894,16565,16649,48,5.4,48,5.4,1820,655,1165,3.9,10.9,1987,641,1346,3.9,11.9,-167,-1,21.8,0,28,28,222
2005,50,l) Left Censored,2275,3941,110697,110629,181,4.6,205,5.2,9326,2423,6903,2.2,8.4,9189,2312,6877,2.1,8.3,137,0.1,16.6,0,74,77,678
2005,51,a) 0,14096,14161,82493,41457,14061,198.6,0,0,82073,82073,0,198,198,0,0,0,0,0,82073,198,0,0,,,
2005,51,b) 1,10313,10377,72764,75274,38,0.3,2898,24.2,19440,1072,18368,1.4,25.8,24460,11969,12491,15.9,32.5,-5020,-6.7,51.6,0,2283,2283,10294
2005,51,c) 2,8169,8257,63588,64266,305,3.4,1459,16.5,14021,1212,12809,1.9,21.8,15376,6992,8384,10.9,23.9,-1355,-2.1,43.6,0,1168,1168,6023
2005,51,d) 3,7345,7526,60817,61853,290,3.7,1023,12.9,11484,1683,9801,2.7,18.6,13556,6508,7048,10.5,21.9,-2072,-3.3,37.2,0,824,824,4977
2005,51,e) 4,6351,6670,59534,60096,266,3.8,839,12,11113,1942,9171,3.2,18.5,12237,5092,7145,8.5,20.4,-1124,-1.9,37,0,651,651,3589
2005,51,f) 5,5889,6124,57023,57925,230,3.6,743,11.6,8875,1254,7621,2.2,15.3,10679,3901,6778,6.7,18.4,-1804,-3.1,30.6,0,583,586,3299
2005,51,g) 6 to 10,24378,25938,291942,294188,911,3.4,2360,8.8,43285,6866,36419,2.3,14.7,47777,14965,32812,5.1,16.2,-4492,-1.5,29.4,0,1732,1748,11133
2005,51,h) 11 to 15,16485,17905,252800,253472,605,3.3,1304,7.1,33047,5988,27059,2.4,13,34391,8115,26276,3.2,13.6,-1344,-0.6,26,0,923,923,6137
2005,51,i) 16 to 20,13418,16160,280201,281333,581,3.5,983,6,32615,9248,23367,3.3,11.6,34878,9573,25305,3.4,12.4,-2263,-0.8,23.2,0,590,600,3785
2005,51,j) 21 to 25,9144,11634,223351,223687,362,3.1,576,4.9,23339,5585,17754,2.5,10.4,24010,4827,19183,2.2,10.7,-671,-0.3,20.8,0,360,364,1985
2005,51,k) 26+,4406,7371,167173,164199,346,4.7,353,4.8,21935,6910,15025,4.2,13.4,15987,2562,13425,1.6,9.7,5948,3.7,19.4,0,176,190,1126
2005,51,l) Left Censored,14751,40855,1436300,1443174,2779,6.8,2205,5.4,158440,53930,104510,3.7,11,172190,38328,133862,2.7,11.9,-13750,-0.9,22,0,502,506,5655
2005,53,a) 0,14281,14374,70484,35410,14257,198.4,0,0,70149,70149,0,198.1,198.1,0,0,0,0,0,70149,198.1,0,0,,,
2005,53,b) 1,9708,9788,61884,63951,43,0.4,2924,25.7,15589,679,14910,1.1,24.4,19722,12348,7374,19.3,30.8,-4133,-6.4,48.8,0,2304,2304,10756
2005,53,c) 2,8069,8132,55734,58491,455,5.2,1516,17.4,12697,1785,10912,3.1,21.7,18211,11083,7128,18.9,31.1,-5514,-9.4,43.4,0,1220,1220,9977
2005,53,d) 3,7274,7444,56962,57077,351,4.5,1076,13.7,10557,1313,9244,2.3,18.5,10787,4666,6121,8.2,18.9,-230,-0.4,37,0,852,852,3922
2005,53,e) 4,6385,6570,52461,52690,323,4.7,826,12.1,9220,1412,7808,2.7,17.5,9677,3819,5858,7.2,18.4,-457,-0.9,35,0,656,656,3080
2005,53,f) 5,5918,6174,53950,54254,304,4.8,726,11.4,9051,1465,7586,2.7,16.7,9659,4048,5611,7.5,17.8,-608,-1.1,33.4,0,564,564,3449
2005,53,g) 6 to 10,23568,25033,239052,242586,1240,4.8,2592,10.1,35568,6991,28577,2.9,14.7,42636,14178,28458,5.8,17.6,-7068,-2.9,29.4,0,1902,1902,11406
2005,53,h) 11 to 15,16078,17389,193046,192243,814,4.6,1527,8.6,27499,5269,22230,2.7,14.3,25893,7514,18379,3.9,13.5,1606,0.8,27,0,1082,1082,5329
2005,53,i) 16 to 20,10680,12514,206998,205008,494,3.9,859,6.8,24951,5698,19253,2.8,12.2,20971,5506,15465,2.7,10.2,3980,2,20.4,0,573,574,3407
2005,53,j) 21 to 25,8313,10810,205847,206326,416,3.8,597,5.5,19959,3087,16872,1.5,9.7,20916,5765,15151,2.8,10.1,-957,-0.4,19.4,0,367,367,2652
2005,53,k) 26+,4335,6660,138442,138231,269,4,331,4.9,14351,3298,11053,2.4,10.4,13928,2349,11579,1.7,10.1,423,0.3,20.2,0,183,186,978
2005,53,l) Left Censored,11860,29499,983316,977871,2131,7.3,1908,6.5,125101,42561,82540,4.4,12.8,114210,37038,77172,3.8,11.7,10891,1.1,23.4,0,391,392,5982
2005,54,a) 0,2483,2501,14455,7295,2490,199.1,0,0,14320,14320,0,196.3,196.3,0,0,0,0,0,14320,196.3,0,0,,,
2005,54,b) 1,1774,1804,12394,12383,13,0.6,511,24.6,3454,94,3360,0.8,27.9,3432,1861,1571,15,27.7,22,0.2,55.4,0,403,403,1582
2005,54,c) 2,1403,1437,11855,12430,63,4.1,276,17.8,2257,176,2081,1.4,18.2,3407,1500,1907,12.1,27.4,-1150,-9.2,36.4,0,230,230,1381
2005,54,d) 3,1308,1342,10977,11390,53,3.7,213,15,1746,345,1401,3,15.3,2571,895,1676,7.9,22.6,-825,-7.3,30.6,0,175,175,739
2005,54,e) 4,1146,1173,10431,10729,31,2.5,144,11.6,1567,120,1447,1.1,14.6,2162,915,1247,8.5,20.2,-595,-5.6,29.2,0,108,108,715
2005,54,f) 5,1158,1210,10188,10491,36,2.8,155,12.2,1577,256,1321,2.4,15,2182,812,1370,7.7,20.8,-605,-5.8,30,0,129,129,691
2005,54,g) 6 to 10,4843,5259,48404,49415,214,3.9,566,10.4,6996,1267,5729,2.6,14.2,9018,3191,5827,6.5,18.2,-2022,-4,28.4,0,438,438,2645
2005,54,h) 11 to 15,3526,3749,36446,37688,132,3.4,316,8.2,4793,399,4394,1.1,12.7,7276,1671,5605,4.4,19.3,-2483,-6.6,25.4,0,243,243,1138
2005,54,i) 16 to 20,3009,3457,56456,57274,92,2.6,237,6.7,5324,846,4478,1.5,9.3,6960,2164,4796,3.8,12.2,-1636,-2.9,18.6,0,177,178,947
2005,54,j) 21 to 25,2563,2885,37517,37629,74,2.5,145,5,3942,424,3518,1.1,10.5,4165,776,3389,2.1,11.1,-223,-0.6,21,0,103,105,488
2005,54,k) 26+,1287,2311,37623,37888,204,8.9,157,6.9,4920,1815,3105,4.8,13,5450,1461,3989,3.9,14.4,-530,-1.4,26,0,61,61,292
2005,54,l) Left Censored,5007,10302,277297,277031,471,4.6,492,4.8,26403,6976,19427,2.5,9.5,25870,5831,20039,2.1,9.3,533,0.2,18.6,0,167,168,722
2005,55,a) 0,8843,8868,53732,26953,8811,198.7,0,0,53558,53558,0,198.7,198.7,0,0,0,0,0,53558,198.7,0,0,,,
2005,55,b) 1,6449,6511,49541,51685,20,0.3,1753,23.5,11218,164,11054,0.3,21.7,15505,9211,6294,17.8,30,-4287,-8.3,43.4,0,1354,1354,8224
2005,55,c) 2,5584,5667,42158,45217,229,3.8,932,15.5,7041,900,6141,2,15.6,13159,7260,5899,16.1,29.1,-6118,-13.5,31.2,0,741,741,6464
2005,55,d) 3,5375,5514,46303,47322,205,3.5,730,12.6,7434,1245,6189,2.6,15.7,9471,3401,6070,7.2,20,-2037,-4.3,31.4,0,570,570,2937
2005,55,e) 4,4648,4874,52844,52881,199,3.9,569,11.2,7696,1677,6019,3.2,14.6,7769,3108,4661,5.9,14.7,-73,-0.1,29.2,0,437,437,2726
2005,55,f) 5,4518,4686,44238,44753,186,3.8,471,9.7,6453,853,5600,1.9,14.4,7483,2690,4793,6,16.7,-1030,-2.3,28.8,0,351,351,1749
2005,55,g) 6 to 10,18640,19945,209816,211911,786,3.8,1762,8.6,28551,4660,23891,2.2,13.5,32740,10037,22703,4.7,15.4,-4189,-1.9,27,0,1329,1329,8018
2005,55,h) 11 to 15,14406,15437,169151,169757,613,3.9,1283,8.1,22314,4079,18235,2.4,13.1,23526,6928,16598,4.1,13.9,-1212,-0.8,26.2,0,861,861,4633
2005,55,i) 16 to 20,10447,12375,203528,204926,344,2.7,736,5.9,21585,4378,17207,2.1,10.5,24380,7250,17130,3.5,11.9,-2795,-1.4,21,0,504,510,4119
2005,55,j) 21 to 25,7637,9209,152966,152979,251,2.7,451,4.8,15930,2502,13428,1.6,10.4,15955,4010,11945,2.6,10.4,-25,0,20.8,0,337,337,3103
2005,55,k) 26+,4221,6864,149351,147040,285,4.1,324,4.7,18078,4778,13300,3.2,12.3,13455,2877,10578,2,9.2,4623,3.1,18.4,0,179,180,1277
2005,55,l) Left Censored,16052,33236,1282816,1285395,1523,4.6,1557,4.7,121004,32496,88508,2.5,9.4,126161,33341,92820,2.6,9.8,-5157,-0.4,18.8,0,529,561,5841
2005,56,a) 0,1525,1530,6622,3326,1517,198.3,0,0,6592,,,,198.2,0,0,0,0,0,6592,198.2,0,1,,,
2005,56,b) 1,1069,1075,5522,5766,8,0.6,311,25.1,1477,,,,25.6,1965,1286,679,22.3,34.1,-488,-8.5,51.2,1,237,237,1125
2005,56,c) 2,928,932,5660,5949,48,4.8,168,16.8,1114,230,884,3.9,18.7,1692,970,722,16.3,28.4,-578,-9.7,37.4,0,125,125,874
2005,56,d) 3,942,949,6824,6888,43,4.3,127,12.8,1219,122,1097,1.8,17.7,1347,532,815,7.7,19.6,-128,-1.9,35.4,0,105,105,487
2005,56,e) 4,734,742,5017,4972,41,5.3,103,13.3,1049,127,922,2.6,21.1,959,463,496,9.3,19.3,90,1.8,38.6,0,76,76,389
2005,56,f) 5,719,734,4994,5087,17,2.2,86,11.2,771,66,705,1.3,15.2,957,416,541,8.2,18.8,-186,-3.6,30.4,0,65,65,350
2005,56,g) 6 to 10,2747,2869,21971,22498,113,3.8,270,9.1,3260,435,2825,1.9,14.5,4314,1167,3147,5.2,19.2,-1054,-4.7,29,0,200,200,885
2005,56,h) 11 to 15,1792,1880,15901,16220,95,5,145,7.6,2237,367,1870,2.3,13.8,2874,533,2341,3.3,17.7,-637,-3.9,27.6,0,94,94,369
2005,56,i) 16 to 20,1198,1354,19792,19597,65,4.7,89,6.5,2502,772,1730,3.9,12.8,2111,515,1596,2.6,10.8,391,2,21.6,0,64,64,416
2005,56,j) 21 to 25,1129,1334,15923,16195,54,4,74,5.5,1878,468,1410,2.9,11.6,2422,716,1706,4.4,15,-544,-3.4,23.2,0,51,51,285
2005,56,k) 26+,648,906,14542,14356,34,3.7,48,5.3,1682,302,1380,2.1,11.7,1309,274,1035,1.9,9.1,373,2.6,18.2,0,28,28,120
2005,56,l) Left Censored,1789,3276,66786,66587,187,5.7,154,4.7,6853,1792,5061,2.7,10.3,6455,1186,5269,1.8,9.7,398,0.6,19.4,0,52,52,212
2006,01,a) 0,6810,6993,51500,25841,6943,198.6,0,0,51319,51319,0,198.6,198.6,0,0,0,0,0,51319,198.6,0,0,,,
2006,01,b) 1,5034,5142,43597,43768,48,0.8,1497,25.2,11629,920,10709,2.1,26.6,11970,6986,4984,16,27.3,-341,-0.7,53.2,0,1246,1246,5559
2006,01,c) 2,4267,4329,36935,37562,145,3.1,842,17.9,7760,965,6795,2.6,20.7,9013,4854,4159,12.9,24,-1253,-3.3,41.4,0,697,699,4199
2006,01,d) 3,3645,3693,32637,34386,96,2.4,658,16.5,5280,589,4691,1.7,15.4,8778,4745,4033,13.8,25.5,-3498,-10.1,30.8,0,550,550,3521
2006,01,e) 4,3267,3388,32521,33475,110,3.1,455,12.7,5098,583,4515,1.7,15.2,7005,3031,3974,9.1,20.9,-1907,-5.7,30.4,0,362,362,1812
2006,01,f) 5,2878,3063,33835,33261,112,3.5,378,11.8,6560,887,5673,2.7,19.7,5412,1896,3516,5.7,16.3,1148,3.4,32.6,0,297,304,1628
2006,01,g) 6 to 10,12831,13843,164482,163607,499,3.5,1499,10.4,29295,8173,21122,5,17.9,27544,10401,17143,6.4,16.8,1751,1.1,33.6,0,1177,1177,8323
2006,01,h) 11 to 15,8891,9746,127000,126771,284,2.8,826,8.2,17962,3654,14308,2.9,14.2,17504,5602,11902,4.4,13.8,458,0.4,27.6,0,593,605,3548
2006,01,i) 16 to 20,6815,8147,163679,162018,331,4,573,6.9,20103,5885,14218,3.6,12.4,16780,3945,12835,2.4,10.4,3323,2,20.8,0,395,395,2301
2006,01,j) 21 to 25,5696,7225,139759,138826,254,3.5,414,5.7,16862,4039,12823,2.9,12.1,14995,4519,10476,3.3,10.8,1867,1.3,21.6,0,233,237,1871
2006,01,k) 26+,3528,5976,117759,115291,305,5.1,309,5.2,16476,6271,10205,5.4,14.3,11539,3747,7792,3.3,10,4937,4.3,20,0,146,146,941
2006,01,l) Left Censored,8708,23015,761517,764408,1396,6.1,1208,5.3,85546,26591,58955,3.5,11.2,91327,30601,60726,4,11.9,-5781,-0.7,22.4,0,304,304,8859
2006,02,a) 0,1367,1378,6499,3319,1361,197.5,0,0,6361,,,,191.7,0,0,0,0,0,6361,191.7,0,1,,,
2006,02,b) 1,865,872,5142,5166,5,0.5,366,34,1648,,,,31.9,1695,1112,583,21.5,32.8,-47,-0.9,63.8,1,264,264,793
2006,02,c) 2,821,829,5231,5247,48,5.3,185,20.6,1426,140,1286,2.7,27.2,1457,788,669,15,27.8,-31,-0.6,54.4,0,134,134,650
2006,02,d) 3,709,741,5186,5292,45,5.8,115,14.8,1003,122,881,2.3,19,1215,398,817,7.5,23,-212,-4,38,0,80,80,318
2006,02,e) 4,719,756,6648,6922,39,4.9,121,15.2,1021,193,828,2.8,14.8,1569,776,793,11.2,22.7,-548,-7.9,29.6,0,80,80,583
2006,02,f) 5,565,584,4133,4627,29,4.7,87,14.2,709,55,654,1.2,15.3,1696,388,1308,8.4,36.7,-987,-21.4,30.6,0,54,54,282
2006,02,g) 6 to 10,2424,2596,29437,29345,113,4.2,309,11.4,4587,587,4000,2,15.6,4403,1713,2690,5.8,15,184,0.6,30,0,191,191,1093
2006,02,h) 11 to 15,1605,1708,13794,14164,82,4.6,184,10.4,2033,453,1580,3.2,14.4,2773,942,1831,6.7,19.6,-740,-5.2,28.8,0,104,104,480
2006,02,i) 16 to 20,1276,1413,21882,21767,58,4,105,7.3,2426,384,2042,1.8,11.1,2195,742,1453,3.4,10.1,231,1,20.2,0,78,78,628
2006,02,j) 21 to 25,1132,1422,19946,19810,77,5.4,80,5.6,3169,1026,2143,5.2,16,2896,992,1904,5,14.6,273,1.4,29.2,0,41,41,215
2006,02,k) 26+,710,1215,28682,28023,61,5,54,4.5,3851,972,2879,3.5,13.7,2532,653,1879,2.3,9,1319,4.7,18,0,20,20,257
2006,02,l) Left Censored,1341,3196,92573,90078,225,7.1,141,4.5,13123,1719,11404,1.9,14.6,8133,1864,6269,2.1,9,4990,5.6,18,0,39,39,344
2006,04,a) 0,12794,12924,87319,44196,12815,198.3,0,0,86246,86246,0,195.1,195.1,0,0,0,0,0,86246,195.1,0,0,,,
2006,04,b) 1,8610,8812,78965,77885,57,0.6,2357,23.4,23039,618,22421,0.8,29.6,20879,12162,8717,15.6,26.8,2160,2.8,53.6,0,1851,1851,10417
2006,04,c) 2,6783,6914,67253,65392,253,3.4,1230,16.6,16894,1546,15348,2.4,25.8,13171,6522,6649,10,20.1,3723,5.7,40.2,0,1003,1003,5846
2006,04,d) 3,5632,5774,61522,60169,228,3.7,868,14.2,14462,1815,12647,3,24,11756,5648,6108,9.4,19.5,2706,4.5,39,0,697,697,5029
2006,04,e) 4,4978,5129,60935,60049,210,3.9,708,13.1,12323,825,11498,1.4,20.5,10551,5279,5272,8.8,17.6,1772,2.9,35.2,0,553,553,4292
2006,04,f) 5,4474,4700,53585,52331,184,3.8,560,11.4,9909,949,8960,1.8,18.9,7400,2781,4619,5.3,14.1,2509,4.8,28.2,0,436,436,2173
2006,04,g) 6 to 10,16909,18244,280351,276860,759,4,2015,10.7,44185,7237,36948,2.6,16,37202,14680,22522,5.3,13.4,6983,2.6,26.8,0,1424,1426,11066
2006,04,h) 11 to 15,10074,11085,185739,183770,492,4.3,1035,9.1,29559,5472,24087,3,16.1,25620,8248,17372,4.5,13.9,3939,2.2,27.8,0,760,760,5982
2006,04,i) 16 to 20,7243,9730,197698,193940,558,5.7,656,6.7,28999,7913,21086,4.1,15,21483,5169,16314,2.7,11.1,7516,3.9,22.2,0,436,436,3059
2006,04,j) 21 to 25,5453,7855,176720,172373,455,5.8,495,6.3,27168,7562,19606,4.4,15.8,18473,5726,12747,3.3,10.7,8695,5.1,21.4,0,302,309,2855
2006,04,k) 26+,3204,5722,161434,156824,405,7.1,372,6.5,26473,9233,17240,5.9,16.9,17253,5111,12142,3.3,11,9220,5.9,22,0,161,163,1206
2006,04,l) Left Censored,6380,22582,906816,881440,2543,11.6,1226,5.6,138187,50634,87553,5.7,15.7,87434,22246,65188,2.5,9.9,50753,5.8,19.8,0,217,231,3036
2006,05,a) 0,4684,4854,29718,14902,4810,198.2,0,0,29632,29632,0,198.8,198.8,0,0,0,0,0,29632,198.8,0,0,,,
2006,05,b) 1,3444,3496,24201,25169,23,0.6,1108,27.1,5970,125,5845,0.5,23.7,7905,4599,3306,18.3,31.4,-1935,-7.7,47.4,0,882,882,3787
2006,05,c) 2,2832,2876,20790,21222,88,2.8,598,19,4082,415,3667,2,19.2,4946,2449,2497,11.5,23.3,-864,-4.1,38.4,0,502,502,2067
2006,05,d) 3,2502,2537,19514,19968,91,3.3,447,16.4,3893,396,3497,2,19.5,4800,2654,2146,13.3,24,-907,-4.5,39,0,369,369,2396
2006,05,e) 4,2309,2429,21685,22040,144,5.7,305,12.1,4145,1087,3058,4.9,18.8,4854,1936,2918,8.8,22,-709,-3.2,37.6,0,257,257,1614
2006,05,f) 5,1946,2035,17319,17525,66,3.1,288,13.4,2908,262,2646,1.5,16.6,3319,1787,1532,10.2,18.9,-411,-2.3,33.2,0,228,228,1514
2006,05,g) 6 to 10,8148,8915,83466,84222,368,4,1002,10.8,12622,2647,9975,3.1,15,14133,5321,8812,6.3,16.8,-1511,-1.8,30,0,734,734,4271
2006,05,h) 11 to 15,5904,6502,68961,68850,243,3.6,637,9.5,9834,2103,7731,3.1,14.3,9611,3865,5746,5.6,14,223,0.3,28,0,493,493,3060
2006,05,i) 16 to 20,4128,4893,78021,77861,188,3.8,369,7.4,9449,1876,7573,2.4,12.1,9128,2613,6515,3.4,11.7,321,0.4,23.4,0,270,270,1976
2006,05,j) 21 to 25,3632,4425,87914,88152,167,3.7,301,6.7,7617,1387,6230,1.6,8.6,8093,1767,6326,2,9.2,-476,-0.6,17.2,0,186,187,1277
2006,05,k) 26+,2400,3582,83615,80856,175,4.9,192,5.3,12590,6226,6364,7.7,15.6,7071,1658,5413,2.1,8.7,5519,6.9,17.4,0,120,120,897
2006,05,l) Left Censored,5844,14307,509197,507202,779,5.5,656,4.6,48958,12381,36577,2.4,9.7,44968,9967,35001,2,8.9,3990,0.8,17.8,0,207,222,3048
2006,06,a) 0,74862,75912,487684,244893,75292,198.4,0,0,485583,485583,0,198.3,198.3,0,0,0,0,0,485583,198.3,0,0,,,
2006,06,b) 1,53243,55120,470244,469163,396,0.6,15348,24.2,133987,5133,128854,1.1,28.6,131826,72135,59691,15.4,28.1,2161,0.5,56.2,0,12019,12019,58378
2006,06,c) 2,42717,43259,389124,399878,1570,3.3,8581,18.3,86850,11199,75651,2.8,21.7,108358,58113,50245,14.5,27.1,-21508,-5.4,43.4,0,6822,6836,50303
2006,06,d) 3,36950,37548,373854,375279,1381,3.4,6624,16.5,78849,7469,71380,2,21,81699,40532,41167,10.8,21.8,-2850,-0.8,42,0,5214,5215,34041
2006,06,e) 4,32890,34078,354783,355532,1394,3.9,5070,14.1,68537,8960,59577,2.5,19.3,70035,30733,39302,8.6,19.7,-1498,-0.4,38.6,0,3930,3935,24873
2006,06,f) 5,28809,30155,308219,309260,1234,3.9,4179,13.2,55821,7817,48004,2.5,18,57903,25651,32252,8.3,18.7,-2082,-0.7,36,0,3172,3191,20489
2006,06,g) 6 to 10,107618,115810,1441856,1465612,4600,3.8,13581,11.3,230527,34635,195892,2.4,15.7,278040,99002,179038,6.8,19,-47513,-3.3,31.4,0,9903,9928,73276
2006,06,h) 11 to 15,66715,73103,1078385,1092038,2769,3.7,7498,9.9,166632,29124,137508,2.7,15.3,193937,81154,112783,7.4,17.8,-27305,-2.5,30.6,0,5414,5423,57914
2006,06,i) 16 to 20,57816,69607,1274981,1272251,2918,4.1,5799,8.1,175099,38694,136405,3,13.8,169638,54289,115349,4.3,13.3,5461,0.5,26.6,0,3950,3972,34009
2006,06,j) 21 to 25,42950,55958,1113459,1112566,2128,3.7,3859,6.8,132194,41268,90926,3.7,11.9,130407,38340,92067,3.4,11.7,1787,0.2,23.4,0,2425,2445,22855
2006,06,k) 26+,27325,43258,1013655,1009144,2190,5,2879,6.6,134959,48724,86235,4.8,13.4,125936,31690,94246,3.1,12.5,9023,0.9,25,0,1524,1540,12621
2006,06,l) Left Censored,48027,139652,5457082,5401955,9660,7,7402,5.3,681448,218542,462906,4,12.6,571193,135708,435485,2.5,10.6,110255,2,21.2,0,2330,2359,29483
2006,08,a) 0,12869,13040,68699,34498,12904,197.9,0,0,68402,68402,0,198.3,198.3,0,0,0,0,0,68402,198.3,0,0,,,
2006,08,b) 1,9448,9561,62501,64150,35,0.3,2926,26.2,15875,339,15536,0.5,24.7,19173,11255,7918,17.5,29.9,-3298,-5.2,49.4,0,2195,2195,9560
2006,08,c) 2,7458,7547,51828,52503,377,4.6,1568,19.2,12120,1650,10470,3.1,23.1,13469,7945,5524,15.1,25.7,-1349,-2.6,46.2,0,1191,1191,6858
2006,08,d) 3,6469,6611,49858,50173,275,3.9,1241,17.5,10475,1905,8570,3.8,20.9,11105,6012,5093,12,22.1,-630,-1.2,41.8,0,933,933,5239
2006,08,e) 4,5866,6025,47932,47820,279,4.4,880,13.9,9223,1510,7713,3.2,19.3,8998,4666,4332,9.8,18.8,225,0.5,37.6,0,663,663,3718
2006,08,f) 5,5365,5561,49534,49316,233,4,809,13.8,9507,1045,8462,2.1,19.3,9071,4737,4334,9.6,18.4,436,0.9,36.8,0,559,564,3782
2006,08,g) 6 to 10,20610,21847,215655,217298,953,4.2,2503,11,34001,6248,27753,2.9,15.6,37287,18097,19190,8.3,17.2,-3286,-1.6,31.2,0,1737,1741,14817
2006,08,h) 11 to 15,12998,13885,163075,160950,595,4.2,1420,9.9,26264,6025,20239,3.7,16.3,22013,8590,13423,5.3,13.7,4251,2.6,27.4,0,922,923,5870
2006,08,i) 16 to 20,8595,10310,173841,174159,513,4.9,787,7.5,23577,6827,16750,3.9,13.5,24212,6706,17506,3.9,13.9,-635,-0.4,27,0,508,509,4046
2006,08,j) 21 to 25,6559,8648,170288,168698,382,4.4,590,6.7,23842,7573,16269,4.5,14.1,20662,5423,15239,3.2,12.2,3180,1.9,24.4,0,301,308,3021
2006,08,k) 26+,4111,6652,152900,148804,407,6.1,370,5.6,25022,11071,13951,7.4,16.8,16829,4507,12322,3,11.3,8193,5.5,22.6,0,185,185,1701
2006,08,l) Left Censored,8370,23055,791795,783790,1810,7.9,1327,5.8,95140,30670,64470,3.9,12.1,79129,21682,57447,2.8,10.1,16011,2,20.2,0,245,245,3078
2006,09,a) 0,5432,5620,32193,16187,5571,198.3,0,0,32012,32012,0,197.8,197.8,0,0,0,0,0,32012,197.8,0,0,,,
2006,09,b) 1,4183,4248,32378,34054,19,0.4,1245,25.3,7568,97,7471,0.3,22.2,10920,5834,5086,17.1,32.1,-3352,-9.9,44.4,0,1003,1003,4890
2006,09,c) 2,3392,3414,23814,24386,143,3.8,778,20.8,4867,432,4435,1.8,20,6011,3369,2642,13.8,24.6,-1144,-4.6,40,0,631,632,2997
2006,09,d) 3,2903,2939,24601,24761,119,3.8,486,15.5,4404,528,3876,2.1,17.8,4724,2506,2218,10.1,19.1,-320,-1.3,35.6,0,402,402,2231
2006,09,e) 4,2913,3008,28235,28283,107,3.4,427,13.5,4642,658,3984,2.3,16.4,4738,2344,2394,8.3,16.8,-96,-0.4,32.8,0,353,353,1926
2006,09,f) 5,2562,2631,23781,23711,80,2.9,367,13.2,4549,979,3570,4.1,19.2,4408,2147,2261,9.1,18.6,141,0.6,37.2,0,285,285,1872
2006,09,g) 6 to 10,11069,11684,134007,135316,407,3.4,1217,10,17183,2948,14235,2.2,12.7,19801,7609,12192,5.6,14.6,-2618,-1.9,25.4,0,933,933,6235
2006,09,h) 11 to 15,8096,8513,94165,93263,275,3.2,697,8,15576,2883,12693,3.1,16.7,13771,5837,7934,6.3,14.8,1805,1.9,29.6,0,493,493,4546
2006,09,i) 16 to 20,7693,8541,132502,132567,308,3.5,668,7.7,13143,2871,10272,2.2,9.9,13272,4294,8978,3.2,10,-129,-0.1,19.8,0,439,439,2548
2006,09,j) 21 to 25,5704,6887,102812,103281,265,3.8,392,5.6,12196,3816,8380,3.7,11.8,13134,4016,9118,3.9,12.7,-938,-0.9,23.6,0,238,238,1712
2006,09,k) 26+,3601,4969,97444,95964,202,4,267,5.3,12241,4243,7998,4.4,12.8,9281,3082,6199,3.2,9.7,2960,3.1,19.4,0,158,159,1628
2006,09,l) Left Censored,10970,21468,822728,819709,1123,5.2,1219,5.7,82545,25351,57194,3.1,10.1,76507,18840,57667,2.3,9.3,6038,0.8,18.6,0,402,402,5129
2006,10,a) 0,1677,1693,9814,4945,1670,197.3,0,0,9739,,,,196.9,0,0,0,0,0,9739,196.9,0,1,,,
2006,10,b) 1,1261,1266,7584,8149,3,0.2,352,24.1,2001,,,,24.6,3130,1842,1288,22.6,38.4,-1129,-13.8,49.2,1,276,276,1662
2006,10,c) 2,1112,1119,7937,8188,35,2.9,223,18.3,1470,193,1277,2.4,18,1971,1008,963,12.3,24.1,-501,-6.1,36,0,167,167,868
2006,10,d) 3,1026,1028,8100,8278,29,2.6,216,19.3,1607,180,1427,2.2,19.4,1962,618,1344,7.5,23.7,-355,-4.3,38.8,0,158,158,548
2006,10,e) 4,850,875,7146,7080,20,2.1,154,16.3,1150,55,1095,0.8,16.2,1018,439,579,6.2,14.4,132,1.8,28.8,0,104,104,351
2006,10,f) 5,829,839,6225,6083,37,4.1,142,15.9,1160,164,996,2.7,19.1,875,461,414,7.6,14.4,285,4.7,28.8,0,90,90,342
2006,10,g) 6 to 10,3122,3261,31623,32409,115,3.3,461,13.4,4334,569,3765,1.8,13.4,5905,2755,3150,8.5,18.2,-1571,-4.8,26.8,0,319,319,2306
2006,10,h) 11 to 15,2025,2198,26075,25980,82,3.6,212,9.3,3484,614,2870,2.4,13.4,3294,1226,2068,4.7,12.7,190,0.7,25.4,0,144,144,1016
2006,10,i) 16 to 20,1642,1845,24836,25579,71,3.8,136,7.2,3268,1286,1982,5,12.8,4753,2605,2148,10.2,18.6,-1485,-5.8,25.6,0,82,82,305
2006,10,j) 21 to 25,1149,1411,28136,27653,67,4.7,101,7.1,3544,855,2689,3.1,12.8,2577,1021,1556,3.7,9.3,967,3.5,18.6,0,55,55,573
2006,10,k) 26+,785,1124,28453,31328,54,4.7,75,6.6,3801,1756,2045,5.6,12.1,9551,6589,2962,21,30.5,-5750,-18.4,24.2,0,32,32,877
2006,10,l) Left Censored,2755,5830,197090,199947,384,6.6,360,6.2,20790,5752,15038,2.9,10.4,26503,6224,20279,3.1,13.3,-5713,-2.9,20.8,0,80,96,741
2006,11,a) 0,1173,1184,8001,4022,1177,198.8,0,0,7959,7959,0,197.9,197.9,0,0,0,0,0,7959,197.9,0,0,,,
2006,11,b) 1,1219,1219,9221,9250,6,0.4,262,19.2,2327,66,2261,0.7,25.2,2384,1366,1018,14.8,25.8,-57,-0.6,50.4,0,201,201,1039
2006,11,c) 2,420,420,3979,4056,27,6.2,58,13.2,1093,140,953,3.5,26.9,1246,1035,211,25.5,30.7,-153,-3.8,53.8,0,46,46,212
2006,11,d) 3,592,608,6220,5916,28,4.4,73,11.5,1361,423,938,7.2,23,753,246,507,4.2,12.7,608,10.3,25.4,0,57,57,187
2006,11,e) 4,677,690,8502,9208,24,3.4,72,10.1,1028,138,890,1.5,11.2,2439,1306,1133,14.2,26.5,-1411,-15.3,22.4,0,56,56,809
2006,11,f) 5,584,601,8384,8440,16,2.5,75,11.9,1111,56,1055,0.7,13.2,1222,663,559,7.9,14.5,-111,-1.3,26.4,0,51,51,570
2006,11,g) 6 to 10,2438,2590,39649,39543,84,3.2,212,8,5574,561,5013,1.4,14.1,5362,1509,3853,3.8,13.6,212,0.5,27.2,0,152,152,1047
2006,11,h) 11 to 15,1702,1811,33610,33581,66,3.6,142,7.7,3985,833,3152,2.5,11.9,3926,1294,2632,3.9,11.7,59,0.2,23.4,0,109,109,822
2006,11,i) 16 to 20,1448,1652,27737,28456,58,3.4,159,9.3,3294,461,2833,1.6,11.6,4731,2087,2644,7.3,16.6,-1437,-5,23.2,0,85,91,1334
2006,11,j) 21 to 25,1362,1611,32619,31822,57,3.5,95,5.8,3835,1206,2629,3.8,12.1,2241,401,1840,1.3,7,1594,5.1,14,0,57,57,242
2006,11,k) 26+,881,1191,60737,52641,95,8,80,6.7,19055,11673,7382,22.2,36.2,2862,917,1945,1.7,5.4,16193,30.8,10.8,0,25,25,145
2006,11,l) Left Censored,3119,5810,224461,226297,456,8,306,5.3,26261,7193,19068,3.2,11.6,29933,4172,25761,1.8,13.2,-3672,-1.6,23.2,0,58,58,727
2006,12,a) 0,50356,50857,287182,144388,50408,198.2,0,0,285588,285588,0,197.8,197.8,0,0,0,0,0,285588,197.8,0,0,,,
2006,12,b) 1,36918,37384,244640,253999,179,0.4,12076,27.4,65497,2352,63145,0.9,25.8,84215,49041,35174,19.3,33.2,-18718,-7.4,51.6,0,9592,9592,41057
2006,12,c) 2,32076,32362,218136,222763,1238,3.5,6379,18.2,47732,6296,41436,2.8,21.4,56986,31129,25857,14,25.6,-9254,-4.2,42.8,0,5050,5050,27140
2006,12,d) 3,23366,23635,201464,201909,931,3.7,4187,16.5,40631,5168,35463,2.6,20.1,41521,22972,18549,11.4,20.6,-890,-0.5,40.2,0,3297,3308,19178
2006,12,e) 4,19387,19898,182820,183444,789,3.7,2943,14,32739,4191,28548,2.3,17.8,33986,14685,19301,8,18.5,-1247,-0.7,35.6,0,2280,2284,12053
2006,12,f) 5,16518,17015,165027,166194,636,3.5,2396,13.4,28507,3621,24886,2.2,17.2,30843,13083,17760,7.9,18.6,-2336,-1.4,34.4,0,1844,1847,10714
2006,12,g) 6 to 10,61932,66124,721616,717865,2575,3.7,7497,10.9,127526,18346,109180,2.6,17.8,120024,53946,66078,7.5,16.7,7502,1.1,33.4,0,5497,5501,38907
2006,12,h) 11 to 15,40641,44094,668417,655491,1637,3.6,4062,8.9,123931,19257,104674,2.9,18.9,98079,42963,55116,6.6,15,25852,3.9,30,0,2924,2948,34816
2006,12,i) 16 to 20,29341,35108,639838,633995,1592,4.5,2670,7.5,88335,21459,66876,3.4,13.9,76648,26265,50383,4.1,12.1,11687,1.8,24.2,0,1799,1800,15181
2006,12,j) 21 to 25,19774,25883,520305,515170,1107,4.2,1727,6.6,65913,16684,49229,3.2,12.8,55642,20444,35198,4,10.8,10271,2,21.6,0,1075,1079,8322
2006,12,k) 26+,10781,18326,419196,414883,983,5.3,1300,7,57632,20682,36950,5,13.9,49006,14101,34905,3.4,11.8,8626,2.1,23.6,0,593,599,4719
2006,12,l) Left Censored,20710,74553,2890289,2823667,5849,7.9,4441,6,419242,110782,308460,3.9,14.8,285999,73900,212099,2.6,10.1,133243,4.7,20.2,0,842,845,10228
2006,13,a) 0,18218,18460,119933,60134,18322,198.5,0,0,119598,119598,0,198.9,198.9,0,0,0,0,0,119598,198.9,0,0,,,
2006,13,b) 1,13428,13650,105928,108549,95,0.6,3913,24.8,28558,1449,27109,1.3,26.3,33799,22193,11606,20.4,31.1,-5241,-4.8,52.6,0,3079,3080,18937
2006,13,c) 2,10875,11043,93961,94538,394,3.3,2217,18.5,20844,1766,19078,1.9,22,21997,13020,8977,13.8,23.3,-1153,-1.3,44,0,1743,1748,11163
2006,13,d) 3,9183,9330,76113,77506,327,3.3,1589,15.9,15902,1783,14119,2.3,20.5,18688,9614,9074,12.4,24.1,-2786,-3.6,41,0,1230,1230,8400
2006,13,e) 4,8190,8476,92277,88125,363,4.1,1247,13.9,22061,6669,15392,7.6,25,13757,5894,7863,6.7,15.6,8304,9.4,31.2,0,936,936,4849
2006,13,f) 5,7277,7572,87071,85894,295,3.7,975,12.3,15640,1842,13798,2.1,18.2,13286,5535,7751,6.4,15.5,2354,2.7,31,0,740,740,4640
2006,13,g) 6 to 10,28974,31125,363569,370870,1221,3.8,3341,10.4,61675,12493,49182,3.4,16.6,76277,23676,52601,6.4,20.6,-14602,-4,33.2,0,2469,2469,19181
2006,13,h) 11 to 15,17737,19560,264481,262576,770,3.8,1718,8.6,40365,8265,32100,3.1,15.4,36555,13745,22810,5.2,13.9,3810,1.5,27.8,0,1177,1177,8560
2006,13,i) 16 to 20,12548,15409,291021,290980,717,4.6,1216,7.8,36273,10326,25947,3.5,12.5,36191,12911,23280,4.4,12.4,82,0.1,24.8,0,762,762,7355
2006,13,j) 21 to 25,9802,12505,235222,233015,504,4,779,6.2,31791,8127,23664,3.5,13.6,27377,7205,20172,3.1,11.7,4414,1.9,23.4,0,448,448,4202
2006,13,k) 26+,5640,9599,250623,246280,597,6.2,648,6.7,34600,14628,19972,5.9,14,25913,8880,17033,3.6,10.5,8687,3.5,21,0,263,267,2295
2006,13,l) Left Censored,13557,42231,1618773,1612648,3020,7.2,2386,5.7,195265,62022,133243,3.8,12.1,183014,52695,130319,3.3,11.3,12251,0.8,22.6,0,499,505,11310
2006,15,a) 0,2104,2163,14432,7239,2146,198.4,0,0,14386,,,,198.7,0,0,0,0,0,14386,198.7,0,1,,,
2006,15,b) 1,1587,1595,14503,14418,2,0.1,403,22.1,3411,,,,23.7,3240,1647,1593,11.4,22.5,171,1.2,45,1,344,344,1489
2006,15,c) 2,1361,1397,12053,11936,40,2.7,238,15.8,2314,115,2199,1,19.4,2079,971,1108,8.1,17.4,235,2,34.8,0,198,198,891
2006,15,d) 3,1203,1282,13502,13162,43,3.2,165,12.2,2515,302,2213,2.3,19.1,1835,823,1012,6.3,13.9,680,5.2,27.8,0,136,136,745
2006,15,e) 4,1106,1153,11662,11197,41,3.4,129,10.8,2298,281,2017,2.5,20.5,1367,440,927,3.9,12.2,931,8.3,24.4,0,94,94,344
2006,15,f) 5,940,983,9771,9919,30,2.9,116,11.3,1295,202,1093,2,13.1,1591,742,849,7.5,16,-296,-2.9,26.2,0,90,90,681
2006,15,g) 6 to 10,3790,4056,44787,44443,135,3.2,350,8.4,7590,784,6806,1.8,17.1,6901,2499,4402,5.6,15.5,689,1.6,31,0,254,254,2035
2006,15,h) 11 to 15,2748,2956,38975,39428,118,3.9,202,6.7,5148,1401,3747,3.6,13.1,6055,1989,4066,5,15.4,-907,-2.3,26.2,0,152,152,1218
2006,15,i) 16 to 20,2341,2774,41145,41116,117,4.2,160,5.7,5133,1932,3201,4.7,12.5,5075,2181,2894,5.3,12.3,58,0.2,24.6,0,87,87,607
2006,15,j) 21 to 25,1963,2529,44955,44852,98,3.9,117,4.6,5316,2006,3310,4.5,11.9,5110,1750,3360,3.9,11.4,206,0.5,22.8,0,70,70,798
2006,15,k) 26+,1423,2063,38112,36718,91,4.4,84,4.1,5772,1182,4590,3.2,15.7,2983,1101,1882,3,8.1,2789,7.6,16.2,0,49,49,600
2006,15,l) Left Censored,3236,7148,226255,224010,442,6.2,312,4.4,22065,5795,16270,2.6,9.9,17575,3714,13861,1.7,7.8,4490,2.1,15.6,0,82,82,1105
2006,16,a) 0,4752,4823,23444,11793,4758,197.3,0,0,23303,23303,0,197.6,197.6,0,0,0,0,0,23303,197.6,0,0,,,
2006,16,b) 1,2996,3012,19107,18992,11,0.3,873,25,6197,28,6169,0.1,32.6,5966,3791,2175,20,31.4,231,1.2,62.8,0,630,630,2721
2006,16,c) 2,2275,2302,17039,17874,105,4.2,448,18.1,3431,462,2969,2.6,19.2,5101,2958,2143,16.5,28.5,-1670,-9.3,38.4,0,328,328,1478
2006,16,d) 3,1917,1967,15397,15462,93,4.5,305,14.7,3017,391,2626,2.5,19.5,3147,1740,1407,11.3,20.4,-130,-0.9,39,0,222,222,1477
2006,16,e) 4,1682,1716,21010,20951,67,3.7,254,14.1,3249,260,2989,1.2,15.5,3130,1879,1251,9,14.9,119,0.6,29.8,0,184,184,1572
2006,16,f) 5,1553,1620,13440,14090,64,3.8,168,10,2379,174,2205,1.2,16.9,3679,946,2733,6.7,26.1,-1300,-9.2,33.8,0,123,123,833
2006,16,g) 6 to 10,6158,6523,63710,64923,295,4.4,732,10.9,10308,1605,8703,2.5,15.9,12733,7186,5547,11.1,19.6,-2425,-3.7,31.8,0,460,460,6032
2006,16,h) 11 to 15,3743,3907,38193,38664,161,4,428,10.6,5532,548,4984,1.4,14.3,6473,2553,3920,6.6,16.7,-941,-2.4,28.6,0,278,278,1959
2006,16,i) 16 to 20,2527,2956,52164,52128,137,4.6,230,7.7,5340,1195,4145,2.3,10.2,5267,1241,4026,2.4,10.1,73,0.1,20.2,0,163,163,837
2006,16,j) 21 to 25,1829,2373,42515,40336,105,4.4,161,6.7,7933,3630,4303,9,19.7,3574,892,2682,2.2,8.9,4359,10.8,17.8,0,100,100,676
2006,16,k) 26+,1269,1784,44386,42665,95,5.3,133,7.4,7592,1372,6220,3.2,17.8,4149,2124,2025,5,9.7,3443,8.1,19.4,0,68,68,574
2006,16,l) Left Censored,2950,6774,196369,193067,397,5.9,323,4.8,21731,4975,16756,2.6,11.3,15127,2818,12309,1.5,7.8,6604,3.5,15.6,0,106,108,1172
2006,17,a) 0,20853,21163,131346,66070,20946,197.9,0,0,130553,130553,0,197.6,197.6,0,0,0,0,0,130553,197.6,0,0,,,
2006,17,b) 1,15784,16035,124116,127336,90,0.5,4419,24,29271,836,28435,0.7,23,35711,21466,14245,16.9,28,-6440,-5,46,0,3335,3335,17873
2006,17,c) 2,13347,13479,102464,104139,530,3.7,2453,16.9,20348,2313,18035,2.2,19.5,23697,11930,11767,11.5,22.8,-3349,-3.3,39,0,1894,1894,10296
2006,17,d) 3,11427,11841,111199,108646,506,4,1816,14.5,24825,4461,20364,4.1,22.8,19719,8658,11061,8,18.1,5106,4.7,36.2,0,1386,1386,7444
2006,17,e) 4,10252,10562,99035,99324,420,3.8,1419,12.8,16913,2322,14591,2.3,17,17490,7276,10214,7.3,17.6,-577,-0.6,34,0,1026,1026,5978
2006,17,f) 5,9170,9555,88009,87834,353,3.5,1151,11.5,16472,2188,14284,2.5,18.8,16121,8421,7700,9.6,18.4,351,0.4,36.8,0,826,826,7188
2006,17,g) 6 to 10,39506,41833,485077,489315,1641,3.8,4504,10.4,79288,17566,61722,3.6,16.2,87764,41445,46319,8.5,17.9,-8476,-1.7,32.4,0,3082,3094,25010
2006,17,h) 11 to 15,28422,30458,381608,381204,1111,3.5,2763,8.8,56125,12294,43831,3.2,14.7,55317,20323,34994,5.3,14.5,808,0.2,29,0,1838,1840,15774
2006,17,i) 16 to 20,22761,26178,441880,442436,1047,3.9,2002,7.5,50487,10947,39540,2.5,11.4,51598,16993,34605,3.8,11.7,-1111,-0.3,22.8,0,1251,1258,11909
2006,17,j) 21 to 25,17277,21316,438321,434736,703,3.2,1399,6.5,52959,13399,39560,3.1,12.2,45789,13205,32584,3,10.5,7170,1.7,21,0,853,856,7924
2006,17,k) 26+,10860,16091,364219,364661,587,3.6,950,5.8,40665,12111,28554,3.3,11.2,41549,14893,26656,4.1,11.4,-884,-0.2,22.4,0,545,545,9535
2006,17,l) Left Censored,29877,68339,2585101,2575696,4324,6.3,4238,6.2,292965,90194,202771,3.5,11.4,274155,83582,190573,3.2,10.6,18810,0.8,21.2,0,1155,1162,16119
2006,18,a) 0,9347,9594,67346,33851,9496,198,0,0,66991,66991,0,197.9,197.9,0,0,0,0,0,66991,197.9,0,0,,,
2006,18,b) 1,6683,6786,56935,59720,42,0.5,1974,25.1,13740,739,13001,1.2,23,19310,12028,7282,20.1,32.3,-5570,-9.3,46,0,1515,1537,10709
2006,18,c) 2,5734,5793,46206,47630,197,3.1,1179,18.7,8628,844,7784,1.8,18.1,11476,6174,5302,13,24.1,-2848,-6,36.2,0,925,925,5061
2006,18,d) 3,4874,4990,48814,47670,198,3.7,839,15.8,13090,1106,11984,2.3,27.5,10802,5998,4804,12.6,22.7,2288,4.8,45.4,0,642,642,4013
2006,18,e) 4,4752,4881,48904,49480,169,3.3,667,13,8255,957,7298,1.9,16.7,9407,4080,5327,8.2,19,-1152,-2.3,33.4,0,514,515,3352
2006,18,f) 5,4122,4394,42883,43987,140,3,535,11.6,5976,1048,4928,2.4,13.6,8183,2986,5197,6.8,18.6,-2207,-5,27.2,0,400,400,2446
2006,18,g) 6 to 10,17765,19153,218088,220360,619,3.1,1994,10,30926,5147,25779,2.3,14,35469,14717,20752,6.7,16.1,-4543,-2.1,28,0,1434,1434,11897
2006,18,h) 11 to 15,13074,14217,172562,174224,453,3.1,1185,8.1,24523,6286,18237,3.6,14.1,27847,9920,17927,5.7,16,-3324,-1.9,28.2,0,820,820,6197
2006,18,i) 16 to 20,10277,12582,231797,229641,578,4.5,897,7,29683,9642,20041,4.2,12.9,25371,8098,17273,3.5,11,4312,1.9,22,0,557,557,4973
2006,18,j) 21 to 25,8405,10527,191417,190269,377,3.5,661,6.2,22592,6157,16435,3.2,11.9,20296,5288,15008,2.8,10.7,2296,1.2,21.4,0,374,379,2603
2006,18,k) 26+,5275,8295,178818,176567,310,3.7,477,5.7,22380,5944,16436,3.4,12.7,17878,4888,12990,2.8,10.1,4502,2.6,20.2,0,219,219,2169
2006,18,l) Left Censored,14956,36684,1361249,1355923,2170,5.9,1859,5.1,137783,36826,100957,2.7,10.2,127131,29057,98074,2.1,9.4,10652,0.8,18.8,0,486,491,7596
2006,19,a) 0,5026,5250,29002,14562,5195,197.9,0,0,28881,28881,0,198.3,198.3,0,0,0,0,0,28881,198.3,0,0,,,
2006,19,b) 1,3671,3713,28716,29526,22,0.5,1050,24.4,6071,218,5853,0.7,20.6,7691,4287,3404,14.5,26,-1620,-5.4,41.2,0,755,755,3600
2006,19,c) 2,3101,3148,21357,21758,133,3.9,579,17.1,4224,533,3691,2.4,19.4,5025,2461,2564,11.3,23.1,-801,-3.7,38.8,0,433,433,2174
2006,19,d) 3,2673,2774,21469,21869,131,4.4,484,16.3,3520,622,2898,2.8,16.1,4319,1989,2330,9.1,19.7,-799,-3.6,32.2,0,344,344,1616
2006,19,e) 4,2514,2620,27975,27840,115,4.2,386,14,4298,375,3923,1.3,15.4,4028,1887,2141,6.8,14.5,270,0.9,29,0,260,260,1569
2006,19,f) 5,2194,2297,20368,20484,69,2.8,312,12.8,2807,463,2344,2.3,13.7,3039,1356,1683,6.6,14.8,-232,-1.1,27.4,0,200,200,1071
2006,19,g) 6 to 10,9747,10398,101203,101629,474,4.4,1293,11.9,14707,2039,12668,2,14.5,15559,6436,9123,6.3,15.3,-852,-0.8,29,0,801,801,5293
2006,19,h) 11 to 15,7437,7933,78359,78381,346,4.2,859,10.5,11715,3194,8521,4.1,14.9,11758,4459,7299,5.7,15,-43,-0.1,29.8,0,515,515,3293
2006,19,i) 16 to 20,5507,6463,104754,104705,284,4.3,549,8.3,11008,3249,7759,3.1,10.5,10909,3965,6944,3.8,10.4,99,0.1,20.8,0,341,341,3077
2006,19,j) 21 to 25,4821,6097,91056,91228,263,4.2,430,6.9,8220,2371,5849,2.6,9,8563,2275,6288,2.5,9.4,-343,-0.4,18,0,211,211,1248
2006,19,k) 26+,3483,5811,93611,91098,305,5.3,275,4.7,14288,7170,7118,7.9,15.7,9262,2939,6323,3.2,10.2,5026,5.5,20.4,0,174,174,1382
2006,19,l) Left Censored,10072,20351,675865,671855,961,4.7,969,4.8,63500,16946,46554,2.5,9.5,55480,11598,43882,1.7,8.3,8020,1.2,16.6,0,363,363,3738
2006,20,a) 0,4905,4994,28076,14099,4940,197.8,0,0,27955,27955,0,198.3,198.3,0,0,0,0,0,27955,198.3,0,0,,,
2006,20,b) 1,3723,3756,28340,28259,21,0.5,1155,26.3,8643,300,8343,1.1,30.6,8481,5737,2744,20.3,30,162,0.6,60,0,878,878,4852
2006,20,c) 2,3203,3243,23584,24422,111,3.2,588,16.8,4430,551,3879,2.3,18.1,6105,2719,3386,11.1,25,-1675,-6.9,36.2,0,449,449,2333
2006,20,d) 3,2773,2816,25842,25743,100,3.3,516,17.1,5056,588,4468,2.3,19.6,4858,2656,2202,10.3,18.9,198,0.7,37.8,0,401,401,2269
2006,20,e) 4,2521,2593,23398,23536,94,3.4,436,15.7,3791,569,3222,2.4,16.1,4067,2132,1935,9.1,17.3,-276,-1.2,32.2,0,327,327,1826
2006,20,f) 5,2300,2368,20331,20193,88,3.5,325,13.1,3488,292,3196,1.4,17.3,3212,1452,1760,7.2,15.9,276,1.4,31.8,0,246,246,1289
2006,20,g) 6 to 10,9724,10367,114128,113331,368,3.4,1177,10.9,16155,2760,13395,2.4,14.3,14561,5619,8942,5,12.8,1594,1.5,25.6,0,781,781,4026
2006,20,h) 11 to 15,6746,7232,82730,83594,293,3.9,673,9.1,12426,4075,8351,4.9,14.9,14154,4126,10028,4.9,16.9,-1728,-2,29.8,0,423,423,2524
2006,20,i) 16 to 20,5055,5879,82688,82857,271,4.5,486,8.1,10477,2925,7552,3.5,12.6,10815,3281,7534,4,13.1,-338,-0.5,25.2,0,304,310,2400
2006,20,j) 21 to 25,4422,5419,80305,80113,191,3.4,407,7.3,9165,2074,7091,2.6,11.4,8781,2061,6720,2.6,11,384,0.4,22,0,214,214,1010
2006,20,k) 26+,2902,4577,89554,89356,178,3.8,295,6.4,10860,4162,6698,4.7,12.2,10464,2921,7543,3.3,11.7,396,0.5,23.4,0,131,132,1416
2006,20,l) Left Censored,8173,17506,539261,541291,954,5.5,866,5,49975,13214,36761,2.4,9.2,54035,13346,40689,2.5,10,-4060,-0.8,18.4,0,255,271,3221
2006,21,a) 0,5742,5893,40058,20279,5854,198.7,0,0,39558,39558,0,195.1,195.1,0,0,0,0,0,39558,195.1,0,0,,,
2006,21,b) 1,4506,4569,35824,38089,33,0.6,1278,24.4,9410,710,8700,1.9,24.7,13940,8637,5303,22.7,36.6,-4530,-11.9,49.4,0,1063,1063,7684
2006,21,c) 2,3686,3733,28479,29924,111,2.7,741,18.3,5199,694,4505,2.3,17.4,8089,4870,3219,16.3,27,-2890,-9.6,34.8,0,619,619,3908
2006,21,d) 3,3050,3129,27681,27811,138,4.1,542,16.2,5482,719,4763,2.6,19.7,5741,2769,2972,10,20.6,-259,-0.9,39.4,0,436,436,2081
2006,21,e) 4,2824,2918,28921,29626,94,3.1,398,12.9,4340,440,3900,1.5,14.6,5749,2321,3428,7.8,19.4,-1409,-4.8,29.2,0,334,334,1962
2006,21,f) 5,2670,2749,23630,24349,78,2.7,356,12.3,3608,612,2996,2.5,14.8,5045,2346,2699,9.6,20.7,-1437,-5.9,29.6,0,282,282,1934
2006,21,g) 6 to 10,11342,12349,129983,130762,385,3,1251,9.8,18190,3136,15054,2.4,13.9,19747,7967,11780,6.1,15.1,-1557,-1.2,27.8,0,918,918,6493
2006,21,h) 11 to 15,8053,8873,108426,107824,329,3.6,819,9,16525,3689,12836,3.4,15.3,15320,6646,8674,6.2,14.2,1205,1.1,28.4,0,585,585,5450
2006,21,i) 16 to 20,6597,7877,143008,143121,319,4,554,6.9,16175,4128,12047,2.9,11.3,16401,5352,11049,3.7,11.5,-226,-0.2,22.6,0,361,362,3790
2006,21,j) 21 to 25,5284,6439,110238,110200,212,3.2,427,6.5,13744,2515,11229,2.3,12.5,13667,4841,8826,4.4,12.4,77,0.1,24.8,0,250,250,1699
2006,21,k) 26+,3094,5079,111172,109956,255,5,311,6.1,15007,5247,9760,4.8,13.6,12575,3933,8642,3.6,11.4,2432,2.2,22.8,0,140,143,1737
2006,21,l) Left Censored,8904,21695,751454,747132,1151,5.3,1003,4.6,79435,20392,59043,2.7,10.6,70790,16155,54635,2.2,9.5,8645,1.1,19,0,313,313,4706
2006,22,a) 0,6402,6566,49772,24957,6505,198.1,0,0,49630,49630,0,198.9,198.9,0,0,0,0,0,49630,198.9,0,0,,,
2006,22,b) 1,4642,4723,40569,41264,34,0.6,1557,27.8,11994,289,11705,0.7,29.1,13383,8853,4530,21.5,32.4,-1389,-3.3,58.2,0,1229,1229,7752
2006,22,c) 2,3984,4063,36603,38161,171,3.8,999,22.1,8157,1365,6792,3.6,21.4,11272,6158,5114,16.1,29.5,-3115,-8.1,42.8,0,791,791,5193
2006,22,d) 3,3473,3544,34898,35788,111,2.8,771,19.7,7629,760,6869,2.1,21.3,9408,4372,5036,12.2,26.3,-1779,-5,42.6,0,573,573,3406
2006,22,e) 4,3214,3332,37079,37257,108,3,638,17.6,8037,1334,6703,3.6,21.6,8393,4318,4075,11.6,22.5,-356,-0.9,43.2,0,462,462,3123
2006,22,f) 5,2941,3051,33233,35083,84,2.6,515,15.7,4988,252,4736,0.7,14.2,8688,3673,5015,10.5,24.8,-3700,-10.6,28.4,0,379,380,2994
2006,22,g) 6 to 10,12154,13010,157498,162318,430,3.1,1960,14.1,25633,4724,20909,2.9,15.8,35273,13689,21584,8.4,21.7,-9640,-5.9,31.6,0,1365,1365,9533
2006,22,h) 11 to 15,8734,9586,121817,126893,295,2.9,1308,12.9,17360,2611,14749,2.1,13.7,27512,9662,17850,7.6,21.7,-10152,-8,27.4,0,858,858,6248
2006,22,i) 16 to 20,6375,7648,142151,144142,304,3.8,865,10.9,18755,2895,15860,2,13,22737,6191,16546,4.3,15.8,-3982,-2.8,26,0,528,530,3761
2006,22,j) 21 to 25,6321,7792,123001,127279,262,3.2,740,9.2,15659,3711,11948,2.9,12.3,24215,5889,18326,4.6,19,-8556,-6.7,24.6,0,425,425,3469
2006,22,k) 26+,3889,5808,119204,119183,243,4.1,552,9.2,20423,6675,13748,5.6,17.1,20380,5829,14551,4.9,17.1,43,0,34.2,0,250,250,1441
2006,22,l) Left Censored,9263,22271,673829,683802,1438,6.4,1847,8.2,86576,24783,61793,3.6,12.7,106521,27494,79027,4,15.6,-19945,-2.9,25.4,0,544,547,5493
2006,23,a) 0,2907,2988,15432,7730,2968,198.7,0,0,15405,15405,0,199.3,199.3,0,0,0,0,0,15405,199.3,0,0,,,
2006,23,b) 1,2000,2007,10837,11209,6,0.3,671,28.3,2632,64,2568,0.6,23.5,3376,2218,1158,19.8,30.1,-744,-6.6,47,0,501,501,1783
2006,23,c) 2,1729,1737,11388,11371,73,3.9,355,18.8,2297,550,1747,4.8,20.2,2263,1010,1253,8.9,19.9,34,0.3,39.8,0,277,277,871
2006,23,d) 3,1398,1421,12239,12681,63,4.1,257,16.9,1870,273,1597,2.2,14.7,2754,1204,1550,9.5,21.7,-884,-7,29.4,0,198,198,1077
2006,23,e) 4,1444,1484,10965,11170,53,3.4,202,12.9,1716,286,1430,2.6,15.4,2125,925,1200,8.3,19,-409,-3.6,30.8,0,151,151,822
2006,23,f) 5,1366,1406,9626,9824,59,4,170,11.6,1295,110,1185,1.1,13.2,1691,596,1095,6.1,17.2,-396,-4,26.4,0,118,118,466
2006,23,g) 6 to 10,5477,5814,48224,48908,206,3.4,662,10.9,6576,834,5742,1.7,13.4,7943,3515,4428,7.2,16.2,-1367,-2.8,26.8,0,465,470,2550
2006,23,h) 11 to 15,3532,3820,36433,36418,154,3.9,322,8.2,5016,1517,3499,4.2,13.8,4985,1483,3502,4.1,13.7,31,0.1,27.4,0,219,219,1130
2006,23,i) 16 to 20,3188,3591,47415,47489,131,3.6,280,7.6,5024,974,4050,2.1,10.6,5171,1563,3608,3.3,10.9,-147,-0.3,21.2,0,187,187,1013
2006,23,j) 21 to 25,2201,2707,41906,41717,115,4.2,188,6.8,4114,1193,2921,2.9,9.9,3735,1221,2514,2.9,9,379,0.9,18,0,124,124,763
2006,23,k) 26+,1418,2301,34430,35274,95,4.1,140,6,3856,1355,2501,3.8,10.9,5544,2974,2570,8.4,15.7,-1688,-4.8,21.8,0,71,71,542
2006,23,l) Left Censored,3614,7303,221513,220816,338,4.6,327,4.5,20320,7687,12633,3.5,9.2,18926,5260,13666,2.4,8.6,1394,0.6,17.2,0,135,135,3177
2006,24,a) 0,9931,10123,61445,30848,10036,198.3,0,0,61195,61195,0,198.4,198.4,0,0,0,0,0,61195,198.4,0,0,,,
2006,24,b) 1,7380,7456,51705,51256,25,0.3,2080,24.2,14622,197,14425,0.4,28.5,13723,8325,5398,16.2,26.8,899,1.7,53.6,0,1606,1606,7012
2006,24,c) 2,6164,6230,45539,47644,232,3.4,1165,17.3,9579,896,8683,1.9,20.1,13788,8023,5765,16.8,28.9,-4209,-8.8,40.2,0,880,880,6982
2006,24,d) 3,5224,5320,47832,48031,191,3.4,849,15,9337,1001,8336,2.1,19.4,9735,4046,5689,8.4,20.3,-398,-0.9,38.8,0,659,660,3186
2006,24,e) 4,4999,5108,51509,51181,160,3,666,12.4,9090,1357,7733,2.7,17.8,8433,3963,4470,7.7,16.5,657,1.3,33,0,489,489,3089
2006,24,f) 5,4358,4479,41921,41808,173,3.7,573,12.2,6987,966,6021,2.3,16.7,6761,3151,3610,7.5,16.2,226,0.5,32.4,0,438,438,2683
2006,24,g) 6 to 10,17787,19027,215994,214253,741,3.8,1871,9.5,35641,6683,28958,3.1,16.6,32158,11686,20472,5.5,15,3483,1.6,30,0,1316,1316,8437
2006,24,h) 11 to 15,12150,13116,172581,172688,409,3,1075,8,23717,5052,18665,2.9,13.7,23931,7047,16884,4.1,13.9,-214,-0.2,27.4,0,736,742,4198
2006,24,i) 16 to 20,10214,11846,212127,212396,481,4,869,7.2,26370,6877,19493,3.2,12.4,26908,9482,17426,4.5,12.7,-538,-0.3,24.8,0,563,563,7177
2006,24,j) 21 to 25,6967,8785,151058,150538,319,3.6,508,5.7,18656,3396,15260,2.3,12.4,17615,5054,12561,3.4,11.7,1041,0.7,23.4,0,305,305,2290
2006,24,k) 26+,4094,6233,149562,148375,267,4.2,395,6.3,17100,5702,11398,3.8,11.5,14725,4646,10079,3.1,9.9,2375,1.6,19.8,0,191,193,1449
2006,24,l) Left Censored,11066,27229,1016549,1010178,1729,6.4,1445,5.3,117852,35270,82582,3.5,11.7,105112,32256,72856,3.2,10.4,12740,1.3,20.8,0,427,435,5611
2006,25,a) 0,11070,11189,62441,31304,11096,198.3,0,0,62275,62275,0,198.9,198.9,0,0,0,0,0,62275,198.9,0,0,,,
2006,25,b) 1,8203,8279,54901,56092,42,0.4,2280,24,13730,756,12974,1.3,24.5,16112,9624,6488,17.2,28.7,-2382,-4.2,49,0,1729,1729,8272
2006,25,c) 2,6906,6988,55923,53475,281,3.7,1240,16.5,14916,6111,8805,11.4,27.9,10020,5138,4882,9.6,18.7,4896,9.2,37.4,0,979,979,4434
2006,25,d) 3,5965,6060,48621,49512,232,3.6,999,15.5,9001,1167,7834,2.4,18.2,10783,6159,4624,12.4,21.8,-1782,-3.6,36.4,0,778,778,5654
2006,25,e) 4,5653,5811,57784,57814,218,3.6,796,13,9919,1560,8359,2.7,17.2,9979,4495,5484,7.8,17.3,-60,-0.1,34.4,0,632,632,3969
2006,25,f) 5,5185,5331,50007,50599,172,3.1,635,11.4,7896,1168,6728,2.3,15.6,9080,3691,5389,7.3,17.9,-1184,-2.3,31.2,0,511,513,3385
2006,25,g) 6 to 10,21859,23013,246518,248532,802,3.4,2431,10.2,36070,5044,31026,2,14.5,40098,18289,21809,7.4,16.1,-4028,-1.6,29,0,1783,1783,13728
2006,25,h) 11 to 15,14806,15787,199531,200310,487,3,1317,8.1,26929,5137,21792,2.6,13.4,28487,10967,17520,5.5,14.2,-1558,-0.8,26.8,0,942,943,7448
2006,25,i) 16 to 20,13412,15555,277696,274316,571,3.6,1056,6.7,33397,7652,25745,2.8,12.2,26636,8275,18361,3,9.7,6761,2.5,19.4,0,672,672,4877
2006,25,j) 21 to 25,10012,12704,268297,265801,551,4.3,714,5.6,32314,13298,19016,5,12.2,27321,9930,17391,3.7,10.3,4993,1.9,20.6,0,440,440,5109
2006,25,k) 26+,6037,9114,230550,229392,359,3.9,488,5.3,23649,7200,16449,3.1,10.3,21333,5619,15714,2.4,9.3,2316,1,18.6,0,278,278,2408
2006,25,l) Left Censored,18542,38254,1494998,1489150,2136,5.6,2089,5.5,177589,56044,121545,3.8,11.9,165893,40524,125369,2.7,11.1,11696,0.8,22.2,0,637,641,7984
2006,26,a) 0,14369,14446,105549,53247,14319,198.2,0,0,104605,104605,0,196.5,196.5,0,0,0,0,0,104605,196.5,0,0,,,
2006,26,b) 1,10843,10997,102444,104285,55,0.4,3369,26.3,24631,571,24060,0.5,23.6,28312,16904,11408,16.2,27.1,-3681,-3.5,47.2,0,2600,2600,14463
2006,26,c) 2,9058,9151,97383,100282,332,3.3,1907,19.1,17315,1771,15544,1.8,17.3,23112,10688,12424,10.7,23,-5797,-5.7,34.6,0,1463,1463,8827
2006,26,d) 3,7925,8094,78053,82047,299,3.4,1468,16.9,11189,917,10272,1.1,13.6,19176,8986,10190,11,23.4,-7987,-9.8,27.2,0,1129,1129,7656
2006,26,e) 4,7572,7771,103488,106527,262,3.2,1200,14.5,12885,2042,10843,1.9,12.1,18962,9080,9882,8.5,17.8,-6077,-5.7,24.2,0,944,944,7618
2006,26,f) 5,6507,6807,59684,61136,264,3.7,1049,14.5,8895,1178,7717,1.9,14.5,11798,4939,6859,8.1,19.3,-2903,-4.8,29,0,786,786,4229
2006,26,g) 6 to 10,28655,30431,324773,332232,1120,3.5,3617,11.4,41672,6332,35340,1.9,12.5,56590,21758,34832,6.5,17,-14918,-4.5,25,0,2585,2590,17841
2006,26,h) 11 to 15,20939,22667,254426,259339,741,3.2,2031,8.7,29129,5096,24033,2,11.2,38954,11171,27783,4.3,15,-9825,-3.8,22.4,0,1345,1357,7611
2006,26,i) 16 to 20,17160,20195,315976,317818,759,3.7,1570,7.6,40035,10349,29686,3.3,12.6,43719,14445,29274,4.5,13.8,-3684,-1.2,25.2,0,987,987,9468
2006,26,j) 21 to 25,13055,16618,287618,287382,531,3.1,995,5.9,32237,5617,26620,2,11.2,31765,8181,23584,2.8,11.1,472,0.1,22.2,0,596,599,3611
2006,26,k) 26+,8149,11645,219463,218885,368,3.1,662,5.6,26533,8431,18102,3.9,12.1,25377,5796,19581,2.6,11.6,1156,0.5,23.2,0,398,403,2767
2006,26,l) Left Censored,21532,51286,1829573,1830043,3000,5.9,2482,4.9,200049,50721,149328,2.8,10.9,200989,45601,155388,2.5,11,-940,-0.1,21.8,0,791,802,8197
2006,27,a) 0,10055,10377,64922,32598,10248,197.5,0,0,64648,64648,0,198.3,198.3,0,0,0,0,0,64648,198.3,0,0,,,
2006,27,b) 1,7349,7449,53796,56748,35,0.4,2264,26.1,12079,305,11774,0.5,21.3,17983,10227,7756,18,31.7,-5904,-10.4,42.6,0,1615,1615,8575
2006,27,c) 2,6354,6423,45026,47302,307,4.4,1292,18.6,8156,1347,6809,2.8,17.2,12708,8183,4525,17.3,26.9,-4552,-9.7,34.4,0,940,940,5161
2006,27,d) 3,5683,5792,45144,45968,316,5.2,930,15.2,8642,1672,6970,3.6,18.8,10289,6028,4261,13.1,22.4,-1647,-3.6,37.6,0,665,665,5140
2006,27,e) 4,5222,5361,48061,49042,257,4.6,779,13.8,7397,851,6546,1.7,15.1,9358,4478,4880,9.1,19.1,-1961,-4,30.2,0,530,530,3616
2006,27,f) 5,4627,4786,42310,42818,215,4.3,626,12.5,6187,874,5313,2,14.4,7203,3300,3903,7.7,16.8,-1016,-2.4,28.8,0,423,423,2635
2006,27,g) 6 to 10,19458,20871,224092,225222,900,4.2,2143,9.9,29733,5546,24187,2.5,13.2,31992,13093,18899,5.8,14.2,-2259,-1,26.4,0,1383,1388,9866
2006,27,h) 11 to 15,13463,14648,170257,171423,612,4.1,1330,8.8,25327,6219,19108,3.6,14.8,27658,11532,16126,6.7,16.1,-2331,-1.3,29.6,0,824,824,7379
2006,27,i) 16 to 20,9803,11476,196971,195539,400,3.4,852,7.3,24387,4483,19904,2.3,12.5,21522,6163,15359,3.2,11,2865,1.5,22,0,532,533,5173
2006,27,j) 21 to 25,7297,9613,200816,200857,319,3.3,598,6.1,18868,4517,14351,2.2,9.4,18950,5306,13644,2.6,9.4,-82,0,18.8,0,339,341,3522
2006,27,k) 26+,4915,7324,165019,164553,321,4.3,462,6.2,17046,3868,13178,2.4,10.4,16113,4750,11363,2.9,9.8,933,0.6,19.6,0,229,229,1554
2006,27,l) Left Censored,13439,30259,1229224,1221686,1738,5.8,1346,4.5,137463,37043,100420,3,11.3,122388,29855,92533,2.4,10,15075,1.3,20,0,400,401,5775
2006,28,a) 0,4023,4114,30220,15173,4068,197.8,0,0,30095,30095,0,198.3,198.3,0,0,0,0,0,30095,198.3,0,0,,,
2006,28,b) 1,2841,2880,24302,24672,15,0.4,1025,29.8,8055,480,7575,1.9,32.6,8794,6224,2570,25.2,35.6,-739,-3,65.2,0,823,823,5170
2006,28,c) 2,2441,2487,19234,20152,89,3.3,534,19.6,4144,423,3721,2.1,20.6,5979,2345,3634,11.6,29.7,-1835,-9.1,41.2,0,424,424,1933
2006,28,d) 3,2201,2238,18931,19712,78,3.2,436,17.9,3204,613,2591,3.1,16.3,4766,2371,2395,12,24.2,-1562,-7.9,32.6,0,341,341,2106
2006,28,e) 4,1926,1984,21189,21188,69,3.2,341,16.1,4355,446,3909,2.1,20.6,4353,1993,2360,9.4,20.5,2,0.1,41,0,277,277,1487
2006,28,f) 5,1765,1833,17675,17911,64,3.3,281,14.5,2771,624,2147,3.5,15.5,3242,1498,1744,8.4,18.1,-471,-2.6,31,0,215,215,1202
2006,28,g) 6 to 10,7307,7875,78509,80987,268,3.2,1014,12.3,11074,1715,9359,2.1,13.7,16030,6050,9980,7.5,19.8,-4956,-6.1,27.4,0,725,725,4148
2006,28,h) 11 to 15,5028,5568,69775,70265,196,3.4,635,10.9,9708,1871,7837,2.7,13.8,10687,3904,6783,5.6,15.2,-979,-1.4,27.6,0,446,446,2738
2006,28,i) 16 to 20,3746,4225,74940,74878,158,3.6,401,9.2,9033,1915,7118,2.6,12.1,8909,2906,6003,3.9,11.9,124,0.2,23.8,0,274,274,2219
2006,28,j) 21 to 25,3548,4367,64569,63631,196,4.4,305,6.9,8574,1985,6589,3.1,13.5,6698,1684,5014,2.6,10.5,1876,3,21,0,175,175,989
2006,28,k) 26+,2250,3254,69685,69485,186,5.7,241,7.3,10398,4404,5994,6.3,15,9998,2474,7524,3.6,14.4,400,0.6,28.8,0,120,120,1048
2006,28,l) Left Censored,5872,14498,447739,449348,821,5.7,847,5.8,46014,12636,33378,2.8,10.2,49232,11294,37938,2.5,11,-3218,-0.8,20.4,0,198,203,2863
2006,29,a) 0,10864,11108,62578,31461,11019,198.4,0,0,62235,62235,0,197.8,197.8,0,0,0,0,0,62235,197.8,0,0,,,
2006,29,b) 1,8253,8379,58179,61688,51,0.5,3324,32.6,15099,687,14412,1.1,24.5,22116,15338,6778,24.9,35.9,-7017,-11.4,49,0,2704,2704,13346
2006,29,c) 2,6924,6998,51963,53880,222,2.8,1927,24.5,10694,695,9999,1.3,19.8,14527,7741,6786,14.4,27,-3833,-7.2,39.6,0,1562,1562,6877
2006,29,d) 3,5650,5738,42064,43633,201,3.2,1226,19.6,7107,896,6211,2.1,16.3,10244,5304,4940,12.2,23.5,-3137,-7.2,32.6,0,978,978,4481
2006,29,e) 4,5094,5224,48250,49871,151,2.7,912,16.2,6587,640,5947,1.3,13.2,9828,4467,5361,9,19.7,-3241,-6.5,26.4,0,720,720,3919
2006,29,f) 5,4293,4478,43673,43729,137,2.9,602,12.7,8092,1528,6564,3.5,18.5,8203,3659,4544,8.4,18.8,-111,-0.3,37,0,458,458,2579
2006,29,g) 6 to 10,18375,19693,209511,212212,681,3.3,2255,11,32129,4880,27249,2.3,15.1,37531,16280,21251,7.7,17.7,-5402,-2.6,30.2,0,1603,1606,10906
2006,29,h) 11 to 15,12639,13807,167144,168154,477,3.3,1421,9.9,22734,4699,18035,2.8,13.5,24753,8843,15910,5.3,14.7,-2019,-1.2,27,0,1022,1022,6548
2006,29,i) 16 to 20,10172,12244,192023,191429,569,4.6,934,7.5,24379,6493,17886,3.4,12.7,23190,5941,17249,3.1,12.1,1189,0.6,24.2,0,601,605,4318
2006,29,j) 21 to 25,8168,10342,200499,201912,394,3.7,720,6.8,20103,4650,15453,2.3,10,22929,5813,17116,2.9,11.4,-2826,-1.4,20,0,404,432,3838
2006,29,k) 26+,5051,8313,187856,184867,566,6.8,477,5.8,23269,9206,14063,5,12.6,17291,4023,13268,2.2,9.4,5978,3.2,18.8,0,258,258,1507
2006,29,l) Left Censored,13874,33010,1183474,1177778,1898,5.8,1770,5.4,131534,43272,88262,3.7,11.2,120141,31544,88597,2.7,10.2,11393,1,20.4,0,515,524,6324
2006,30,a) 0,3229,3288,14589,7343,3257,198.1,0,0,14492,14492,0,197.4,197.4,0,0,0,0,0,14492,197.4,0,0,,,
2006,30,b) 1,2180,2186,11463,11801,0,0,637,25.1,3066,0,3066,0,26,3741,2085,1656,17.7,31.7,-675,-5.7,52,0,470,470,1792
2006,30,c) 2,1865,1888,10647,10640,89,4.4,342,16.9,2348,391,1957,3.7,22.1,2334,1173,1161,11,21.9,14,0.2,43.8,0,255,255,988
2006,30,d) 3,1461,1483,8788,8964,81,5.2,248,15.8,1792,281,1511,3.1,20,2143,1046,1097,11.7,23.9,-351,-3.9,40,0,182,182,789
2006,30,e) 4,1381,1423,9930,9960,48,3.2,181,12.1,1638,145,1493,1.5,16.4,1698,751,947,7.5,17,-60,-0.6,32.8,0,124,124,597
2006,30,f) 5,1233,1246,7601,7777,49,3.8,163,12.5,1102,184,918,2.4,14.2,1454,570,884,7.3,18.7,-352,-4.5,28.4,0,100,100,411
2006,30,g) 6 to 10,5071,5323,44181,44668,242,4.4,590,10.7,8496,3510,4986,7.9,19,9470,4398,5072,9.8,21.2,-974,-2.2,38,0,387,387,3477
2006,30,h) 11 to 15,3234,3370,29663,29191,144,4.2,309,8.9,4749,1358,3391,4.7,16.3,3805,1411,2394,4.8,13,944,3.3,26,0,203,203,1044
2006,30,i) 16 to 20,2161,2398,28111,27789,131,5.4,217,8.9,3684,1275,2409,4.6,13.3,3040,1069,1971,3.8,10.9,644,2.4,21.8,0,140,140,651
2006,30,j) 21 to 25,1785,2156,28338,28199,89,4.1,152,7,3131,795,2336,2.8,11.1,2853,779,2074,2.8,10.1,278,1,20.2,0,91,91,407
2006,30,k) 26+,1288,1906,28184,27911,58,3,117,6,3069,646,2423,2.3,11,2522,744,1778,2.7,9,547,2,18,0,57,57,413
2006,30,l) Left Censored,2672,5297,117789,116133,273,5.2,260,4.9,13087,2670,10417,2.3,11.3,9775,2990,6785,2.6,8.4,3312,2.9,16.8,0,71,71,1202
2006,31,a) 0,3287,3372,17573,8818,3336,197.9,0,0,17511,17511,0,198.6,198.6,0,0,0,0,0,17511,198.6,0,0,,,
2006,31,b) 1,2491,2514,15697,16731,16,0.6,680,23.5,3528,119,3409,0.7,21.1,5596,3529,2067,21.1,33.4,-2068,-12.3,42.2,0,495,495,2763
2006,31,c) 2,2164,2190,15586,16133,91,3.9,376,16.1,2932,789,2143,4.9,18.2,4026,2130,1896,13.2,25,-1094,-6.8,36.4,0,274,274,1400
2006,31,d) 3,1822,1853,12556,13046,54,2.7,323,16.2,1952,343,1609,2.6,15,2931,1395,1536,10.7,22.5,-979,-7.5,30,0,231,231,1198
2006,31,e) 4,1783,1837,13661,14416,84,4.3,303,15.5,1975,199,1776,1.4,13.7,3484,2228,1256,15.5,24.2,-1509,-10.5,27.4,0,186,186,1315
2006,31,f) 5,1650,1714,15011,15323,67,3.7,214,11.9,1832,166,1666,1.1,12,2456,1087,1369,7.1,16,-624,-4,24,0,147,147,852
2006,31,g) 6 to 10,6693,7126,75156,75294,232,3.1,751,10.1,9442,1434,8008,1.9,12.5,9717,3258,6459,4.3,12.9,-275,-0.4,25,0,458,458,2430
2006,31,h) 11 to 15,4788,5172,49609,50030,205,3.8,516,9.7,6785,2357,4428,4.7,13.6,7627,2459,5168,4.9,15.2,-842,-1.6,27.2,0,307,311,1571
2006,31,i) 16 to 20,3705,4256,70025,69832,178,4.1,362,8.3,7148,1794,5354,2.6,10.2,6762,2154,4608,3.1,9.7,386,0.5,19.4,0,218,218,1584
2006,31,j) 21 to 25,3080,3782,75760,75405,146,3.8,257,6.7,6565,1953,4612,2.6,8.7,5854,1748,4106,2.3,7.8,711,0.9,15.6,0,149,149,1290
2006,31,k) 26+,2097,3235,62908,60535,184,5.7,187,5.8,9834,5401,4433,8.9,16.2,5087,1374,3713,2.3,8.4,4747,7.8,16.8,0,96,96,668
2006,31,l) Left Censored,6001,11676,370344,368022,539,4.6,572,4.9,39944,11528,28416,3.1,10.9,35302,7021,28281,1.9,9.6,4642,1.3,19.2,0,212,215,2096
2006,32,a) 0,6382,6496,50084,25099,6454,198.7,0,0,49971,49971,0,199.1,199.1,0,0,0,0,0,49971,199.1,0,0,,,
2006,32,b) 1,4442,4559,46627,46592,51,1,1429,26.9,12759,516,12243,1.1,27.4,12689,7493,5196,16.1,27.2,70,0.2,54.4,0,1144,1144,6401
2006,32,c) 2,3513,3548,38618,39210,149,3.9,747,19.3,7858,729,7129,1.9,20,9042,4475,4567,11.4,23.1,-1184,-3.1,40,0,618,618,3736
2006,32,d) 3,2830,2939,33549,34806,127,4,589,18.5,7416,605,6811,1.7,21.3,9930,5457,4473,15.7,28.5,-2514,-7.2,42.6,0,466,466,4008
2006,32,e) 4,2399,2464,34117,33594,110,4.2,372,14.3,7552,840,6712,2.5,22.5,6506,2875,3631,8.6,19.4,1046,3.1,38.8,0,279,279,2427
2006,32,f) 5,2016,2091,39919,35883,85,3.9,280,12.8,12924,519,12405,1.4,36,4852,1668,3184,4.6,13.5,8072,22.5,27,0,214,214,1442
2006,32,g) 6 to 10,7310,7909,127977,125848,384,4.7,973,11.8,24856,3744,21112,3,19.8,20597,7914,12683,6.3,16.4,4259,3.4,32.8,0,708,708,6618
2006,32,h) 11 to 15,3828,4237,87808,86897,185,4.3,397,9.1,12995,1710,11285,2,15,11172,3771,7401,4.3,12.9,1823,2.1,25.8,0,296,297,2490
2006,32,i) 16 to 20,2729,3479,82586,80648,208,5.9,272,7.7,13435,3792,9643,4.7,16.7,9558,2855,6703,3.5,11.9,3877,4.8,23.8,0,197,198,1911
2006,32,j) 21 to 25,1923,2908,75910,75437,187,6.4,186,6.4,10941,4322,6619,5.7,14.5,9995,2825,7170,3.7,13.2,946,1.3,26.4,0,110,110,1890
2006,32,k) 26+,1410,2362,76964,73687,170,7.2,161,6.8,12831,5991,6840,8.1,17.4,6277,1375,4902,1.9,8.5,6554,8.9,17,0,68,68,876
2006,32,l) Left Censored,3159,9208,461238,453829,845,9.4,480,5.3,56003,20010,35993,4.4,12.3,41185,11629,29556,2.6,9.1,14818,3.2,18.2,0,93,94,1903
2006,33,a) 0,2698,2766,15572,7813,2741,198.2,0,0,15519,15519,0,198.6,198.6,0,0,0,0,0,15519,198.6,0,0,,,
2006,33,b) 1,1975,2004,13885,14349,8,0.3,603,25.8,3055,25,3030,0.2,21.3,3982,2371,1611,16.5,27.8,-927,-6.5,42.6,0,470,470,2108
2006,33,c) 2,1677,1691,10442,10714,58,3.1,347,18.8,1991,199,1792,1.9,18.6,2535,1424,1111,13.3,23.7,-544,-5.1,37.2,0,287,287,1286
2006,33,d) 3,1382,1415,9725,9986,42,2.8,250,16.4,1601,106,1495,1.1,16,2122,979,1143,9.8,21.2,-521,-5.2,32,0,203,203,877
2006,33,e) 4,1236,1257,11978,12467,35,2.6,212,15.7,1650,162,1488,1.3,13.2,2628,806,1822,6.5,21.1,-978,-7.9,26.4,0,158,158,654
2006,33,f) 5,1114,1162,10713,10688,46,3.7,185,15,1594,208,1386,1.9,14.9,1543,657,886,6.1,14.4,51,0.5,28.8,0,135,135,478
2006,33,g) 6 to 10,5200,5449,50847,50664,190,3.4,548,9.7,7364,1093,6271,2.2,14.5,6997,2916,4081,5.8,13.8,367,0.7,27.6,0,419,419,2543
2006,33,h) 11 to 15,3547,3709,43431,43300,95,2.5,334,8.7,5751,1251,4500,2.9,13.3,5488,2220,3268,5.1,12.7,263,0.6,25.4,0,242,242,1861
2006,33,i) 16 to 20,3241,3639,54583,54503,149,4,280,7.5,7309,1859,5450,3.4,13.4,7148,2482,4666,4.6,13.1,161,0.3,26.2,0,176,176,1233
2006,33,j) 21 to 25,2101,2514,41271,42163,90,3.5,160,6.3,3984,953,3031,2.3,9.4,5768,2816,2952,6.7,13.7,-1784,-4.3,18.8,0,104,105,1032
2006,33,k) 26+,1263,1930,41488,40853,68,3.5,103,5.3,6302,2666,3636,6.5,15.4,5032,1958,3074,4.8,12.3,1270,3.1,24.6,0,54,54,478
2006,33,l) Left Censored,3592,7570,265248,262302,432,5.7,394,5.2,31330,8305,23025,3.2,11.9,25438,5623,19815,2.1,9.7,5892,2.2,19.4,0,116,116,1980
2006,34,a) 0,17735,18014,98632,49514,17844,198.1,0,0,98236,98236,0,198.4,198.4,0,0,0,0,0,98236,198.4,0,0,,,
2006,34,b) 1,13444,13578,88337,90798,51,0.3,3936,25,22055,625,21430,0.7,24.3,26977,14865,12112,16.4,29.7,-4922,-5.4,48.6,0,3136,3136,12025
2006,34,c) 2,10940,11016,78022,79494,385,3.2,2207,18.4,15728,1184,14544,1.5,19.8,18672,10557,8115,13.3,23.5,-2944,-3.7,39.6,0,1819,1819,9374
2006,34,d) 3,9409,9512,80018,79801,361,3.5,1590,15.6,15486,1841,13645,2.3,19.4,15051,7947,7104,10,18.9,435,0.5,37.8,0,1262,1262,6732
2006,34,e) 4,8443,8572,79634,80814,356,3.9,1248,13.8,12130,1534,10596,1.9,15,14489,6169,8320,7.6,17.9,-2359,-2.9,30,0,977,977,4891
2006,34,f) 5,7951,8149,75937,77223,314,3.7,1067,12.5,11994,1580,10414,2,15.5,14566,7089,7477,9.2,18.9,-2572,-3.4,31,0,790,794,3788
2006,34,g) 6 to 10,32873,34236,364974,367104,1230,3.5,3752,10.5,50654,8400,42254,2.3,13.8,54913,21869,33044,6,15,-4259,-1.2,27.6,0,2893,2893,18081
2006,34,h) 11 to 15,20972,21953,259449,260071,711,3.1,1978,8.7,34499,7161,27338,2.8,13.3,35742,11730,24012,4.5,13.7,-1243,-0.4,26.6,0,1461,1461,8536
2006,34,i) 16 to 20,17502,19500,289196,287129,821,4.1,1560,7.8,38053,11789,26264,4.1,13.3,33919,10046,23873,3.5,11.8,4134,1.5,23.6,0,1087,1087,6352
2006,34,j) 21 to 25,12593,15031,291302,291593,510,3.3,1074,7,33513,8753,24760,3,11.5,34094,10398,23696,3.6,11.7,-581,-0.2,23,0,687,687,5820
2006,34,k) 26+,7991,10747,237815,237559,450,4.1,693,6.4,26658,7007,19651,2.9,11.2,26145,7727,18418,3.3,11,513,0.2,22,0,397,399,2650
2006,34,l) Left Censored,21166,43882,1661314,1667272,2539,5.8,2891,6.6,192815,60790,132025,3.6,11.6,204730,58426,146304,3.5,12.3,-11915,-0.7,23.2,0,1023,1031,11810
2006,35,a) 0,3381,3419,20933,10532,3381,197.8,0,0,20803,20803,0,197.5,197.5,0,0,0,0,0,20803,197.5,0,0,,,
2006,35,b) 1,2412,2444,19131,19020,18,0.6,669,23.8,5396,257,5139,1.4,28.4,5174,3307,1867,17.4,27.2,222,1.2,54.4,0,510,510,2917
2006,35,c) 2,1963,2025,16750,17314,93,4.2,437,19.8,3437,307,3130,1.8,19.9,4564,2684,1880,15.5,26.4,-1127,-6.5,39.8,0,343,343,2376
2006,35,d) 3,1655,1683,14095,14173,53,2.9,284,15.7,2684,121,2563,0.9,18.9,2839,1562,1277,11,20,-155,-1.1,37.8,0,221,221,1196
2006,35,e) 4,1551,1601,16910,17244,70,4.1,258,15.2,2876,267,2609,1.5,16.7,3543,2280,1263,13.2,20.5,-667,-3.8,33.4,0,177,177,1917
2006,35,f) 5,1478,1599,15522,15698,86,5.2,194,11.7,2530,337,2193,2.1,16.1,2882,1122,1760,7.1,18.4,-352,-2.3,32.2,0,142,142,1023
2006,35,g) 6 to 10,5804,6121,76514,76095,250,3.9,667,10.5,12713,2009,10704,2.6,16.7,11874,5184,6690,6.8,15.6,839,1.1,31.2,0,499,499,4014
2006,35,h) 11 to 15,4131,4557,52822,53105,197,4.2,411,8.8,7487,1323,6164,2.5,14.1,8052,3187,4865,6,15.2,-565,-1.1,28.2,0,292,292,2595
2006,35,i) 16 to 20,2983,3500,60234,59947,141,4,248,7,7658,2076,5582,3.5,12.8,7083,2726,4357,4.5,11.8,575,1,23.6,0,158,162,2226
2006,35,j) 21 to 25,2540,3317,48934,48741,141,4.2,225,6.7,5748,1493,4255,3.1,11.8,5362,1467,3895,3,11,386,0.8,22,0,143,143,962
2006,35,k) 26+,1712,2665,52182,50575,161,6,203,7.6,10242,3972,6270,7.9,20.3,7028,2602,4426,5.1,13.9,3214,6.4,27.8,0,87,87,507
2006,35,l) Left Censored,3600,8224,233819,228338,503,6.2,388,4.8,31117,9223,21894,4,13.6,20156,5196,14960,2.3,8.8,10961,4.8,17.6,0,116,117,951
2006,36,a) 0,39195,39812,215583,108119,39519,198.5,0,0,214928,214928,0,198.8,198.8,0,0,0,0,0,214928,198.8,0,0,,,
2006,36,b) 1,29242,29523,195681,204610,119,0.3,8617,25.2,44973,1202,43771,0.6,22,62831,34850,27981,17,30.7,-17858,-8.7,44,0,6862,6862,29871
2006,36,c) 2,24596,24757,163088,168197,861,3.2,5165,19.1,32617,2925,29692,1.7,19.4,42834,25400,17434,15.1,25.5,-10217,-6.1,38.8,0,4196,4196,22468
2006,36,d) 3,21118,21343,155185,157676,704,3.1,3827,16.7,29813,2873,26940,1.8,18.9,34795,17946,16849,11.4,22.1,-4982,-3.2,37.8,0,3136,3136,15784
2006,36,e) 4,18695,19044,161465,165450,674,3.3,2984,14.8,23598,2453,21145,1.5,14.3,31568,14815,16753,9,19.1,-7970,-4.8,28.6,0,2394,2396,12857
2006,36,f) 5,16863,17163,145249,148566,654,3.6,2429,13.4,23014,3737,19277,2.5,15.5,29648,15223,14425,10.2,20,-6634,-4.5,31,0,1915,1915,13568
2006,36,g) 6 to 10,66965,70182,720688,726968,2285,3.1,8264,11.3,99563,11494,88069,1.6,13.7,112125,45464,66661,6.3,15.4,-12562,-1.7,27.4,0,6316,6316,36896
2006,36,h) 11 to 15,42957,45042,509927,518772,1307,2.8,4220,9.1,62518,12933,49585,2.5,12.1,80207,31043,49164,6,15.5,-17689,-3.4,24.2,0,3099,3101,23623
2006,36,i) 16 to 20,37123,40784,621545,622414,1373,3.3,3176,7.6,69049,18444,50605,3,11.1,70787,20854,49933,3.4,11.4,-1738,-0.3,22.2,0,2179,2192,14037
2006,36,j) 21 to 25,27090,32173,560991,564771,1034,3.2,2122,6.5,55140,12727,42413,2.3,9.8,62699,19407,43292,3.4,11.1,-7559,-1.3,19.6,0,1414,1417,12586
2006,36,k) 26+,15883,22779,516052,515461,820,3.6,1357,5.9,52783,15125,37658,2.9,10.2,51601,14266,37335,2.8,10,1182,0.2,20,0,789,791,6744
2006,36,l) Left Censored,46083,93340,3543923,3543795,4756,5.1,5278,5.6,380390,102371,278019,2.9,10.7,380135,103071,277064,2.9,10.7,255,0,21.4,0,2211,2235,32397
2006,37,a) 0,16356,16734,102798,51794,16595,198.3,0,0,102008,102008,0,196.9,196.9,0,0,0,0,0,102008,196.9,0,0,,,
2006,37,b) 1,12230,12421,95340,95609,71,0.5,3371,23.6,25464,688,24776,0.7,26.6,26002,14993,11009,15.7,27.2,-538,-0.6,53.2,0,2665,2667,12717
2006,37,c) 2,9694,9839,79614,81039,342,3.2,1860,17.4,18320,1618,16702,2,22.6,21169,9967,11202,12.3,26.1,-2849,-3.5,45.2,0,1500,1500,8954
2006,37,d) 3,8260,8420,76106,76774,286,3.2,1324,14.8,14136,1854,12282,2.4,18.4,15472,6990,8482,9.1,20.2,-1336,-1.8,36.8,0,1058,1058,5949
2006,37,e) 4,7336,7597,73845,73399,266,3.3,1014,12.7,14148,1885,12263,2.6,19.3,13255,6314,6941,8.6,18.1,893,1.2,36.2,0,780,780,4822
2006,37,f) 5,6986,7315,68902,69189,278,3.6,942,12.3,11733,1590,10143,2.3,17,12306,5272,7034,7.6,17.8,-573,-0.8,34,0,712,712,4447
2006,37,g) 6 to 10,28118,30494,339977,340394,1162,3.7,3246,10.3,51897,8805,43092,2.6,15.2,52731,20300,32431,6,15.5,-834,-0.3,30.4,0,2367,2370,16718
2006,37,h) 11 to 15,17271,18951,249479,246845,686,3.5,1686,8.7,38798,6659,32139,2.7,15.7,33530,11874,21656,4.8,13.6,5268,2.1,27.2,0,1209,1209,8601
2006,37,i) 16 to 20,13898,16801,304666,300313,739,4.3,1240,7.3,41633,16245,25388,5.4,13.9,32927,9450,23477,3.1,11,8706,2.9,22,0,886,886,6571
2006,37,j) 21 to 25,11707,14962,244829,245058,687,4.5,932,6.2,27330,7111,20219,2.9,11.2,27788,8973,18815,3.7,11.3,-458,-0.1,22.4,0,552,552,4685
2006,37,k) 26+,6409,10710,251116,246218,599,5.6,576,5.4,35546,14009,21537,5.7,14.4,25749,6467,19282,2.6,10.5,9797,3.9,21,0,276,280,1896
2006,37,l) Left Censored,16192,44953,1639099,1630451,2787,6.2,2301,5.1,192617,60964,131653,3.7,11.8,175321,53663,121658,3.3,10.8,17296,1,21.6,0,685,699,11536
2006,38,a) 0,1450,1495,7568,3807,1464,195.9,0,0,7522,,,,197.6,0,0,0,0,0,7522,197.6,0,1,,,
2006,38,b) 1,1032,1046,6288,6739,6,0.5,315,25.9,1279,,,,19,2181,1253,928,18.6,32.4,-902,-13.4,38,1,198,198,989
2006,38,c) 2,858,877,6056,6279,57,6,181,19.1,872,96,776,1.5,13.9,1318,637,681,10.1,21,-446,-7.1,27.8,0,131,131,477
2006,38,d) 3,726,742,4369,4656,41,5.2,126,16.1,624,64,560,1.4,13.4,1198,473,725,10.2,25.7,-574,-12.3,26.8,0,84,84,367
2006,38,e) 4,711,734,5119,5234,33,4.3,96,12.5,704,60,644,1.1,13.5,934,313,621,6,17.8,-230,-4.3,27,0,60,60,236
2006,38,f) 5,629,649,5542,5498,30,4.4,93,13.6,835,78,757,1.4,15.2,746,351,395,6.4,13.6,89,1.6,27.2,0,57,57,259
2006,38,g) 6 to 10,2631,2751,22606,22807,134,4.7,330,11.5,3338,773,2565,3.4,14.6,3740,1817,1923,8,16.4,-402,-1.8,29.2,0,193,193,1406
2006,38,h) 11 to 15,2203,2283,23141,23200,128,5.4,249,10.6,3039,658,2381,2.8,13.1,3158,1392,1766,6,13.6,-119,-0.5,26.2,0,132,132,1080
2006,38,i) 16 to 20,1605,1805,21044,20736,110,6,173,9.4,2770,883,1887,4.3,13.4,2154,709,1445,3.4,10.4,616,3,20.8,0,93,93,527
2006,38,j) 21 to 25,1392,1679,21165,21074,65,3.8,129,7.5,3434,723,2711,3.4,16.3,3251,1875,1376,8.9,15.4,183,0.9,30.8,0,54,54,512
2006,38,k) 26+,953,1303,22479,22210,47,3.5,86,6.5,2795,612,2183,2.8,12.6,2257,400,1857,1.8,10.2,538,2.4,20.4,0,41,41,269
2006,38,l) Left Censored,2742,5003,135165,133768,199,4,214,4.3,12625,3027,9598,2.3,9.4,9831,2081,7750,1.6,7.3,2794,2.1,14.6,0,88,88,672
2006,39,a) 0,14758,15067,113416,56914,14940,198.3,0,0,113005,113005,0,198.6,198.6,0,0,0,0,0,113005,198.6,0,0,,,
2006,39,b) 1,11196,11408,102776,104912,63,0.5,3260,24.8,25611,1184,24427,1.1,24.4,29882,17362,12520,16.5,28.5,-4271,-4.1,48.8,0,2579,2579,15089
2006,39,c) 2,9466,9590,86044,88570,338,3.3,1856,17.9,16386,1996,14390,2.3,18.5,21437,11267,10170,12.7,24.2,-5051,-5.7,37,0,1479,1483,9895
2006,39,d) 3,8213,8416,77381,79557,252,2.8,1337,14.9,12915,1499,11416,1.9,16.2,17266,7728,9538,9.7,21.7,-4351,-5.5,32.4,0,1037,1037,6370
2006,39,e) 4,7876,8278,87924,89384,297,3.4,1225,14,12293,1197,11096,1.3,13.8,15213,6917,8296,7.7,17,-2920,-3.2,27.6,0,947,947,5921
2006,39,f) 5,7084,7433,68601,70220,254,3.3,952,12.2,9874,1361,8513,1.9,14.1,13111,5834,7277,8.3,18.7,-3237,-4.6,28.2,0,715,718,5109
2006,39,g) 6 to 10,30791,33590,387272,390680,1229,3.5,3709,10.6,55637,9503,46134,2.4,14.2,62453,27248,35205,7,16,-6816,-1.8,28.4,0,2571,2571,20847
2006,39,h) 11 to 15,23209,25531,311437,313020,879,3.3,2326,8.8,42406,7283,35123,2.3,13.5,45571,15265,30306,4.9,14.6,-3165,-1.1,27,0,1581,1581,11328
2006,39,i) 16 to 20,18993,22953,382212,381155,879,3.8,1726,7.4,46520,11388,35132,3,12.2,44405,14744,29661,3.9,11.7,2115,0.5,23.4,0,1118,1118,9620
2006,39,j) 21 to 25,14807,19070,351188,353312,566,2.9,1227,6.3,33399,5961,27438,1.7,9.5,37647,11023,26624,3.1,10.7,-4248,-1.2,19,0,727,732,6845
2006,39,k) 26+,10093,15488,338297,335129,552,3.5,960,6.1,40731,12467,28264,3.7,12.2,34394,9499,24895,2.8,10.3,6337,1.9,20.6,0,510,515,3968
2006,39,l) Left Censored,28922,69847,2495785,2496693,3973,5.7,3845,5.5,270924,88148,182776,3.5,10.9,272741,82437,190304,3.3,10.9,-1817,0,21.8,0,1201,1263,19868
2006,40,a) 0,6383,6526,43335,21769,6462,198,0,0,43133,43133,0,198.1,198.1,0,0,0,0,0,43133,198.1,0,0,,,
2006,40,b) 1,4632,4718,40917,39314,31,0.6,1433,26.1,13816,3615,10201,9.2,35.1,10609,6918,3691,17.6,27,3207,8.1,54,0,1147,1153,5943
2006,40,c) 2,3689,3730,29342,29525,136,3.4,737,18.2,5845,531,5314,1.8,19.8,6210,3173,3037,10.7,21,-365,-1.2,39.6,0,597,597,2780
2006,40,d) 3,3251,3284,26788,27079,103,2.9,551,15.6,5377,373,5004,1.4,19.9,5958,3155,2803,11.7,22,-581,-2.1,39.8,0,434,434,2713
2006,40,e) 4,2986,3093,28215,28504,103,3.1,491,14.9,4647,847,3800,3,16.3,5225,2428,2797,8.5,18.3,-578,-2,32.6,0,391,391,2093
2006,40,f) 5,2697,2822,25515,25180,90,3,360,12.1,5433,848,4585,3.4,21.6,4763,2072,2691,8.2,18.9,670,2.7,37.8,0,271,271,1740
2006,40,g) 6 to 10,11209,12254,130800,129173,469,3.7,1281,10.1,23630,4863,18767,3.8,18.3,20375,8461,11914,6.6,15.8,3255,2.5,31.6,0,898,900,6293
2006,40,h) 11 to 15,7713,8329,89984,89462,280,3.3,738,8.6,12187,2108,10079,2.4,13.6,11142,3849,7293,4.3,12.5,1045,1.1,25,0,513,513,2962
2006,40,i) 16 to 20,5734,6579,105277,102727,252,3.7,536,8,17184,4636,12548,4.5,16.7,12083,4086,7997,4,11.8,5101,4.9,23.6,0,348,352,2539
2006,40,j) 21 to 25,5740,6923,106489,105865,223,3.2,446,6.3,12609,2989,9620,2.8,11.9,11360,3585,7775,3.4,10.7,1249,1.2,21.4,0,274,274,1844
2006,40,k) 26+,3365,5214,111170,109519,250,4.7,348,6.6,15764,6903,8861,6.3,14.4,12462,3332,9130,3,11.4,3302,3,22.8,0,155,166,1252
2006,40,l) Left Censored,7544,17893,538343,529059,984,5.5,853,4.8,66898,20734,46164,3.9,12.6,48331,13920,34411,2.6,9.1,18567,3.5,18.2,0,282,289,2894
2006,41,a) 0,8978,9228,46267,23219,9157,198.5,0,0,46096,46096,0,198.5,198.5,0,0,0,0,0,46096,198.5,0,0,,,
2006,41,b) 1,6481,6587,41615,41940,30,0.4,1903,24.9,10940,285,10655,0.7,26.1,11589,7077,4512,16.9,27.6,-649,-1.5,52.2,0,1497,1497,5961
2006,41,c) 2,4971,5074,36861,38029,229,4.2,985,18,8231,1215,7016,3.2,21.6,10566,6093,4473,16,27.8,-2335,-6.2,43.2,0,736,736,5287
2006,41,d) 3,4298,4430,29871,30963,164,3.5,739,15.6,5728,815,4913,2.6,18.5,7911,4392,3519,14.2,25.5,-2183,-7,37,0,562,562,3743
2006,41,e) 4,3874,3992,31731,32160,140,3.3,600,14.1,5492,607,4885,1.9,17.1,6349,3408,2941,10.6,19.7,-857,-2.6,34.2,0,447,447,2781
2006,41,f) 5,3626,3760,31016,31071,161,4.1,483,12.3,5633,796,4837,2.6,18.1,5743,2308,3435,7.4,18.5,-110,-0.4,36.2,0,359,359,1828
2006,41,g) 6 to 10,14633,15596,159829,162105,623,3.9,1705,10.5,22172,3362,18810,2.1,13.7,26723,9401,17322,5.8,16.5,-4551,-2.8,27.4,0,1228,1228,7658
2006,41,h) 11 to 15,9989,10787,113103,114519,454,4.1,994,9,16425,3713,12712,3.2,14.3,19257,6921,12336,6,16.8,-2832,-2.5,28.6,0,674,674,5510
2006,41,i) 16 to 20,7054,8182,122857,121968,310,3.7,619,7.4,16760,4499,12261,3.7,13.7,14981,4491,10490,3.7,12.3,1779,1.4,24.6,0,408,408,3223
2006,41,j) 21 to 25,5227,6953,134893,133108,319,4.6,394,5.6,17759,4775,12984,3.6,13.3,14188,2973,11215,2.2,10.7,3571,2.6,21.4,0,255,255,2094
2006,41,k) 26+,3744,5496,107571,107265,234,4.2,363,6.5,12293,3378,8915,3.1,11.5,11680,4285,7395,4,10.9,613,0.6,21.8,0,213,213,2050
2006,41,l) Left Censored,7652,18464,602616,595905,1044,5.7,845,4.6,66889,18246,48643,3.1,11.2,53466,12557,40909,2.1,9,13423,2.2,18,0,247,247,3426
2006,42,a) 0,17503,17923,125555,63086,17799,198.6,0,0,124939,124939,0,198,198,0,0,0,0,0,124939,198,0,0,,,
2006,42,b) 1,13659,13884,107962,111567,69,0.4,3944,24.6,23813,991,22822,0.9,21.3,31022,18469,12553,16.6,27.8,-7209,-6.5,42.6,0,3117,3117,16686
2006,42,c) 2,11484,11699,90632,93794,444,3.5,2108,16.8,16532,1535,14997,1.6,17.6,22855,12581,10274,13.4,24.4,-6323,-6.8,35.2,0,1688,1688,10852
2006,42,d) 3,9828,10006,94212,95533,326,3.1,1557,14.6,16096,1793,14303,1.9,16.8,18738,9798,8940,10.3,19.6,-2642,-2.8,33.6,0,1221,1232,8512
2006,42,e) 4,9511,9797,103311,106812,300,2.9,1283,12.4,13291,2251,11040,2.1,12.4,20292,10318,9974,9.7,19,-7001,-6.6,24.8,0,950,950,8960
2006,42,f) 5,8654,8976,85744,85829,298,3.2,1065,11.4,13989,3159,10830,3.7,16.3,14158,6128,8030,7.1,16.5,-169,-0.2,32.6,0,814,814,5374
2006,42,g) 6 to 10,36097,38940,443698,445239,1279,3.2,3899,9.7,60351,10823,49528,2.4,13.6,63433,24111,39322,5.4,14.2,-3082,-0.6,27.2,0,2822,2823,19313
2006,42,h) 11 to 15,25261,27435,327411,328615,1002,3.6,2322,8.3,43911,11012,32899,3.4,13.4,46319,18191,28128,5.5,14.1,-2408,-0.7,26.8,0,1685,1686,13695
2006,42,i) 16 to 20,23199,26173,383873,383771,941,3.5,2084,7.8,49067,13481,35586,3.5,12.8,48863,18599,30264,4.8,12.7,204,0.1,25.4,0,1432,1437,11125
2006,42,j) 21 to 25,17474,22578,437065,441437,868,3.8,1441,6.3,43528,11712,31816,2.7,9.9,52271,15332,36939,3.5,11.8,-8743,-1.9,19.8,0,845,847,7694
2006,42,k) 26+,10938,16454,356549,354946,637,3.8,938,5.6,40128,13024,27104,3.7,11.3,36922,9275,27647,2.6,10.4,3206,0.9,20.8,0,496,496,5197
2006,42,l) Left Censored,31631,73515,2603611,2593747,3684,5,3583,4.9,258204,72440,185764,2.8,10,238475,67072,171403,2.6,9.2,19729,0.8,18.4,0,1276,1429,23742
2006,44,a) 0,2034,2080,10090,5056,2067,198.8,0,0,10069,10069,0,199.1,199.1,0,0,0,0,0,10069,199.1,0,0,,,
2006,44,b) 1,1518,1527,9990,10536,4,0.2,424,24.1,1964,10,1954,0.1,18.6,3055,1598,1457,15.2,29,-1091,-10.4,37.2,0,344,344,1285
2006,44,c) 2,1327,1339,10404,10474,56,3.8,299,20.4,2103,337,1766,3.2,20.1,2242,1199,1043,11.4,21.4,-139,-1.3,40.2,0,242,242,1039
2006,44,d) 3,1120,1130,8336,8661,49,4.1,172,14.4,1135,86,1049,1,13.1,1785,648,1137,7.5,20.6,-650,-7.5,26.2,0,132,132,509
2006,44,e) 4,1011,1020,7522,7639,34,3.2,123,11.5,1104,156,948,2,14.5,1337,648,689,8.5,17.5,-233,-3,29,0,90,90,407
2006,44,f) 5,908,928,6692,6996,36,3.7,138,14.1,939,102,837,1.5,13.4,1546,664,882,9.5,22.1,-607,-8.7,26.8,0,100,100,537
2006,44,g) 6 to 10,3760,3961,37699,38315,151,3.7,408,10,4775,518,4257,1.4,12.5,6007,1991,4016,5.2,15.7,-1232,-3.2,25,0,302,302,1482
2006,44,h) 11 to 15,2663,2758,29726,30393,87,3.1,208,7.4,3156,424,2732,1.4,10.4,4490,1485,3005,4.9,14.8,-1334,-4.4,20.8,0,151,151,1199
2006,44,i) 16 to 20,2480,2679,38623,39074,73,2.7,184,6.7,3999,739,3260,1.9,10.2,4901,1480,3421,3.8,12.5,-902,-2.3,20.4,0,128,133,1173
2006,44,j) 21 to 25,1677,1979,34200,33057,77,3.8,126,6.3,5457,2634,2823,8,16.5,3170,764,2406,2.3,9.6,2287,6.9,19.2,0,87,87,391
2006,44,k) 26+,1118,1453,27063,27347,67,4.6,99,6.7,2854,1197,1657,4.4,10.4,3422,787,2635,2.9,12.5,-568,-2.1,20.8,0,65,65,631
2006,44,l) Left Censored,3697,6132,216446,217866,373,6.1,369,6,23210,7164,16046,3.3,10.7,26050,5740,20310,2.6,12,-2840,-1.3,21.4,0,102,102,858
2006,45,a) 0,7758,7855,48950,24538,7800,198.6,0,0,48825,48825,0,199,199,0,0,0,0,0,48825,199,0,0,,,
2006,45,b) 1,5819,5939,45418,46057,46,0.7,1616,23.7,12076,488,11588,1.1,26.2,13354,8323,5031,18.1,29,-1278,-2.8,52.4,0,1309,1309,7182
2006,45,c) 2,4576,4660,38265,39181,140,2.8,924,18.2,7497,570,6927,1.5,19.1,9329,4606,4723,11.8,23.8,-1832,-4.7,38.2,0,744,744,4075
2006,45,d) 3,4023,4118,43094,43044,157,3.6,665,15.2,8207,1059,7148,2.5,19.1,8106,3702,4404,8.6,18.8,101,0.3,37.6,0,530,530,3215
2006,45,e) 4,3671,3795,32702,33025,137,3.4,532,13.3,5772,649,5123,2,17.5,6418,3122,3296,9.5,19.4,-646,-1.9,35,0,413,414,2436
2006,45,f) 5,3244,3404,39319,39217,118,3.3,418,11.7,5717,967,4750,2.5,14.6,5512,1955,3557,5,14.1,205,0.5,28.2,0,321,321,1665
2006,45,g) 6 to 10,13421,14411,167983,169477,538,3.6,1459,9.8,26435,4616,21819,2.7,15.6,29422,12069,17353,7.1,17.4,-2987,-1.8,31.2,0,1057,1057,9531
2006,45,h) 11 to 15,8410,9275,124504,125043,318,3.3,838,8.8,17201,3104,14097,2.5,13.8,18280,6210,12070,5,14.6,-1079,-0.8,27.6,0,589,589,4412
2006,45,i) 16 to 20,6561,8124,128064,127991,336,4.1,605,7.3,17704,4923,12781,3.8,13.8,17558,4795,12763,3.7,13.7,146,0.1,27.4,0,389,389,2885
2006,45,j) 21 to 25,5387,6776,114420,113984,257,3.7,473,6.9,12596,2844,9752,2.5,11.1,11725,2612,9113,2.3,10.3,871,0.8,20.6,0,268,268,1516
2006,45,k) 26+,3111,5276,109331,106510,248,4.7,341,6.4,15873,4799,11074,4.5,14.9,10230,3919,6311,3.7,9.6,5643,5.3,19.2,0,165,167,1262
2006,45,l) Left Censored,8162,21495,733112,727201,1236,5.8,991,4.6,76695,23865,52830,3.3,10.5,64872,15020,49852,2.1,8.9,11823,1.6,17.8,0,292,299,2690
2006,46,a) 0,1900,1919,9590,4829,1894,197.4,0,0,9523,9523,0,197.2,197.2,0,0,0,0,0,9523,197.2,0,0,,,
2006,46,b) 1,1305,1326,7047,7453,7,0.4,452,28.5,1752,46,1706,0.6,23.5,2564,1747,817,23.4,34.4,-812,-10.9,47,0,323,323,1383
2006,46,c) 2,1139,1151,6713,6715,60,4.8,220,17.8,1618,123,1495,1.8,24.1,1621,828,793,12.3,24.1,-3,0,48.2,0,160,160,699
2006,46,d) 3,1006,1021,6315,6619,35,3.2,166,15.2,1047,161,886,2.4,15.8,1655,582,1073,8.8,25,-608,-9.2,31.6,0,114,114,435
2006,46,e) 4,1023,1040,7399,7543,39,3.5,161,14.6,1147,175,972,2.3,15.2,1434,651,783,8.6,19,-287,-3.8,30.4,0,106,106,467
2006,46,f) 5,824,861,5849,6251,36,4,112,12.4,686,77,609,1.2,11,1489,687,802,11,23.8,-803,-12.8,22,0,68,68,326
2006,46,g) 6 to 10,3488,3644,30658,30952,148,3.9,389,10.3,4041,527,3514,1.7,13.1,4628,2013,2615,6.5,15,-587,-1.9,26.2,0,266,266,1764
2006,46,h) 11 to 15,2451,2585,25489,25687,95,3.6,272,10.2,3150,786,2364,3.1,12.3,3545,1356,2189,5.3,13.8,-395,-1.5,24.6,0,164,164,1018
2006,46,i) 16 to 20,1712,1869,25839,26176,75,3.9,186,9.6,3563,859,2704,3.3,13.6,4236,894,3342,3.4,16.2,-673,-2.6,27.2,0,94,94,478
2006,46,j) 21 to 25,1428,1756,20470,20426,40,2.2,131,7.3,2145,209,1936,1,10.5,2057,676,1381,3.3,10.1,88,0.4,20.2,0,60,60,293
2006,46,k) 26+,996,1346,20470,20328,57,4.2,90,6.6,2049,561,1488,2.8,10.1,1765,357,1408,1.8,8.7,284,1.4,17.4,0,45,45,180
2006,46,l) Left Censored,2837,5156,155277,152359,238,4.6,250,4.8,15297,3555,11742,2.3,10,9461,2366,7095,1.6,6.2,5836,3.8,12.4,0,94,95,1027
2006,47,a) 0,9020,9193,65646,32910,9126,198.5,0,0,65473,65473,0,198.9,198.9,0,0,0,0,0,65473,198.9,0,0,,,
2006,47,b) 1,6741,6874,61912,60769,50,0.6,2001,25.2,19696,503,19193,0.8,32.4,17410,9619,7791,15.8,28.6,2286,3.8,57.2,0,1671,1675,8625
2006,47,c) 2,5448,5551,50209,50288,193,3.2,1160,19.1,10834,1024,9810,2,21.5,10991,6061,4930,12.1,21.9,-157,-0.4,43,0,960,965,5483
2006,47,d) 3,4672,4781,45653,45365,171,3.4,764,15,8447,966,7481,2.1,18.6,7870,3539,4331,7.8,17.3,577,1.3,34.6,0,622,622,3038
2006,47,e) 4,4086,4287,46135,46165,163,3.6,617,13.7,8613,1103,7510,2.4,18.7,8673,3981,4692,8.6,18.8,-60,-0.1,37.4,0,483,483,2721
2006,47,f) 5,3563,3713,38551,39025,112,2.8,527,13.4,5992,823,5169,2.1,15.4,6939,3711,3228,9.5,17.8,-947,-2.4,30.8,0,415,415,3214
2006,47,g) 6 to 10,15640,17215,226695,223645,659,3.7,1859,10.4,37982,6192,31790,2.8,17,31881,11664,20217,5.2,14.3,6101,2.7,28.6,0,1332,1337,9049
2006,47,h) 11 to 15,11125,12445,170519,168112,470,3.7,1138,8.9,27117,6008,21109,3.6,16.1,22302,8734,13568,5.2,13.3,4815,2.8,26.6,0,797,797,6551
2006,47,i) 16 to 20,8895,10855,204007,202650,452,4.1,801,7.3,26358,6773,19585,3.3,13,23644,5515,18129,2.7,11.7,2714,1.3,23.4,0,514,514,3271
2006,47,j) 21 to 25,7649,9703,176282,175028,374,3.8,589,6,21932,7959,13973,4.5,12.5,19423,5385,14038,3.1,11.1,2509,1.4,22.2,0,329,331,3046
2006,47,k) 26+,4558,8043,199353,194312,577,7.2,462,5.8,35034,12335,22699,6.3,18,24951,7371,17580,3.8,12.8,10083,5.2,25.6,0,214,221,2136
2006,47,l) Left Censored,11574,31264,1179949,1172673,1952,6.3,1829,5.9,122894,38227,84667,3.3,10.5,108342,28582,79760,2.4,9.2,14552,1.3,18.4,0,423,427,4337
2006,48,a) 0,37852,38776,274334,137892,38415,198.1,0,0,272885,272885,0,197.9,197.9,0,0,0,0,0,272885,197.9,0,0,,,
2006,48,b) 1,27856,28796,274526,279213,275,0.8,8428,25.3,75874,2819,73055,1,27.2,85247,50439,34808,18.1,30.5,-9373,-3.3,54.4,0,6805,6805,43120
2006,48,c) 2,23143,23571,220615,222252,808,3.2,4749,18.5,50095,4991,45104,2.2,22.5,53369,30660,22709,13.8,24,-3274,-1.5,45,0,3858,3858,26749
2006,48,d) 3,19778,20365,205535,210446,712,3.3,3524,16.2,45137,4987,40150,2.4,21.4,54959,25799,29160,12.3,26.1,-9822,-4.7,42.8,0,2826,2826,22317
2006,48,e) 4,17522,18414,211334,213186,662,3.4,2617,13.5,39088,5223,33865,2.4,18.3,42792,22506,20286,10.6,20.1,-3704,-1.8,36.6,0,2072,2074,19239
2006,48,f) 5,15462,16351,188742,187059,564,3.3,2196,12.8,34765,3821,30944,2,18.6,31398,13895,17503,7.4,16.8,3367,1.8,33.6,0,1712,1737,11406
2006,48,g) 6 to 10,62086,68135,896955,894691,2656,3.8,7310,10.3,154875,33366,121509,3.7,17.3,150346,56258,94088,6.3,16.8,4529,0.5,33.6,0,5439,5445,44936
2006,48,h) 11 to 15,41856,46776,656323,652311,1858,3.9,4400,9.1,106067,20435,85632,3.1,16.3,98042,36804,61238,5.6,15,8025,1.3,30,0,3098,3119,24497
2006,48,i) 16 to 20,30009,37274,702052,699145,1788,4.7,2868,7.6,98490,26462,72028,3.8,14.1,92678,27455,65223,3.9,13.3,5812,0.8,26.6,0,1788,1791,14408
2006,48,j) 21 to 25,28137,37239,667620,663125,1364,3.6,2323,6.2,84792,19632,65160,3,12.8,75801,23199,52602,3.5,11.4,8991,1.4,22.8,0,1380,1398,11284
2006,48,k) 26+,13167,23129,539128,524868,1408,6.1,1380,6,82155,33548,48607,6.4,15.7,53634,14187,39447,2.7,10.2,28521,5.5,20.4,0,682,686,4385
2006,48,l) Left Censored,28936,101797,3746535,3692718,7976,7.9,6069,6,488725,158846,329879,4.3,13.2,381091,111935,269156,3,10.3,107634,2.9,20.6,0,1228,1248,14443
2006,49,a) 0,6906,7023,39995,20104,6961,198.2,0,0,39782,39782,0,197.9,197.9,0,0,0,0,0,39782,197.9,0,0,,,
2006,49,b) 1,4599,4654,35018,35580,28,0.5,1435,26.4,9542,323,9219,0.9,26.8,10665,6585,4080,18.5,30,-1123,-3.2,53.6,0,1101,1101,5638
2006,49,c) 2,3640,3695,34662,33986,199,5,776,19.4,8968,1245,7723,3.7,26.4,7616,4447,3169,13.1,22.4,1352,4,44.8,0,589,589,3568
2006,49,d) 3,3194,3240,33627,33568,157,4.6,524,15.2,6086,557,5529,1.7,18.1,5967,2350,3617,7,17.8,119,0.3,35.6,0,395,395,1950
2006,49,e) 4,2793,2878,29706,28840,127,4.2,398,13.2,7256,1064,6192,3.7,25.2,5524,2742,2782,9.5,19.2,1732,6,38.4,0,296,296,2386
2006,49,f) 5,2355,2446,24607,24544,101,4,314,12.3,4712,315,4397,1.3,19.2,4586,2228,2358,9.1,18.7,126,0.5,37.4,0,229,231,1831
2006,49,g) 6 to 10,8730,9194,118693,116818,450,4.8,946,10,19681,3795,15886,3.2,16.8,15930,6356,9574,5.4,13.6,3751,3.2,27.2,0,660,660,5036
2006,49,h) 11 to 15,4935,5319,86252,86513,216,4,471,8.6,10634,1615,9019,1.9,12.3,11156,3602,7554,4.2,12.9,-522,-0.6,24.6,0,333,333,3071
2006,49,i) 16 to 20,3037,3623,72970,72317,163,4.4,265,7.2,10540,1411,9129,2,14.6,9233,2806,6427,3.9,12.8,1307,1.8,25.6,0,171,171,1864
2006,49,j) 21 to 25,2315,3176,68741,69145,183,5.8,189,5.9,9011,3126,5885,4.5,13,9818,1849,7969,2.7,14.2,-807,-1.2,26,0,120,120,1338
2006,49,k) 26+,1744,2580,61131,59735,153,5.9,139,5.4,8259,3179,5080,5.3,13.8,5466,1390,4076,2.3,9.2,2793,4.6,18.4,0,61,82,810
2006,49,l) Left Censored,3887,10415,429381,420715,809,7.8,614,5.9,56561,17801,38760,4.2,13.4,39228,12704,26524,3,9.3,17333,4.1,18.6,0,141,160,1749
2006,50,a) 0,1354,1371,6578,3301,1357,198,0,0,6554,6554,0,198.5,198.5,0,0,0,0,0,6554,198.5,0,0,,,
2006,50,b) 1,988,992,5772,6166,0,0,307,26.5,1086,0,1086,0,17.6,1873,1195,678,19.4,30.4,-787,-12.8,35.2,0,235,235,1000
2006,50,c) 2,914,924,5347,5867,47,4.8,146,14.9,857,81,776,1.4,14.6,1896,892,1004,15.2,32.3,-1039,-17.7,29.2,0,105,105,812
2006,50,d) 3,798,808,5025,5257,32,3.7,143,16.6,686,65,621,1.2,13,1150,622,528,11.8,21.9,-464,-8.9,26,0,117,117,569
2006,50,e) 4,724,736,5161,5277,27,3.5,91,11.9,623,70,553,1.3,11.8,855,323,532,6.1,16.2,-232,-4.4,23.6,0,67,67,264
2006,50,f) 5,676,686,4498,4601,25,3.5,74,10.4,628,58,570,1.3,13.6,833,309,524,6.7,18.1,-205,-4.5,27.2,0,55,55,255
2006,50,g) 6 to 10,2978,3122,26799,27012,100,3.1,324,10,3230,326,2904,1.2,12,3655,1159,2496,4.3,13.5,-425,-1.5,24,0,226,226,954
2006,50,h) 11 to 15,2143,2278,20339,20620,83,3.5,201,8.6,2222,288,1934,1.4,10.8,2783,940,1843,4.6,13.5,-561,-2.7,21.6,0,133,133,801
2006,50,i) 16 to 20,2085,2205,22978,23067,73,3.2,189,8.3,2227,398,1829,1.7,9.7,2404,741,1663,3.2,10.4,-177,-0.7,19.4,0,123,123,575
2006,50,j) 21 to 25,1449,1758,30870,30647,61,3.4,99,5.6,3094,608,2486,2,10.1,2648,798,1850,2.6,8.6,446,1.5,17.2,0,66,68,443
2006,50,k) 26+,836,1122,19169,18835,44,3.9,65,5.7,2228,885,1343,4.7,11.8,1559,252,1307,1.3,8.3,669,3.5,16.6,0,43,43,190
2006,50,l) Left Censored,2184,3865,110082,110573,172,4.4,191,4.9,8564,1769,6795,1.6,7.7,9546,2305,7241,2.1,8.6,-982,-0.9,15.4,0,73,77,653
2006,51,a) 0,14556,14834,86511,43518,14721,198.5,0,0,85987,85987,0,197.6,197.6,0,0,0,0,0,85987,197.6,0,0,,,
2006,51,b) 1,10760,10858,83267,82701,50,0.4,3042,24.3,22339,647,21692,0.8,27,21206,12202,9004,14.8,25.6,1133,1.4,51.2,0,2417,2417,10179
2006,51,c) 2,8837,8936,71403,71578,328,3.4,1689,17.5,14857,1245,13612,1.7,20.8,15206,7181,8025,10,21.2,-349,-0.4,41.6,0,1340,1340,6174
2006,51,d) 3,7140,7235,59642,60638,246,3.2,1227,15.8,12276,1138,11138,1.9,20.2,14268,7071,7197,11.7,23.5,-1992,-3.3,40.4,0,981,981,6094
2006,51,e) 4,6607,6804,63459,61782,234,3.3,916,12.8,13803,1633,12170,2.6,22.3,10448,4728,5720,7.7,16.9,3355,5.4,33.8,0,693,693,3798
2006,51,f) 5,5770,6103,60620,60067,206,3.2,719,11.3,11276,1000,10276,1.7,18.8,10170,4642,5528,7.7,16.9,1106,1.9,33.8,0,545,545,3782
2006,51,g) 6 to 10,24119,26027,304402,301680,1024,3.8,2604,9.7,51184,8315,42869,2.8,17,45739,17465,28274,5.8,15.2,5445,1.8,30.4,0,1907,1907,13508
2006,51,h) 11 to 15,16472,17900,243900,246093,600,3.3,1523,8.3,32102,6170,25932,2.5,13,36487,13397,23090,5.4,14.8,-4385,-1.8,26,0,1085,1085,8990
2006,51,i) 16 to 20,13209,15489,263745,261018,644,4.1,1055,6.7,34397,8786,25611,3.4,13.2,28942,7709,21233,3,11.1,5455,2.1,22.2,0,704,704,5077
2006,51,j) 21 to 25,9829,12870,258169,257420,483,3.7,691,5.3,28557,7002,21555,2.7,11.1,27058,6021,21037,2.3,10.5,1499,0.6,21,0,404,404,3138
2006,51,k) 26+,5647,9171,199046,198379,488,5.3,510,5.6,26464,9018,17446,4.5,13.3,25130,7974,17156,4,12.7,1334,0.6,25.4,0,251,251,1679
2006,51,l) Left Censored,14155,41080,1460124,1444172,2930,7.2,2059,5.1,182037,55318,126719,3.8,12.6,150134,39089,111045,2.7,10.4,31903,2.2,20.8,0,488,502,6894
2006,53,a) 0,15211,15434,80466,40425,15264,197.8,0,0,80082,80082,0,198.1,198.1,0,0,0,0,0,80082,198.1,0,0,,,
2006,53,b) 1,10470,10605,67721,68645,54,0.4,3424,27.4,18202,671,17531,1,26.5,20050,12636,7414,18.4,29.2,-1848,-2.7,53,0,2571,2571,10071
2006,53,c) 2,8239,8339,58346,59031,341,3.8,1712,18.9,12440,1507,10933,2.6,21.1,13810,7073,6737,12,23.4,-1370,-2.3,42.2,0,1338,1338,5992
2006,53,d) 3,7037,7129,53747,54146,310,4.1,1271,16.7,10649,1048,9601,1.9,19.7,11446,5847,5599,10.8,21.1,-797,-1.4,39.4,0,951,951,4798
2006,53,e) 4,6510,6702,56348,56575,239,3.4,966,13.7,10601,1192,9409,2.1,18.7,11055,4833,6222,8.5,19.5,-454,-0.8,37.4,0,719,719,4009
2006,53,f) 5,5786,5975,53228,52711,224,3.6,793,12.7,9490,830,8660,1.6,18,8455,3603,4852,6.8,16,1035,2,32,0,578,580,2928
2006,53,g) 6 to 10,23585,25293,256451,254194,1112,4.2,2845,10.9,43341,6152,37189,2.4,17.1,38826,15885,22941,6.2,15.3,4515,1.8,30.6,0,1969,1969,11902
2006,53,h) 11 to 15,15638,16899,192746,191281,727,4.2,1681,9.7,30757,5098,25659,2.7,16.1,27827,11175,16652,5.8,14.5,2930,1.6,29,0,1152,1152,8497
2006,53,i) 16 to 20,11129,12871,205101,205199,576,4.4,1087,8.3,25245,5397,19848,2.6,12.3,25440,9322,16118,4.5,12.4,-195,-0.1,24.6,0,704,704,5601
2006,53,j) 21 to 25,8486,11335,231980,226680,468,4.1,692,6,32611,9293,23318,4.1,14.4,22010,5307,16703,2.3,9.7,10601,4.7,19.4,0,400,400,3391
2006,53,k) 26+,5454,8120,167830,166153,366,4.4,570,6.9,21249,6631,14618,4,12.8,17894,6940,10954,4.2,10.8,3355,2,21.6,0,321,321,3407
2006,53,l) Left Censored,11406,29344,987247,983963,1749,6,1446,4.9,115568,31440,84128,3.2,11.7,108999,21831,87168,2.2,11.1,6569,0.6,22.2,0,396,399,4553
2006,54,a) 0,2399,2464,16983,8519,2436,197.7,0,0,16929,16929,0,198.7,198.7,0,0,0,0,0,16929,198.7,0,0,,,
2006,54,b) 1,1871,1901,14417,14165,14,0.6,544,24.7,3889,114,3775,0.8,27.5,3384,1760,1624,12.4,23.9,505,3.6,47.8,0,431,431,1480
2006,54,c) 2,1510,1545,11195,11476,61,3.7,294,17.6,2273,194,2079,1.7,19.8,2834,1361,1473,11.9,24.7,-561,-4.9,39.6,0,243,243,1221
2006,54,d) 3,1205,1244,10501,10830,45,3.4,216,16.2,1757,315,1442,2.9,16.2,2415,1015,1400,9.4,22.3,-658,-6.1,32.4,0,170,170,917
2006,54,e) 4,1141,1175,10484,10569,33,2.6,183,14.6,1869,125,1744,1.2,17.7,2038,889,1149,8.4,19.3,-169,-1.6,35.4,0,146,146,705
2006,54,f) 5,1025,1057,10078,10205,45,4,154,13.8,1918,176,1742,1.7,18.8,2171,1150,1021,11.3,21.3,-253,-2.5,37.6,0,120,120,1073
2006,54,g) 6 to 10,4643,5076,48655,49205,164,3.1,578,10.9,6875,1266,5609,2.6,14,7975,3273,4702,6.7,16.2,-1100,-2.2,28,0,422,422,2634
2006,54,h) 11 to 15,3463,3758,37535,37472,149,3.8,364,9.4,6133,1357,4776,3.6,16.4,6006,2151,3855,5.7,16,127,0.4,32,0,255,255,1487
2006,54,i) 16 to 20,2828,3145,47790,47894,96,2.9,302,9.3,5744,960,4784,2,12,5951,1971,3980,4.1,12.4,-207,-0.4,24,0,209,209,1667
2006,54,j) 21 to 25,2562,3061,49450,48318,97,3.1,215,6.9,6615,1669,4946,3.5,13.7,4351,1062,3289,2.2,9,2264,4.7,18,0,116,116,806
2006,54,k) 26+,1586,2645,44544,43996,102,3.8,191,7.1,5971,1568,4403,3.6,13.6,4875,1359,3516,3.1,11.1,1096,2.5,22.2,0,84,84,385
2006,54,l) Left Censored,4805,10136,278444,278050,479,4.7,549,5.4,27344,8197,19147,2.9,9.8,26555,7317,19238,2.6,9.6,789,0.2,19.2,0,191,198,1571
2006,55,a) 0,8936,9179,59360,29797,9099,198.3,0,0,59126,59126,0,198.4,198.4,0,0,0,0,0,59126,198.4,0,0,,,
2006,55,b) 1,6713,6777,47534,50113,47,0.6,1919,24.5,10612,504,10108,1,21.2,15769,10096,5673,20.1,31.5,-5157,-10.3,42.4,0,1462,1462,8729
2006,55,c) 2,5485,5554,46884,47863,191,3.2,1089,18.1,7780,547,7233,1.1,16.3,9737,4535,5202,9.5,20.3,-1957,-4,32.6,0,814,814,3681
2006,55,d) 3,4905,5016,41902,41936,186,3.5,814,15.2,7605,1322,6283,3.2,18.1,7673,3477,4196,8.3,18.3,-68,-0.2,36.2,0,621,621,2950
2006,55,e) 4,4812,4944,43595,44705,175,3.4,711,13.6,6548,832,5716,1.9,14.6,8768,4078,4690,9.1,19.6,-2220,-5,29.2,0,527,527,2897
2006,55,f) 5,4168,4381,44531,45217,129,2.8,566,12.3,6713,1050,5663,2.3,14.8,8084,3265,4819,7.2,17.9,-1371,-3.1,29.6,0,422,422,2841
2006,55,g) 6 to 10,18291,19634,210432,211671,663,3.3,2095,10.3,27583,3933,23650,1.9,13,30061,10947,19114,5.2,14.2,-2478,-1.2,26,0,1444,1445,8520
2006,55,h) 11 to 15,13476,14530,164839,165674,527,3.5,1314,8.8,21762,5705,16057,3.4,13.1,23432,8261,15171,5,14.1,-1670,-1,26.2,0,854,854,6486
2006,55,i) 16 to 20,10952,12700,195505,197136,422,3.2,1018,7.8,21510,3572,17938,1.8,10.9,24772,7594,17178,3.9,12.6,-3262,-1.7,21.8,0,659,659,5069
2006,55,j) 21 to 25,7836,9851,169813,171277,365,3.7,613,6.1,18511,5302,13209,3.1,10.8,21438,7002,14436,4.1,12.5,-2927,-1.7,21.6,0,376,378,4179
2006,55,k) 26+,5220,8048,172246,173463,278,3.4,581,7.1,17198,4469,12729,2.6,9.9,19631,6150,13481,3.5,11.3,-2433,-1.4,19.8,0,250,250,2516
2006,55,l) Left Censored,15366,33054,1282575,1281855,1720,5.2,1522,4.6,121457,34633,86824,2.7,9.5,120016,24958,95058,1.9,9.4,1441,0.1,18.8,0,558,561,8686
2006,56,a) 0,1687,1717,8621,4350,1686,196.4,0,0,8542,8542,0,196.4,196.4,0,0,0,0,0,8542,196.4,0,0,,,
2006,56,b) 1,1160,1168,6894,6680,5,0.4,325,24.1,2204,10,2194,0.1,33,1776,1066,710,16,26.6,428,6.4,53.2,0,249,249,884
2006,56,c) 2,905,916,5018,5236,47,4.7,191,19.2,967,150,817,2.9,18.5,1403,671,732,12.8,26.8,-436,-8.3,37,0,141,141,537
2006,56,d) 3,802,805,5218,5353,32,3.7,150,17.3,880,66,814,1.2,16.4,1150,583,567,10.9,21.5,-270,-5.1,32.8,0,112,112,457
2006,56,e) 4,832,841,6256,6485,31,3.5,133,14.9,1035,120,915,1.9,16,1493,878,615,13.5,23,-458,-7,32,0,103,103,676
2006,56,f) 5,675,682,4888,4973,28,3.9,84,11.8,757,88,669,1.8,15.2,926,340,586,6.8,18.6,-169,-3.4,30.4,0,51,51,237
2006,56,g) 6 to 10,2825,2957,22610,22856,114,3.7,310,10.1,3498,525,2973,2.3,15.3,3990,1498,2492,6.6,17.5,-492,-2.2,30.6,0,203,203,1147
2006,56,h) 11 to 15,1766,1837,16881,16981,59,3.1,162,8.6,2320,235,2085,1.4,13.7,2519,668,1851,3.9,14.8,-199,-1.1,27.4,0,113,113,517
2006,56,i) 16 to 20,1217,1367,19616,19380,70,5,100,7.2,2477,286,2191,1.5,12.8,2004,718,1286,3.7,10.3,473,2.5,20.6,0,72,72,667
2006,56,j) 21 to 25,1099,1299,17370,17107,43,3.2,104,7.8,2321,329,1992,1.9,13.6,1795,710,1085,4.2,10.5,526,3.1,21,0,55,55,277
2006,56,k) 26+,802,1119,17865,17454,54,4.8,65,5.8,2380,859,1521,4.9,13.6,1557,351,1206,2,8.9,823,4.7,17.8,0,39,39,248
2006,56,l) Left Censored,1728,3201,70941,68415,169,5.2,226,7,10251,3557,6694,5.2,15,5199,1654,3545,2.4,7.6,5052,7.4,15.2,0,55,59,676
2007,01,a) 0,6798,6888,43244,21969,6738,195.6,0,0,42551,42551,0,193.7,193.7,0,0,0,0,0,42551,193.7,0,0,,,
2007,01,b) 1,5160,5338,45109,47566,43,0.7,1541,25,13238,1912,11326,4,27.8,18152,8588,9564,18.1,38.2,-4914,-10.4,55.6,0,1278,1306,7727
2007,01,c) 2,4379,4509,40641,41686,172,3.6,817,17,7653,1174,6479,2.8,18.4,9742,4012,5730,9.6,23.4,-2089,-5,36.8,0,675,675,3410
2007,01,d) 3,3808,3890,34927,35939,130,3.2,602,14.6,6140,536,5604,1.5,17.1,8163,3879,4284,10.8,22.7,-2023,-5.6,34.2,0,504,504,3561
2007,01,e) 4,3402,3605,33051,33031,166,4.5,426,11.5,6080,1083,4997,3.3,18.4,6040,2643,3397,8,18.3,40,0.1,36.6,0,350,351,2154
2007,01,f) 5,3046,3171,29824,30901,120,3.7,336,10.3,3983,763,3220,2.5,12.9,6136,2497,3639,8.1,19.9,-2153,-7,25.8,0,258,258,1686
2007,01,g) 6 to 10,12496,13493,166423,167454,499,3.6,1390,10,27444,5006,22438,3,16.4,29506,9707,19799,5.8,17.6,-2062,-1.2,32.8,0,1012,1024,6041
2007,01,h) 11 to 15,9057,9803,118972,120366,309,3.1,825,8.2,16155,1958,14197,1.6,13.4,18943,7036,11907,5.8,15.7,-2788,-2.3,26.8,0,578,591,3340
2007,01,i) 16 to 20,6753,8135,153814,155880,323,3.9,552,6.7,17596,3389,14207,2.2,11.3,21728,5221,16507,3.3,13.9,-4132,-2.6,22.6,0,340,343,2306
2007,01,j) 21 to 25,5901,7590,143285,143875,377,4.9,462,6.1,19191,5085,14106,3.5,13.3,20370,6013,14357,4.2,14.2,-1179,-0.9,26.6,0,227,230,1536
2007,01,k) 26+,4294,7172,145818,144526,370,5.2,376,5.2,20140,4991,15149,3.5,13.9,17556,4079,13477,2.8,12.1,2584,1.8,24.2,0,184,188,1738
2007,01,l) Left Censored,8521,23305,764234,765488,1874,8.1,1485,6.4,94118,34532,59586,4.5,12.3,96625,27638,68987,3.6,12.6,-2507,-0.3,24.6,0,290,315,3782
2007,02,a) 0,1312,1324,6176,3177,1263,190.8,0,0,5999,5999,0,188.8,188.8,0,0,0,0,0,5999,188.8,0,0,,,
2007,02,b) 1,974,1006,6066,6253,16,1.3,354,29.7,1656,229,1427,3.7,26.5,2029,1009,1020,16.1,32.4,-373,-5.9,53,0,233,233,650
2007,02,c) 2,769,778,4761,4968,42,5.1,142,17.3,1186,466,720,9.4,23.9,1599,704,895,14.2,32.2,-413,-8.3,47.8,0,102,102,574
2007,02,d) 3,736,754,4700,4948,40,5,134,16.8,878,152,726,3.1,17.7,1373,504,869,10.2,27.7,-495,-10,35.4,0,91,91,357
2007,02,e) 4,640,684,5307,5245,31,4.3,113,15.7,1191,188,1003,3.6,22.7,1066,485,581,9.2,20.3,125,2.4,40.6,0,73,73,344
2007,02,f) 5,635,662,5460,6009,30,4.3,115,16.4,761,73,688,1.2,12.7,1858,706,1152,11.7,30.9,-1097,-18.2,25.4,0,78,78,491
2007,02,g) 6 to 10,2435,2594,29107,29571,144,5.4,288,10.8,4182,704,3478,2.4,14.1,5109,1448,3661,4.9,17.3,-927,-3.2,28.2,0,165,167,928
2007,02,h) 11 to 15,1604,1679,13361,13719,74,4.3,186,10.7,2012,272,1740,2,14.7,2727,955,1772,7,19.9,-715,-5.2,29.4,0,110,111,529
2007,02,i) 16 to 20,1233,1350,19836,20300,45,3.2,125,9,2431,226,2205,1.1,12,3358,568,2790,2.8,16.5,-927,-4.5,24,0,70,71,285
2007,02,j) 21 to 25,1168,1441,20820,21285,58,3.9,129,8.7,2626,779,1847,3.7,12.3,3555,1277,2278,6,16.7,-929,-4.4,24.6,0,59,63,381
2007,02,k) 26+,841,1418,33272,32908,81,5.7,100,7,8028,4355,3673,13.2,24.4,7300,1113,6187,3.4,22.2,728,2.2,44.4,0,33,35,237
2007,02,l) Left Censored,1331,3267,93415,92237,225,6.9,176,5.4,13760,2679,11081,2.9,14.9,11403,2544,8859,2.8,12.4,2357,2.5,24.8,0,30,31,196
2007,04,a) 0,11972,12062,70818,36059,11748,194.8,0,0,69518,69518,0,192.8,192.8,0,0,0,0,0,69518,192.8,0,0,,,
2007,04,b) 1,9644,9863,78559,82268,114,1,2881,25.3,21791,3477,18314,4.2,26.5,29209,17482,11727,21.3,35.5,-7418,-9,53,0,2272,2272,14125
2007,04,c) 2,7413,7659,68702,73131,319,3.9,1447,17.6,13475,2487,10988,3.4,18.4,22332,10556,11776,14.4,30.5,-8857,-12.1,36.8,0,1154,1154,9110
2007,04,d) 3,6089,6290,61686,64511,239,3.6,948,14.3,10819,1568,9251,2.4,16.8,16469,7663,8806,11.9,25.5,-5650,-8.7,33.6,0,750,754,6246
2007,04,e) 4,5144,5448,59677,60353,245,4.3,767,13.5,12727,2329,10398,3.9,21.1,14079,6147,7932,10.2,23.3,-1352,-2.2,42.2,0,586,587,4684
2007,04,f) 5,4514,4635,53683,56488,145,3,586,12.1,7455,737,6718,1.3,13.2,13064,4940,8124,8.7,23.1,-5609,-9.9,26.4,0,454,454,3057
2007,04,g) 6 to 10,17242,18491,285194,288797,844,4.4,2107,11,48578,10351,38227,3.6,16.8,55784,18837,36947,6.5,19.3,-7206,-2.5,33.6,0,1433,1443,11401
2007,04,h) 11 to 15,10346,11401,174505,179407,487,4.2,1107,9.5,23308,5214,18094,2.9,13,33111,9179,23932,5.1,18.5,-9803,-5.5,26,0,709,709,5562
2007,04,i) 16 to 20,7167,9638,199049,199054,542,5.6,743,7.6,31697,7741,23956,3.9,15.9,31707,9061,22646,4.6,15.9,-10,0,31.8,0,393,399,3666
2007,04,j) 21 to 25,5687,8242,181562,182477,488,5.8,685,8.2,27956,6393,21563,3.5,15.3,29786,5575,24211,3.1,16.3,-1830,-1,30.6,0,294,304,2846
2007,04,k) 26+,3991,6827,211122,201195,519,7.6,462,6.8,45594,12782,32812,6.4,22.7,25740,6044,19696,3,12.8,19854,9.9,25.6,0,196,212,1997
2007,04,l) Left Censored,6347,23386,933220,919659,2439,10.6,1747,7.6,157374,44548,112826,4.8,17.1,130251,38723,91528,4.2,14.2,27123,2.9,28.4,0,197,218,1609
2007,05,a) 0,4360,4377,25170,12706,4278,195.5,0,0,24928,24928,0,196.2,196.2,0,0,0,0,0,24928,196.2,0,0,,,
2007,05,b) 1,3481,3672,26551,27984,33,0.8,1097,25.8,6405,743,5662,2.7,22.9,9271,5234,4037,18.7,33.1,-2866,-10.2,45.8,0,901,901,4475
2007,05,c) 2,2960,3027,22087,22760,127,3.9,591,18.1,4306,765,3541,3.4,18.9,5651,2683,2968,11.8,24.8,-1345,-5.9,37.8,0,470,470,2270
2007,05,d) 3,2517,2605,19312,20274,92,3.3,435,15.7,3213,551,2662,2.7,15.8,5136,2111,3025,10.4,25.3,-1923,-9.5,31.6,0,345,345,1664
2007,05,e) 4,2285,2401,19919,20167,71,2.8,305,12.1,4239,899,3340,4.5,21,4735,2183,2552,10.8,23.5,-496,-2.5,42,0,250,250,1987
2007,05,f) 5,2097,2224,20404,20816,73,3.1,275,11.9,3364,1061,2303,5.1,16.2,4188,1911,2277,9.2,20.1,-824,-3.9,32.4,0,219,219,1565
2007,05,g) 6 to 10,8075,8767,75737,77749,358,4,889,9.9,11077,2162,8915,2.8,14.2,15100,6037,9063,7.8,19.4,-4023,-5.2,28.4,0,637,642,4265
2007,05,h) 11 to 15,5897,6445,71518,72093,204,3.1,557,8.4,9420,1747,7673,2.4,13.1,10570,2657,7913,3.7,14.7,-1150,-1.6,26.2,0,391,392,1833
2007,05,i) 16 to 20,4248,5094,79607,79759,192,3.7,378,7.3,10260,1973,8287,2.5,12.9,10563,3173,7390,4,13.2,-303,-0.3,25.8,0,232,235,1526
2007,05,j) 21 to 25,3642,4488,74737,79941,210,4.6,277,6.1,6840,1960,4880,2.5,8.6,17247,4480,12767,5.6,21.6,-10407,-13,17.2,0,147,149,1186
2007,05,k) 26+,2882,4327,96784,98070,223,5.2,224,5.2,10335,3387,6948,3.5,10.5,12906,2905,10001,3,13.2,-2571,-2.7,21,0,108,112,985
2007,05,l) Left Censored,5717,14371,503079,504679,998,7,775,5.4,59378,15254,44124,3,11.8,62579,13231,49348,2.6,12.4,-3201,-0.6,23.6,0,184,189,1466
2007,06,a) 0,68712,69031,388517,197312,67510,195.6,0,0,382411,382411,0,193.8,193.8,0,0,0,0,0,382411,193.8,0,0,,,
2007,06,b) 1,56641,57971,451590,466391,425,0.6,16525,24.7,115946,6747,109199,1.4,24.9,145548,77474,68074,16.6,31.2,-29602,-6.3,49.8,0,13201,13207,60983
2007,06,c) 2,45810,47762,410713,434180,1961,3.8,9204,17.9,83101,14310,68791,3.3,19.1,130034,52788,77246,12.2,29.9,-46933,-10.8,38.2,0,7226,7319,42049
2007,06,d) 3,37644,38469,356927,371650,1437,3.5,6470,15.8,66378,11009,55369,3,17.9,95823,41966,53857,11.3,25.8,-29445,-7.9,35.8,0,5099,5099,33459
2007,06,e) 4,33409,34697,355329,366549,1493,4.1,5059,13.9,68097,10696,57401,2.9,18.6,90537,33885,56652,9.2,24.7,-22440,-6.1,37.2,0,3920,3921,24131
2007,06,f) 5,29971,31017,328033,338500,1205,3.7,4048,12.5,52719,8966,43753,2.6,15.6,73653,27031,46622,8,21.8,-20934,-6.2,31.2,0,2917,2926,18429
2007,06,g) 6 to 10,110066,117563,1394835,1431996,5074,4.2,13663,11.2,220736,45314,175422,3.2,15.4,295058,110137,184921,7.7,20.6,-74322,-5.2,30.8,0,9132,9316,69937
2007,06,h) 11 to 15,66953,72646,1044164,1067364,2927,3.9,7108,9.5,154115,32898,121217,3.1,14.4,200515,67012,133503,6.3,18.8,-46400,-4.4,28.8,0,4818,4862,37504
2007,06,i) 16 to 20,56498,67376,1223658,1230368,3145,4.6,5900,8.6,175412,37004,138408,3,14.3,188831,56505,132326,4.6,15.3,-13419,-1,28.6,0,3544,3588,25946
2007,06,j) 21 to 25,43395,56334,1113011,1121448,2647,4.6,4704,8.2,158113,50040,108073,4.5,14.1,174987,52781,122206,4.7,15.6,-16874,-1.5,28.2,0,2344,2386,20174
2007,06,k) 26+,33982,52374,1247965,1248121,2677,5.1,3855,7.3,166220,42311,123909,3.4,13.3,166532,44057,122475,3.5,13.3,-312,0,26.6,0,1734,1786,12566
2007,06,l) Left Censored,46829,140696,5488879,5481161,11577,8.2,10866,7.7,708208,215192,493016,3.9,12.9,692774,203124,489650,3.7,12.6,15434,0.3,25.2,0,1955,2075,21286
2007,08,a) 0,12512,12539,64347,32715,12151,193.8,0,0,63265,63265,0,193.4,193.4,0,0,0,0,0,63265,193.4,0,0,,,
2007,08,b) 1,9559,9750,63277,64980,70,0.6,2983,26.2,16724,1277,15447,2,25.7,20129,11690,8439,18,31,-3405,-5.3,51.4,0,2224,2224,9232
2007,08,c) 2,8122,8214,57884,58836,351,4,1635,18.5,12358,1792,10566,3,21,14261,6994,7267,11.9,24.2,-1903,-3.2,42,0,1225,1225,5667
2007,08,d) 3,6634,6755,47456,49050,310,4.3,1145,16,9266,1231,8035,2.5,18.9,12454,6147,6307,12.5,25.4,-3188,-6.5,37.8,0,862,862,4808
2007,08,e) 4,5946,6187,49933,50026,296,4.6,845,13.1,10871,1508,9363,3,21.7,11057,5764,5293,11.5,22.1,-186,-0.4,43.4,0,624,624,4827
2007,08,f) 5,5335,5499,44907,46005,268,4.7,775,13.5,7602,1400,6202,3,16.5,9797,4046,5751,8.8,21.3,-2195,-4.8,33,0,527,532,2632
2007,08,g) 6 to 10,20986,22152,216616,222529,1003,4.4,2597,11.3,34359,6529,27830,2.9,15.4,46184,19248,26936,8.6,20.8,-11825,-5.4,30.8,0,1651,1662,11907
2007,08,h) 11 to 15,13263,14217,160414,162724,609,4.2,1400,9.6,22856,5080,17776,3.1,14,27477,10116,17361,6.2,16.9,-4621,-2.9,28,0,899,902,6234
2007,08,i) 16 to 20,8670,10440,168603,169740,523,4.9,913,8.6,23316,6380,16936,3.8,13.7,25589,7940,17649,4.7,15.1,-2273,-1.4,27.4,0,491,493,3901
2007,08,j) 21 to 25,6687,8793,165972,166014,503,5.7,642,7.3,27655,10239,17416,6.2,16.7,27739,7651,20088,4.6,16.7,-84,0,33.4,0,308,312,3433
2007,08,k) 26+,5123,8137,190127,189113,542,6.7,549,6.7,29295,9355,19940,4.9,15.5,27267,6776,20491,3.6,14.4,2028,1.1,28.8,0,234,258,1345
2007,08,l) Left Censored,8215,23378,811273,802590,2142,9.2,1752,7.6,116508,38529,77979,4.8,14.5,99141,26838,72303,3.3,12.4,17367,2.1,24.8,0,269,283,3258
2007,09,a) 0,4941,4970,35365,17950,4834,194.5,0,0,34831,34831,0,194,194,0,0,0,0,0,34831,194,0,0,,,
2007,09,b) 1,4138,4336,31425,31587,28,0.6,1159,23.3,8096,647,7449,2,25.6,8419,4313,4106,13.7,26.7,-323,-1.1,51.2,0,889,889,3429
2007,09,c) 2,3672,3739,31471,31950,138,3.5,676,16.9,6227,800,5427,2.5,19.5,7185,2891,4294,9,22.5,-958,-3,39,0,559,559,2348
2007,09,d) 3,3039,3095,22068,23188,131,4,497,15.2,4070,546,3524,2.4,17.6,6309,3911,2398,16.9,27.2,-2239,-9.6,35.2,0,388,388,3585
2007,09,e) 4,2628,2703,23631,24383,106,3.7,408,14.3,5098,1589,3509,6.5,20.9,6601,3772,2829,15.5,27.1,-1503,-6.2,41.8,0,317,317,1450
2007,09,f) 5,2623,2714,25596,26529,107,3.8,368,12.9,4243,1190,3053,4.5,16,6109,3251,2858,12.3,23,-1866,-7,32,0,265,266,1856
2007,09,g) 6 to 10,10850,11460,136115,136815,405,3.4,1224,10.3,21982,4485,17497,3.3,16.1,23381,8266,15115,6,17.1,-1399,-1,32.2,0,863,865,5345
2007,09,h) 11 to 15,8065,8458,90514,92088,285,3.3,716,8.3,11547,2414,9133,2.6,12.5,14695,5001,9694,5.4,16,-3148,-3.5,25,0,495,498,2911
2007,09,i) 16 to 20,7302,8116,121741,124337,270,3.3,606,7.3,15324,4303,11021,3.5,12.3,20516,4867,15649,3.9,16.5,-5192,-4.2,24.6,0,374,375,2754
2007,09,j) 21 to 25,5906,7095,103336,104425,287,4,478,6.7,11892,4415,7477,4.2,11.4,14069,3588,10481,3.4,13.5,-2177,-2.1,22.8,0,266,272,2083
2007,09,k) 26+,4404,6159,124860,125017,350,5.7,409,6.6,17619,5066,12553,4.1,14.1,17932,4179,13753,3.3,14.3,-313,-0.2,28.2,0,190,199,1095
2007,09,l) Left Censored,10711,21397,791703,803302,1458,6.8,1372,6.4,85873,24704,61169,3.1,10.7,109070,21927,87143,2.7,13.6,-23197,-2.9,21.4,0,331,361,3919
2007,10,a) 0,1499,1524,11624,5874,1482,194.5,0,0,11501,11501,0,195.8,195.8,0,0,0,0,0,11501,195.8,0,0,,,
2007,10,b) 1,1238,1256,8532,8996,11,0.8,386,26.4,2064,211,1853,2.3,22.9,2991,1782,1209,19.8,33.2,-927,-10.3,45.8,0,286,286,1376
2007,10,c) 2,1056,1058,6806,7171,30,2.6,223,19.4,1350,146,1204,2,18.8,2080,1161,919,16.2,29,-730,-10.2,37.6,0,169,169,843
2007,10,d) 3,944,959,7440,7604,28,2.7,171,16.7,1324,164,1160,2.2,17.4,1651,854,797,11.2,21.7,-327,-4.3,34.8,0,126,126,738
2007,10,e) 4,904,929,7572,7834,40,4.1,131,13.4,1295,381,914,4.9,16.5,1818,791,1027,10.1,23.2,-523,-6.7,33,0,103,103,713
2007,10,f) 5,748,780,6055,6552,25,3.1,102,12.5,782,266,516,4.1,11.9,1776,661,1115,10.1,27.1,-994,-15.2,23.8,0,81,81,583
2007,10,g) 6 to 10,3063,3197,29807,31038,164,4.9,410,12.4,4019,1030,2989,3.3,12.9,6480,2561,3919,8.3,20.9,-2461,-8,25.8,0,295,296,1633
2007,10,h) 11 to 15,2006,2204,26088,27167,103,4.6,192,8.5,3328,1186,2142,4.4,12.3,5486,2668,2818,9.8,20.2,-2158,-7.9,24.6,0,137,137,2223
2007,10,i) 16 to 20,1623,1817,23565,24199,77,4.2,152,8.2,2951,776,2175,3.2,12.2,4219,1679,2540,6.9,17.4,-1268,-5.2,24.4,0,97,98,797
2007,10,j) 21 to 25,1225,1491,23966,24077,79,5.3,108,7.2,3001,564,2437,2.3,12.5,3222,672,2550,2.8,13.4,-221,-0.9,25,0,41,41,153
2007,10,k) 26+,975,1378,33488,34226,69,4.9,105,7.5,2809,661,2148,1.9,8.2,4285,937,3348,2.7,12.5,-1476,-4.3,16.4,0,36,36,351
2007,10,l) Left Censored,2824,6117,198683,197970,609,10.1,468,7.7,34870,14695,20175,7.4,17.6,33443,11592,21851,5.9,16.9,1427,0.7,33.8,0,41,41,429
2007,11,a) 0,1079,1080,6135,3126,1059,196.1,0,0,6019,6019,0,192.5,192.5,0,0,0,0,0,6019,192.5,0,0,,,
2007,11,b) 1,919,932,7539,7641,6,0.6,226,21.4,2308,52,2256,0.7,30.2,2512,1416,1096,18.5,32.9,-204,-2.7,60.4,0,180,180,1220
2007,11,c) 2,1077,1083,8491,8497,41,3.6,170,14.8,1905,235,1670,2.8,22.4,1916,667,1249,7.8,22.5,-11,-0.1,44.8,0,137,137,522
2007,11,d) 3,398,400,5119,4930,17,4.1,42,10.2,985,214,771,4.3,20,607,283,324,5.7,12.3,378,7.7,24.6,0,34,34,231
2007,11,e) 4,571,596,6640,6205,24,3.9,62,10.2,1562,351,1211,5.7,25.2,691,256,435,4.1,11.1,871,14.1,22.2,0,45,45,213
2007,11,f) 5,597,614,7136,7391,18,2.8,87,13.4,1175,148,1027,2,15.9,1685,814,871,11,22.8,-510,-6.9,31.8,0,62,62,395
2007,11,g) 6 to 10,2454,2605,42932,42321,103,3.8,246,9.2,7072,964,6108,2.3,16.7,5849,2015,3834,4.8,13.8,1223,2.9,27.6,0,170,171,1361
2007,11,h) 11 to 15,1697,1798,32826,33313,64,3.5,157,8.5,4700,1059,3641,3.2,14.1,5673,1386,4287,4.2,17,-973,-2.9,28.2,0,91,92,978
2007,11,i) 16 to 20,1451,1637,30203,29711,108,6.6,113,6.9,5088,1329,3759,4.5,17.1,4103,1063,3040,3.6,13.8,985,3.3,27.6,0,57,57,395
2007,11,j) 21 to 25,1331,1598,29833,29283,92,5.7,135,8.3,4658,794,3864,2.7,15.9,3557,1452,2105,5,12.1,1101,3.8,24.2,0,48,48,522
2007,11,k) 26+,1112,1474,63278,67142,76,5.1,91,6.2,7226,853,6373,1.3,10.8,14954,932,14022,1.4,22.3,-7728,-11.5,21.6,0,33,33,379
2007,11,l) Left Censored,3029,5863,228166,225476,528,9.1,461,7.9,33175,11569,21606,5.1,14.7,27794,9191,18603,4.1,12.3,5381,2.4,24.6,0,85,87,1138
2007,12,a) 0,46045,46402,253220,128618,44980,193.9,0,0,249205,249205,0,193.8,193.8,0,0,0,0,0,249205,193.8,0,0,,,
2007,12,b) 1,35973,36533,248251,263906,184,0.4,12999,29.8,63878,4288,59590,1.6,24.2,95188,49900,45288,18.9,36.1,-31310,-11.9,48.4,0,10438,10483,42250
2007,12,c) 2,30862,31491,216463,229168,1269,3.7,7208,20.9,49146,5779,43367,2.5,21.4,74555,30934,43621,13.5,32.5,-25409,-11.1,42.8,0,5821,5821,26268
2007,12,d) 3,27880,28297,188711,202940,1006,3.3,5235,17.2,32616,6282,26334,3.1,16.1,61073,29433,31640,14.5,30.1,-28457,-14,32.2,0,4157,4161,24994
2007,12,e) 4,20977,21644,195306,199519,875,3.8,3396,14.9,35681,6354,29327,3.2,17.9,44107,18000,26107,9,22.1,-8426,-4.2,35.8,0,2647,2648,13830
2007,12,f) 5,17475,17986,173789,176235,736,3.9,2530,13.4,31914,8269,23645,4.7,18.1,36805,14536,22269,8.2,20.9,-4891,-2.8,36.2,0,1910,1916,9834
2007,12,g) 6 to 10,62874,66469,698393,719031,2706,3.9,7954,11.5,103046,26232,76814,3.6,14.3,144322,61113,83209,8.5,20.1,-41276,-5.8,28.6,0,5585,5631,44011
2007,12,h) 11 to 15,40944,44510,626990,652812,1736,3.8,4212,9.2,82054,20756,61298,3.2,12.6,133697,31837,101860,4.9,20.5,-51643,-7.9,25.2,0,2918,2935,20082
2007,12,i) 16 to 20,29418,35238,579793,583323,1549,4.3,2957,8.2,80761,20458,60303,3.5,13.8,87821,23881,63940,4.1,15.1,-7060,-1.3,27.6,0,1814,1838,12146
2007,12,j) 21 to 25,20544,26635,557278,565878,1426,5.3,2133,7.9,69004,19076,49928,3.4,12.2,86204,26303,59901,4.6,15.2,-17200,-3,24.4,0,1061,1097,8177
2007,12,k) 26+,13486,22359,523933,521138,1472,6.6,1651,7.4,80269,25944,54325,5,15.4,74679,18026,56653,3.5,14.3,5590,1.1,28.6,0,706,741,5430
2007,12,l) Left Censored,20211,76286,2856413,2882890,7699,10.2,5858,7.8,397123,121777,275346,4.2,13.8,450078,155098,294980,5.4,15.6,-52955,-1.8,27.6,0,834,903,8451
2007,13,a) 0,18144,18290,106299,53932,17792,194.6,0,0,104734,104734,0,194.2,194.2,0,0,0,0,0,104734,194.2,0,0,,,
2007,13,b) 1,13781,14055,106519,112594,100,0.6,4058,25,25089,2015,23074,1.8,22.3,37238,18747,18491,16.7,33.1,-12149,-10.8,44.6,0,3163,3184,14589
2007,13,c) 2,11622,11931,97948,100907,502,3.9,2212,17.3,21567,3572,17995,3.5,21.4,27485,13196,14289,13.1,27.2,-5918,-5.8,42.8,0,1789,1789,10003
2007,13,d) 3,9740,9922,84471,88103,395,3.8,1623,15.5,14004,2192,11812,2.5,15.9,21268,10326,10942,11.7,24.1,-7264,-8.2,31.8,0,1276,1276,7735
2007,13,e) 4,8374,8695,79137,78947,336,3.7,1238,13.6,16652,2553,14099,3.2,21.1,16271,7197,9074,9.1,20.6,381,0.5,41.2,0,965,965,5261
2007,13,f) 5,7470,7786,84715,87704,353,4.4,1024,12.6,11998,2849,9149,3.2,13.7,17975,5775,12200,6.6,20.5,-5977,-6.8,27.4,0,783,784,4307
2007,13,g) 6 to 10,29037,31094,373614,378497,1270,3.9,3652,11.3,58519,11230,47289,3,15.5,68285,26596,41689,7,18,-9766,-2.5,31,0,2422,2500,17527
2007,13,h) 11 to 15,18299,20059,258674,264013,927,4.5,1802,8.8,36255,9408,26847,3.6,13.7,46933,14889,32044,5.6,17.8,-10678,-4.1,27.4,0,1211,1223,7994
2007,13,i) 16 to 20,12459,15427,289455,291142,674,4.3,1267,8.1,38851,9696,29155,3.3,13.3,42225,13696,28529,4.7,14.5,-3374,-1.2,26.6,0,737,758,6268
2007,13,j) 21 to 25,10184,12900,249585,250405,602,4.6,924,7.1,33195,6854,26341,2.7,13.3,34835,9623,25212,3.8,13.9,-1640,-0.6,26.6,0,450,461,3545
2007,13,k) 26+,6948,11539,304521,296386,715,6.2,776,6.7,56680,12139,44541,4.1,19.1,40410,10536,29874,3.6,13.6,16270,5.5,27.2,0,331,336,3090
2007,13,l) Left Censored,13271,43093,1607848,1611329,3721,8.7,2724,6.4,199637,68086,131551,4.2,12.4,206599,55990,150609,3.5,12.8,-6962,-0.4,24.8,0,428,493,7156
2007,15,a) 0,2031,2034,12395,6241,1981,194.8,0,0,12308,12308,0,197.2,197.2,0,0,0,0,0,12308,197.2,0,0,,,
2007,15,b) 1,1611,1676,13753,13972,19,1,456,23.8,3498,330,3168,2.4,25,3935,2137,1798,15.3,28.2,-437,-3.2,50,0,364,364,1798
2007,15,c) 2,1375,1397,13368,13691,50,3.3,255,17,3248,916,2332,6.7,23.7,3893,1702,2191,12.4,28.4,-645,-4.7,47.4,0,216,217,1526
2007,15,d) 3,1211,1256,9799,10504,40,3,192,14.5,1649,93,1556,0.9,15.7,3058,1693,1365,16.1,29.1,-1409,-13.4,31.4,0,149,149,997
2007,15,e) 4,1109,1214,12590,13025,47,3.7,148,11.8,1996,350,1646,2.7,15.3,2865,1035,1830,7.9,22,-869,-6.7,30.6,0,99,102,662
2007,15,f) 5,1037,1084,10995,11400,34,3.1,104,9.3,1789,365,1424,3.2,15.7,2598,938,1660,8.2,22.8,-809,-7.1,31.4,0,83,83,564
2007,15,g) 6 to 10,3802,4043,42140,44255,158,3.8,399,9.6,5772,966,4806,2.2,13,10002,5152,4850,11.6,22.6,-4230,-9.6,26,0,273,280,4303
2007,15,h) 11 to 15,2697,2896,39029,38706,92,3.1,226,7.6,6304,1007,5297,2.6,16.3,5658,1334,4324,3.4,14.6,646,1.7,29.2,0,145,148,860
2007,15,i) 16 to 20,2391,2788,42172,41483,107,3.8,203,7.2,6956,1197,5759,2.9,16.8,5578,2414,3164,5.8,13.4,1378,3.4,26.8,0,116,116,1213
2007,15,j) 21 to 25,1895,2347,40109,40906,89,3.7,187,7.8,5162,1409,3753,3.4,12.6,6755,3591,3164,8.8,16.5,-1593,-3.9,25.2,0,83,83,1382
2007,15,k) 26+,1807,2648,52560,51892,132,4.9,189,7.1,6820,1560,5260,3,13.1,5483,2245,3238,4.3,10.6,1337,2.5,21.2,0,46,48,525
2007,15,l) Left Censored,3169,7074,229113,227359,439,6.2,487,6.9,27116,8289,18827,3.6,11.9,23608,7328,16280,3.2,10.4,3508,1.5,20.8,0,90,95,562
2007,16,a) 0,4404,4418,21424,10875,4296,194.5,0,0,21099,21099,0,194,194,0,0,0,0,0,21099,194,0,0,,,
2007,16,b) 1,3573,3645,22495,22847,22,0.5,1075,25.4,6333,458,5875,2,27.7,7037,3967,3070,17.4,30.8,-704,-3.1,55.4,0,830,832,3312
2007,16,c) 2,2652,2684,18475,18751,126,4.4,454,15.9,4422,1593,2829,8.5,23.6,4973,2093,2880,11.2,26.5,-551,-2.9,47.2,0,349,349,1676
2007,16,d) 3,2078,2108,16039,16432,93,4.2,304,13.8,2911,323,2588,2,17.7,3696,1777,1919,10.8,22.5,-785,-4.8,35.4,0,228,228,1561
2007,16,e) 4,1743,1835,14053,14716,80,4.2,271,14.1,2479,346,2133,2.4,16.8,3804,2089,1715,14.2,25.8,-1325,-9,33.6,0,188,188,1024
2007,16,f) 5,1555,1594,21316,21131,64,3.9,192,11.6,3207,493,2714,2.3,15.2,2837,1000,1837,4.7,13.4,370,1.8,26.8,0,145,145,805
2007,16,g) 6 to 10,6186,6566,61829,63768,296,4.4,714,10.5,10421,1686,8735,2.6,16.3,14299,6491,7808,10.2,22.4,-3878,-6.1,32.6,0,469,472,4597
2007,16,h) 11 to 15,3957,4128,40125,40998,214,5.1,378,9,5612,1308,4304,3.2,13.7,7357,2598,4759,6.3,17.9,-1745,-4.2,27.4,0,226,226,1502
2007,16,i) 16 to 20,2613,3010,40251,40124,177,5.8,273,8.9,6721,1914,4807,4.8,16.8,6467,2096,4371,5.2,16.1,254,0.7,32.2,0,166,166,1005
2007,16,j) 21 to 25,1868,2404,45496,49497,128,5.3,166,6.9,8514,1338,7176,2.7,17.2,16516,1586,14930,3.2,33.4,-8002,-16.2,34.4,0,92,94,480
2007,16,k) 26+,1541,2213,53825,52867,122,5.5,128,5.8,6919,1338,5581,2.5,13.1,5003,1039,3964,2,9.5,1916,3.6,19,0,65,67,450
2007,16,l) Left Censored,2949,6964,194669,195880,523,7.6,389,5.6,23562,8551,15011,4.4,12,25984,7275,18709,3.7,13.3,-2422,-1.3,24,0,71,75,2564
2007,17,a) 0,19912,20008,115769,58634,19422,194.1,0,0,114271,114271,0,194.9,194.9,0,0,0,0,0,114271,194.9,0,0,,,
2007,17,b) 1,15861,16253,120394,123789,109,0.6,4532,24.2,28565,1289,27276,1,23.1,35354,19335,16019,15.6,28.6,-6789,-5.5,46.2,0,3245,3245,15419
2007,17,c) 2,13802,14081,116209,118642,524,3.5,2477,16.5,23349,3816,19533,3.2,19.7,28215,13803,14412,11.6,23.8,-4866,-4.1,39.4,0,1895,1895,11573
2007,17,d) 3,11981,12205,96487,99296,461,3.6,1894,14.7,17463,2501,14962,2.5,17.6,23081,11524,11557,11.6,23.2,-5618,-5.6,35.2,0,1431,1431,9642
2007,17,e) 4,10561,11203,107380,110616,454,3.9,1410,12.1,23499,6766,16733,6.1,21.2,29970,12014,17956,10.9,27.1,-6471,-5.9,42.4,0,1036,1036,9767
2007,17,f) 5,9392,9685,88829,92417,397,3.9,1236,12.3,14348,2039,12309,2.2,15.5,21523,9439,12084,10.2,23.3,-7175,-7.8,31,0,847,863,6576
2007,17,g) 6 to 10,38865,41338,468641,478928,1620,3.8,4409,10.3,74206,13091,61115,2.7,15.5,94780,36565,58215,7.6,19.8,-20574,-4.3,31,0,2881,2904,21051
2007,17,h) 11 to 15,28339,30126,355007,365955,1109,3.6,2688,8.7,44078,9909,34169,2.7,12,65973,23227,42746,6.3,18,-21895,-6,24,0,1735,1744,15753
2007,17,i) 16 to 20,22729,26399,432265,434371,1157,4.3,2039,7.6,52552,10961,41591,2.5,12.1,56764,15277,41487,3.5,13.1,-4212,-1,24.2,0,1210,1217,8196
2007,17,j) 21 to 25,17538,21419,441614,443994,912,4.2,1598,7.3,53347,13354,39993,3,12,58107,15922,42185,3.6,13.1,-4760,-1.1,24,0,843,873,6220
2007,17,k) 26+,13314,19564,458718,456913,954,4.8,1287,6.5,56593,15781,40812,3.5,12.4,52983,13497,39486,3,11.6,3610,0.8,23.2,0,604,638,5416
2007,17,l) Left Censored,29021,67934,2569954,2571376,4600,6.8,4474,6.6,315766,89667,226099,3.5,12.3,318610,83033,235577,3.2,12.4,-2844,-0.1,24.6,0,974,1023,10917
2007,18,a) 0,8737,8820,56569,28583,8606,195.1,0,0,55973,55973,0,195.8,195.8,0,0,0,0,0,55973,195.8,0,0,,,
2007,18,b) 1,7164,7446,57577,61672,49,0.6,2015,23.7,13468,1124,12344,1.8,21.8,21658,12056,9602,19.5,35.1,-8190,-13.3,43.6,0,1562,1562,10273
2007,18,c) 2,5815,5952,49296,53470,229,3.6,1084,17,8546,1251,7295,2.3,16,16893,10203,6690,19.1,31.6,-8347,-15.6,32,0,851,856,5989
2007,18,d) 3,5148,5259,43579,44777,204,3.7,850,15.3,7293,1428,5865,3.2,16.3,9689,4553,5136,10.2,21.6,-2396,-5.3,32.6,0,682,682,3774
2007,18,e) 4,4502,4694,41845,42842,192,3.9,633,12.9,7564,952,6612,2.2,17.7,9558,4535,5023,10.6,22.3,-1994,-4.6,35.4,0,489,489,3626
2007,18,f) 5,4350,4472,44711,46121,152,3.3,575,12.3,5979,1082,4897,2.3,13,8798,3837,4961,8.3,19.1,-2819,-6.1,26,0,421,424,2773
2007,18,g) 6 to 10,17311,18741,205370,209242,692,3.6,2054,10.6,31215,6557,24658,3.1,14.9,38958,13075,25883,6.2,18.6,-7743,-3.7,29.8,0,1430,1445,8923
2007,18,h) 11 to 15,12964,14050,167417,173760,465,3.2,1262,8.7,21463,4746,16717,2.7,12.4,34148,8336,25812,4.8,19.7,-12685,-7.3,24.8,0,870,872,4888
2007,18,i) 16 to 20,10248,12453,207341,213111,577,4.6,906,7.2,23674,5102,18572,2.4,11.1,35213,12909,22304,6.1,16.5,-11539,-5.4,22.2,0,538,545,4929
2007,18,j) 21 to 25,8660,10959,199575,198343,480,4.3,797,7.2,28831,7009,21822,3.5,14.5,26367,6813,19554,3.4,13.3,2464,1.2,26.6,0,383,408,3725
2007,18,k) 26+,6311,9935,223505,221978,655,6.6,616,6.2,30316,8036,22280,3.6,13.7,27261,6701,20560,3,12.3,3055,1.4,24.6,0,295,308,2937
2007,18,l) Left Censored,14549,36580,1347455,1354641,2274,6.2,2177,6,157146,43557,113589,3.2,11.6,171518,37885,133633,2.8,12.7,-14372,-1.1,23.2,0,464,496,4509
2007,19,a) 0,4497,4510,26496,13432,4352,193,0,0,26129,26129,0,194.5,194.5,0,0,0,0,0,26129,194.5,0,0,,,
2007,19,b) 1,3932,4180,28032,28454,53,1.1,993,21.1,7528,859,6669,3,26.5,8371,4365,4006,15.3,29.4,-843,-2.9,53,0,732,732,3372
2007,19,c) 2,3241,3287,26460,27435,129,3.7,560,16,4583,776,3807,2.8,16.7,6533,3174,3359,11.6,23.8,-1950,-7.1,33.4,0,438,438,2124
2007,19,d) 3,2842,2901,19862,20552,115,3.8,395,13,3339,348,2991,1.7,16.2,4718,2260,2458,11,23,-1379,-6.8,32.4,0,308,308,1930
2007,19,e) 4,2472,2640,21021,21366,126,4.6,349,12.7,3391,989,2402,4.6,15.9,4080,1772,2308,8.3,19.1,-689,-3.2,31.8,0,260,260,1166
2007,19,f) 5,2302,2413,25906,26873,96,3.8,299,11.9,3519,460,3059,1.7,13.1,5452,1680,3772,6.3,20.3,-1933,-7.2,26.2,0,202,204,1420
2007,19,g) 6 to 10,9510,10194,98631,100261,469,4.5,1049,10,13861,2888,10973,2.9,13.8,17121,5723,11398,5.7,17.1,-3260,-3.3,27.6,0,681,687,3497
2007,19,h) 11 to 15,7525,8001,75326,76652,315,3.9,666,8.1,10449,1929,8520,2.5,13.6,13101,4017,9084,5.2,17.1,-2652,-3.5,27.2,0,432,436,3091
2007,19,i) 16 to 20,5655,6434,94301,93743,251,3.8,479,7.3,12163,2570,9593,2.7,13,11047,2960,8087,3.2,11.8,1116,1.2,23.6,0,281,286,1516
2007,19,j) 21 to 25,4744,6159,104670,104328,253,4.1,410,6.6,11622,2168,9454,2.1,11.1,10938,2529,8409,2.4,10.5,684,0.6,21,0,206,209,1199
2007,19,k) 26+,4152,6730,113133,112636,288,4.2,432,6.4,13791,3188,10603,2.8,12.2,12797,2739,10058,2.4,11.4,994,0.8,22.8,0,189,200,983
2007,19,l) Left Censored,9814,20098,664150,668940,981,4.9,1133,5.6,63155,13804,49351,2.1,9.4,72735,19653,53082,2.9,10.9,-9580,-1.5,18.8,0,308,319,3200
2007,20,a) 0,4595,4614,25366,12873,4469,193.7,0,0,24987,24987,0,194.1,194.1,0,0,0,0,0,24987,194.1,0,0,,,
2007,20,b) 1,3727,3841,24750,26266,27,0.6,1080,24.4,5914,276,5638,1.1,22.5,8945,5572,3373,21.2,34.1,-3031,-11.6,45,0,837,837,4830
2007,20,c) 2,3249,3315,25788,26787,151,4.3,632,17.8,5496,758,4738,2.8,20.5,7494,3248,4246,12.1,28,-1998,-7.5,41,0,504,504,2347
2007,20,d) 3,2867,2911,22544,22934,99,3.2,457,14.8,4184,929,3255,4.1,18.2,4963,2592,2371,11.3,21.6,-779,-3.4,36.4,0,359,359,2011
2007,20,e) 4,2523,2579,25335,25409,99,3.7,366,13.5,4149,604,3545,2.4,16.3,4296,1888,2408,7.4,16.9,-147,-0.6,32.6,0,284,284,1203
2007,20,f) 5,2328,2396,21917,22532,90,3.6,297,12,3333,741,2592,3.3,14.8,4562,1907,2655,8.5,20.2,-1229,-5.4,29.6,0,218,218,1455
2007,20,g) 6 to 10,9607,10274,115156,115063,471,4.5,1078,10.2,18747,5566,13181,4.8,16.3,18561,7212,11349,6.3,16.1,186,0.2,32.2,0,738,752,4964
2007,20,h) 11 to 15,6805,7258,78618,79079,259,3.5,649,8.7,10773,2335,8438,3,13.6,11694,3347,8347,4.2,14.8,-921,-1.2,27.2,0,428,433,2129
2007,20,i) 16 to 20,5089,5977,87321,87027,280,4.6,473,7.8,11907,2738,9169,3.1,13.7,11319,2736,8583,3.1,13,588,0.7,26,0,289,290,1561
2007,20,j) 21 to 25,4396,5340,77363,77778,239,4.4,399,7.4,9553,2204,7349,2.8,12.3,10382,3426,6956,4.4,13.3,-829,-1,24.6,0,179,186,1241
2007,20,k) 26+,3597,5514,109682,108542,250,4.5,330,5.9,14528,5250,9278,4.8,13.4,12247,3038,9209,2.8,11.3,2281,2.1,22.6,0,132,136,754
2007,20,l) Left Censored,8007,17394,540430,538902,1128,6.5,1100,6.3,61417,21201,40216,3.9,11.4,58360,14099,44261,2.6,10.8,3057,0.6,21.6,0,228,239,1988
2007,21,a) 0,5448,5486,37307,18994,5360,195.4,0,0,36627,36627,0,192.8,192.8,0,0,0,0,0,36627,192.8,0,0,,,
2007,21,b) 1,4357,4498,33424,36070,22,0.4,1232,23.8,8408,217,8191,0.6,23.3,13700,7179,6521,19.9,38,-5292,-14.7,46.6,0,983,983,5865
2007,21,c) 2,3845,3928,31204,33344,114,2.7,767,18,5966,647,5319,1.9,17.9,10246,4344,5902,13,30.7,-4280,-12.8,35.8,0,643,643,3705
2007,21,d) 3,3259,3382,29145,29491,135,3.8,551,15.4,6354,1522,4832,5.2,21.5,7046,3043,4003,10.3,23.9,-692,-2.4,43,0,430,430,2516
2007,21,e) 4,2782,2882,26156,26734,110,3.6,399,13.2,4699,633,4066,2.4,17.6,5854,2293,3561,8.6,21.9,-1155,-4.3,35.2,0,319,319,1991
2007,21,f) 5,2561,2658,26537,27372,102,3.7,355,12.8,4173,1029,3144,3.8,15.2,5843,2264,3579,8.3,21.3,-1670,-6.1,30.4,0,266,268,1648
2007,21,g) 6 to 10,11248,12153,124279,125854,485,3.9,1220,9.7,19638,4020,15618,3.2,15.6,22788,7944,14844,6.3,18.1,-3150,-2.5,31.2,0,853,859,5401
2007,21,h) 11 to 15,8069,8891,109990,112087,333,3.7,778,8.5,14909,4331,10578,3.9,13.3,19102,5361,13741,4.8,17,-4193,-3.7,26.6,0,528,530,3602
2007,21,i) 16 to 20,6421,7662,125727,127022,280,3.6,572,7.3,14888,3093,11795,2.4,11.7,17478,4625,12853,3.6,13.8,-2590,-2.1,23.4,0,358,364,2591
2007,21,j) 21 to 25,5453,6670,124896,123355,246,3.6,463,6.8,18688,3952,14736,3.2,15.1,15606,5111,10495,4.1,12.7,3082,2.4,25.4,0,243,252,1675
2007,21,k) 26+,3778,6133,132956,131650,330,5.4,335,5.5,16521,4128,12393,3.1,12.5,13908,3108,10800,2.4,10.6,2613,1.9,21.2,0,144,156,964
2007,21,l) Left Censored,8693,21707,741561,745984,1378,6.4,1257,5.8,85125,27379,57746,3.7,11.4,93970,18982,74988,2.5,12.6,-8845,-1.2,22.8,0,287,300,4258
2007,22,a) 0,6944,6977,45581,23126,6779,194.3,0,0,44911,44911,0,194.2,194.2,0,0,0,0,0,44911,194.2,0,0,,,
2007,22,b) 1,4953,5188,45983,47142,57,1,1306,22.2,12788,715,12073,1.5,27.1,15106,7553,7553,16,32,-2318,-4.9,54.2,0,1046,1046,6168
2007,22,c) 2,4196,4285,39454,39630,200,4.4,665,14.8,9409,1171,8238,3,23.7,9760,4308,5452,10.9,24.6,-351,-0.9,47.4,0,525,525,3178
2007,22,d) 3,3701,3792,37185,36651,183,4.7,526,13.4,8981,1599,7382,4.4,24.5,7912,4132,3780,11.3,21.6,1069,2.9,43.2,0,421,421,3406
2007,22,e) 4,3353,3601,37691,36330,221,6,400,10.9,9138,2028,7110,5.6,25.2,6416,2785,3631,7.7,17.7,2722,7.5,35.4,0,308,309,2080
2007,22,f) 5,3048,3151,37090,37169,139,4.3,334,10.4,7354,1048,6306,2.8,19.8,7512,2637,4875,7.1,20.2,-158,-0.4,39.6,0,244,244,1607
2007,22,g) 6 to 10,12487,13232,162571,161959,711,5.3,1227,9.1,28559,5492,23067,3.4,17.6,27334,9950,17384,6.1,16.9,1225,0.7,33.8,0,842,853,6855
2007,22,h) 11 to 15,9022,9708,125597,124569,489,5,751,7.7,19889,3683,16206,3,16,17833,5300,12533,4.3,14.3,2056,1.7,28.6,0,504,510,3475
2007,22,i) 16 to 20,6458,7822,145850,144768,380,4.8,524,6.7,23248,3882,19366,2.7,16.1,21084,3798,17286,2.6,14.6,2164,1.5,29.2,0,311,311,1982
2007,22,j) 21 to 25,6367,7827,125403,122211,404,5.1,498,6.3,20928,4542,16386,3.7,17.1,14544,3635,10909,3,11.9,6384,5.2,23.8,0,269,282,1438
2007,22,k) 26+,4978,7409,153596,151212,445,6,443,6,27214,10466,16748,6.9,18,22446,5151,17295,3.4,14.8,4768,3.2,29.6,0,214,216,1224
2007,22,l) Left Censored,9121,22360,679782,675680,1638,7.4,1349,6.1,87810,22500,65310,3.3,13,79606,18482,61124,2.7,11.8,8204,1.2,23.6,0,303,319,3344
2007,23,a) 0,2648,2656,11248,5705,2569,193.4,0,0,11086,11086,0,194.3,194.3,0,0,0,0,0,11086,194.3,0,0,,,
2007,23,b) 1,2188,2278,13609,14455,25,0.9,679,25.8,3268,216,3052,1.5,22.6,4960,2684,2276,18.6,34.3,-1692,-11.7,45.2,0,472,472,2065
2007,23,c) 2,1754,1764,9455,10147,75,4,323,17.1,1461,281,1180,2.8,14.4,2844,1304,1540,12.9,28,-1383,-13.6,28.8,0,252,252,1016
2007,23,d) 3,1572,1592,10196,10738,56,3.4,231,13.8,1438,160,1278,1.5,13.4,2521,918,1603,8.5,23.5,-1083,-10.1,26.8,0,180,180,753
2007,23,e) 4,1246,1301,9179,10857,49,3.5,209,15.1,1630,195,1435,1.8,15,4986,3910,1076,36,45.9,-3356,-30.9,30,0,156,156,3696
2007,23,f) 5,1332,1372,10002,10420,41,2.9,154,10.8,1364,260,1104,2.5,13.1,2199,930,1269,8.9,21.1,-835,-8,26.2,0,104,104,661
2007,23,g) 6 to 10,5453,5753,47657,48215,212,3.6,639,10.7,6378,1029,5349,2.1,13.2,7493,2627,4866,5.4,15.5,-1115,-2.3,26.4,0,408,409,1666
2007,23,h) 11 to 15,3636,3862,35465,36468,115,2.9,337,8.5,3972,985,2987,2.7,10.9,5978,1816,4162,5,16.4,-2006,-5.5,21.8,0,221,221,1213
2007,23,i) 16 to 20,3017,3431,43248,43778,144,4.1,285,8.1,5495,1472,4023,3.4,12.6,6555,2025,4530,4.6,15,-1060,-2.4,25.2,0,178,184,1278
2007,23,j) 21 to 25,2355,2886,43959,43235,107,3.7,178,6.1,5692,2779,2913,6.4,13.2,4244,821,3423,1.9,9.8,1448,3.4,19.6,0,100,100,473
2007,23,k) 26+,1702,2715,44496,44401,136,5,181,6.6,6154,1752,4402,3.9,13.9,5964,1336,4628,3,13.4,190,0.5,26.8,0,77,79,339
2007,23,l) Left Censored,3531,7408,219915,220076,554,7.5,438,6,25476,8627,16849,3.9,11.6,25798,8827,16971,4,11.7,-322,-0.1,23.2,0,103,103,852
2007,24,a) 0,8890,8947,49772,25392,8691,194.3,0,0,48760,48760,0,192,192,0,0,0,0,0,48760,192,0,0,,,
2007,24,b) 1,7424,7649,55230,57239,48,0.5,2271,25.6,13835,671,13164,1.2,24.2,17853,10036,7817,17.5,31.2,-4018,-7,48.4,0,1757,1757,7913
2007,24,c) 2,6531,6667,47230,49598,269,3.8,1110,15.7,8751,1222,7529,2.5,17.6,13486,5240,8246,10.6,27.2,-4735,-9.6,35.2,0,883,883,4497
2007,24,d) 3,5600,5688,44309,44823,246,4.1,848,14.2,8380,1631,6749,3.6,18.7,9408,3773,5635,8.4,21,-1028,-2.3,37.4,0,651,651,2943
2007,24,e) 4,4767,4953,50223,49060,185,3.6,701,13.5,12669,4418,8251,9,25.8,10342,4927,5415,10,21.1,2327,4.7,42.2,0,506,522,2732
2007,24,f) 5,4583,4686,48305,49673,159,3.3,583,11.9,7250,939,6311,1.9,14.6,9985,3185,6800,6.4,20.1,-2735,-5.5,29.2,0,433,434,2445
2007,24,g) 6 to 10,17866,19039,211379,215482,745,3.8,1956,10,30723,5660,25063,2.6,14.3,38928,13777,25151,6.4,18.1,-8205,-3.8,28.6,0,1270,1273,7509
2007,24,h) 11 to 15,12202,13036,161988,166125,460,3.4,1115,8.4,19324,3818,15506,2.3,11.6,27598,9896,17702,6,16.6,-8274,-5,23.2,0,753,759,6221
2007,24,i) 16 to 20,9987,11575,206965,208910,405,3.4,926,7.8,24635,3612,21023,1.7,11.8,28524,7167,21357,3.4,13.7,-3889,-1.9,23.6,0,509,512,2904
2007,24,j) 21 to 25,7401,9110,154007,155043,345,3.7,717,7.7,20727,4520,16207,2.9,13.4,22798,7200,15598,4.6,14.7,-2071,-1.3,26.8,0,312,317,2123
2007,24,k) 26+,5075,7600,180689,180304,405,5.3,499,6.5,22631,6058,16573,3.4,12.6,21861,5661,16200,3.1,12.1,770,0.5,24.2,0,198,214,1188
2007,24,l) Left Censored,10738,27300,1003446,1009691,2204,8.1,1894,7,120330,41213,79117,4.1,11.9,132821,33561,99260,3.3,13.2,-12491,-1.3,23.8,0,357,370,5983
2007,25,a) 0,9804,9829,52153,26337,9592,195.2,0,0,51632,51632,0,196,196,0,0,0,0,0,51632,196,0,0,,,
2007,25,b) 1,8509,8650,65139,67432,47,0.5,2337,23.6,13807,1121,12686,1.7,20.5,18394,9610,8784,14.3,27.3,-4587,-6.8,41,0,1743,1743,8075
2007,25,c) 2,7087,7182,54615,54334,282,3.7,1340,17.3,12709,1452,11257,2.7,23.4,12147,6032,6115,11.1,22.4,562,1,44.8,0,1017,1017,4530
2007,25,d) 3,6192,6343,59059,57857,229,3.4,985,14.7,14582,1062,13520,1.8,25.2,12178,4199,7979,7.3,21,2404,4.2,42,0,757,757,3300
2007,25,e) 4,5508,5753,50256,49982,260,4.3,784,13.1,10378,1891,8487,3.8,20.8,9829,4529,5300,9.1,19.7,549,1.1,39.4,0,546,546,3159
2007,25,f) 5,5125,5268,52673,53843,174,3.2,671,12.2,8081,1527,6554,2.8,15,10421,4569,5852,8.5,19.4,-2340,-4.4,30,0,484,488,2414
2007,25,g) 6 to 10,21484,22518,243425,246167,759,3.2,2467,10.6,36566,4561,32005,1.9,14.9,42050,18018,24032,7.3,17.1,-5484,-2.2,29.8,0,1605,1634,11590
2007,25,h) 11 to 15,15177,16053,187648,190695,521,3.2,1373,8.3,24796,3857,20939,2,13,30889,10364,20525,5.4,16.2,-6093,-3.2,26,0,929,943,5810
2007,25,i) 16 to 20,12715,14676,247435,251014,552,3.7,1094,7.3,28529,6436,22093,2.6,11.4,35687,10182,25505,4.1,14.2,-7158,-2.8,22.8,0,659,675,5324
2007,25,j) 21 to 25,10502,13257,284787,286727,525,3.9,900,6.7,31939,6319,25620,2.2,11.1,35819,8953,26866,3.1,12.5,-3880,-1.4,22.2,0,433,433,2630
2007,25,k) 26+,7433,11039,281766,281980,607,5.5,760,6.8,32584,7900,24684,2.8,11.6,33011,9562,23449,3.4,11.7,-427,-0.1,23.2,0,339,355,1823
2007,25,l) Left Censored,17989,37963,1487328,1489508,2377,6.2,2622,6.9,168565,44390,124175,3,11.3,172925,42910,130015,2.9,11.6,-4360,-0.3,22.6,0,659,690,6808
2007,26,a) 0,13140,13237,85110,43202,12791,193.3,0,0,83817,83817,0,194,194,0,0,0,0,0,83817,194,0,0,,,
2007,26,b) 1,10640,10743,96771,98946,45,0.4,3406,27.1,27681,928,26753,0.9,28,32031,17328,14703,17.5,32.4,-4350,-4.4,56,0,2614,2614,14762
2007,26,c) 2,9325,9487,88987,94653,345,3.4,1909,18.6,15305,2638,12667,2.8,16.2,26637,12403,14234,13.1,28.1,-11332,-11.9,32.4,0,1464,1467,10237
2007,26,d) 3,8078,8227,88533,92113,338,3.9,1372,15.8,13699,3014,10685,3.3,14.9,20859,8064,12795,8.8,22.6,-7160,-7.7,29.8,0,1078,1078,6640
2007,26,e) 4,7115,7443,75867,77734,339,4.3,1183,15.1,15137,2352,12785,3,19.5,18870,7884,10986,10.1,24.3,-3733,-4.8,39,0,887,887,5318
2007,26,f) 5,6813,7006,72138,75883,235,3.2,994,13.5,9097,1573,7524,2.1,12,16587,7370,9217,9.7,21.9,-7490,-9.9,24,0,727,729,5310
2007,26,g) 6 to 10,27375,29183,300670,310862,1125,3.7,3681,12.1,40557,8377,32180,2.7,13,60941,22736,38205,7.3,19.6,-20384,-6.6,26,0,2495,2520,14659
2007,26,h) 11 to 15,20849,22243,245576,253453,850,3.7,2235,9.8,30494,6961,23533,2.7,12,46247,15641,30606,6.2,18.2,-15753,-6.2,24,0,1489,1498,9620
2007,26,i) 16 to 20,16910,20100,301781,306277,871,4.2,1697,8.3,39826,8501,31325,2.8,13,48817,14879,33938,4.9,15.9,-8991,-2.9,26,0,979,1000,7132
2007,26,j) 21 to 25,13307,16783,284997,289013,646,3.8,1267,7.4,32216,7097,25119,2.5,11.1,40247,11934,28313,4.1,13.9,-8031,-2.8,22.2,0,568,582,4106
2007,26,k) 26+,9948,14034,260253,265423,675,4.8,985,6.9,30477,8883,21594,3.3,11.5,40817,10354,30463,3.9,15.4,-10340,-3.9,23,0,452,468,3282
2007,26,l) Left Censored,20839,50861,1768196,1806408,3175,6.2,3223,6.3,183392,52612,130780,2.9,10.2,259815,76500,183315,4.2,14.4,-76423,-4.2,20.4,0,785,927,7688
2007,27,a) 0,9058,9099,55434,28045,8769,192.7,0,0,54778,54778,0,195.3,195.3,0,0,0,0,0,54778,195.3,0,0,,,
2007,27,b) 1,7420,7784,52013,58011,64,0.7,2374,26.2,11637,1030,10607,1.8,20.1,23632,12400,11232,21.4,40.7,-11995,-20.6,40.2,0,1660,1660,9981
2007,27,c) 2,6390,6511,47192,50010,280,4,1206,17.3,8878,1130,7748,2.3,17.8,14514,8354,6160,16.7,29,-5636,-11.2,35.6,0,900,900,7062
2007,27,d) 3,5663,5848,43816,44463,340,5.5,949,15.4,8156,1940,6216,4.4,18.3,9449,5123,4326,11.5,21.3,-1293,-3,36.6,0,676,676,4067
2007,27,e) 4,5181,5424,43642,44097,228,4,770,13.5,7236,1199,6037,2.7,16.4,8146,3692,4454,8.4,18.5,-910,-2.1,32.8,0,542,544,2613
2007,27,f) 5,4721,4850,44778,45835,177,3.5,650,12.8,5922,776,5146,1.7,12.9,8035,3366,4669,7.3,17.5,-2113,-4.6,25.8,0,447,447,2328
2007,27,g) 6 to 10,19249,20538,216823,220326,834,3.9,2246,10.6,30704,7137,23567,3.2,13.9,37710,14025,23685,6.4,17.1,-7006,-3.2,27.8,0,1336,1347,8070
2007,27,h) 11 to 15,13635,14729,173714,175372,589,3.9,1334,8.8,24099,5058,19041,2.9,13.7,27416,9477,17939,5.4,15.6,-3317,-1.9,27.4,0,801,812,5674
2007,27,i) 16 to 20,9980,11632,187408,186322,524,4.4,858,7.3,25867,5454,20413,2.9,13.9,23694,7210,16484,3.9,12.7,2173,1.2,25.4,0,458,466,3045
2007,27,j) 21 to 25,7506,9617,196504,198088,363,3.7,687,7,23079,6224,16855,3.1,11.7,26246,7934,18312,4,13.2,-3167,-1.5,23.4,0,294,300,2199
2007,27,k) 26+,5954,8966,218872,217278,425,4.7,556,6.2,26692,6261,20431,2.9,12.3,23504,5442,18062,2.5,10.8,3188,1.5,21.6,0,236,238,1741
2007,27,l) Left Censored,13151,29972,1258820,1240383,1978,6.6,2206,7.3,171145,44358,126787,3.6,13.8,134270,35927,98343,2.9,10.8,36875,3,21.6,0,363,378,4381
2007,28,a) 0,4059,4112,22387,11413,4009,195,0,0,21948,21948,0,192.3,192.3,0,0,0,0,0,21948,192.3,0,0,,,
2007,28,b) 1,3046,3159,26920,28416,31,0.9,908,25,6399,391,6008,1.4,22.5,9390,4824,4566,17,33,-2991,-10.5,45,0,737,737,3777
2007,28,c) 2,2498,2543,22151,23134,133,4.9,484,17.9,3407,626,2781,2.7,14.7,5372,2153,3219,9.3,23.2,-1965,-8.5,29.4,0,388,388,1720
2007,28,d) 3,2189,2261,18580,19134,106,4.5,385,16.2,3732,1084,2648,5.7,19.5,4840,2421,2419,12.7,25.3,-1108,-5.8,39,0,303,303,1709
2007,28,e) 4,2057,2155,17928,18223,109,4.9,279,12.6,3480,841,2639,4.6,19.1,4069,1800,2269,9.9,22.3,-589,-3.2,38.2,0,205,205,1041
2007,28,f) 5,1739,1780,18632,19801,58,3.1,247,13.2,2721,599,2122,3,13.7,5058,2071,2987,10.5,25.5,-2337,-11.8,27.4,0,192,193,1539
2007,28,g) 6 to 10,7381,7980,80761,81309,386,4.7,762,9.4,12221,2793,9428,3.4,15,13316,4055,9261,5,16.4,-1095,-1.4,30,0,545,547,2893
2007,28,h) 11 to 15,5120,5566,67938,69637,218,3.8,513,9,9203,1686,7517,2.4,13.2,12601,4189,8412,6,18.1,-3398,-4.9,26.4,0,355,362,2238
2007,28,i) 16 to 20,3821,4388,77012,77695,202,4.5,329,7.4,9079,2250,6829,2.9,11.7,10444,2033,8411,2.6,13.4,-1365,-1.7,23.4,0,224,225,1326
2007,28,j) 21 to 25,3591,4359,58823,59263,207,4.7,265,6,7288,1448,5840,2.4,12.3,8167,1917,6250,3.2,13.8,-879,-1.5,24.6,0,125,128,868
2007,28,k) 26+,2691,3978,82837,82967,188,4.7,261,6.5,11595,3189,8406,3.8,14,11855,2541,9314,3.1,14.3,-260,-0.3,28,0,142,142,710
2007,28,l) Left Censored,5715,14526,442965,444665,939,6.5,818,5.7,48935,11639,37296,2.6,11,52334,13329,39005,3,11.8,-3399,-0.8,22,0,199,208,1447
2007,29,a) 0,9970,10047,58752,29746,9771,194.5,0,0,58013,58013,0,195,195,0,0,0,0,0,58013,195,0,0,,,
2007,29,b) 1,8057,8328,57917,59967,47,0.5,2549,26.2,13850,485,13365,0.8,23.1,17949,9903,8046,16.5,29.9,-4099,-6.8,46.2,0,2054,2054,8552
2007,29,c) 2,6999,7169,55741,57001,293,3.8,1548,19.9,11910,1315,10595,2.3,20.9,14429,7050,7379,12.4,25.3,-2519,-4.4,41.8,0,1250,1250,6045
2007,29,d) 3,5998,6107,50282,51305,226,3.4,1168,17.8,9817,1389,8428,2.7,19.1,11863,6505,5358,12.7,23.1,-2046,-4,38.2,0,951,951,5798
2007,29,e) 4,5104,5333,41504,42100,206,3.7,792,14.1,7610,1155,6455,2.7,18.1,8802,3742,5060,8.9,20.9,-1192,-2.8,36.2,0,629,629,2839
2007,29,f) 5,4542,4678,44312,45488,181,3.7,689,14,6459,709,5750,1.6,14.2,8810,3725,5085,8.2,19.4,-2351,-5.2,28.4,0,526,528,3086
2007,29,g) 6 to 10,17999,19287,196265,201765,789,3.9,2175,10.9,27859,5766,22093,2.9,13.8,38859,15271,23588,7.6,19.3,-11000,-5.5,27.6,0,1494,1516,9739
2007,29,h) 11 to 15,12758,13744,165348,169233,503,3.6,1213,8.6,22011,5000,17011,3,13,29780,9244,20536,5.5,17.6,-7769,-4.6,26,0,839,849,4964
2007,29,i) 16 to 20,9950,12199,180453,183597,634,5.1,922,7.5,22742,5800,16942,3.2,12.4,29030,7818,21212,4.3,15.8,-6288,-3.4,24.8,0,576,592,4659
2007,29,j) 21 to 25,8401,10674,205996,206180,497,4.6,729,6.8,22763,6428,16335,3.1,11,23130,5059,18071,2.5,11.2,-367,-0.2,22,0,385,424,2557
2007,29,k) 26+,6135,9875,221724,220634,495,5,656,6.6,27748,6493,21255,2.9,12.6,25567,5913,19654,2.7,11.6,2181,1,23.2,0,280,288,1539
2007,29,l) Left Censored,13477,32996,1183113,1182827,2075,6.3,1926,5.9,135399,35106,100293,3,11.4,134828,31156,103672,2.6,11.4,571,0,22.8,0,453,472,3683
2007,30,a) 0,3026,3037,11936,6072,2934,193.2,0,0,11728,11728,0,193.1,193.1,0,0,0,0,0,11728,193.1,0,0,,,
2007,30,b) 1,2478,2541,18632,17388,18,0.6,661,22.7,6352,132,6220,0.8,36.5,3863,2079,1784,12,22.2,2489,14.3,44.4,0,463,463,1639
2007,30,c) 2,1897,1904,10518,10953,69,3.4,358,17.5,2206,184,2022,1.7,20.1,3075,1229,1846,11.2,28.1,-869,-8,40.2,0,257,257,995
2007,30,d) 3,1727,1769,10746,10662,81,4.4,224,12.2,2129,260,1869,2.4,20,1961,807,1154,7.6,18.4,168,1.6,36.8,0,150,150,597
2007,30,e) 4,1377,1416,9263,9058,66,4.5,166,11.3,1909,456,1453,5,21.1,1499,533,966,5.9,16.5,410,4.6,33,0,116,116,386
2007,30,f) 5,1281,1302,9103,9382,44,3.3,151,11.2,1416,117,1299,1.2,15.1,1973,856,1117,9.1,21,-557,-5.9,30.2,0,98,98,441
2007,30,g) 6 to 10,5072,5284,40574,41001,244,4.5,574,10.5,6060,945,5115,2.3,14.8,6914,2937,3977,7.2,16.9,-854,-2.1,29.6,0,381,381,1980
2007,30,h) 11 to 15,3386,3516,30333,31113,111,3.1,311,8.6,3705,798,2907,2.6,11.9,5264,1820,3444,5.8,16.9,-1559,-5,23.8,0,191,194,1009
2007,30,i) 16 to 20,2190,2412,26986,27405,97,3.9,204,8.3,4150,1143,3007,4.2,15.1,4987,1348,3639,4.9,18.2,-837,-3.1,30.2,0,120,127,804
2007,30,j) 21 to 25,1787,2179,29671,29664,110,5,146,6.6,3625,746,2879,2.5,12.2,3611,1334,2277,4.5,12.2,14,0,24.4,0,79,82,472
2007,30,k) 26+,1565,2271,36576,35468,108,4.7,118,5.2,5479,2245,3234,6.3,15.4,3263,657,2606,1.9,9.2,2216,6.2,18.4,0,71,74,469
2007,30,l) Left Censored,2637,5364,118814,117923,339,6.3,285,5.3,14157,3341,10816,2.8,12,12375,2365,10010,2,10.5,1782,1.5,21,0,80,87,509
2007,31,a) 0,3078,3109,15333,7767,3023,194.5,0,0,15133,15133,0,194.8,194.8,0,0,0,0,0,15133,194.8,0,0,,,
2007,31,b) 1,2528,2626,16476,16800,10,0.3,674,22.5,4055,87,3968,0.5,24.1,4702,2658,2044,15.8,28,-647,-3.9,48.2,0,504,504,2248
2007,31,c) 2,2174,2191,13272,13765,79,3.4,384,16.4,2607,753,1854,5.5,18.9,3593,1950,1643,14.2,26.1,-986,-7.2,37.8,0,294,294,1511
2007,31,d) 3,1963,1994,14133,14880,70,3.3,283,13.5,2352,299,2053,2,15.8,3845,2111,1734,14.2,25.8,-1493,-10,31.6,0,207,207,1385
2007,31,e) 4,1720,1781,12163,12428,68,3.7,208,11.3,2024,298,1726,2.4,16.3,2553,1021,1532,8.2,20.5,-529,-4.2,32.6,0,151,151,695
2007,31,f) 5,1675,1729,12860,13279,78,4.4,198,11.1,1633,350,1283,2.6,12.3,2470,904,1566,6.8,18.6,-837,-6.3,24.6,0,125,126,633
2007,31,g) 6 to 10,6737,7164,74811,75986,276,3.7,705,9.6,8889,1521,7368,2,11.7,11239,4327,6912,5.7,14.8,-2350,-3.1,23.4,0,452,453,3072
2007,31,h) 11 to 15,4781,5119,47329,48292,212,4,490,9.3,5931,1647,4284,3.4,12.3,7856,2440,5416,5.1,16.3,-1925,-4,24.6,0,327,327,1596
2007,31,i) 16 to 20,3738,4349,67456,68559,189,4.3,316,7.2,8766,2443,6323,3.6,12.8,10971,2939,8032,4.3,16,-2205,-3.2,25.6,0,194,194,1415
2007,31,j) 21 to 25,3083,3819,70999,72017,189,4.9,268,6.9,7276,2415,4861,3.4,10.1,9311,2614,6697,3.6,12.9,-2035,-2.8,20.2,0,148,150,1317
2007,31,k) 26+,2506,3858,81475,81621,145,3.7,236,6,7266,1337,5929,1.6,8.9,7557,1750,5807,2.1,9.3,-291,-0.4,17.8,0,103,103,596
2007,31,l) Left Censored,5841,11544,372640,369299,641,5.6,660,5.7,46041,11610,34431,3.1,12.5,39359,7799,31560,2.1,10.7,6682,1.8,21.4,0,162,166,1236
2007,32,a) 0,5961,6015,44592,22549,5877,195.4,0,0,44086,44086,0,195.5,195.5,0,0,0,0,0,44086,195.5,0,0,,,
2007,32,b) 1,4688,4811,44220,46633,37,0.7,1549,27.5,11805,393,11412,0.8,25.3,16630,7075,9555,15.2,35.7,-4825,-10.4,50.6,0,1277,1277,6022
2007,32,c) 2,3764,3899,38640,41430,162,3.8,812,19.2,7119,767,6352,1.9,17.2,12699,4490,8209,10.8,30.7,-5580,-13.5,34.4,0,648,650,3625
2007,32,d) 3,3041,3100,34407,35216,129,3.9,603,18.1,6802,1087,5715,3.1,19.3,8420,3381,5039,9.6,23.9,-1618,-4.6,38.6,0,487,487,2695
2007,32,e) 4,2518,2671,33987,34389,134,4.7,470,16.6,7736,1044,6692,3,22.5,8540,3582,4958,10.4,24.8,-804,-2.3,45,0,369,371,3099
2007,32,f) 5,2115,2180,30480,31849,99,4.3,334,14.5,5267,561,4706,1.8,16.5,8004,2912,5092,9.1,25.1,-2737,-8.6,33,0,262,262,2419
2007,32,g) 6 to 10,7534,8043,136955,138729,376,4.5,995,11.9,20791,4621,16170,3.3,15,24339,7084,17255,5.1,17.5,-3548,-2.5,30,0,672,678,4714
2007,32,h) 11 to 15,3942,4399,84833,86800,239,5.3,414,9.2,12718,2643,10075,3,14.7,16652,6133,10519,7.1,19.2,-3934,-4.5,29.4,0,268,271,3019
2007,32,i) 16 to 20,2788,3639,82076,82944,241,6.6,267,7.3,11909,2919,8990,3.5,14.4,13645,3040,10605,3.7,16.5,-1736,-2.1,28.8,0,157,157,1599
2007,32,j) 21 to 25,1950,3021,87997,83722,254,8.4,232,7.7,18414,5384,13030,6.4,22,9863,2208,7655,2.6,11.8,8551,10.2,23.6,0,114,116,1197
2007,32,k) 26+,1729,2957,96276,95591,218,7.4,224,7.6,13491,2645,10846,2.8,14.1,12121,3297,8824,3.4,12.7,1370,1.4,25.4,0,87,89,1163
2007,32,l) Left Censored,3208,9438,473257,466931,990,10.6,800,8.6,74873,25195,49678,5.4,16,62221,18013,44208,3.9,13.3,12652,2.7,26.6,0,80,86,1055
2007,33,a) 0,2317,2331,11109,5601,2279,195.5,0,0,11017,11017,0,196.7,196.7,0,0,0,0,0,11017,196.7,0,0,,,
2007,33,b) 1,2072,2161,15065,15409,26,1.1,592,24,3342,224,3118,1.5,21.7,4030,2006,2024,13,26.2,-688,-4.5,43.4,0,434,434,1542
2007,33,c) 2,1700,1726,12530,13066,72,3.9,343,18.4,2213,409,1804,3.1,16.9,3285,1467,1818,11.2,25.1,-1072,-8.2,33.8,0,288,288,1154
2007,33,d) 3,1468,1486,9749,10056,56,3.5,257,16.2,1644,240,1404,2.4,16.3,2257,991,1266,9.9,22.4,-613,-6.1,32.6,0,213,213,859
2007,33,e) 4,1286,1345,10129,10220,60,4.3,161,11.5,1969,439,1530,4.3,19.3,2150,690,1460,6.8,21,-181,-1.7,38.6,0,129,129,593
2007,33,f) 5,1118,1138,11175,11390,44,3.7,159,13.3,1516,112,1404,1,13.3,1946,788,1158,6.9,17.1,-430,-3.8,26.6,0,119,119,585
2007,33,g) 6 to 10,4973,5250,47631,49367,192,3.5,579,10.6,6242,1256,4986,2.5,12.6,9713,3535,6178,7.2,19.7,-3471,-7.1,25.2,0,401,402,2441
2007,33,h) 11 to 15,3646,3776,40803,42772,118,3,325,8.4,3871,680,3191,1.6,9.1,7808,2277,5531,5.3,18.3,-3937,-9.2,18.2,0,218,218,1405
2007,33,i) 16 to 20,3017,3364,49723,50195,139,4.1,232,6.8,5379,1224,4155,2.4,10.7,6323,1530,4793,3,12.6,-944,-1.9,21.4,0,147,147,919
2007,33,j) 21 to 25,2358,2864,45688,45985,141,4.9,211,7.3,5775,2039,3736,4.4,12.6,6368,2081,4287,4.5,13.8,-593,-1.2,25.2,0,121,122,1075
2007,33,k) 26+,1531,2300,49313,49012,143,6.2,166,7.2,6399,2145,4254,4.4,13.1,5796,1563,4233,3.2,11.8,603,1.3,23.6,0,66,74,1001
2007,33,l) Left Censored,3512,7556,266543,265401,530,7,500,6.6,30453,6962,23491,2.6,11.5,28168,5765,22403,2.2,10.6,2285,0.9,21.2,0,124,125,1227
2007,34,a) 0,16552,16598,90653,46269,16093,193.9,0,0,88769,88769,0,191.9,191.9,0,0,0,0,0,88769,191.9,0,0,,,
2007,34,b) 1,13260,13541,91375,93858,74,0.5,4064,25.8,23180,930,22250,1,24.7,28145,15067,13078,16.1,30,-4965,-5.3,49.4,0,3130,3130,11276
2007,34,c) 2,11663,11833,83858,85792,438,3.4,2193,17.3,16732,2763,13969,3.2,19.5,20599,10613,9986,12.4,24,-3867,-4.5,39,0,1791,1791,8803
2007,34,d) 3,9730,9849,78815,79844,321,3.1,1642,15.7,14196,2208,11988,2.8,17.8,16253,7609,8644,9.5,20.4,-2057,-2.6,35.6,0,1283,1283,5431
2007,34,e) 4,8516,8754,76740,79175,346,3.8,1324,14.4,13512,2942,10570,3.7,17.1,18382,7558,10824,9.5,23.2,-4870,-6.1,34.2,0,1022,1022,4814
2007,34,f) 5,7646,7756,76358,77003,289,3.6,1068,13.1,11376,1282,10094,1.7,14.8,12666,5040,7626,6.5,16.4,-1290,-1.6,29.6,0,814,819,3490
2007,34,g) 6 to 10,32351,33667,361892,370039,1141,3.3,3879,11.1,49162,8752,40410,2.4,13.3,65455,24350,41105,6.6,17.7,-16293,-4.4,26.6,0,2812,2815,17737
2007,34,h) 11 to 15,21439,22449,266455,271374,677,2.9,2023,8.8,33063,4532,28531,1.7,12.2,42901,13452,29449,5,15.8,-9838,-3.6,24.4,0,1439,1444,9056
2007,34,i) 16 to 20,16874,18821,272573,273699,683,3.5,1533,8,37161,9035,28126,3.3,13.6,39415,13141,26274,4.8,14.4,-2254,-0.8,27.2,0,989,999,6904
2007,34,j) 21 to 25,13059,15496,301975,302492,608,3.8,1253,7.9,38173,8280,29893,2.7,12.6,39206,13279,25927,4.4,13,-1033,-0.4,25.2,0,693,702,5195
2007,34,k) 26+,9686,12828,278042,281069,693,5.3,1079,8.3,34022,9669,24353,3.4,12.1,40075,13517,26558,4.8,14.3,-6053,-2.2,24.2,0,530,550,3168
2007,34,l) Left Censored,20336,43512,1648087,1651606,3122,7.2,3380,7.8,208698,65306,143392,4,12.6,215735,56143,159592,3.4,13.1,-7037,-0.5,25.2,0,939,953,9123
2007,35,a) 0,3210,3219,28561,14606,3129,194.4,0,0,27910,27910,0,191.1,191.1,0,0,0,0,0,27910,191.1,0,0,,,
2007,35,b) 1,2570,2640,19887,20260,27,0.9,732,24.1,5370,210,5160,1,26.5,6115,3499,2616,17.3,30.2,-745,-3.7,53,0,555,555,2525
2007,35,c) 2,2120,2172,17017,17407,83,3.6,367,15.9,3180,287,2893,1.6,18.3,3959,1684,2275,9.7,22.7,-779,-4.4,36.6,0,289,289,1311
2007,35,d) 3,1777,1854,17294,17166,100,5.1,283,14.6,4339,645,3694,3.8,25.3,4082,2012,2070,11.7,23.8,257,1.5,47.6,0,207,210,1515
2007,35,e) 4,1531,1568,15032,15259,73,4.5,216,13.3,2632,443,2189,2.9,17.2,3085,1360,1725,8.9,20.2,-453,-3,34.4,0,164,164,1133
2007,35,f) 5,1408,1482,17908,17309,68,4.4,190,12.3,4096,680,3416,3.9,23.7,2898,1308,1590,7.6,16.7,1198,7,33.4,0,126,126,676
2007,35,g) 6 to 10,5898,6262,77296,78722,274,4.3,631,9.8,11261,3023,8238,3.8,14.3,14113,4199,9914,5.3,17.9,-2852,-3.6,28.6,0,440,445,2590
2007,35,h) 11 to 15,4039,4324,50745,51590,163,3.7,424,9.5,7073,1518,5555,2.9,13.7,8763,2952,5811,5.7,17,-1690,-3.3,27.4,0,277,279,1822
2007,35,i) 16 to 20,3052,3722,59560,60370,178,4.7,275,7.3,8685,2028,6657,3.4,14.4,10304,2302,8002,3.8,17.1,-1619,-2.7,28.8,0,171,174,1109
2007,35,j) 21 to 25,2523,3238,48323,48482,152,4.6,217,6.6,5911,2014,3897,4.2,12.2,6229,1166,5063,2.4,12.8,-318,-0.6,24.4,0,109,109,578
2007,35,k) 26+,2054,3238,58199,59245,163,5,203,6.2,7280,2002,5278,3.4,12.3,9371,2185,7186,3.7,15.8,-2091,-3.5,24.6,0,99,105,1191
2007,35,l) Left Censored,3545,8327,235041,234757,552,6.6,511,6.2,30141,9784,20357,4.2,12.8,29572,6584,22988,2.8,12.6,569,0.2,25.2,0,100,103,667
2007,36,a) 0,37277,37340,184896,93837,36314,194.5,0,0,182119,182119,0,194.1,194.1,0,0,0,0,0,182119,194.1,0,0,,,
2007,36,b) 1,29768,30486,198501,205068,125,0.4,8411,23.9,45939,2447,43492,1.2,22.4,59072,32570,26502,15.9,28.8,-13133,-6.4,44.8,0,6543,6543,27791
2007,36,c) 2,25320,25683,182014,186728,927,3.4,4792,17.4,35527,4972,30555,2.7,19,44955,24019,20936,12.9,24.1,-9428,-5.1,38,0,3845,3846,20043
2007,36,d) 3,21664,21871,156332,159271,761,3.3,3709,15.9,28126,4186,23940,2.6,17.7,34004,17683,16321,11.1,21.3,-5878,-3.6,35.4,0,3003,3013,13616
2007,36,e) 4,18917,19444,155397,155484,683,3.3,2901,14.1,31846,5241,26605,3.4,20.5,32020,15006,17014,9.7,20.6,-174,-0.1,41,0,2275,2275,10519
2007,36,f) 5,16902,17226,156233,160224,570,3.2,2303,12.7,23000,3098,19902,1.9,14.4,30981,14613,16368,9.1,19.3,-7981,-4.9,28.8,0,1762,1762,11954
2007,36,g) 6 to 10,66880,69817,704332,718702,2294,3.2,7841,10.8,99554,14985,84569,2.1,13.9,128295,46863,81432,6.5,17.9,-28741,-4,27.8,0,5709,5728,30897
2007,36,h) 11 to 15,43313,45274,516509,523101,1369,2.9,4053,8.7,63352,10810,52542,2.1,12.1,76535,28461,48074,5.4,14.6,-13183,-2.5,24.2,0,2909,2932,20336
2007,36,i) 16 to 20,36079,39574,610461,617415,1285,3.2,3024,7.5,68328,12437,55891,2,11.1,82236,23686,58550,3.8,13.3,-13908,-2.2,22.2,0,1920,1936,13475
2007,36,j) 21 to 25,28144,33025,528571,535673,1099,3.3,2402,7.1,59600,14082,45518,2.6,11.1,73803,24862,48941,4.6,13.8,-14203,-2.7,22.2,0,1344,1353,9571
2007,36,k) 26+,19446,27563,634508,634683,1155,4.1,1821,6.5,71150,16325,54825,2.6,11.2,71499,16406,55093,2.6,11.3,-349,-0.1,22.4,0,963,1010,7867
2007,36,l) Left Censored,44428,92151,3507916,3523698,5749,6.2,6697,7.2,412500,129560,282940,3.7,11.7,444065,136606,307459,3.9,12.6,-31565,-0.9,23.4,0,1848,1929,18703
2007,37,a) 0,15878,15950,87478,44313,15545,194.9,0,0,86331,86331,0,194.8,194.8,0,0,0,0,0,86331,194.8,0,0,,,
2007,37,b) 1,12511,12947,94850,98933,94,0.6,3551,23.9,24710,1329,23381,1.3,25,32876,15919,16957,16.1,33.2,-8166,-8.2,50,0,2695,2724,12633
2007,37,c) 2,10713,10885,86361,89728,390,3.4,1893,16.3,18407,2197,16210,2.4,20.5,25140,14087,11053,15.7,28,-6733,-7.5,41,0,1523,1531,11787
2007,37,d) 3,8792,9026,77260,77890,351,3.7,1318,13.9,15974,2722,13252,3.5,20.5,17233,6941,10292,8.9,22.1,-1259,-1.6,41,0,1059,1059,5718
2007,37,e) 4,7664,8113,77783,77144,354,4.2,995,11.8,15352,3140,12212,4.1,19.9,14073,5928,8145,7.7,18.2,1279,1.7,36.4,0,797,798,4625
2007,37,f) 5,6686,6900,67104,69562,238,3.3,878,12.2,10557,1654,8903,2.4,15.2,15473,5851,9622,8.4,22.2,-4916,-7,30.4,0,655,655,4077
2007,37,g) 6 to 10,28333,30484,339554,345154,1212,3.9,3207,10.2,51446,10050,41396,2.9,14.9,62646,22670,39976,6.6,18.2,-11200,-3.3,29.8,0,2234,2252,13683
2007,37,h) 11 to 15,17794,19502,252471,251161,814,4.1,1743,8.7,41986,8434,33552,3.4,16.7,39366,13191,26175,5.3,15.7,2620,1,31.4,0,1183,1198,7694
2007,37,i) 16 to 20,13718,16536,294899,295759,747,4.5,1234,7.4,37165,10297,26868,3.5,12.6,38885,9677,29208,3.3,13.1,-1720,-0.5,25.2,0,734,742,5055
2007,37,j) 21 to 25,12198,15221,238828,240028,659,4.3,1067,6.9,30228,8093,22135,3.4,12.6,32627,8952,23675,3.7,13.6,-2399,-1,25.2,0,524,546,3712
2007,37,k) 26+,7801,13114,321845,321096,892,6.8,875,6.7,39348,11387,27961,3.5,12.3,37849,10702,27147,3.3,11.8,1499,0.5,23.6,0,345,348,2970
2007,37,l) Left Censored,15775,45895,1646131,1637129,3882,8.6,2859,6.3,219985,71089,148896,4.3,13.4,201980,52427,149553,3.2,12.3,18005,1.1,24.6,0,576,634,7727
2007,38,a) 0,1381,1391,7519,3793,1352,194.4,0,0,7453,7453,0,196.5,196.5,0,0,0,0,0,7453,196.5,0,0,,,
2007,38,b) 1,1102,1146,8615,8728,6,0.5,326,24.7,2211,128,2083,1.5,25.3,2439,1496,943,17.1,27.9,-228,-2.6,50.6,0,213,213,1086
2007,38,c) 2,911,925,5382,5691,49,5,163,16.6,941,203,738,3.6,16.5,1558,793,765,13.9,27.4,-617,-10.9,33,0,108,108,615
2007,38,d) 3,780,804,5376,5715,44,5.2,122,14.4,967,302,665,5.3,16.9,1644,510,1134,8.9,28.8,-677,-11.9,33.8,0,81,81,394
2007,38,e) 4,679,699,4305,4381,38,5.2,98,13.5,757,145,612,3.3,17.3,908,388,520,8.9,20.7,-151,-3.4,34.6,0,58,58,260
2007,38,f) 5,672,692,4978,4954,37,5.2,77,10.9,876,222,654,4.5,17.7,828,316,512,6.4,16.7,48,1,33.4,0,47,47,223
2007,38,g) 6 to 10,2638,2785,25513,25458,132,4.6,293,10.3,4264,1042,3222,4.1,16.7,4154,1520,2634,6,16.3,110,0.4,32.6,0,176,176,1153
2007,38,h) 11 to 15,2168,2234,20629,20712,140,6.2,199,8.8,2682,723,1959,3.5,12.9,2847,844,2003,4.1,13.7,-165,-0.8,25.8,0,110,110,428
2007,38,i) 16 to 20,1663,1812,22605,22493,77,4.2,137,7.4,2850,339,2511,1.5,12.7,2626,930,1696,4.1,11.7,224,1,23.4,0,63,63,604
2007,38,j) 21 to 25,1385,1712,19855,20084,65,3.8,97,5.6,2192,517,1675,2.6,10.9,2650,685,1965,3.4,13.2,-458,-2.3,21.8,0,47,48,305
2007,38,k) 26+,1189,1627,27196,27634,75,4.6,87,5.3,3338,905,2433,3.3,12.1,4213,1261,2952,4.6,15.2,-875,-3.1,24.2,0,42,42,1011
2007,38,l) Left Censored,2679,4942,139231,136992,247,5,307,6.2,18093,6171,11922,4.5,13.2,13614,3416,10198,2.5,9.9,4479,3.3,19.8,0,80,90,777
2007,39,a) 0,13192,13325,94325,47774,12971,194.7,0,0,93102,93102,0,194.9,194.9,0,0,0,0,0,93102,194.9,0,0,,,
2007,39,b) 1,11247,11627,103764,106179,99,0.7,3204,24,27139,1296,25843,1.2,25.6,31968,17539,14429,16.5,30.1,-4829,-4.5,51.2,0,2508,2517,14325
2007,39,c) 2,9686,9971,94442,97240,366,3.4,1780,16.7,17959,3212,14747,3.3,18.5,23555,10342,13213,10.6,24.2,-5596,-5.7,37,0,1417,1417,8750
2007,39,d) 3,8448,8681,77070,80754,318,3.5,1365,14.9,13501,2097,11404,2.6,16.7,20869,11142,9727,13.8,25.8,-7368,-9.1,33.4,0,1082,1082,9667
2007,39,e) 4,7448,7953,77644,78107,309,3.7,1115,13.4,14670,2280,12390,2.9,18.8,15596,6990,8606,8.9,20,-926,-1.2,37.6,0,879,879,5515
2007,39,f) 5,7129,7488,81502,83865,280,3.6,983,12.6,11734,2284,9450,2.7,14,16459,6681,9778,8,19.6,-4725,-5.6,28,0,728,735,4377
2007,39,g) 6 to 10,29913,32535,362164,373994,1340,4,3721,11.1,50612,11782,38830,3.2,13.5,74271,27496,46775,7.4,19.9,-23659,-6.4,27,0,2496,2519,17928
2007,39,h) 11 to 15,22964,25213,304213,310743,905,3.5,2432,9.4,36768,7826,28942,2.5,11.8,49828,16418,33410,5.3,16,-13060,-4.2,23.6,0,1575,1636,11141
2007,39,i) 16 to 20,18528,22641,359595,363252,923,4,1824,7.9,45107,9844,35263,2.7,12.4,52421,16028,36393,4.4,14.4,-7314,-2,24.8,0,1087,1095,8526
2007,39,j) 21 to 25,15058,19219,343557,345542,782,4,1480,7.6,40983,10367,30616,3,11.9,44952,15556,29396,4.5,13,-3969,-1.1,23.8,0,694,724,4935
2007,39,k) 26+,12147,18403,401302,404225,909,4.9,1239,6.7,47494,14043,33451,3.5,11.7,53339,12109,41230,3,13.2,-5845,-1.5,23.4,0,538,568,4150
2007,39,l) Left Censored,28137,69751,2478615,2488511,4897,7,4446,6.4,280443,91011,189432,3.7,11.3,300236,72214,228022,2.9,12.1,-19793,-0.8,22.6,0,967,1034,10648
2007,40,a) 0,6163,6196,37181,18858,6023,194.4,0,0,36646,36646,0,194.3,194.3,0,0,0,0,0,36646,194.3,0,0,,,
2007,40,b) 1,4797,4953,38255,40282,46,0.8,1442,25.1,10181,953,9228,2.4,25.3,14235,8431,5804,20.9,35.3,-4054,-10,50.6,0,1153,1153,7186
2007,40,c) 2,4058,4166,38252,39070,158,3.6,683,15.4,6900,1048,5852,2.7,17.7,8535,3681,4854,9.4,21.8,-1635,-4.1,35.4,0,548,548,2960
2007,40,d) 3,3295,3359,28788,29112,123,3.5,542,15.2,5670,909,4761,3.1,19.5,6318,2986,3332,10.3,21.7,-648,-2.2,39,0,439,439,2268
2007,40,e) 4,3000,3089,28073,27890,101,3.1,398,12.3,5451,567,4884,2,19.5,5085,2428,2657,8.7,18.2,366,1.3,36.4,0,326,326,2040
2007,40,f) 5,2771,2893,26146,26953,116,3.9,335,11.2,3772,470,3302,1.7,14,5386,2702,2684,10,20,-1614,-6,28,0,246,248,1688
2007,40,g) 6 to 10,11127,12249,131483,133425,530,4.2,1270,10.1,21810,5293,16517,4,16.3,25694,9405,16289,7,19.3,-3884,-3,32.6,0,910,916,6594
2007,40,h) 11 to 15,7745,8296,85201,87636,262,3.1,733,8.6,10914,1943,8971,2.2,12.5,15784,5482,10302,6.3,18,-4870,-5.5,25,0,489,490,3425
2007,40,i) 16 to 20,5676,6697,113825,111373,321,4.7,526,7.7,20506,4576,15930,4.1,18.4,15601,4924,10677,4.4,14,4905,4.4,28,0,318,319,2786
2007,40,j) 21 to 25,5690,6793,101702,100370,248,3.6,442,6.4,14109,2404,11705,2.4,14.1,11444,3113,8331,3.1,11.4,2665,2.7,22.8,0,225,239,1176
2007,40,k) 26+,4150,6339,134734,134114,318,5,414,6.5,16331,3968,12363,3,12.2,15091,3124,11967,2.3,11.3,1240,0.9,22.6,0,196,201,996
2007,40,l) Left Censored,7337,17976,535230,535532,1272,7.1,1043,5.8,70215,18933,51282,3.5,13.1,70819,16411,54408,3.1,13.2,-604,-0.1,26.2,0,238,255,1972
2007,41,a) 0,8428,8462,40383,20486,8277,195.6,0,0,39794,39794,0,194.2,194.2,0,0,0,0,0,39794,194.2,0,0,,,
2007,41,b) 1,6832,7104,43325,44594,44,0.5,1931,23.7,10128,369,9759,0.8,22.7,12666,7444,5222,16.7,28.4,-2538,-5.7,45.4,0,1515,1515,6340
2007,41,c) 2,5617,5751,36808,38639,217,3.5,1088,17.6,7878,1026,6852,2.7,20.4,11539,5563,5976,14.4,29.9,-3661,-9.5,40.8,0,825,825,4228
2007,41,d) 3,4501,4608,36448,36344,206,4.2,718,14.8,7902,1937,5965,5.3,21.7,7694,3798,3896,10.5,21.2,208,0.5,42.4,0,524,544,2931
2007,41,e) 4,3997,4261,30526,30418,208,4.7,502,11.4,6502,1630,4872,5.4,21.4,6286,2798,3488,9.2,20.7,216,0.7,41.4,0,381,381,2162
2007,41,f) 5,3615,3694,31951,31931,151,4,425,11.1,5797,682,5115,2.1,18.2,5756,2262,3494,7.1,18,41,0.2,36,0,307,307,1528
2007,41,g) 6 to 10,14783,15695,146264,147373,682,4.2,1617,10,23210,3994,19216,2.7,15.7,25427,9638,15789,6.5,17.3,-2217,-1.6,31.4,0,1061,1067,6361
2007,41,h) 11 to 15,10163,10844,125960,127078,428,3.8,1001,9,17309,3047,14262,2.4,13.6,19545,6765,12780,5.3,15.4,-2236,-1.8,27.2,0,604,616,3419
2007,41,i) 16 to 20,7085,8292,120051,120562,366,4.3,626,7.4,15900,3856,12044,3.2,13.2,16922,4242,12680,3.5,14,-1022,-0.8,26.4,0,386,392,2421
2007,41,j) 21 to 25,5348,7050,135281,136784,286,4,481,6.7,15959,3627,12332,2.7,11.7,18965,4067,14898,3,13.9,-3006,-2.2,23.4,0,241,247,1356
2007,41,k) 26+,4575,6601,130953,130991,327,4.9,485,7.3,15533,3619,11914,2.8,11.9,15608,3537,12071,2.7,11.9,-75,0,23.8,0,213,228,1435
2007,41,l) Left Censored,7563,18731,601303,601411,1265,6.8,1040,5.6,66392,18014,48378,3,11,66608,16581,50027,2.8,11.1,-216,-0.1,22,0,228,234,2208
2007,42,a) 0,16179,16253,92113,46729,15847,195,0,0,90769,90769,0,194.2,194.2,0,0,0,0,0,90769,194.2,0,0,,,
2007,42,b) 1,13486,13940,113082,117599,79,0.5,3605,22.7,25601,1574,24027,1.3,21.8,34634,19836,14798,16.9,29.5,-9033,-7.7,43.6,0,2736,2736,16249
2007,42,c) 2,12040,12329,103155,105023,435,3.3,1962,15,18198,2253,15945,2.1,17.3,21933,10042,11891,9.6,20.9,-3735,-3.6,34.6,0,1567,1567,8145
2007,42,d) 3,10225,10523,87177,87719,351,3.1,1576,14.1,16921,2139,14782,2.4,19.3,18005,8435,9570,9.6,20.5,-1084,-1.2,38.6,0,1241,1241,6151
2007,42,e) 4,9020,9409,93439,92882,334,3.4,1173,11.9,17125,4632,12493,5,18.4,16011,6898,9113,7.4,17.2,1114,1.2,34.4,0,873,874,4792
2007,42,f) 5,8725,8982,98255,99567,295,3.2,1055,11.3,13850,2228,11622,2.2,13.9,16474,6332,10142,6.4,16.5,-2624,-2.6,27.8,0,764,764,4230
2007,42,g) 6 to 10,35957,38643,437793,441320,1375,3.5,3770,9.5,63156,15413,47743,3.5,14.3,70209,24311,45898,5.5,15.9,-7053,-1.6,28.6,0,2546,2555,15402
2007,42,h) 11 to 15,24968,26884,336175,340953,841,3,2289,8.3,38930,8331,30599,2.4,11.4,48486,15442,33044,4.5,14.2,-9556,-2.8,22.8,0,1541,1554,9346
2007,42,i) 16 to 20,22641,25811,366132,370096,944,3.6,1836,7,40194,8306,31888,2.2,10.9,48122,14394,33728,3.9,13,-7928,-2.1,21.8,0,1180,1190,7440
2007,42,j) 21 to 25,18133,23123,442216,445576,1033,4.4,1832,7.8,58153,16968,41185,3.8,13.1,64873,22485,42388,5,14.6,-6720,-1.5,26.2,0,848,890,6070
2007,42,k) 26+,13290,19551,430950,428124,959,4.9,1409,7.1,54430,14030,40400,3.3,12.7,48777,14421,34356,3.4,11.4,5653,1.3,22.8,0,616,655,4742
2007,42,l) Left Censored,30691,72892,2593086,2590814,4652,6.4,4795,6.6,299346,85451,213895,3.3,11.6,294801,78512,216289,3,11.4,4545,0.2,22.8,0,1055,1140,13413
2007,44,a) 0,1774,1781,11360,5708,1747,196.2,0,0,11305,11305,0,198.1,198.1,0,0,0,0,0,11305,198.1,0,0,,,
2007,44,b) 1,1501,1555,9190,9542,8,0.4,500,27.4,2054,172,1882,1.8,21.5,2758,1444,1314,15.1,28.9,-704,-7.4,43,0,369,369,1147
2007,44,c) 2,1323,1332,8433,8810,44,3.1,240,16.8,1277,140,1137,1.6,14.5,2030,973,1057,11,23,-753,-8.5,29,0,178,178,763
2007,44,d) 3,1174,1192,9825,10062,40,3.2,203,16,1397,149,1248,1.5,13.9,1871,747,1124,7.4,18.6,-474,-4.7,27.8,0,166,166,614
2007,44,e) 4,1032,1062,8548,8624,38,3.4,142,12.8,1348,171,1177,2,15.6,1500,624,876,7.2,17.4,-152,-1.8,31.2,0,106,108,546
2007,44,f) 5,894,901,6585,6860,26,2.7,138,14.4,1030,243,787,3.5,15,1580,649,931,9.5,23,-550,-8,30,0,104,104,492
2007,44,g) 6 to 10,3690,3895,34244,35120,139,3.4,468,11.5,4511,640,3871,1.8,12.8,6262,2494,3768,7.1,17.8,-1751,-5,25.6,0,308,310,1789
2007,44,h) 11 to 15,2645,2706,27935,28716,76,2.7,259,9.2,3396,660,2736,2.3,11.8,4958,2043,2915,7.1,17.3,-1562,-5.5,23.6,0,181,183,1627
2007,44,i) 16 to 20,2374,2609,39190,39380,104,3.9,181,6.8,5160,859,4301,2.2,13.1,5540,1843,3697,4.7,14.1,-380,-1,26.2,0,114,120,1420
2007,44,j) 21 to 25,1778,2123,32003,32480,86,4,124,5.8,3874,1204,2670,3.7,11.9,4827,1128,3699,3.5,14.9,-953,-3,23.8,0,68,68,617
2007,44,k) 26+,1371,1755,35380,35015,75,4.2,105,5.9,4220,998,3222,2.9,12.1,3489,747,2742,2.1,10,731,2.1,20,0,51,53,329
2007,44,l) Left Censored,3593,6067,218880,217963,358,5.9,369,6.1,23067,4554,18513,2.1,10.6,21233,4980,16253,2.3,9.7,1834,0.9,19.4,0,119,120,1012
2007,45,a) 0,7483,7552,47387,23934,7391,195.7,0,0,46906,46906,0,196,196,0,0,0,0,0,46906,196,0,0,,,
2007,45,b) 1,5934,6129,44263,46260,104,1.5,1670,23.9,10501,628,9873,1.4,22.7,14495,7670,6825,16.6,31.3,-3994,-8.6,45.4,0,1314,1314,6553
2007,45,c) 2,5077,5199,43593,44006,173,3.1,915,16.4,9840,987,8853,2.2,22.4,10665,5324,5341,12.1,24.2,-825,-1.8,44.8,0,761,761,4496
2007,45,d) 3,4124,4219,36943,37578,157,3.5,635,14.3,6893,819,6074,2.2,18.3,8163,3915,4248,10.4,21.7,-1270,-3.4,36.6,0,514,514,3384
2007,45,e) 4,3656,3877,40811,42131,161,4,550,13.5,7036,1928,5108,4.6,16.7,9675,3224,6451,7.7,23,-2639,-6.3,33.4,0,430,430,2362
2007,45,f) 5,3337,3435,31421,31707,122,3.4,451,12.6,5534,733,4801,2.3,17.5,6105,2786,3319,8.8,19.3,-571,-1.8,35,0,338,338,1940
2007,45,g) 6 to 10,13420,14322,174429,176560,510,3.4,1510,10.2,25484,5387,20097,3.1,14.4,29745,11706,18039,6.6,16.8,-4261,-2.4,28.8,0,1069,1075,7857
2007,45,h) 11 to 15,8528,9306,121487,122958,377,4,843,8.8,14507,2720,11787,2.2,11.8,17449,5285,12164,4.3,14.2,-2942,-2.4,23.6,0,590,606,3506
2007,45,i) 16 to 20,6464,8106,129313,130344,355,4.3,640,7.8,16672,4353,12319,3.3,12.8,18734,4478,14256,3.4,14.4,-2062,-1.6,25.6,0,418,425,2413
2007,45,j) 21 to 25,5643,7181,120449,118266,330,4.6,462,6.4,21830,5903,15927,5,18.5,17464,5892,11572,5,14.8,4366,3.7,29.6,0,238,241,1821
2007,45,k) 26+,3757,6224,125534,125663,385,6.2,377,6.1,16892,4642,12250,3.7,13.4,17149,3189,13960,2.5,13.6,-257,-0.2,26.8,0,143,158,1241
2007,45,l) Left Censored,7942,22039,724625,727715,1703,7.8,1182,5.4,90024,29922,60102,4.1,12.4,96203,23253,72950,3.2,13.2,-6179,-0.8,24.8,0,287,328,3775
2007,46,a) 0,1793,1805,8149,4157,1739,192.7,0,0,7984,7984,0,192.1,192.1,0,0,0,0,0,7984,192.1,0,0,,,
2007,46,b) 1,1452,1475,9190,9500,8,0.5,401,23.6,2350,137,2213,1.4,24.7,2970,1861,1109,19.6,31.3,-620,-6.6,49.4,0,281,281,1530
2007,46,c) 2,1128,1142,6027,6424,55,4.5,227,18.5,1225,185,1040,2.9,19.1,2019,1025,994,16,31.4,-794,-12.3,38.2,0,168,168,826
2007,46,d) 3,1049,1077,6806,6822,55,4.9,144,12.8,1422,204,1218,3,20.8,1454,707,747,10.4,21.3,-32,-0.5,41.6,0,106,106,595
2007,46,e) 4,949,1001,6746,6610,53,5.2,105,10.2,1481,392,1089,5.9,22.4,1208,506,702,7.7,18.3,273,4.1,36.6,0,71,71,383
2007,46,f) 5,943,960,7189,7232,47,4.7,115,11.6,1177,243,934,3.4,16.3,1262,503,759,7,17.5,-85,-1.2,32.6,0,78,78,377
2007,46,g) 6 to 10,3458,3602,30891,31160,139,3.7,363,9.8,4717,1265,3452,4.1,15.1,5255,1992,3263,6.4,16.9,-538,-1.8,30.2,0,208,208,1109
2007,46,h) 11 to 15,2511,2610,25883,25395,107,4,228,8.5,4174,1357,2817,5.3,16.4,3197,1082,2115,4.3,12.6,977,3.8,25.2,0,140,140,731
2007,46,i) 16 to 20,1780,1958,25189,25759,101,5.1,169,8.5,2975,1040,1935,4,11.5,4115,1437,2678,5.6,16,-1140,-4.5,23,0,92,92,563
2007,46,j) 21 to 25,1424,1743,21414,21415,70,4,111,6.3,2795,1134,1661,5.3,13.1,2796,959,1837,4.5,13.1,-1,0,26.2,0,69,72,448
2007,46,k) 26+,1195,1624,24029,24135,65,4,101,6.1,2541,766,1775,3.2,10.5,2753,618,2135,2.6,11.4,-212,-0.9,21,0,49,49,245
2007,46,l) Left Censored,2764,5162,155280,154956,282,5.5,268,5.2,15872,3496,12376,2.3,10.2,15223,3702,11521,2.4,9.8,649,0.4,19.6,0,80,81,727
2007,47,a) 0,8742,8840,56481,28533,8671,196.2,0,0,55897,55897,0,195.9,195.9,0,0,0,0,0,55897,195.9,0,0,,,
2007,47,b) 1,6912,7159,59532,62037,87,1.1,1937,23.7,17049,2537,14512,4.1,27.5,22058,10688,11370,17.2,35.6,-5009,-8.1,55,0,1586,1586,9055
2007,47,c) 2,5764,5938,55036,58283,188,2.9,1128,17.6,11152,1265,9887,2.2,19.1,17645,6039,11606,10.4,30.3,-6493,-11.2,38.2,0,966,967,5300
2007,47,d) 3,4845,5005,48688,49149,177,3.3,788,14.9,11343,1360,9983,2.8,23.1,12264,5623,6641,11.4,25,-921,-1.9,46.2,0,657,657,4856
2007,47,e) 4,4256,4458,45580,46245,157,3.4,602,12.9,8932,1272,7660,2.8,19.3,10264,5665,4599,12.2,22.2,-1332,-2.9,38.6,0,484,485,3045
2007,47,f) 5,3700,3915,42134,43732,172,4.2,526,12.9,7146,1959,5187,4.5,16.3,10341,4928,5413,11.3,23.6,-3195,-7.3,32.6,0,388,402,3309
2007,47,g) 6 to 10,15274,16751,210475,216476,651,3.8,1662,9.6,31247,5055,26192,2.3,14.4,43249,14175,29074,6.5,20,-12002,-5.6,28.8,0,1172,1184,9183
2007,47,h) 11 to 15,11237,12445,170890,171735,499,3.9,1129,8.9,32304,5922,26382,3.4,18.8,33994,11934,22060,6.9,19.8,-1690,-1,37.6,0,779,788,5547
2007,47,i) 16 to 20,8708,10792,211490,206792,465,4.2,805,7.3,35849,7098,28751,3.4,17.3,26452,8297,18155,4,12.8,9397,4.5,25.6,0,498,499,3326
2007,47,j) 21 to 25,7952,9989,172757,176074,411,4.1,679,6.7,20460,3519,16941,2,11.6,27094,7033,20061,4,15.4,-6634,-3.8,23.2,0,342,351,2376
2007,47,k) 26+,5505,9480,234166,233645,606,6.3,832,8.7,39198,10775,28423,4.6,16.8,38156,13059,25097,5.6,16.3,1042,0.5,32.6,0,257,267,1655
2007,47,l) Left Censored,11312,31518,1184982,1182161,2362,7.6,1887,6,141662,41274,100388,3.5,12,136019,30408,105611,2.6,11.5,5643,0.5,23,0,374,414,3172
2007,48,a) 0,37580,37887,261045,131872,37100,195.8,0,0,258346,258346,0,195.9,195.9,0,0,0,0,0,258346,195.9,0,0,,,
2007,48,b) 1,28748,29836,256226,262108,242,0.7,8210,24,71588,4450,67138,1.7,27.3,83352,49188,34164,18.8,31.8,-11764,-4.5,54.6,0,6760,6760,41922
2007,48,c) 2,24043,25172,269632,270218,1030,3.8,4652,17.2,65219,8455,56764,3.1,24.1,66391,34131,32260,12.6,24.6,-1172,-0.5,48.2,0,3820,3820,28364
2007,48,d) 3,20594,21159,218802,218241,797,3.6,3399,15.2,46854,5767,41087,2.6,21.5,45731,22905,22826,10.5,21,1123,0.5,42,0,2780,2788,17622
2007,48,e) 4,18080,19319,213523,210822,828,4.1,2637,13.1,47044,9259,37785,4.4,22.3,41641,18119,23522,8.6,19.8,5403,2.5,39.6,0,2093,2097,13039
2007,48,f) 5,15911,16839,205067,205587,689,3.9,2193,12.5,38381,6897,31484,3.4,18.7,39420,18800,20620,9.1,19.2,-1039,-0.5,37.4,0,1643,1658,12367
2007,48,g) 6 to 10,61991,67796,915726,921826,2989,4.3,7395,10.6,156150,32321,123829,3.5,16.9,168350,65057,103293,7.1,18.3,-12200,-1.4,33.8,0,5205,5275,41656
2007,48,h) 11 to 15,42183,47281,672829,671922,2065,4.3,4176,8.6,112421,29382,83039,4.4,16.7,110607,34356,76251,5.1,16.5,1814,0.2,33,0,2821,2856,19727
2007,48,i) 16 to 20,30445,37839,727009,721258,2092,5.5,3034,7.9,118622,25843,92779,3.6,16.4,107120,30483,76637,4.2,14.9,11502,1.5,29.8,0,1748,1801,15795
2007,48,j) 21 to 25,26125,35300,644531,640595,1936,5.4,2630,7.4,101829,29577,72252,4.6,15.9,93957,27264,66693,4.3,14.7,7872,1.2,29.4,0,1276,1327,9619
2007,48,k) 26+,19084,31953,704862,698863,2053,6.4,2015,6.3,101375,31945,69430,4.6,14.5,89377,19630,69747,2.8,12.8,11998,1.7,25.6,0,882,909,5362
2007,48,l) Left Censored,28206,102233,3819669,3774520,9070,8.9,7400,7.3,583244,193457,389787,5.1,15.5,492946,154809,338137,4.1,13.1,90298,2.4,26.2,0,1082,1191,17692
2007,49,a) 0,7160,7184,36952,18851,6945,193.3,0,0,36203,36203,0,192,192,0,0,0,0,0,36203,192,0,0,,,
2007,49,b) 1,5217,5358,38681,38516,46,0.7,1515,24.5,11311,490,10821,1.3,29.4,10980,6374,4606,16.5,28.5,331,0.9,57,0,1147,1147,5153
2007,49,c) 2,4016,4076,33474,33787,179,4.1,765,17.5,7118,876,6242,2.6,21.1,7743,3914,3829,11.6,22.9,-625,-1.8,42.2,0,584,584,3131
2007,49,d) 3,3273,3336,28925,29163,157,4.5,526,15,6678,894,5784,3.1,22.9,7153,3820,3333,13.1,24.5,-475,-1.6,45.8,0,415,415,3050
2007,49,e) 4,2884,2958,34170,33600,121,3.9,464,14.9,7515,1085,6430,3.2,22.4,6374,3404,2970,10.1,19,1141,3.4,38,0,358,358,2763
2007,49,f) 5,2586,2670,29147,28853,116,4.2,304,11,5738,557,5181,1.9,19.9,5150,1924,3226,6.7,17.8,588,2.1,35.6,0,226,226,1442
2007,49,g) 6 to 10,9037,9553,123819,122682,445,4.5,949,9.7,22151,3034,19117,2.5,18.1,19876,7355,12521,6,16.2,2275,1.9,32.4,0,618,620,4523
2007,49,h) 11 to 15,5285,5639,83004,83206,218,3.8,447,7.8,11825,1971,9854,2.4,14.2,12228,3963,8265,4.8,14.7,-403,-0.5,28.4,0,284,290,2327
2007,49,i) 16 to 20,3228,3846,95477,93902,189,4.9,246,6.4,13061,2616,10445,2.8,13.9,9910,2451,7459,2.6,10.6,3151,3.3,21.2,0,136,136,1285
2007,49,j) 21 to 25,2345,3242,74177,70575,223,6.9,215,6.6,14287,4273,10014,6.1,20.2,7083,2041,5042,2.9,10,7204,10.2,20,0,112,113,1077
2007,49,k) 26+,2093,3195,75881,76041,202,6.3,182,5.7,9726,2494,7232,3.3,12.8,10046,1688,8358,2.2,13.2,-320,-0.4,25.6,0,85,87,556
2007,49,l) Left Censored,3877,10450,433364,429541,849,8.1,804,7.7,60697,14839,45858,3.5,14.1,53051,15491,37560,3.6,12.4,7646,1.7,24.8,0,115,122,1388
2007,50,a) 0,1313,1321,7730,3900,1284,194.4,0,0,7660,,,,196.4,0,0,0,0,0,7660,196.4,0,1,,,
2007,50,b) 1,1066,1080,5637,6050,3,0.2,267,21.8,1205,,,,19.9,2031,1294,737,21.4,33.6,-826,-13.7,39.8,1,192,192,692
2007,50,c) 2,853,858,5257,5474,35,3.8,154,16.7,1018,165,853,3,18.6,1452,737,715,13.5,26.5,-434,-7.9,37.2,0,121,121,649
2007,50,d) 3,829,840,5199,5339,31,3.5,130,14.7,811,84,727,1.6,15.2,1091,496,595,9.3,20.4,-280,-5.2,30.4,0,97,97,424
2007,50,e) 4,741,762,4808,4790,30,3.8,89,11.2,739,183,556,3.8,15.4,703,288,415,6,14.7,36,0.7,29.4,0,65,65,229
2007,50,f) 5,677,686,4923,5002,33,4.7,84,11.9,669,73,596,1.5,13.4,826,278,548,5.6,16.5,-157,-3.1,26.8,0,54,54,204
2007,50,g) 6 to 10,2929,3053,25962,26309,98,3.1,291,9.2,3130,316,2814,1.2,11.9,3823,1262,2561,4.8,14.5,-693,-2.6,23.8,0,185,186,802
2007,50,h) 11 to 15,2145,2277,20251,20768,71,3.1,178,7.6,2180,267,1913,1.3,10.5,3213,753,2460,3.6,15.5,-1033,-5,21,0,124,126,539
2007,50,i) 16 to 20,2010,2138,27775,24733,82,3.8,177,8.1,9072,452,8620,1.8,36.7,2987,935,2052,3.8,12.1,6085,24.6,24.2,0,110,110,428
2007,50,j) 21 to 25,1540,1791,31667,31695,73,4,132,7.2,3248,824,2424,2.6,10.2,3304,961,2343,3,10.4,-56,-0.2,20.4,0,56,56,221
2007,50,k) 26+,1026,1370,22550,22879,57,4.1,109,7.8,2114,512,1602,2.2,9.2,2772,671,2101,2.9,12.1,-658,-2.9,18.4,0,41,46,291
2007,50,l) Left Censored,2140,3851,109773,109988,263,6.8,293,7.6,10509,2753,7756,2.5,9.6,10941,3173,7768,2.9,9.9,-432,-0.3,19.2,0,70,70,639
2007,51,a) 0,13413,13454,67513,34208,13118,195,0,0,66610,66610,0,194.7,194.7,0,0,0,0,0,66610,194.7,0,0,,,
2007,51,b) 1,11111,11520,79515,82052,101,0.8,3140,23.8,20076,1303,18773,1.6,24.5,25149,12666,12483,15.4,30.7,-5073,-6.2,49,0,2410,2410,9902
2007,51,c) 2,9331,9528,71712,76529,351,3.4,1734,17,15924,3542,12382,4.6,20.8,25557,16025,9532,20.9,33.4,-9633,-12.6,41.6,0,1375,1375,13702
2007,51,d) 3,7887,8017,63603,65733,323,3.8,1284,15.1,12026,1937,10089,2.9,18.3,16286,7492,8794,11.4,24.8,-4260,-6.5,36.6,0,1017,1017,4961
2007,51,e) 4,6538,6783,61686,61371,287,4.1,905,12.8,13143,2755,10388,4.5,21.4,12512,4826,7686,7.9,20.4,631,1,40.8,0,678,678,3575
2007,51,f) 5,6059,6241,55922,58385,223,3.4,755,11.6,8948,1698,7250,2.9,15.3,13874,5326,8548,9.1,23.8,-4926,-8.5,30.6,0,561,563,3639
2007,51,g) 6 to 10,23906,25775,293433,300033,986,3.7,2717,10.2,44567,7999,36568,2.7,14.9,57767,19675,38092,6.6,19.3,-13200,-4.4,29.8,0,1792,1818,12788
2007,51,h) 11 to 15,16515,17854,225653,231499,597,3.3,1604,8.7,29466,5531,23935,2.4,12.7,41158,12137,29021,5.2,17.8,-11692,-5.1,25.4,0,1075,1088,7566
2007,51,i) 16 to 20,12947,15336,260292,261910,595,3.8,1105,7.1,34809,6555,28254,2.5,13.3,38044,9783,28261,3.7,14.5,-3235,-1.2,26.6,0,636,646,4008
2007,51,j) 21 to 25,10379,13427,246156,249642,600,4.4,983,7.2,30385,7765,22620,3.1,12.2,37357,8431,28926,3.4,15,-6972,-2.8,24.4,0,433,444,2820
2007,51,k) 26+,6919,11028,257069,256984,611,5.5,700,6.3,32638,8182,24456,3.2,12.7,32467,7754,24713,3,12.6,171,0.1,25.2,0,319,342,2546
2007,51,l) Left Censored,13826,41581,1471605,1469937,3420,8.3,2848,6.9,207948,59452,148496,4,14.1,204614,54184,150430,3.7,13.9,3334,0.2,27.8,0,429,455,4265
2007,53,a) 0,14458,14529,71234,36186,14116,194.3,0,0,70097,70097,0,193.7,193.7,0,0,0,0,0,70097,193.7,0,0,,,
2007,53,b) 1,11376,11661,73620,76094,70,0.5,3451,25.5,18817,634,18183,0.8,24.7,23764,13492,10272,17.7,31.2,-4947,-6.5,49.4,0,2620,2621,10917
2007,53,c) 2,9276,9457,64031,65443,462,4.6,1670,16.6,13525,2365,11160,3.6,20.7,16349,7701,8648,11.8,25,-2824,-4.3,41.4,0,1297,1298,6197
2007,53,d) 3,7407,7542,56828,57278,321,4,1212,15.2,11505,1773,9732,3.1,20.1,12404,5989,6415,10.5,21.7,-899,-1.6,40.2,0,902,902,4531
2007,53,e) 4,6456,6693,55374,55514,339,4.8,995,14.2,11888,1802,10086,3.2,21.4,12168,5317,6851,9.6,21.9,-280,-0.5,42.8,0,760,760,4206
2007,53,f) 5,6010,6172,55666,55940,228,3.6,738,11.5,10345,972,9373,1.7,18.5,10893,4441,6452,7.9,19.5,-548,-1,37,0,545,546,3383
2007,53,g) 6 to 10,23605,25082,260159,260010,1125,4.3,2908,11.2,48377,9386,38991,3.6,18.6,48078,17395,30683,6.7,18.5,299,0.1,37,0,1883,1905,9967
2007,53,h) 11 to 15,15772,17027,190344,191795,722,4.1,1574,9,27244,6514,20730,3.4,14.2,30146,9544,20602,5,15.7,-2902,-1.5,28.4,0,1030,1032,5672
2007,53,i) 16 to 20,11302,13100,210996,208190,645,4.8,1112,8.3,31585,6051,25534,2.9,15.2,25972,8566,17406,4.1,12.5,5613,2.7,25,0,665,675,4426
2007,53,j) 21 to 25,8808,11322,230938,230825,534,4.7,796,7,25282,5948,19334,2.6,11,25055,7627,17428,3.3,10.9,227,0.1,21.8,0,385,395,2528
2007,53,k) 26+,6632,10052,212797,210947,621,6.2,691,6.9,28585,7351,21234,3.5,13.6,24885,6678,18207,3.2,11.8,3700,1.8,23.6,0,311,318,2165
2007,53,l) Left Censored,11188,29545,1013774,1001738,2211,7.5,2009,6.8,134751,34887,99864,3.5,13.5,110678,35797,74881,3.6,11,24073,2.5,22,0,350,364,4872
2007,54,a) 0,2079,2083,11726,5925,2037,195.6,0,0,11603,11603,0,195.8,195.8,0,0,0,0,0,11603,195.8,0,0,,,
2007,54,b) 1,1836,1936,15630,16188,28,1.3,500,22.7,4367,305,4062,1.9,27,5482,3286,2196,20.3,33.9,-1115,-6.9,54,0,401,401,2855
2007,54,c) 2,1604,1641,12423,13303,56,3.2,321,18.1,2160,400,1760,3,16.2,3919,1309,2610,9.8,29.5,-1759,-13.3,32.4,0,266,266,1095
2007,54,d) 3,1358,1430,10673,11031,55,3.7,197,13.1,2010,230,1780,2.1,18.2,2725,1212,1513,11,24.7,-715,-6.5,36.4,0,160,160,1066
2007,54,e) 4,1126,1207,9065,9738,60,4.8,153,12.2,1352,199,1153,2,13.9,2697,1310,1387,13.5,27.7,-1345,-13.8,27.8,0,117,117,863
2007,54,f) 5,1043,1057,9316,9830,34,3.1,139,12.6,1730,691,1039,7,17.6,2758,1089,1669,11.1,28.1,-1028,-10.5,35.2,0,107,107,499
2007,54,g) 6 to 10,4476,4869,47554,48630,184,3.6,548,10.9,7089,1433,5656,2.9,14.6,9243,3848,5395,7.9,19,-2154,-4.4,29.2,0,377,389,2718
2007,54,h) 11 to 15,3438,3698,37416,38519,136,3.6,342,9,4730,1101,3629,2.9,12.3,6936,2201,4735,5.7,18,-2206,-5.7,24.6,0,234,238,1696
2007,54,i) 16 to 20,2767,3081,41470,42129,107,3.4,250,7.9,4754,876,3878,2.1,11.3,6071,1545,4526,3.7,14.4,-1317,-3.1,22.6,0,173,177,974
2007,54,j) 21 to 25,2605,3176,52218,52826,112,3.5,238,7.4,5425,1200,4225,2.3,10.3,6640,2234,4406,4.2,12.6,-1215,-2.3,20.6,0,127,134,899
2007,54,k) 26+,1951,3090,50273,50494,142,4.6,167,5.4,6495,2492,4003,4.9,12.9,6936,1613,5323,3.2,13.7,-441,-0.8,25.8,0,83,86,593
2007,54,l) Left Censored,4689,10119,280917,279919,658,6.5,608,6,33815,11342,22473,4.1,12.1,31819,6312,25507,2.3,11.4,1996,0.7,22.8,0,147,156,909
2007,55,a) 0,8174,8234,47808,24145,8016,194.7,0,0,47326,47326,0,196,196,0,0,0,0,0,47326,196,0,0,,,
2007,55,b) 1,6848,7137,53187,56045,75,0.9,1886,23.1,11728,993,10735,1.8,20.9,17443,8613,8830,15.4,31.1,-5715,-10.2,41.8,0,1399,1399,6776
2007,55,c) 2,5861,5937,43734,45328,214,3.4,1028,16.2,7421,1185,6236,2.6,16.4,10609,4563,6046,10.1,23.4,-3188,-7,32.8,0,818,818,3801
2007,55,d) 3,4922,5055,44784,45627,226,4.2,767,14.4,7490,1078,6412,2.4,16.4,9176,4006,5170,8.8,20.1,-1686,-3.7,32.8,0,595,596,3325
2007,55,e) 4,4460,4664,40570,41670,139,2.8,623,12.7,6473,1061,5412,2.5,15.5,8673,3237,5436,7.8,20.8,-2200,-5.3,31,0,461,461,2524
2007,55,f) 5,4375,4500,39603,41204,158,3.4,608,12.9,5424,1058,4366,2.6,13.2,8625,4381,4244,10.6,20.9,-3201,-7.7,26.4,0,428,432,2711
2007,55,g) 6 to 10,18011,19401,209500,213493,715,3.6,1871,9.4,26960,4821,22139,2.3,12.6,34946,11222,23724,5.3,16.4,-7986,-3.8,25.2,0,1187,1189,6618
2007,55,h) 11 to 15,13407,14204,155935,158312,480,3.3,1174,8.1,20118,4197,15921,2.7,12.7,24872,7683,17189,4.9,15.7,-4754,-3,25.4,0,762,764,4972
2007,55,i) 16 to 20,11013,13011,194195,193343,571,4.3,1009,7.6,25046,4954,20092,2.6,13,23342,5929,17413,3.1,12.1,1704,0.9,24.2,0,617,631,3554
2007,55,j) 21 to 25,7971,10001,171722,174715,366,3.6,712,7,18958,4257,14701,2.4,10.9,24944,7091,17853,4.1,14.3,-5986,-3.4,21.8,0,351,351,3486
2007,55,k) 26+,6281,9560,206719,206528,411,4.3,593,6.1,23599,6056,17543,2.9,11.4,23216,5566,17650,2.7,11.2,383,0.2,22.4,0,277,285,2384
2007,55,l) Left Censored,14908,32610,1281840,1281022,1928,5.9,2179,6.7,128787,36209,92578,2.8,10.1,127151,30683,96468,2.4,9.9,1636,0.2,19.8,0,500,546,5147
2007,56,a) 0,1636,1641,7168,3655,1606,195.7,0,0,7027,,,,192.3,0,0,0,0,0,7027,192.3,0,1,,,
2007,56,b) 1,1325,1363,8499,8165,18,1.2,332,21.6,2517,,,,30.8,1848,983,865,12,22.6,669,8.2,45.2,1,254,254,658
2007,56,c) 2,1017,1030,6533,6582,42,3.8,171,15.6,1426,232,1194,3.5,21.7,1524,692,832,10.5,23.2,-98,-1.5,43.4,0,125,125,430
2007,56,d) 3,830,844,4853,4929,40,4.5,117,13.3,947,130,817,2.6,19.2,1099,479,620,9.7,22.3,-152,-3.1,38.4,0,83,83,375
2007,56,e) 4,742,757,5088,5143,47,6,108,13.8,935,170,765,3.3,18.2,1044,515,529,10,20.3,-109,-2.1,36.4,0,91,91,405
2007,56,f) 5,779,786,6067,6104,35,4.3,86,10.6,989,146,843,2.4,16.2,1062,314,748,5.1,17.4,-73,-1.2,32.4,0,61,61,226
2007,56,g) 6 to 10,2779,2877,23374,23443,102,3.4,335,11.2,3882,379,3503,1.6,16.6,4019,1566,2453,6.7,17.1,-137,-0.5,33.2,0,216,216,1030
2007,56,h) 11 to 15,1871,1946,16484,16963,81,4.1,172,8.6,2080,544,1536,3.2,12.3,3037,1061,1976,6.3,17.9,-957,-5.6,24.6,0,123,124,857
2007,56,i) 16 to 20,1225,1375,20626,20548,64,4.6,113,8.1,2710,510,2200,2.5,13.2,2553,691,1862,3.4,12.4,157,0.8,24.8,0,57,59,316
2007,56,j) 21 to 25,1088,1291,16622,16822,60,4.6,71,5.5,1885,286,1599,1.7,11.2,2285,793,1492,4.7,13.6,-400,-2.4,22.4,0,49,49,498
2007,56,k) 26+,992,1376,21362,21420,82,6,90,6.5,2752,635,2117,3,12.8,2867,841,2026,3.9,13.4,-115,-0.6,25.6,0,44,49,202
2007,56,l) Left Censored,1686,3231,73512,71807,218,6.8,183,5.7,11392,2953,8439,4.1,15.9,7981,2602,5379,3.6,11.1,3411,4.8,22.2,0,43,43,450
2008,01,a) 0,5996,6083,34968,17769,5941,195.3,0,0,34398,34398,0,193.6,193.6,0,0,0,0,0,34398,193.6,0,0,,,
2008,01,b) 1,5091,5168,38842,40445,20,0.3,1576,26.2,9415,233,9182,0.6,23.3,12621,7203,5418,17.8,31.2,-3206,-7.9,46.6,0,1343,1343,6205
2008,01,c) 2,4358,4551,38127,41434,124,2.5,900,18.2,6807,775,6032,1.9,16.4,13420,7562,5858,18.3,32.4,-6613,-16,32.8,0,769,769,6932
2008,01,d) 3,3843,3975,37978,39080,124,2.9,655,15.5,6555,1033,5522,2.6,16.8,8760,3540,5220,9.1,22.4,-2205,-5.6,33.6,0,547,547,2833
2008,01,e) 4,3335,3448,33255,34167,95,2.6,558,15.2,5282,487,4795,1.4,15.5,7106,3268,3838,9.6,20.8,-1824,-5.3,31,0,486,487,3074
2008,01,f) 5,3064,3281,31640,32878,80,2.3,407,11.8,3896,411,3485,1.3,11.8,6372,3042,3330,9.3,19.4,-2476,-7.6,23.6,0,340,340,2770
2008,01,g) 6 to 10,12210,13218,158226,162532,378,2.8,1389,10.1,23453,5230,18223,3.2,14.4,32065,14212,17853,8.7,19.7,-8612,-5.3,28.8,0,1112,1115,7716
2008,01,h) 11 to 15,9284,9912,116609,119592,298,2.9,845,8.3,13698,2579,11119,2.2,11.5,19663,5704,13959,4.8,16.4,-5965,-4.9,23,0,617,618,3810
2008,01,i) 16 to 20,6632,7757,124217,125529,221,2.8,538,6.8,13963,2564,11399,2,11.1,16587,4232,12355,3.4,13.2,-2624,-2.1,22.2,0,333,334,2045
2008,01,j) 21 to 25,6082,7809,173179,172901,227,2.9,391,5,16579,3707,12872,2.1,9.6,16023,3244,12779,1.9,9.3,556,0.3,18.6,0,289,289,2352
2008,01,k) 26+,4896,8049,162911,162714,274,3.4,389,4.8,18651,3833,14818,2.4,11.5,18256,3145,15111,1.9,11.2,395,0.3,22.4,0,231,231,1580
2008,01,l) Left Censored,8217,23218,759772,758046,1232,5.3,904,3.9,83031,22644,60387,3,11,79578,18777,60801,2.5,10.5,3453,0.5,21,0,261,262,2474
2008,02,a) 0,1247,1272,6067,3089,1222,192.1,0,0,5956,5956,0,192.8,192.8,0,0,0,0,0,5956,192.8,0,0,,,
2008,02,b) 1,937,951,5235,5643,2,0.2,322,28.4,1154,,,,20.5,1970,1091,879,19.3,34.9,-816,-14.4,41,1,211,211,851
2008,02,c) 2,828,861,6085,6064,41,4.4,177,19,1273,,,,21,1231,603,628,9.9,20.3,42,0.7,40.6,1,117,117,458
2008,02,d) 3,683,694,4468,4615,42,5.7,122,16.6,836,123,713,2.7,18.1,1129,580,549,12.6,24.5,-293,-6.4,36.2,0,93,93,508
2008,02,e) 4,647,665,4658,4717,32,4.5,126,17.7,837,108,729,2.3,17.7,955,384,571,8.1,20.2,-118,-2.5,35.4,0,90,90,302
2008,02,f) 5,572,622,4498,4897,30,4.6,88,13.5,581,123,458,2.5,11.9,1379,526,853,10.7,28.2,-798,-16.3,23.8,0,57,57,466
2008,02,g) 6 to 10,2446,2616,30183,30369,100,3.7,306,11.3,4212,487,3725,1.6,13.9,4583,1349,3234,4.4,15.1,-371,-1.2,27.8,0,208,208,1007
2008,02,h) 11 to 15,1622,1678,13831,14205,75,4.3,207,11.9,1804,359,1445,2.5,12.7,2552,774,1778,5.4,18,-748,-5.3,25.4,0,120,120,532
2008,02,i) 16 to 20,1175,1278,14668,14629,58,4.4,101,7.7,1861,206,1655,1.4,12.7,1783,392,1391,2.7,12.2,78,0.5,24.4,0,62,62,267
2008,02,j) 21 to 25,1181,1462,26136,25871,50,3.4,82,5.5,3136,1432,1704,5.5,12.1,2606,494,2112,1.9,10.1,530,2,20.2,0,58,59,320
2008,02,k) 26+,979,1550,36277,36278,50,3.2,110,6.9,3930,602,3328,1.7,10.8,3932,617,3315,1.7,10.8,-2,0,21.6,0,37,37,196
2008,02,l) Left Censored,1304,3270,94822,93430,166,5.1,125,3.8,11347,2646,8701,2.8,12.1,8562,660,7902,0.7,9.2,2785,2.9,18.4,0,25,25,160
2008,04,a) 0,10832,11029,68279,34602,10745,194.8,0,0,67355,67355,0,194.7,194.7,0,0,0,0,0,67355,194.7,0,0,,,
2008,04,b) 1,8588,8723,62085,66069,51,0.5,3080,29.6,15480,544,14936,0.8,23.4,23448,12611,10837,19.1,35.5,-7968,-12.1,46.8,0,2497,2497,10934
2008,04,c) 2,7885,8091,66141,71711,272,3,1944,21.7,12460,2327,10133,3.2,17.4,23600,11791,11809,16.4,32.9,-11140,-15.5,34.8,0,1574,1590,10664
2008,04,d) 3,6302,6563,57885,62592,214,3,1292,18.2,9078,1133,7945,1.8,14.5,18492,7752,10740,12.4,29.5,-9414,-15,29,0,1073,1073,6682
2008,04,e) 4,5329,5551,54934,58301,169,2.9,904,15.3,8449,650,7799,1.1,14.5,15182,6821,8361,11.7,26,-6733,-11.5,29,0,749,753,6279
2008,04,f) 5,4499,4836,52428,56389,183,3.6,754,14.7,7002,989,6013,1.8,12.4,14923,6844,8079,12.1,26.5,-7921,-14.1,24.8,0,618,618,5511
2008,04,g) 6 to 10,17152,18270,264841,275051,599,3.1,2292,12,32869,7017,25852,2.6,12,53290,18117,35173,6.6,19.4,-20421,-7.4,24,0,1804,1804,14892
2008,04,h) 11 to 15,10785,11765,177068,184866,431,3.6,1141,9.4,22395,5634,16761,3,12.1,37991,9997,27994,5.4,20.6,-15596,-8.5,24.2,0,809,809,6772
2008,04,i) 16 to 20,6923,9144,171524,176495,384,4.1,783,8.4,22783,4773,18010,2.7,12.9,32725,8203,24522,4.6,18.5,-9942,-5.6,25.8,0,494,494,4045
2008,04,j) 21 to 25,5795,8551,186884,192767,396,4.6,594,6.9,21659,7105,14554,3.7,11.2,33424,8013,25411,4.2,17.3,-11765,-6.1,22.4,0,336,337,2704
2008,04,k) 26+,4610,7669,210215,220979,360,4.6,508,6.6,25504,6691,18813,3,11.5,47031,8456,38575,3.8,21.3,-21527,-9.8,23,0,262,264,3062
2008,04,l) Left Censored,6144,23770,934133,933238,1920,8.2,1271,5.4,112942,39092,73850,4.2,12.1,111151,18239,92912,2,11.9,1791,0.2,23.8,0,179,183,1579
2008,05,a) 0,3967,3978,22390,11338,3864,194.3,0,0,22105,22105,0,195,195,0,0,0,0,0,22105,195,0,0,,,
2008,05,b) 1,3187,3223,21256,22087,23,0.6,1049,27.6,5521,319,5202,1.4,25,7182,4313,2869,19.5,32.5,-1661,-7.5,50,0,874,874,3837
2008,05,c) 2,2978,3167,23041,24507,113,3.3,585,17.1,3930,539,3391,2.2,16,6862,3584,3278,14.6,28,-2932,-12,32,0,476,476,3146
2008,05,d) 3,2578,2651,20742,21468,92,3.2,471,16.6,3135,399,2736,1.9,14.6,4587,2281,2306,10.6,21.4,-1452,-6.8,29.2,0,396,396,2034
2008,05,e) 4,2253,2346,18477,18870,68,2.7,335,13.5,2771,423,2348,2.2,14.7,3557,1548,2009,8.2,18.9,-786,-4.2,29.4,0,276,276,1399
2008,05,f) 5,2045,2164,19475,19679,56,2.5,287,12.6,3473,921,2552,4.7,17.6,3881,1496,2385,7.6,19.7,-408,-2.1,35.2,0,233,233,1339
2008,05,g) 6 to 10,8005,8774,79502,80725,272,3,970,10.6,10821,2234,8587,2.8,13.4,13266,5044,8222,6.2,16.4,-2445,-3,26.8,0,724,733,4070
2008,05,h) 11 to 15,5858,6313,66110,68669,184,2.8,564,8.7,6852,1089,5763,1.6,10,11970,3772,8198,5.5,17.4,-5118,-7.4,20,0,415,415,3062
2008,05,i) 16 to 20,4171,4833,71109,71806,157,3.2,386,7.8,6898,1239,5659,1.7,9.6,8291,2227,6064,3.1,11.5,-1393,-1.9,19.2,0,259,259,1600
2008,05,j) 21 to 25,3749,4751,83755,84942,140,2.9,265,5.5,7417,1628,5789,1.9,8.7,9790,1718,8072,2,11.5,-2373,-2.8,17.4,0,164,164,1084
2008,05,k) 26+,3315,4985,121437,121716,168,3.3,232,4.6,10259,1796,8463,1.5,8.4,10816,1717,9099,1.4,8.9,-557,-0.5,16.8,0,146,146,661
2008,05,l) Left Censored,5541,14223,480493,481358,651,4.6,502,3.5,45335,12411,32924,2.6,9.4,47066,6489,40577,1.3,9.8,-1731,-0.4,18.8,0,153,154,1142
2008,06,a) 0,63441,63992,364716,184990,62473,195.3,0,0,359453,359453,0,194.3,194.3,0,0,0,0,0,359453,194.3,0,0,,,
2008,06,b) 1,50244,50667,353730,370948,147,0.2,16720,27.9,91353,1705,89648,0.5,24.6,125788,73791,51997,19.9,33.9,-34435,-9.3,49.2,0,13397,13397,62744
2008,06,c) 2,47200,48638,390104,416032,1629,3.1,10707,20.1,71148,9092,62056,2.2,17.1,123003,65008,57995,15.6,29.6,-51855,-12.5,34.2,0,8587,8587,47849
2008,06,d) 3,39478,41526,376062,393443,1494,3.3,7546,16.9,69707,11905,57802,3,17.7,104468,48189,56279,12.2,26.6,-34761,-8.9,35.4,0,6070,6077,41063
2008,06,e) 4,33080,34013,332119,343086,1206,3.3,5605,15.5,55233,7982,47251,2.3,16.1,77166,37332,39834,10.9,22.5,-21933,-6.4,32.2,0,4451,4451,30705
2008,06,f) 5,29901,31411,313969,332467,1156,3.5,4419,13.4,47396,6631,40765,2,14.3,84393,43669,40724,13.1,25.4,-36997,-11.1,28.6,0,3501,3501,39934
2008,06,g) 6 to 10,112337,119904,1409074,1443359,4162,3.3,13628,10.9,210731,31724,179007,2.2,14.6,279301,104260,175041,7.2,19.4,-68570,-4.8,29.2,0,10178,10195,82225
2008,06,h) 11 to 15,68454,73270,1034682,1058460,2508,3.3,6906,9.2,129053,34401,94652,3.3,12.2,176609,53191,123418,5,16.7,-47556,-4.5,24.4,0,4943,4946,36827
2008,06,i) 16 to 20,53704,63595,1040133,1058475,2355,3.6,5117,7.9,141636,28897,112739,2.7,13.4,178320,46363,131957,4.4,16.8,-36684,-3.4,26.8,0,3442,3445,22940
2008,06,j) 21 to 25,44437,58108,1233815,1238694,2340,4,3922,6.7,140239,31231,109008,2.5,11.3,149996,37138,112858,3,12.1,-9757,-0.8,22.6,0,2407,2415,19218
2008,06,k) 26+,39319,59515,1437533,1434903,2433,4.1,3475,5.8,185767,47858,137909,3.3,12.9,180508,37636,142872,2.6,12.6,5259,0.3,25.2,0,1993,2008,15202
2008,06,l) Left Censored,44575,139638,5478508,5463795,8359,6,7392,5.3,651745,209910,441835,3.8,11.9,622318,135451,486867,2.5,11.4,29427,0.5,22.8,0,1852,1912,28220
2008,08,a) 0,11792,11845,55618,28450,11487,194,0,0,54337,54337,0,191,191,0,0,0,0,0,54337,191,0,0,,,
2008,08,b) 1,9080,9128,58200,60129,35,0.3,3123,28.8,13440,451,12989,0.8,22.4,17297,10396,6901,17.3,28.8,-3857,-6.4,44.8,0,2338,2338,8811
2008,08,c) 2,8106,8297,56789,59166,355,3.9,1756,19.5,10544,1420,9124,2.4,17.8,15297,7632,7665,12.9,25.9,-4753,-8.1,35.6,0,1278,1278,6367
2008,08,d) 3,7143,7249,54593,56256,300,3.9,1255,16.2,9042,1156,7886,2.1,16.1,12368,5074,7294,9,22,-3326,-5.9,32.2,0,936,936,4240
2008,08,e) 4,5881,6022,46935,47435,243,3.8,980,15.3,8391,2177,6214,4.6,17.7,9390,4276,5114,9,19.8,-999,-2.1,35.4,0,729,737,3620
2008,08,f) 5,5333,5664,46770,48283,282,4.8,788,13.3,7447,1104,6343,2.3,15.4,10473,4460,6013,9.2,21.7,-3026,-6.3,30.8,0,595,595,3785
2008,08,g) 6 to 10,21124,22186,208598,214330,889,3.9,2637,11.4,30111,5133,24978,2.4,14,41574,17425,24149,8.1,19.4,-11463,-5.4,28,0,1820,1820,12788
2008,08,h) 11 to 15,13680,14742,166402,167688,524,3.5,1383,9.1,22400,4243,18157,2.5,13.4,24972,9227,15745,5.5,14.9,-2572,-1.5,26.8,0,946,946,6307
2008,08,i) 16 to 20,8720,10153,157155,158809,416,4,781,7.5,18044,3644,14400,2.3,11.4,21352,4893,16459,3.1,13.4,-3308,-2,22.8,0,498,498,2997
2008,08,j) 21 to 25,6703,9178,175839,174993,372,4,584,6.3,23072,6340,16732,3.6,13.2,21379,6336,15043,3.6,12.2,1693,1,24.4,0,343,343,3183
2008,08,k) 26+,5930,9031,221279,219210,361,4,529,5.8,29436,6839,22597,3.1,13.4,25298,5844,19454,2.7,11.5,4138,1.9,23,0,282,282,2711
2008,08,l) Left Censored,7874,23293,828850,818335,1650,7.1,1354,5.8,112610,36673,75937,4.5,13.8,91580,24058,67522,2.9,11.2,21030,2.6,22.4,0,259,266,2896
2008,09,a) 0,4941,4981,30777,15605,4823,193.7,0,0,30344,30344,0,194.5,194.5,0,0,0,0,0,30344,194.5,0,0,,,
2008,09,b) 1,3738,3777,28969,32285,15,0.3,1105,25.3,5994,156,5838,0.5,18.6,12625,5940,6685,18.4,39.1,-6631,-20.5,37.2,0,888,888,5359
2008,09,c) 2,3605,3792,29754,30443,141,3.5,665,16.4,5119,725,4394,2.4,16.8,6496,2909,3587,9.6,21.3,-1377,-4.5,33.6,0,536,536,2302
2008,09,d) 3,3212,3279,29311,30012,94,2.7,540,15.4,5144,483,4661,1.6,17.1,6545,3426,3119,11.4,21.8,-1401,-4.7,34.2,0,444,444,2186
2008,09,e) 4,2712,2769,21480,21875,100,3.4,409,13.9,3625,375,3250,1.7,16.6,4414,1832,2582,8.4,20.2,-789,-3.6,33.2,0,320,320,1576
2008,09,f) 5,2376,2455,21801,22779,71,2.8,314,12.2,2743,240,2503,1.1,12,4698,1629,3069,7.2,20.6,-1955,-8.6,24,0,253,253,1502
2008,09,g) 6 to 10,10819,11495,145967,143682,386,3.3,1154,9.7,25952,3207,22745,2.2,18.1,21381,7318,14063,5.1,14.9,4571,3.2,29.8,0,869,869,5834
2008,09,h) 11 to 15,8029,8360,89812,91235,232,2.7,661,7.7,10851,2459,8392,2.7,11.9,13696,4352,9344,4.8,15,-2845,-3.1,23.8,0,472,472,2806
2008,09,i) 16 to 20,6912,7603,101083,100453,224,2.9,538,6.9,14305,2820,11485,2.8,14.2,13045,4408,8637,4.4,13,1260,1.2,26,0,349,349,2405
2008,09,j) 21 to 25,6117,7317,125339,125712,176,2.4,464,6.2,13133,1687,11446,1.3,10.4,13879,4901,8978,3.9,11,-746,-0.6,20.8,0,294,295,2885
2008,09,k) 26+,5091,7117,141195,140827,286,4,412,5.7,16814,4272,12542,3,11.9,16077,4594,11483,3.3,11.4,737,0.5,22.8,0,234,234,1889
2008,09,l) Left Censored,10253,21193,789833,786793,1163,5.5,1041,4.9,98322,36586,61736,4.7,12.5,92242,14700,77542,1.9,11.7,6080,0.8,23.4,0,337,337,2699
2008,10,a) 0,1483,1497,9142,4772,1456,194.5,0,0,8740,8740,0,183.2,183.2,0,0,0,0,0,8740,183.2,0,0,,,
2008,10,b) 1,1099,1130,8642,9585,6,0.5,362,27.3,1421,,,,14.8,3307,1316,1991,13.7,34.5,-1886,-19.7,29.6,1,292,292,1105
2008,10,c) 2,1051,1070,7858,8124,45,3.9,226,19.5,1262,215,1047,2.6,15.5,1794,820,974,10.1,22.1,-532,-6.6,31,0,183,183,735
2008,10,d) 3,954,958,6264,6564,36,3.6,146,14.5,1032,157,875,2.4,15.7,1632,674,958,10.3,24.9,-600,-9.2,31.4,0,120,120,586
2008,10,e) 4,843,861,8624,8091,33,3.6,137,15.1,2331,454,1877,5.6,28.8,1264,527,737,6.5,15.6,1067,13.2,31.2,0,116,116,467
2008,10,f) 5,802,831,8324,7965,28,3.2,125,14.2,2142,,,,26.9,1423,644,779,8.1,17.9,719,9,35.8,1,101,101,595
2008,10,g) 6 to 10,2984,3137,27505,28012,124,3.8,417,12.7,4008,653,3355,2.3,14.3,5021,1871,3150,6.7,17.9,-1013,-3.6,28.6,0,347,347,1636
2008,10,h) 11 to 15,2063,2213,29595,29563,72,3.2,202,8.9,3925,770,3155,2.6,13.3,3861,849,3012,2.9,13.1,64,0.2,26.2,0,153,153,727
2008,10,i) 16 to 20,1539,1719,20210,20236,48,2.7,134,7.6,2507,534,1973,2.6,12.4,2559,699,1860,3.5,12.6,-52,-0.2,24.8,0,83,83,425
2008,10,j) 21 to 25,1277,1589,23318,23224,50,3.1,81,5,2453,535,1918,2.3,10.6,2264,324,1940,1.4,9.7,189,0.9,19.4,0,61,61,267
2008,10,k) 26+,1137,1590,39662,39249,76,4.8,72,4.5,4780,860,3920,2.2,12.2,3954,526,3428,1.3,10.1,826,2.1,20.2,0,42,42,402
2008,10,l) Left Censored,2702,5983,198336,198987,368,6.1,380,6.3,26512,7969,18543,4,13.3,27813,5105,22708,2.6,14,-1301,-0.7,26.6,0,56,56,720
2008,11,a) 0,997,1005,7049,3555,981,195.2,0,0,6989,6989,0,196.6,196.6,0,0,0,0,0,6989,196.6,0,0,,,
2008,11,b) 1,856,859,6969,6678,5,0.5,201,20.8,1832,,,,27.4,1250,530,720,7.9,18.7,582,8.7,37.4,1,167,167,457
2008,11,c) 2,806,823,6965,7270,29,3.3,143,16.3,1195,,,,16.4,1805,751,1054,10.3,24.8,-610,-8.4,32.8,1,108,108,613
2008,11,d) 3,957,969,8986,8719,32,3.1,145,14.1,1810,110,1700,1.3,20.8,1276,498,778,5.7,14.6,534,6.2,29.2,0,116,116,410
2008,11,e) 4,360,362,6305,6059,8,2.1,37,9.7,992,27,965,0.4,16.4,500,140,360,2.3,8.3,492,8.1,16.6,0,29,29,121
2008,11,f) 5,531,558,7114,6848,17,2.9,55,9.5,1188,147,1041,2.1,17.3,655,221,434,3.2,9.6,533,7.7,19.2,0,46,46,203
2008,11,g) 6 to 10,2470,2645,43912,43364,111,4.1,221,8.2,6662,1738,4924,4,15.4,5565,1585,3980,3.7,12.8,1097,2.6,25.6,0,154,154,963
2008,11,h) 11 to 15,1730,1831,29651,29460,65,3.5,131,7,3818,904,2914,3.1,13,3436,1114,2322,3.8,11.7,382,1.3,23.4,0,96,97,848
2008,11,i) 16 to 20,1418,1574,34262,34212,48,3,100,6.2,4073,706,3367,2.1,11.9,3972,642,3330,1.9,11.6,101,0.3,23.2,0,61,61,382
2008,11,j) 21 to 25,1283,1498,28470,28476,52,3.4,106,6.9,3393,675,2718,2.4,11.9,3404,725,2679,2.5,12,-11,-0.1,23.8,0,55,55,267
2008,11,k) 26+,1332,1752,69152,69246,81,4.6,116,6.6,5238,1546,3692,2.2,7.6,5426,1236,4190,1.8,7.8,-188,-0.2,15.2,0,37,37,338
2008,11,l) Left Censored,2953,5888,227958,227184,527,9.1,346,6,25823,7333,18490,3.2,11.4,24274,7498,16776,3.3,10.7,1549,0.7,21.4,0,59,59,833
2008,12,a) 0,40581,40859,206260,105207,39608,193.9,0,0,202107,202107,0,192.1,192.1,0,0,0,0,0,202107,192.1,0,0,,,
2008,12,b) 1,31485,31899,212996,229242,94,0.2,13161,33.6,52584,11061,41523,4.8,22.9,85076,48046,37030,21,37.1,-32492,-14.2,45.8,0,10811,10811,41726
2008,12,c) 2,28394,29005,203306,225463,1089,3.3,8458,25.8,34155,5051,29104,2.2,15.1,78468,36364,42104,16.1,34.8,-44313,-19.7,30.2,0,6896,6896,31732
2008,12,d) 3,25141,25859,187314,200695,966,3.4,6402,22.3,34185,10448,23737,5.2,17,60947,26043,34904,13,30.4,-26762,-13.4,34,0,5229,5229,22581
2008,12,e) 4,23587,24060,164010,175485,810,3.1,5014,19.2,25142,4165,20977,2.4,14.3,48092,24816,23276,14.1,27.4,-22950,-13.1,28.6,0,4024,4024,21875
2008,12,f) 5,18249,18976,177626,185462,657,3.2,3291,16.2,28328,4801,23527,2.6,15.3,44000,15441,28559,8.3,23.7,-15672,-8.4,30.6,0,2616,2616,13348
2008,12,g) 6 to 10,63187,66986,708883,740437,2307,3.3,8957,12.7,93323,20484,72839,2.8,12.6,156431,62023,94408,8.4,21.1,-63108,-8.5,25.2,0,6823,6868,46577
2008,12,h) 11 to 15,40738,43672,513334,530651,1507,3.3,4538,10,64431,17878,46553,3.4,12.1,99065,30586,68479,5.8,18.7,-34634,-6.6,24.2,0,3306,3338,20686
2008,12,i) 16 to 20,29372,34716,576844,590699,1287,3.6,2928,8.2,77786,17057,60729,2.9,13.2,105495,38810,66685,6.6,17.9,-27709,-4.7,26.4,0,1977,1983,18798
2008,12,j) 21 to 25,21090,27718,581244,587471,1093,3.9,1877,6.7,67005,19962,47043,3.4,11.4,79459,15757,63702,2.7,13.5,-12454,-2.1,22.8,0,1184,1184,7963
2008,12,k) 26+,16000,26062,619396,625111,1308,5,1579,6,81866,24481,57385,3.9,13.1,93296,18932,74364,3,14.9,-11430,-1.8,26.2,0,852,855,8701
2008,12,l) Left Censored,19387,75802,2830656,2831000,5139,6.8,4157,5.5,326189,101526,224663,3.6,11.5,326877,64007,262870,2.3,11.5,-688,0,23,0,739,751,8390
2008,13,a) 0,16608,16752,98939,50114,16284,194.4,0,0,97651,97651,0,194.9,194.9,0,0,0,0,0,97651,194.9,0,0,,,
2008,13,b) 1,13092,13259,87043,94507,37,0.2,4597,29.2,20225,873,19352,0.9,21.4,35152,19557,15595,20.7,37.2,-14927,-15.8,42.8,0,3772,3772,17104
2008,13,c) 2,11451,11779,95138,99936,440,3.4,2684,20.8,17560,1734,15826,1.7,17.6,27156,13529,13627,13.5,27.2,-9596,-9.6,35.2,0,2143,2143,11995
2008,13,d) 3,9885,10234,87005,91903,327,3,2021,18.3,15588,1968,13620,2.1,17,25384,14021,11363,15.3,27.6,-9796,-10.6,34,0,1682,1682,13057
2008,13,e) 4,8436,8634,75291,79774,249,2.7,1538,16.6,10371,1339,9032,1.7,13,19337,9291,10046,11.6,24.2,-8966,-11.2,26,0,1246,1246,8238
2008,13,f) 5,7453,7792,73743,76285,258,3.1,1158,14.1,12009,2973,9036,3.9,15.7,17092,6759,10333,8.9,22.4,-5083,-6.7,31.4,0,956,956,6007
2008,13,g) 6 to 10,28896,31070,370371,380907,1096,3.4,3695,11.4,51578,10621,40957,2.8,13.5,72650,27208,45442,7.1,19.1,-21072,-5.6,27,0,2815,2817,18794
2008,13,h) 11 to 15,18734,20320,260598,266957,703,3.4,1975,9.4,35305,10791,24514,4,13.2,48022,15277,32745,5.7,18,-12717,-4.8,26.4,0,1421,1428,9998
2008,13,i) 16 to 20,12354,14968,263001,263519,510,3.3,1201,7.8,37625,8020,29605,3,14.3,38661,10948,27713,4.2,14.7,-1036,-0.4,28.6,0,813,815,6101
2008,13,j) 21 to 25,10361,13366,265556,265270,552,4.1,791,5.9,33216,9289,23927,3.5,12.5,32643,7448,25195,2.8,12.3,573,0.2,24.6,0,517,517,3495
2008,13,k) 26+,8095,13365,342047,351826,746,5.6,771,5.8,46781,12468,34313,3.5,13.3,66338,31536,34802,9,18.9,-19557,-5.6,26.6,0,391,391,3777
2008,13,l) Left Censored,12774,43082,1602337,1595310,3034,7.1,2233,5.2,197329,73262,124067,4.6,12.4,183275,42218,141057,2.6,11.5,14054,0.9,23,0,398,398,4977
2008,15,a) 0,1771,1784,9675,4896,1737,194.7,0,0,9559,9559,0,195.2,195.2,0,0,0,0,0,9559,195.2,0,0,,,
2008,15,b) 1,1545,1550,11246,11658,5,0.3,434,24.2,2862,39,2823,0.3,24.5,3686,2138,1548,18.3,31.6,-824,-7.1,49,0,337,337,1784
2008,15,c) 2,1365,1439,12573,13200,45,2.9,270,17.4,1941,265,1676,2,14.7,3194,1764,1430,13.4,24.2,-1253,-9.5,29.4,0,214,214,1231
2008,15,d) 3,1192,1215,12079,12649,26,2,207,15.9,1628,99,1529,0.8,12.9,2767,1359,1408,10.7,21.9,-1139,-9,25.8,0,177,177,1265
2008,15,e) 4,1065,1113,9491,9584,32,2.7,168,14.2,1606,117,1489,1.2,16.8,1791,819,972,8.5,18.7,-185,-1.9,33.6,0,131,131,695
2008,15,f) 5,995,1110,11689,12082,51,4.4,146,12.6,1324,168,1156,1.4,11,2109,613,1496,5.1,17.5,-785,-6.5,22,0,110,110,478
2008,15,g) 6 to 10,3873,4128,44263,45298,117,2.7,433,10.1,5766,894,4872,2,12.7,7836,2620,5216,5.8,17.3,-2070,-4.6,25.4,0,339,339,1983
2008,15,h) 11 to 15,2649,2789,35534,36433,62,2.1,258,8.9,3344,437,2907,1.2,9.2,5141,1805,3336,5,14.1,-1797,-4.9,18.4,0,188,188,1466
2008,15,i) 16 to 20,2293,2692,36106,36635,85,3.1,185,6.7,3881,1146,2735,3.1,10.6,4938,1200,3738,3.3,13.5,-1057,-2.9,21.2,0,133,133,783
2008,15,j) 21 to 25,1877,2346,46963,47009,86,3.6,152,6.4,4751,1264,3487,2.7,10.1,4842,995,3847,2.1,10.3,-91,-0.2,20.2,0,102,102,537
2008,15,k) 26+,2073,2946,55274,56594,88,3,128,4.3,4869,860,4009,1.5,8.6,7508,1355,6153,2.4,13.3,-2639,-4.7,17.2,0,73,73,561
2008,15,l) Left Censored,3074,7067,230397,228651,350,5,271,3.9,23716,7417,16299,3.2,10.4,20223,2904,17319,1.3,8.8,3493,1.6,17.6,0,73,75,934
2008,16,a) 0,3576,3591,16267,8345,3486,194.2,0,0,15845,15845,0,189.9,189.9,0,0,0,0,0,15845,189.9,0,0,,,
2008,16,b) 1,3050,3069,17244,19179,7,0.2,1226,32.8,3854,58,3796,0.3,20.1,7723,5252,2471,27.4,40.3,-3869,-20.2,40.2,0,937,937,4565
2008,16,c) 2,2887,2953,17896,20135,106,3.2,756,23,2968,322,2646,1.6,14.7,7445,4097,3348,20.3,37,-4477,-22.3,29.4,0,579,579,3638
2008,16,d) 3,2288,2329,16300,17243,91,3.6,443,17.7,2298,314,1984,1.8,13.3,4184,1697,2487,9.8,24.3,-1886,-11,26.6,0,337,337,1386
2008,16,e) 4,1855,1899,14736,15401,77,3.8,285,14.2,1988,258,1730,1.7,12.9,3317,1115,2202,7.2,21.5,-1329,-8.6,25.8,0,212,212,825
2008,16,f) 5,1560,1656,12555,12881,68,3.9,239,13.7,2034,226,1808,1.8,15.8,2686,1043,1643,8.1,20.9,-652,-5.1,31.6,0,170,170,776
2008,16,g) 6 to 10,6102,6490,66653,68885,228,3.4,728,10.8,8088,1417,6671,2.1,11.7,12552,3646,8906,5.3,18.2,-4464,-6.5,23.4,0,499,499,2733
2008,16,h) 11 to 15,4120,4314,42630,43529,166,3.7,414,9.3,5991,1087,4904,2.5,13.8,7789,2556,5233,5.9,17.9,-1798,-4.1,27.6,0,277,277,2002
2008,16,i) 16 to 20,2612,2914,34968,36129,114,3.8,289,9.6,4178,651,3527,1.8,11.6,6499,1980,4519,5.5,18,-2321,-6.4,23.2,0,163,178,1206
2008,16,j) 21 to 25,1879,2415,46556,47621,94,3.8,156,6.4,5532,1721,3811,3.6,11.6,7661,1921,5740,4,16.1,-2129,-4.5,23.2,0,103,103,1375
2008,16,k) 26+,1747,2607,58074,58706,162,6.2,153,5.9,5738,1634,4104,2.8,9.8,7001,1118,5883,1.9,11.9,-1263,-2.1,19.6,0,98,98,486
2008,16,l) Left Censored,2876,7017,194986,194757,366,5.3,238,3.4,18471,5837,12634,3,9.5,18012,2870,15142,1.5,9.2,459,0.3,18.4,0,76,76,700
2008,17,a) 0,19164,19338,107174,54357,18778,194.2,0,0,105634,105634,0,194.3,194.3,0,0,0,0,0,105634,194.3,0,0,,,
2008,17,b) 1,14699,14819,102994,108482,44,0.3,4655,26.7,25430,485,24945,0.4,23.4,36406,20442,15964,18.8,33.6,-10976,-10.2,46.8,0,3400,3400,16895
2008,17,c) 2,13546,13979,111812,115815,559,3.7,2764,18.3,18248,2646,15602,2.3,15.8,26254,11818,14436,10.2,22.7,-8006,-6.9,31.6,0,2021,2021,9207
2008,17,d) 3,12139,12422,107372,111416,421,3.2,2086,15.8,14684,1611,13073,1.4,13.2,22771,9227,13544,8.3,20.4,-8087,-7.2,26.4,0,1628,1628,8007
2008,17,e) 4,10654,10893,89741,92932,356,3.1,1652,14.3,12861,1225,11636,1.3,13.8,19242,8297,10945,8.9,20.7,-6381,-6.9,27.6,0,1268,1268,7198
2008,17,f) 5,9525,10238,101286,104388,351,3.3,1281,12,15179,3284,11895,3.1,14.5,21382,7994,13388,7.7,20.5,-6203,-6,29,0,948,948,6776
2008,17,g) 6 to 10,37878,40306,463175,465207,1319,3.1,4521,10.8,73244,9553,63691,2.1,15.7,77307,25293,52014,5.4,16.6,-4063,-0.9,31.4,0,3218,3232,19396
2008,17,h) 11 to 15,28609,30251,389001,381541,941,3,2614,8.4,69100,31305,37795,8.2,18.1,54180,15769,38411,4.1,14.2,14920,3.9,28.4,0,1753,1753,11072
2008,17,i) 16 to 20,22032,25150,390351,390126,878,3.4,2097,8.1,52220,10181,42039,2.6,13.4,51770,16562,35208,4.2,13.3,450,0.1,26.6,0,1247,1248,9586
2008,17,j) 21 to 25,17767,21979,447945,447518,691,3.1,1314,5.9,49007,8904,40103,2,11,48153,14597,33556,3.3,10.8,854,0.2,21.6,0,840,842,8292
2008,17,k) 26+,15509,22589,551404,550333,780,3.4,1210,5.3,57907,10999,46908,2,10.5,55764,12831,42933,2.3,10.1,2143,0.4,20.2,0,727,728,5189
2008,17,l) Left Censored,27910,67594,2590078,2570176,3809,5.7,3177,4.7,291861,77495,214366,3,11.4,252057,53047,199010,2.1,9.8,39804,1.6,19.6,0,927,934,10338
2008,18,a) 0,8120,8204,52129,26272,8015,195.4,0,0,51715,51715,0,196.8,196.8,0,0,0,0,0,51715,196.8,0,0,,,
2008,18,b) 1,6480,6590,49470,52475,31,0.4,2062,26.8,11576,218,11358,0.4,22.1,17586,10596,6990,20.2,33.5,-6010,-11.4,44.2,0,1612,1612,9156
2008,18,c) 2,6111,6426,53227,55529,212,3.1,1241,17.9,8832,1133,7699,2,15.9,13436,6322,7114,11.4,24.2,-4604,-8.3,31.8,0,985,985,5138
2008,18,d) 3,5094,5229,44249,45743,153,2.7,867,15.5,6480,719,5761,1.6,14.2,9468,4448,5020,9.7,20.7,-2988,-6.5,28.4,0,714,714,4018
2008,18,e) 4,4500,4633,41548,43206,140,2.8,740,15,5706,962,4744,2.2,13.2,9022,4351,4671,10.1,20.9,-3316,-7.7,26.4,0,586,586,3658
2008,18,f) 5,4056,4265,40405,40779,155,3.5,564,12.6,6440,1084,5356,2.7,15.8,7188,3049,4139,7.5,17.6,-748,-1.8,31.6,0,463,463,2604
2008,18,g) 6 to 10,17144,18566,204346,209980,548,2.8,1947,10.1,26536,6255,20281,3,12.6,37804,14141,23663,6.7,18,-11268,-5.4,25.2,0,1481,1483,10804
2008,18,h) 11 to 15,12838,13693,155857,158953,410,2.9,1200,8.5,19459,3143,16316,2,12.2,25650,7658,17992,4.8,16.1,-6191,-3.9,24.4,0,872,872,5930
2008,18,i) 16 to 20,10035,11886,188067,189872,304,2.5,873,7.2,22525,2878,19647,1.5,11.9,26134,6951,19183,3.7,13.8,-3609,-1.9,23.8,0,563,563,4350
2008,18,j) 21 to 25,8784,11439,217690,220188,346,3,660,5.7,22782,3868,18914,1.8,10.3,27777,6764,21013,3.1,12.6,-4995,-2.3,20.6,0,491,492,3909
2008,18,k) 26+,7243,11352,261586,260874,524,4.6,626,5.5,35489,10214,25275,3.9,13.6,34064,12007,22057,4.6,13.1,1425,0.5,26.2,0,299,299,4577
2008,18,l) Left Censored,13996,35860,1304303,1314388,1571,4.4,1496,4.2,116707,27547,89160,2.1,8.9,136877,24658,112219,1.9,10.4,-20170,-1.5,17.8,0,451,451,6476
2008,19,a) 0,4384,4418,25819,13058,4297,194.5,0,0,25523,25523,0,195.5,195.5,0,0,0,0,0,25523,195.5,0,0,,,
2008,19,b) 1,3385,3400,24959,25603,5,0.1,992,25.1,6609,16,6593,0.1,25.8,7897,4467,3430,17.4,30.8,-1288,-5,51.6,0,728,728,3868
2008,19,c) 2,3359,3620,26215,27148,112,2.9,660,16.9,4202,584,3618,2.2,15.5,6067,2316,3751,8.5,22.3,-1865,-6.8,31,0,482,482,1909
2008,19,d) 3,2834,2880,22392,23455,92,3,509,16.5,3467,241,3226,1,14.8,5593,2895,2698,12.3,23.8,-2126,-9,29.6,0,383,383,2469
2008,19,e) 4,2509,2576,19214,19468,77,2.8,392,14.3,3096,244,2852,1.3,15.9,3603,1681,1922,8.6,18.5,-507,-2.6,31.8,0,304,304,1421
2008,19,f) 5,2221,2395,19255,20099,78,3.1,317,12.6,2506,316,2190,1.6,12.5,4193,2019,2174,10,20.9,-1687,-8.4,25,0,228,228,1769
2008,19,g) 6 to 10,9387,10066,102054,103616,318,3.1,976,9.4,12648,2055,10593,2,12.2,15771,4145,11626,4,15.2,-3123,-3,24.4,0,658,659,3017
2008,19,h) 11 to 15,7551,8013,77522,78999,276,3.3,727,8.8,9163,1189,7974,1.5,11.6,12117,3612,8505,4.6,15.3,-2954,-3.7,23.2,0,459,459,2535
2008,19,i) 16 to 20,5608,6179,77458,76784,181,2.9,499,7.9,10700,868,9832,1.1,13.9,9352,3334,6018,4.3,12.2,1348,1.7,24.4,0,309,309,1626
2008,19,j) 21 to 25,4686,6230,121515,120925,176,2.8,316,5,11032,1833,9199,1.5,9.1,9852,1651,8201,1.4,8.1,1180,1,16.2,0,196,196,812
2008,19,k) 26+,4722,7388,122731,123421,175,2.3,355,4.7,11188,1558,9630,1.3,9.1,12567,3388,9179,2.7,10.2,-1379,-1.1,18.2,0,196,197,1432
2008,19,l) Left Censored,9444,19865,674990,669547,758,3.8,779,3.9,66807,13615,53192,2,10,55920,11590,44330,1.7,8.4,10887,1.6,16.8,0,296,297,2748
2008,20,a) 0,4306,4348,23454,11870,4234,194.8,0,0,23168,23168,0,195.2,195.2,0,0,0,0,0,23168,195.2,0,0,,,
2008,20,b) 1,3488,3509,22679,23662,5,0.1,981,24.2,5460,,,,23.1,7425,4663,2762,19.7,31.4,-1965,-8.3,46.2,1,754,754,3985
2008,20,c) 2,3239,3377,33426,29169,119,3.3,602,16.7,14566,,,,49.9,6051,2887,3164,9.9,20.7,8515,29.2,41.4,1,467,467,2493
2008,20,d) 3,2841,2910,24921,25435,95,3.1,484,15.6,4507,948,3559,3.7,17.7,5535,2786,2749,11,21.8,-1028,-4.1,35.4,0,395,397,2555
2008,20,e) 4,2534,2576,22954,22648,76,2.8,393,14.4,4950,344,4606,1.5,21.9,4338,1753,2585,7.7,19.2,612,2.7,38.4,0,325,325,1604
2008,20,f) 5,2295,2354,23907,24499,88,3.6,317,12.9,3256,757,2499,3.1,13.3,4440,1921,2519,7.8,18.1,-1184,-4.8,26.6,0,223,223,1592
2008,20,g) 6 to 10,9473,10081,110842,113169,316,3,1040,10,13209,1785,11424,1.6,11.7,17863,5894,11969,5.2,15.8,-4654,-4.1,23.4,0,792,792,5228
2008,20,h) 11 to 15,6841,7269,83944,84028,257,3.4,646,8.7,11395,3216,8179,3.8,13.6,11563,3472,8091,4.1,13.8,-168,-0.2,27.2,0,431,431,2468
2008,20,i) 16 to 20,5134,5932,83654,83072,196,3.2,419,6.9,10212,1336,8876,1.6,12.3,9048,1998,7050,2.4,10.9,1164,1.4,21.8,0,288,288,1326
2008,20,j) 21 to 25,4329,5358,80078,80303,192,3.5,329,6.1,8612,1686,6926,2.1,10.7,9061,2878,6183,3.6,11.3,-449,-0.6,21.4,0,204,204,1525
2008,20,k) 26+,4168,6238,126256,125048,241,3.8,320,5.1,15819,2953,12866,2.4,12.7,13402,3023,10379,2.4,10.7,2417,2,21.4,0,169,169,771
2008,20,l) Left Censored,7758,17219,545888,541742,795,4.6,669,3.9,53686,11446,42240,2.1,9.9,45393,8864,36529,1.6,8.4,8293,1.5,16.8,0,226,228,2280
2008,21,a) 0,4950,5047,34772,17617,4940,195.8,0,0,34311,34311,0,194.8,194.8,0,0,0,0,0,34311,194.8,0,0,,,
2008,21,b) 1,4055,4101,29816,33231,14,0.3,1261,26.3,7169,199,6970,0.6,21.6,13998,7017,6981,21.1,42.1,-6829,-20.5,43.2,0,1022,1022,6240
2008,21,c) 2,3715,3865,30358,31943,111,2.7,736,17.6,5334,518,4816,1.6,16.7,8503,4436,4067,13.9,26.6,-3169,-9.9,33.4,0,606,606,4140
2008,21,d) 3,3366,3457,29141,30033,115,3.1,569,15.4,4877,544,4333,1.8,16.2,6660,2876,3784,9.6,22.2,-1783,-6,32.4,0,492,492,2560
2008,21,e) 4,2905,3035,26477,27360,84,2.6,426,13.3,4058,569,3489,2.1,14.8,5823,2301,3522,8.4,21.3,-1765,-6.5,29.6,0,351,351,2068
2008,21,f) 5,2526,2644,23743,24931,81,2.9,344,12.4,3084,417,2667,1.7,12.4,5460,2481,2979,10,21.9,-2376,-9.5,24.8,0,272,272,2203
2008,21,g) 6 to 10,10989,11845,126935,129752,298,2.4,1198,9.8,16695,2319,14376,1.8,12.9,22328,8448,13880,6.5,17.2,-5633,-4.3,25.8,0,882,894,6435
2008,21,h) 11 to 15,8012,8632,108699,109386,235,2.6,771,8.7,16216,2672,13544,2.4,14.8,17589,6715,10874,6.1,16.1,-1373,-1.3,29.6,0,575,575,4357
2008,21,i) 16 to 20,6242,7442,109483,110862,233,3.1,591,7.7,13016,3029,9987,2.7,11.7,15774,3763,12011,3.4,14.2,-2758,-2.5,23.4,0,392,394,2650
2008,21,j) 21 to 25,5543,6854,127696,127899,197,2.8,397,5.7,12405,2036,10369,1.6,9.7,12811,2705,10106,2.1,10,-406,-0.3,19.4,0,275,275,1841
2008,21,k) 26+,4381,7019,156957,157158,319,4.5,405,5.7,18232,4526,13706,2.9,11.6,18634,3552,15082,2.3,11.9,-402,-0.3,23.2,0,195,195,1376
2008,21,l) Left Censored,8320,21593,752418,745007,1029,4.8,876,4.1,88408,35004,53404,4.7,11.9,73585,15621,57964,2.1,9.9,14823,2,19.8,0,323,324,5751
2008,22,a) 0,6285,6408,41626,21150,6267,195.6,0,0,40952,40952,0,193.6,193.6,0,0,0,0,0,40952,193.6,0,0,,,
2008,22,b) 1,5246,5286,42514,43668,10,0.2,1528,24.9,10989,47,10942,0.1,25.2,13296,7060,6236,16.2,30.4,-2307,-5.2,50.4,0,1253,1253,6236
2008,22,c) 2,4273,4565,42537,43980,204,4.2,796,16.3,9169,2439,6730,5.5,20.8,12055,5470,6585,12.4,27.4,-2886,-6.6,41.6,0,657,657,4198
2008,22,d) 3,3700,3796,36340,37857,123,3,614,15.2,5927,648,5279,1.7,15.7,8960,3864,5096,10.2,23.7,-3033,-8,31.4,0,522,522,3317
2008,22,e) 4,3345,3447,35641,36121,104,2.9,467,12.9,5946,452,5494,1.3,16.5,6906,2804,4102,7.8,19.1,-960,-2.6,33,0,395,395,2564
2008,22,f) 5,3076,3336,35508,36244,108,3.1,373,10.8,5227,612,4615,1.7,14.4,6698,2535,4163,7,18.5,-1471,-4.1,28.8,0,297,297,2014
2008,22,g) 6 to 10,12529,13328,163269,167159,397,2.9,1152,8.4,22527,4472,18055,2.7,13.5,30306,12804,17502,7.7,18.1,-7779,-4.6,27,0,902,903,9651
2008,22,h) 11 to 15,9174,9706,128942,131254,269,2.7,754,7.6,14588,2412,12176,1.8,11.1,19212,4732,14480,3.6,14.6,-4624,-3.5,22.2,0,560,561,3562
2008,22,i) 16 to 20,6510,7728,116103,117062,241,3.1,501,6.4,13397,1737,11660,1.5,11.4,15314,3305,12009,2.8,13.1,-1917,-1.7,22.8,0,331,331,2012
2008,22,j) 21 to 25,6145,7716,146270,147011,235,3,410,5.3,16248,3239,13009,2.2,11.1,17729,5782,11947,3.9,12.1,-1481,-1,22.2,0,267,267,3338
2008,22,k) 26+,5870,8521,176838,175977,277,3.2,446,5.2,25207,4584,20623,2.6,14.3,23485,3609,19876,2.1,13.3,1722,1,26.6,0,260,260,1505
2008,22,l) Left Censored,8790,22264,677088,676230,1116,5,910,4.1,69792,17080,52712,2.5,10.3,68078,11180,56898,1.7,10.1,1714,0.2,20.2,0,295,296,2952
2008,23,a) 0,2362,2375,10020,5078,2294,193.2,0,0,9884,9884,0,194.6,194.6,0,0,0,0,0,9884,194.6,0,0,,,
2008,23,b) 1,1932,1942,10627,10880,5,0.2,645,28.1,2899,,,,26.6,3404,2300,1104,21.1,31.3,-505,-4.7,53.2,1,432,432,1799
2008,23,c) 2,1838,1927,11984,12754,64,3,403,19.2,2053,,,,16.1,3592,2011,1581,15.8,28.2,-1539,-12.1,32.2,1,297,297,1763
2008,23,d) 3,1522,1532,9041,9178,43,2.6,270,16.4,1499,196,1303,2.1,16.3,1772,861,911,9.4,19.3,-273,-3,32.6,0,211,211,745
2008,23,e) 4,1373,1398,9562,9686,42,2.8,229,15.3,1409,125,1284,1.3,14.5,1657,771,886,8,17.1,-248,-2.6,29,0,170,170,600
2008,23,f) 5,1106,1166,8472,8833,42,3.4,177,14.3,1037,124,913,1.4,11.7,1758,641,1117,7.3,19.9,-721,-8.2,23.4,0,137,137,536
2008,23,g) 6 to 10,5440,5757,49302,50048,196,3.3,586,9.8,5800,1163,4637,2.3,11.6,7291,2576,4715,5.1,14.6,-1491,-3,23.2,0,407,407,2106
2008,23,h) 11 to 15,3699,3864,34277,35047,132,3.3,379,9.5,3829,640,3189,1.8,10.9,5369,2305,3064,6.6,15.3,-1540,-4.4,21.8,0,257,257,1895
2008,23,i) 16 to 20,2831,3222,33026,33424,86,2.6,269,8.1,3748,436,3312,1.3,11.2,4544,1607,2937,4.8,13.6,-796,-2.4,22.4,0,169,169,1023
2008,23,j) 21 to 25,2455,3028,48738,48298,75,2.4,184,6,5229,544,4685,1.1,10.8,4348,1010,3338,2.1,9,881,1.8,18,0,123,123,553
2008,23,k) 26+,1958,2978,54452,54459,104,3.5,161,5.4,6154,1130,5024,2.1,11.3,6167,1269,4898,2.3,11.3,-13,0,22.6,0,80,80,489
2008,23,l) Left Censored,3417,7372,222007,221054,406,5.5,351,4.8,21235,6194,15041,2.8,9.6,19328,4395,14933,2,8.7,1907,0.9,17.4,0,120,121,1372
2008,24,a) 0,8061,8259,45645,23152,8024,194.3,0,0,44986,44986,0,194.3,194.3,0,0,0,0,0,44986,194.3,0,0,,,
2008,24,b) 1,6534,6604,45953,47447,17,0.2,2130,27.4,11982,173,11809,0.4,25.3,14970,8952,6018,18.9,31.6,-2988,-6.3,50.6,0,1691,1691,7716
2008,24,c) 2,6282,6514,49787,51746,242,3.4,1328,18.8,9728,1063,8665,2.1,18.8,13646,6027,7619,11.6,26.4,-3918,-7.6,37.6,0,1049,1049,5087
2008,24,d) 3,5675,5809,44522,45484,164,2.6,1002,16.1,7370,685,6685,1.5,16.2,9293,4498,4795,9.9,20.4,-1923,-4.2,32.4,0,810,810,3733
2008,24,e) 4,4959,5066,40790,42429,166,3.1,768,14.3,5964,758,5206,1.8,14.1,9242,3788,5454,8.9,21.8,-3278,-7.7,28.2,0,616,616,3352
2008,24,f) 5,4309,4519,46384,48391,160,3.4,576,12.2,6127,855,5272,1.8,12.7,10140,4197,5943,8.7,21,-4013,-8.3,25.4,0,439,439,3569
2008,24,g) 6 to 10,17853,18956,211243,215368,561,2.9,1992,10.1,28359,3739,24620,1.7,13.2,36608,13956,22652,6.5,17,-8249,-3.8,26.4,0,1496,1496,11345
2008,24,h) 11 to 15,12385,13068,167282,169014,410,3,1168,8.7,20388,4085,16303,2.4,12.1,23851,6953,16898,4.1,14.1,-3463,-2,24.2,0,821,821,5002
2008,24,i) 16 to 20,9625,11098,191445,190666,325,2.9,839,7.4,23750,6425,17325,3.4,12.5,22191,5642,16549,3,11.6,1559,0.9,23.2,0,540,540,3223
2008,24,j) 21 to 25,7729,9422,174584,175297,252,2.6,545,5.7,21092,4709,16383,2.7,12,22517,5223,17294,3,12.8,-1425,-0.8,24,0,359,359,2929
2008,24,k) 26+,5977,8759,206511,205674,299,3.4,462,5.2,23299,5639,17660,2.7,11.3,21625,4873,16752,2.4,10.5,1674,0.8,21,0,215,220,1786
2008,24,l) Left Censored,10326,27088,991921,993693,1602,5.9,1436,5.3,109393,31300,78093,3.1,11,112937,33025,79912,3.3,11.4,-3544,-0.4,22,0,344,345,4369
2008,25,a) 0,9119,9183,50119,25406,8929,194.5,0,0,49427,49427,0,194.5,194.5,0,0,0,0,0,49427,194.5,0,0,,,
2008,25,b) 1,7386,7419,46854,49159,16,0.2,2235,25.9,11738,272,11466,0.6,23.9,16347,8735,7612,17.8,33.3,-4609,-9.4,47.8,0,1691,1691,7518
2008,25,c) 2,7356,7493,59683,61449,271,3.4,1388,17.2,8791,1140,7651,1.9,14.3,12323,4867,7456,7.9,20.1,-3532,-5.8,28.6,0,1038,1038,3965
2008,25,d) 3,6302,6399,51153,52829,245,3.6,1018,15,9007,900,8107,1.7,17,12358,6060,6298,11.5,23.4,-3351,-6.4,34,0,797,797,5393
2008,25,e) 4,5551,5717,53881,53609,204,3.4,842,14,9518,1644,7874,3.1,17.8,8973,3192,5781,6,16.7,545,1.1,33.4,0,669,669,2667
2008,25,f) 5,4949,5204,50089,50267,176,3.2,715,13.1,7545,699,6846,1.4,15,7900,2680,5220,5.3,15.7,-355,-0.7,30,0,566,566,2179
2008,25,g) 6 to 10,21182,22279,254231,253957,706,3.1,2306,10,37695,8576,29119,3.4,14.8,37147,12923,24224,5.1,14.6,548,0.2,29.2,0,1648,1648,9528
2008,25,h) 11 to 15,15488,16157,188383,190802,442,2.7,1369,8.2,23668,4977,18691,2.6,12.4,28506,8349,20157,4.4,14.9,-4838,-2.5,24.8,0,1000,1000,6251
2008,25,i) 16 to 20,11756,13515,212735,214670,398,2.9,877,6.4,20544,3809,16735,1.8,9.6,24414,6188,18226,2.9,11.4,-3870,-1.8,19.2,0,584,584,3752
2008,25,j) 21 to 25,10963,13565,265611,266769,409,3,926,6.7,30937,4661,26276,1.7,11.6,33253,12257,20996,4.6,12.5,-2316,-0.9,23.2,0,517,517,6334
2008,25,k) 26+,8699,12994,368033,367245,459,3.5,637,4.9,37687,9082,28605,2.5,10.3,36110,9543,26567,2.6,9.8,1577,0.5,19.6,0,390,391,2925
2008,25,l) Left Censored,17286,37559,1473393,1475002,1809,4.8,1647,4.4,154116,45655,108461,3.1,10.4,157334,33853,123481,2.3,10.7,-3218,-0.3,20.8,0,595,595,7082
2008,26,a) 0,12305,12422,83206,42021,12074,194.4,0,0,82371,82371,0,196,196,0,0,0,0,0,82371,196,0,0,,,
2008,26,b) 1,9569,9678,90491,87118,22,0.2,3243,28.3,34853,231,34622,0.3,40,28106,17079,11027,19.6,32.3,6747,7.7,64.6,0,2468,2468,14361
2008,26,c) 2,8894,9029,77225,86531,317,3.2,1970,19.9,13239,1611,11628,1.9,15.3,31851,20940,10911,24.2,36.8,-18612,-21.5,30.6,0,1563,1563,19688
2008,26,d) 3,7953,8119,78515,82715,260,3,1596,18.2,13035,1211,11824,1.5,15.8,21434,11947,9487,14.4,25.9,-8399,-10.1,31.6,0,1300,1300,10863
2008,26,e) 4,7062,7238,74668,79842,244,3.2,1232,15.9,10641,1552,9089,1.9,13.3,20988,10895,10093,13.6,26.3,-10347,-13,26.6,0,984,984,9597
2008,26,f) 5,6294,6640,66521,71204,233,3.3,1048,14.9,9652,2041,7611,2.9,13.6,19017,10702,8315,15,26.7,-9365,-13.1,27.2,0,841,841,9590
2008,26,g) 6 to 10,26444,28213,297749,305865,928,3.1,3586,12.2,38942,5368,33574,1.8,12.7,55174,23362,31812,7.6,18,-16232,-5.3,25.4,0,2660,2667,18982
2008,26,h) 11 to 15,20765,21909,243994,248457,678,3,2210,9.8,30178,5807,24371,2.3,12.1,39103,11776,27327,4.7,15.7,-8925,-3.6,24.2,0,1513,1513,8969
2008,26,i) 16 to 20,16124,18801,264600,267083,570,3,1547,8,36426,10473,25953,3.9,13.6,41391,12849,28542,4.8,15.5,-4965,-1.9,27.2,0,980,982,6873
2008,26,j) 21 to 25,13835,17379,304966,305696,588,3.3,1022,5.8,31722,8269,23453,2.7,10.4,33181,7663,25518,2.5,10.9,-1459,-0.5,20.8,0,702,703,5078
2008,26,k) 26+,11451,16133,303981,304201,520,3.2,863,5.3,34280,7896,26384,2.6,11.3,34719,6655,28064,2.2,11.4,-439,-0.1,22.6,0,535,543,3850
2008,26,l) Left Censored,19998,50601,1733363,1749865,2667,5.3,2299,4.6,174704,55278,119426,3.2,10,207707,39340,168367,2.2,11.9,-33003,-1.9,20,0,727,743,6827
2008,27,a) 0,8239,8295,52210,26447,7990,192.6,0,0,51526,51526,0,194.8,194.8,0,0,0,0,0,51526,194.8,0,0,,,
2008,27,b) 1,6650,6707,50755,53632,19,0.2,2152,27.2,10515,259,10256,0.5,19.6,16268,9728,6540,18.1,30.3,-5753,-10.7,39.2,0,1507,1507,8345
2008,27,c) 2,6249,6635,48058,49846,290,4,1377,19.1,8692,1818,6874,3.6,17.4,12268,6183,6085,12.4,24.6,-3576,-7.2,34.8,0,927,927,4962
2008,27,d) 3,5591,5733,43944,45605,243,4,1030,16.8,7337,1228,6109,2.7,16.1,10658,5637,5021,12.4,23.4,-3321,-7.3,32.2,0,764,764,4648
2008,27,e) 4,5006,5204,40800,42150,217,3.9,843,15.3,6096,1066,5030,2.5,14.5,8796,3700,5096,8.8,20.9,-2700,-6.4,29,0,633,633,3064
2008,27,f) 5,4630,4882,41870,42592,206,4,711,13.8,6701,1130,5571,2.7,15.7,8145,3638,4507,8.5,19.1,-1444,-3.4,31.4,0,505,505,3260
2008,27,g) 6 to 10,18991,20229,215014,218471,798,3.8,2275,10.9,26832,4008,22824,1.8,12.3,33745,13847,19898,6.3,15.4,-6913,-3.1,24.6,0,1543,1543,10705
2008,27,h) 11 to 15,13769,14939,173899,176598,572,3.7,1335,8.7,22446,4872,17574,2.8,12.7,27844,7711,20133,4.4,15.8,-5398,-3.1,25.4,0,865,865,5836
2008,27,i) 16 to 20,10035,11261,157924,162213,348,3,886,7.7,16625,2281,14344,1.4,10.2,25203,7364,17839,4.5,15.5,-8578,-5.3,20.4,0,538,538,4678
2008,27,j) 21 to 25,7759,10010,212550,211661,299,3,535,5.3,23902,4384,19518,2.1,11.3,22123,4957,17166,2.3,10.5,1779,0.8,21,0,304,305,2310
2008,27,k) 26+,6748,10019,249655,247304,331,3.3,494,4.9,27074,5191,21883,2.1,10.9,22372,4907,17465,2,9,4702,1.9,18,0,283,284,2847
2008,27,l) Left Censored,12743,29837,1236926,1248559,1456,4.9,1218,4.1,120011,37995,82016,3,9.6,143277,22848,120429,1.8,11.5,-23266,-1.9,19.2,0,356,356,4378
2008,28,a) 0,3575,3633,21701,11036,3524,194,0,0,21330,21330,0,193.3,193.3,0,0,0,0,0,21330,193.3,0,0,,,
2008,28,b) 1,2958,3032,19519,20834,29,0.8,1001,28,5234,141,5093,0.7,25.1,7864,4536,3328,21.8,37.7,-2630,-12.6,50.2,0,846,846,4024
2008,28,c) 2,2568,2682,23632,24979,85,2.9,528,18.1,4405,548,3857,2.2,17.6,7098,3795,3303,15.2,28.4,-2693,-10.8,35.2,0,469,469,3583
2008,28,d) 3,2176,2222,21642,21773,82,3.4,393,16.5,3900,565,3335,2.6,17.9,4161,1783,2378,8.2,19.1,-261,-1.2,35.8,0,332,332,1578
2008,28,e) 4,1934,2028,18130,18325,103,4.8,329,15.3,3505,613,2892,3.3,19.1,3894,1560,2334,8.5,21.2,-389,-2.1,38.2,0,275,275,1362
2008,28,f) 5,1845,1961,16882,17432,79,3.8,287,13.9,2593,512,2081,2.9,14.9,3692,1654,2038,9.5,21.2,-1099,-6.3,29.8,0,231,231,1471
2008,28,g) 6 to 10,7275,7833,81488,83287,202,2.5,794,9.8,10498,1644,8854,2,12.6,14095,5002,9093,6,16.9,-3597,-4.3,25.2,0,636,636,3967
2008,28,h) 11 to 15,5202,5547,62400,63800,185,3.2,516,9,7577,1734,5843,2.7,11.9,10376,2926,7450,4.6,16.3,-2799,-4.4,23.8,0,388,389,2147
2008,28,i) 16 to 20,3720,4255,68314,68919,136,3.1,314,7.2,7940,2286,5654,3.3,11.5,9149,2865,6284,4.2,13.3,-1209,-1.8,23,0,207,207,1389
2008,28,j) 21 to 25,3634,4403,71340,71375,121,2.7,213,4.8,7153,1713,5440,2.4,10,7223,2016,5207,2.8,10.1,-70,-0.1,20,0,153,153,947
2008,28,k) 26+,3090,4561,95511,95706,158,3.4,228,5,13171,2279,10892,2.4,13.8,13560,4779,8781,5,14.2,-389,-0.4,27.6,0,148,148,1320
2008,28,l) Left Censored,5522,14493,441907,439688,704,4.9,521,3.6,43865,9703,34162,2.2,10,39427,6534,32893,1.5,9,4438,1,18,0,175,175,1692
2008,29,a) 0,9051,9109,52248,26698,8838,194,0,0,51100,51100,0,191.4,191.4,0,0,0,0,0,51100,191.4,0,0,,,
2008,29,b) 1,7165,7257,46595,51658,21,0.2,2527,29.2,10446,306,10140,0.6,20.2,20571,10376,10195,20.1,39.8,-10125,-19.6,40.4,0,2048,2048,9453
2008,29,c) 2,6828,7106,52208,54563,238,3.1,1442,18.7,9402,1399,8003,2.6,17.2,14111,6703,7408,12.3,25.9,-4709,-8.7,34.4,0,1135,1135,5640
2008,29,d) 3,6038,6216,50501,52863,210,3.1,1163,17.4,7042,802,6240,1.5,13.3,11766,5447,6319,10.3,22.3,-4724,-9,26.6,0,955,955,4589
2008,29,e) 4,5221,5335,47522,48305,171,3,958,16.8,8154,944,7210,2,16.9,9719,4391,5328,9.1,20.1,-1565,-3.2,33.8,0,777,777,3802
2008,29,f) 5,4533,4784,39012,40379,144,2.8,694,13.7,5633,734,4899,1.8,14,8366,3878,4488,9.6,20.7,-2733,-6.7,28,0,541,541,3296
2008,29,g) 6 to 10,17838,19056,199975,201351,609,3.1,2098,10.6,29108,5595,23513,2.8,14.5,31860,10977,20883,5.5,15.8,-2752,-1.3,29,0,1575,1579,8801
2008,29,h) 11 to 15,12913,13840,166892,168169,491,3.5,1220,8.6,23694,5535,18159,3.3,14.1,26247,7198,19049,4.3,15.6,-2553,-1.5,28.2,0,877,877,5065
2008,29,i) 16 to 20,9600,11309,161026,162230,316,2.7,801,6.9,18404,2950,15454,1.8,11.3,20812,5603,15209,3.5,12.8,-2408,-1.5,22.6,0,507,507,3363
2008,29,j) 21 to 25,8688,11405,216996,217947,338,2.9,627,5.4,20024,4539,15485,2.1,9.2,21925,4459,17466,2,10.1,-1901,-0.9,18.4,0,406,408,2620
2008,29,k) 26+,7020,11325,255564,254290,506,4.5,542,4.8,28423,8428,19995,3.3,11.2,25875,4595,21280,1.8,10.2,2548,1,20.4,0,329,329,2460
2008,29,l) Left Censored,13039,32733,1183632,1178167,1654,5.1,1323,4.1,131415,39580,91835,3.4,11.2,120485,21659,98826,1.8,10.2,10930,1,20.4,0,392,394,3043
2008,30,a) 0,2606,2633,10898,5542,2562,194.6,0,0,10712,10712,0,193.3,193.3,0,0,0,0,0,10712,193.3,0,0,,,
2008,30,b) 1,2168,2182,10336,11028,7,0.3,777,29.8,2664,58,2606,0.5,24.2,4048,2644,1404,24,36.7,-1384,-12.5,48.4,0,555,555,2196
2008,30,c) 2,2124,2189,16962,17748,77,3.3,411,17.4,2145,232,1913,1.3,12.1,3716,1498,2218,8.4,20.9,-1571,-8.8,24.2,0,273,273,1080
2008,30,d) 3,1720,1732,10389,10498,77,4.2,247,13.6,1898,202,1696,1.9,18.1,2116,767,1349,7.3,20.2,-218,-2.1,36.2,0,169,169,583
2008,30,e) 4,1543,1586,9639,10141,68,4.1,248,14.8,1415,149,1266,1.5,14,2418,1089,1329,10.7,23.8,-1003,-9.8,28,0,186,186,935
2008,30,f) 5,1242,1280,8194,8564,45,3.3,170,12.6,1003,119,884,1.4,11.7,1742,681,1061,8,20.3,-739,-8.6,23.4,0,126,126,536
2008,30,g) 6 to 10,5092,5304,39922,40866,186,3.4,542,9.9,4854,912,3942,2.2,11.9,6742,2444,4298,6,16.5,-1888,-4.6,23.8,0,369,369,1700
2008,30,h) 11 to 15,3480,3608,31275,31274,123,3.3,307,8.3,4349,993,3356,3.2,13.9,4346,1413,2933,4.5,13.9,3,0,27.8,0,206,208,1022
2008,30,i) 16 to 20,2210,2409,25266,25690,94,3.8,205,8.3,2692,444,2248,1.7,10.5,3539,878,2661,3.4,13.8,-847,-3.3,21,0,132,132,695
2008,30,j) 21 to 25,1798,2171,32306,32491,72,3.3,151,6.8,3664,706,2958,2.2,11.3,4033,1120,2913,3.4,12.4,-369,-1.1,22.6,0,93,93,790
2008,30,k) 26+,1745,2497,39924,39471,78,3.1,137,5.4,4439,576,3863,1.5,11.2,3533,712,2821,1.8,9,906,2.2,18,0,79,79,512
2008,30,l) Left Censored,2585,5392,123319,121433,235,4.4,185,3.4,13092,2577,10515,2.1,10.8,9320,1882,7438,1.5,7.7,3772,3.1,15.4,0,64,64,451
2008,31,a) 0,2871,2892,17022,8642,2801,193.7,0,0,16760,16760,0,193.9,193.9,0,0,0,0,0,16760,193.9,0,0,,,
2008,31,b) 1,2357,2405,14727,14763,7,0.3,635,23,4153,48,4105,0.3,28.1,4224,2431,1793,16.5,28.6,-71,-0.5,56.2,0,461,461,2085
2008,31,c) 2,2162,2263,15423,15817,81,3.3,422,17.3,2742,381,2361,2.4,17.3,3529,1742,1787,11,22.3,-787,-5,34.6,0,312,312,1383
2008,31,d) 3,1951,1975,12517,12915,75,3.6,293,14.1,2351,562,1789,4.4,18.2,3147,1828,1319,14.2,24.4,-796,-6.2,36.4,0,218,218,1375
2008,31,e) 4,1745,1776,13425,13769,54,2.9,276,14.7,1983,167,1816,1.2,14.4,2670,1403,1267,10.2,19.4,-687,-5,28.8,0,202,202,894
2008,31,f) 5,1544,1614,12425,12298,53,3.1,209,12.3,2158,469,1689,3.8,17.5,1903,817,1086,6.6,15.5,255,2,31,0,137,137,627
2008,31,g) 6 to 10,6737,7148,74264,74540,253,3.4,684,9.3,8777,1133,7644,1.5,11.8,9329,3504,5825,4.7,12.5,-552,-0.7,23.6,0,478,478,2663
2008,31,h) 11 to 15,4860,5216,55065,55073,154,2.9,458,8.5,7091,1076,6015,2,12.9,7107,2443,4664,4.4,12.9,-16,0,25.8,0,302,302,1774
2008,31,i) 16 to 20,3702,4268,60987,60340,160,3.7,349,8,7341,1708,5633,2.8,12.2,6046,1638,4408,2.7,10,1295,2.2,20,0,195,195,928
2008,31,j) 21 to 25,3068,3811,71123,73822,111,2.9,180,4.7,5836,1173,4663,1.6,7.9,11234,1533,9701,2.1,15.2,-5398,-7.3,15.8,0,118,118,927
2008,31,k) 26+,2868,4268,85957,86414,123,2.8,275,6.3,9640,1546,8094,1.8,11.2,10553,3260,7293,3.8,12.2,-913,-1,22.4,0,130,130,604
2008,31,l) Left Censored,5664,11528,370958,371263,552,4.8,431,3.8,37722,8440,29282,2.3,10.2,38332,5145,33187,1.4,10.3,-610,-0.1,20.4,0,158,158,1125
2008,32,a) 0,5492,5542,38518,19643,5411,195.3,0,0,37750,37750,0,192.2,192.2,0,0,0,0,0,37750,192.2,0,0,,,
2008,32,b) 1,4214,4278,35946,38856,13,0.3,1624,31.6,8267,52,8215,0.1,21.3,14087,7541,6546,19.4,36.3,-5820,-15,42.6,0,1373,1373,6450
2008,32,c) 2,3778,3907,40204,41980,138,3.2,1001,23,8559,540,8019,1.3,20.4,12110,6359,5751,15.1,28.8,-3551,-8.4,40.8,0,830,830,5472
2008,32,d) 3,3128,3278,33256,35920,116,3.2,724,20.2,4623,720,3903,2,12.9,9950,3558,6392,9.9,27.7,-5327,-14.8,25.8,0,612,612,3139
2008,32,e) 4,2568,2632,31416,33326,84,2.9,551,19.2,3999,455,3544,1.4,12,7819,2844,4975,8.5,23.5,-3820,-11.5,24,0,455,455,2390
2008,32,f) 5,2212,2366,29668,31668,97,3.9,389,15.5,4241,964,3277,3,13.4,8241,3449,4792,10.9,26,-4000,-12.6,26.8,0,321,321,2827
2008,32,g) 6 to 10,7723,8269,132005,139516,304,3.5,1013,11.8,16183,3412,12771,2.4,11.6,31204,8831,22373,6.3,22.4,-15021,-10.8,23.2,0,815,815,7136
2008,32,h) 11 to 15,4191,4680,90164,92660,187,3.9,435,9,12384,2224,10160,2.4,13.4,17375,4679,12696,5,18.8,-4991,-5.4,26.8,0,336,336,4011
2008,32,i) 16 to 20,2681,3419,70652,74502,170,4.9,291,8.4,9209,3676,5533,4.9,12.4,16909,4268,12641,5.7,22.7,-7700,-10.3,24.8,0,183,183,1660
2008,32,j) 21 to 25,2033,3168,76508,78697,149,4.7,194,6.1,10610,2657,7953,3.4,13.5,14987,3237,11750,4.1,19,-4377,-5.5,27,0,103,110,949
2008,32,k) 26+,1968,3376,113745,114252,259,7.8,189,5.7,13580,3818,9762,3.3,11.9,14593,2033,12560,1.8,12.8,-1013,-0.9,23.8,0,96,96,940
2008,32,l) Left Censored,3128,9540,459792,464750,761,8.1,491,5.2,48623,17646,30977,3.8,10.5,58539,10245,48294,2.2,12.6,-9916,-2.1,21,0,65,65,747
2008,33,a) 0,2200,2210,13122,6637,2149,194.5,0,0,12970,12970,0,195.4,195.4,0,0,0,0,0,12970,195.4,0,0,,,
2008,33,b) 1,1717,1735,10242,10581,5,0.2,539,26.5,2512,,,,23.7,3189,1737,1452,16.4,30.1,-677,-6.4,47.4,1,439,439,1558
2008,33,c) 2,1749,1837,13970,14484,61,3.1,363,18.2,2165,,,,14.9,3192,1361,1831,9.4,22,-1027,-7.1,29.8,1,293,293,1143
2008,33,d) 3,1495,1523,11680,12074,41,2.5,252,15.5,1548,188,1360,1.6,12.8,2336,1109,1227,9.2,19.3,-788,-6.5,25.6,0,210,210,996
2008,33,e) 4,1308,1327,8841,9321,35,2.5,207,14.7,1153,106,1047,1.1,12.4,2113,977,1136,10.5,22.7,-960,-10.3,24.8,0,164,164,794
2008,33,f) 5,1136,1201,9862,10137,24,1.9,178,14,1190,44,1146,0.4,11.7,1740,694,1046,6.8,17.2,-550,-5.5,23.4,0,135,135,599
2008,33,g) 6 to 10,4754,5040,49125,49772,157,3,531,10.2,6182,744,5438,1.5,12.4,7476,2672,4804,5.4,15,-1294,-2.6,24.8,0,389,389,2132
2008,33,h) 11 to 15,3782,3879,39025,40054,104,2.6,316,7.9,4206,744,3462,1.9,10.5,6263,1341,4922,3.3,15.6,-2057,-5.1,21,0,224,224,1091
2008,33,i) 16 to 20,2777,3117,43492,43866,64,2,218,6.8,4431,570,3861,1.3,10.1,5178,1738,3440,4,11.8,-747,-1.7,20.2,0,149,150,1348
2008,33,j) 21 to 25,2557,3071,55154,53989,100,3.2,196,6.3,8592,2685,5907,5,15.9,6261,2150,4111,4,11.6,2331,4.3,23.2,0,136,136,1103
2008,33,k) 26+,1745,2519,52995,53205,78,3.1,159,6.2,6885,2363,4522,4.4,12.9,7305,1519,5786,2.9,13.7,-420,-0.8,25.8,0,82,82,508
2008,33,l) Left Censored,3418,7543,279485,272100,446,5.9,363,4.8,39318,7803,31515,2.9,14.4,24547,3838,20709,1.4,9,14771,5.4,18,0,90,90,961
2008,34,a) 0,15416,15483,96434,53888,14944,193,0,0,85092,85092,0,157.9,157.9,0,0,0,0,0,85092,157.9,0,0,,,
2008,34,b) 1,12159,12232,82443,86045,44,0.3,3985,27.7,22215,1432,20783,1.7,25.8,29418,16077,13341,18.7,34.2,-7203,-8.4,51.6,0,3161,3161,13007
2008,34,c) 2,11382,11685,85502,88240,406,3.2,2297,18.2,16158,2395,13763,2.7,18.3,21633,9236,12397,10.5,24.5,-5475,-6.2,36.6,0,1836,1836,7816
2008,34,d) 3,10103,10269,74400,78110,291,2.6,1880,17,11206,1198,10008,1.5,14.3,18625,9220,9405,11.8,23.8,-7419,-9.5,28.6,0,1527,1527,7666
2008,34,e) 4,8497,8622,71435,73012,246,2.7,1482,16.1,11492,1056,10436,1.4,15.7,14645,6634,8011,9.1,20.1,-3153,-4.4,31.4,0,1244,1244,5662
2008,34,f) 5,7619,7915,72709,74926,306,3.7,1191,14.3,9731,1951,7780,2.6,13,14165,5218,8947,7,18.9,-4434,-5.9,26,0,985,985,4433
2008,34,g) 6 to 10,31426,32744,357046,364838,951,2.8,3761,11,45403,8803,36600,2.4,12.4,60986,22726,38260,6.2,16.7,-15583,-4.3,24.8,0,2855,2855,18970
2008,34,h) 11 to 15,22077,23028,276666,281525,700,2.9,2156,9.1,32897,5872,27025,2.1,11.7,42614,14202,28412,5,15.1,-9717,-3.4,23.4,0,1627,1632,11667
2008,34,i) 16 to 20,16045,17419,234194,235419,538,3,1345,7.5,28845,6061,22784,2.6,12.3,31294,10574,20720,4.5,13.3,-2449,-1,24.6,0,962,962,5669
2008,34,j) 21 to 25,13584,16209,298920,304819,498,3,1090,6.6,28616,6107,22509,2,9.4,40415,10407,30008,3.4,13.3,-11799,-3.9,18.8,0,734,738,6287
2008,34,k) 26+,11192,14711,329951,329969,515,3.5,921,6.2,38892,11199,27693,3.4,11.8,38928,7901,31027,2.4,11.8,-36,0,23.6,0,565,565,4055
2008,34,l) Left Censored,19398,43080,1632413,1641086,2432,5.6,2410,5.6,184167,60021,124146,3.7,11.2,201513,46431,155082,2.8,12.3,-17346,-1.1,22.4,0,807,812,8539
2008,35,a) 0,2978,3017,16267,8282,2926,194,0,0,15971,15971,0,192.8,192.8,0,0,0,0,0,15971,192.8,0,0,,,
2008,35,b) 1,2361,2371,25046,26524,3,0.1,761,27.2,4194,,,,15.8,7150,3897,3253,14.7,27,-2956,-11.2,31.6,1,618,618,3330
2008,35,c) 2,2229,2306,17797,18757,90,3.6,434,17.5,3132,,,,16.7,5051,2082,2969,11.1,26.9,-1919,-10.2,33.4,1,355,355,1742
2008,35,d) 3,1866,1924,15523,16133,62,3,308,15,2519,413,2106,2.6,15.6,3738,1617,2121,10,23.2,-1219,-7.6,31.2,0,238,238,1461
2008,35,e) 4,1612,1695,15522,16273,65,3.7,238,13.4,2496,272,2224,1.7,15.3,3997,2139,1858,13.1,24.6,-1501,-9.3,30.6,0,192,192,2009
2008,35,f) 5,1365,1407,13808,14350,50,3.4,200,13.5,1996,157,1839,1.1,13.9,3079,1025,2054,7.1,21.5,-1083,-7.6,27.8,0,150,150,886
2008,35,g) 6 to 10,5756,6152,78782,80215,217,3.4,634,10,8930,1094,7836,1.4,11.1,11796,3149,8647,3.9,14.7,-2866,-3.6,22.2,0,498,498,2567
2008,35,h) 11 to 15,4221,4479,49450,51159,170,3.7,404,8.8,5794,1168,4626,2.3,11.3,9212,2778,6434,5.4,18,-3418,-6.7,22.6,0,275,276,2242
2008,35,i) 16 to 20,2991,3568,50836,50739,129,3.5,268,7.4,6980,2063,4917,4.1,13.8,6785,1591,5194,3.1,13.4,195,0.4,26.8,0,171,171,971
2008,35,j) 21 to 25,2559,3390,61614,61487,116,3.4,181,5.3,6164,1541,4623,2.5,10,5909,1194,4715,1.9,9.6,255,0.4,19.2,0,116,116,570
2008,35,k) 26+,2326,3365,60841,60948,99,2.9,276,8,7751,1039,6712,1.7,12.7,7965,2272,5693,3.7,13.1,-214,-0.4,25.4,0,105,105,447
2008,35,l) Left Censored,3433,8420,237814,235800,521,6.2,385,4.6,30249,11889,18360,5,12.8,26221,5308,20913,2.3,11.1,4028,1.7,22.2,0,93,93,1338
2008,36,a) 0,37181,37399,203335,103272,36293,194.1,0,0,200126,200126,0,193.8,193.8,0,0,0,0,0,200126,193.8,0,0,,,
2008,36,b) 1,28109,28192,165807,172491,32,0.1,8165,24.9,40166,639,39527,0.4,23.3,53533,30251,23282,17.5,31,-13367,-7.7,46.6,0,6317,6317,25848
2008,36,c) 2,25576,26341,186025,191202,894,3.1,5045,17.8,32192,3275,28917,1.7,16.8,42545,21723,20822,11.4,22.3,-10353,-5.5,33.6,0,3949,3949,18072
2008,36,d) 3,22293,22699,182489,180343,782,3.2,3744,15.5,40967,16326,24641,9.1,22.7,36675,19290,17385,10.7,20.3,4292,2.4,40.6,0,3068,3068,16508
2008,36,e) 4,19350,19585,153375,155317,603,2.9,2876,13.9,24131,2706,21425,1.7,15.5,28015,13098,14917,8.4,18,-3884,-2.5,31,0,2322,2327,11119
2008,36,f) 5,17041,17606,151346,152817,566,3.1,2387,12.9,25548,2427,23121,1.6,16.7,28490,12130,16360,7.9,18.6,-2942,-1.9,33.4,0,1931,1931,10549
2008,36,g) 6 to 10,66736,69855,734697,739324,2046,2.8,7353,10.1,104848,13229,91619,1.8,14.2,114101,47260,66841,6.4,15.4,-9253,-1.2,28.4,0,5638,5640,37102
2008,36,h) 11 to 15,44712,46412,531786,538368,1207,2.5,4055,8.5,63873,7549,56324,1.4,11.9,77037,30055,46982,5.6,14.3,-13164,-2.4,23.8,0,3011,3016,25747
2008,36,i) 16 to 20,34461,37456,490984,495271,1099,2.9,2708,7.1,56073,10330,45743,2.1,11.3,64647,20697,43950,4.2,13.1,-8574,-1.8,22.6,0,1854,1855,12799
2008,36,j) 21 to 25,29387,34185,608857,609953,915,2.6,2001,5.8,59121,11317,47804,1.9,9.7,61312,16349,44963,2.7,10.1,-2191,-0.4,19.4,0,1354,1378,9808
2008,36,k) 26+,22737,31989,740583,740350,972,3,1717,5.3,78375,16751,61624,2.3,10.6,77909,15503,62406,2.1,10.5,466,0.1,21,0,1093,1095,8121
2008,36,l) Left Censored,42676,91046,3488805,3491029,4602,5.1,4497,4.9,363111,105230,257881,3,10.4,367559,82881,284678,2.4,10.5,-4448,-0.1,20.8,0,1670,1676,22208
2008,37,a) 0,14491,14653,81957,41462,14295,195.1,0,0,80990,80990,0,195.3,195.3,0,0,0,0,0,80990,195.3,0,0,,,
2008,37,b) 1,11893,11988,77067,81509,36,0.3,3600,25.8,18563,374,18189,0.5,22.8,27446,14826,12620,18.2,33.7,-8883,-10.9,45.6,0,2906,2906,12932
2008,37,c) 2,10650,11144,88732,91568,408,3.4,2152,17.9,16937,2564,14373,2.8,18.5,22609,11235,11374,12.3,24.7,-5672,-6.2,37,0,1723,1723,10043
2008,37,d) 3,9357,9556,78019,82069,285,2.8,1579,15.5,13664,1984,11680,2.4,16.6,21764,11747,10017,14.3,26.5,-8100,-9.9,33.2,0,1308,1308,10533
2008,37,e) 4,7764,8042,74913,76071,278,3.3,1246,14.6,12312,1420,10892,1.9,16.2,14628,5711,8917,7.5,19.2,-2316,-3,32.4,0,986,997,4927
2008,37,f) 5,6870,7359,74199,75762,217,2.8,946,12.2,11027,2060,8967,2.7,14.6,14152,5610,8542,7.4,18.7,-3125,-4.1,29.2,0,782,782,5017
2008,37,g) 6 to 10,27657,29749,330963,338796,937,3,3090,10,43807,9187,34620,2.7,12.9,59473,20233,39240,6,17.6,-15666,-4.7,25.8,0,2371,2376,16881
2008,37,h) 11 to 15,18561,20120,255617,258651,614,3,1763,8.5,30463,6100,24363,2.4,11.8,36531,11116,25415,4.3,14.1,-6068,-2.3,23.6,0,1326,1327,7950
2008,37,i) 16 to 20,13228,15695,265426,267039,495,3.1,1169,7.3,29993,6899,23094,2.6,11.2,33219,9462,23757,3.5,12.4,-3226,-1.2,22.4,0,826,827,5202
2008,37,j) 21 to 25,12538,15844,267496,268741,467,2.9,854,5.3,28887,6423,22464,2.4,10.7,31376,7578,23798,2.8,11.7,-2489,-1,21.4,0,576,578,3512
2008,37,k) 26+,8997,14925,364545,363040,636,4.2,824,5.5,45470,9763,35707,2.7,12.5,42460,8609,33851,2.4,11.7,3010,0.8,23.4,0,473,473,3560
2008,37,l) Left Censored,15196,45972,1627094,1625905,2769,6.1,1890,4.2,176856,55183,121673,3.4,10.9,174478,32626,141852,2,10.7,2378,0.2,21.4,0,481,486,5498
2008,38,a) 0,1288,1299,6897,3496,1267,195.1,0,0,6802,6802,0,194.6,194.6,0,0,0,0,0,6802,194.6,0,0,,,
2008,38,b) 1,1059,1071,8357,7982,2,0.2,285,23.1,2860,,,,35.8,2109,1380,729,17.3,26.4,751,9.4,52.8,1,172,172,1183
2008,38,c) 2,957,1006,8222,8431,46,4.3,175,16.3,1573,,,,18.7,1992,677,1315,8,23.6,-419,-4.9,37.4,1,121,121,553
2008,38,d) 3,829,844,5254,5306,54,6.1,133,15,825,195,630,3.7,15.5,929,412,517,7.8,17.5,-104,-2,31,0,91,91,325
2008,38,e) 4,691,713,5332,5347,33,4.4,112,14.9,863,126,737,2.4,16.1,892,451,441,8.4,16.7,-29,-0.6,32.2,0,72,72,365
2008,38,f) 5,624,644,4093,4190,33,4.9,83,12.4,624,82,542,2,14.9,817,459,358,11,19.5,-193,-4.6,29.8,0,60,60,359
2008,38,g) 6 to 10,2631,2794,24781,25510,114,4,285,9.9,3389,476,2913,1.9,13.3,4847,2135,2712,8.4,19,-1458,-5.7,26.6,0,163,163,1862
2008,38,h) 11 to 15,2148,2202,20182,20752,100,4.4,211,9.3,2314,279,2035,1.3,11.2,3454,783,2671,3.8,16.6,-1140,-5.4,22.4,0,116,116,591
2008,38,i) 16 to 20,1623,1767,19609,19727,67,3.7,151,8.3,2227,270,1957,1.4,11.3,2463,530,1933,2.7,12.5,-236,-1.2,22.6,0,77,77,362
2008,38,j) 21 to 25,1390,1680,20247,20371,32,1.9,88,5.2,1988,127,1861,0.6,9.8,2235,526,1709,2.6,11,-247,-1.2,19.6,0,58,58,406
2008,38,k) 26+,1381,1867,33411,32848,42,2.2,84,4.4,3558,406,3152,1.2,10.8,2431,490,1941,1.5,7.4,1127,3.4,14.8,0,49,51,293
2008,38,l) Left Censored,2603,4901,140200,139352,177,3.6,160,3.3,13052,2575,10477,1.8,9.4,11356,1501,9855,1.1,8.1,1696,1.3,16.2,0,70,70,816
2008,39,a) 0,12378,12525,89615,45408,12203,194.9,0,0,88414,88414,0,194.7,194.7,0,0,0,0,0,88414,194.7,0,0,,,
2008,39,b) 1,9791,9940,78167,84391,25,0.2,3129,26.9,17869,132,17737,0.2,21.2,30317,19175,11142,22.7,35.9,-12448,-14.7,42.4,0,2479,2479,17185
2008,39,c) 2,9538,9942,92182,97348,325,3,1964,18.2,15987,1869,14118,1.9,16.4,26319,13246,13073,13.6,27,-10332,-10.6,32.8,0,1561,1561,11886
2008,39,d) 3,8525,8838,87530,91046,288,3.1,1423,15.1,13866,2860,11006,3.1,15.2,20898,8790,12108,9.7,23,-7032,-7.8,30.4,0,1159,1159,8018
2008,39,e) 4,7497,7745,70320,73594,234,2.9,1191,14.5,9730,1364,8366,1.9,13.2,16278,7943,8335,10.8,22.1,-6548,-8.9,26.4,0,980,980,7363
2008,39,f) 5,6663,7223,70579,73298,232,3.1,984,13,9566,1730,7836,2.4,13.1,15004,5968,9036,8.1,20.5,-5438,-7.4,26.2,0,782,782,5367
2008,39,g) 6 to 10,28800,31309,355061,363283,996,3.1,3593,11,46786,9533,37253,2.6,12.9,63229,25114,38115,6.9,17.4,-16443,-4.5,25.8,0,2714,2717,18563
2008,39,h) 11 to 15,22899,25061,303039,305384,743,2.9,2183,8.5,39163,7783,31380,2.5,12.8,43853,13643,30210,4.5,14.4,-4690,-1.6,25.6,0,1578,1582,9466
2008,39,i) 16 to 20,17642,20987,312628,319947,725,3.4,1693,7.9,34395,6683,27712,2.1,10.8,49033,19698,29335,6.2,15.3,-14638,-4.5,21.6,0,1047,1048,8389
2008,39,j) 21 to 25,15595,20052,369546,372511,607,3,1133,5.6,36190,8762,27428,2.4,9.7,42119,9471,32648,2.5,11.3,-5929,-1.6,19.4,0,743,743,5432
2008,39,k) 26+,13761,21025,471585,468086,648,3,1125,5.3,52640,11007,41633,2.4,11.2,45642,9870,35772,2.1,9.8,6998,1.4,19.6,0,654,663,5211
2008,39,l) Left Censored,27052,68153,2418833,2439235,3038,4.4,3361,4.9,236946,67234,169712,2.8,9.7,277751,65829,211922,2.7,11.4,-40805,-1.7,19.4,0,932,944,10463
2008,40,a) 0,5955,6009,35082,17746,5857,194.9,0,0,34673,34673,0,195.4,195.4,0,0,0,0,0,34673,195.4,0,0,,,
2008,40,b) 1,4619,4666,36759,36821,14,0.3,1373,25.3,9837,397,9440,1.1,26.7,9961,5519,4442,15,27.1,-124,-0.4,53.4,0,1096,1096,4725
2008,40,c) 2,4138,4303,34646,35851,139,3,759,16.4,6274,614,5660,1.7,17.5,8683,3999,4684,11.2,24.2,-2409,-6.7,35,0,615,615,3584
2008,40,d) 3,3546,3656,38462,38624,104,2.7,602,15.4,6571,486,6085,1.3,17,6894,3298,3596,8.5,17.8,-323,-0.8,34,0,488,491,2629
2008,40,e) 4,2907,2994,27740,28156,84,2.6,446,14.1,4418,764,3654,2.7,15.7,5249,2172,3077,7.7,18.6,-831,-2.9,31.4,0,363,363,1880
2008,40,f) 5,2737,2836,28101,28251,84,2.8,354,11.9,4403,556,3847,2,15.6,4702,1864,2838,6.6,16.6,-299,-1,31.2,0,288,288,1501
2008,40,g) 6 to 10,11050,11998,128820,131826,351,2.8,1213,9.8,17291,2285,15006,1.7,13.1,23302,7807,15495,5.9,17.7,-6011,-4.6,26.2,0,954,956,6403
2008,40,h) 11 to 15,7854,8561,86478,88459,294,3.4,690,7.9,11397,2437,8960,2.8,12.9,15359,4227,11132,4.8,17.4,-3962,-4.5,25.8,0,479,479,3296
2008,40,i) 16 to 20,5781,6670,97913,97576,322,4.8,514,7.6,13329,4004,9325,4.1,13.7,12655,2660,9995,2.7,13,674,0.7,26,0,349,349,1773
2008,40,j) 21 to 25,5379,6633,108450,108702,196,2.9,349,5.2,12358,2418,9940,2.2,11.4,12861,2540,10321,2.3,11.8,-503,-0.4,22.8,0,249,249,1851
2008,40,k) 26+,4983,7483,163167,160573,309,4.1,374,5,19523,3624,15899,2.3,12.2,14335,2462,11873,1.5,8.9,5188,3.3,17.8,0,228,232,1370
2008,40,l) Left Censored,7058,17914,534899,533210,918,5.2,759,4.3,58950,17657,41293,3.3,11.1,55571,12394,43177,2.3,10.4,3379,0.7,20.8,0,224,224,1985
2008,41,a) 0,7780,7831,35431,17943,7643,195.2,0,0,34977,34977,0,194.9,194.9,0,0,0,0,0,34977,194.9,0,0,,,
2008,41,b) 1,6178,6224,34326,37115,19,0.3,2058,28,8671,103,8568,0.3,23.4,14248,8238,6010,22.2,38.4,-5577,-15,46.8,0,1592,1592,7048
2008,41,c) 2,5819,6115,39004,40963,213,3.2,1195,18.1,6694,982,5712,2.4,16.3,10611,4578,6033,11.2,25.9,-3917,-9.6,32.6,0,951,951,3885
2008,41,d) 3,4957,5079,33747,35050,195,3.6,850,15.7,5279,908,4371,2.6,15.1,7885,3415,4470,9.7,22.5,-2606,-7.4,30.2,0,676,676,2840
2008,41,e) 4,4032,4150,34631,35253,149,3.4,610,13.9,5975,949,5026,2.7,16.9,7218,3091,4127,8.8,20.5,-1243,-3.6,33.8,0,475,475,2479
2008,41,f) 5,3613,3886,29739,30181,154,3.8,501,12.3,5109,887,4222,2.9,16.9,5993,2468,3525,8.2,19.9,-884,-3,33.8,0,401,401,2180
2008,41,g) 6 to 10,14592,15420,143030,145111,501,3.1,1650,10.3,20217,3831,16386,2.6,13.9,24379,7878,16501,5.4,16.8,-4162,-2.9,27.8,0,1200,1200,5850
2008,41,h) 11 to 15,10375,11057,130226,132277,377,3.3,989,8.7,14568,2241,12327,1.7,11,18669,6318,12351,4.8,14.1,-4101,-3.1,22,0,689,689,4749
2008,41,i) 16 to 20,7005,7998,108151,109908,279,3.4,609,7.5,13039,2932,10107,2.7,11.9,16553,5008,11545,4.6,15.1,-3514,-3.2,23.8,0,399,399,3794
2008,41,j) 21 to 25,5464,7223,141551,140922,248,3.4,488,6.6,16671,4206,12465,3,11.8,15412,3947,11465,2.8,10.9,1259,0.9,21.8,0,286,287,2195
2008,41,k) 26+,5240,7574,154119,153020,292,3.8,394,5.2,17682,4487,13195,2.9,11.6,15483,3107,12376,2,10.1,2199,1.5,20.2,0,247,248,1660
2008,41,l) Left Censored,7275,18641,598308,598046,896,4.8,730,3.9,56495,13438,43057,2.2,9.4,55971,9748,46223,1.6,9.4,524,0,18.8,0,221,221,1951
2008,42,a) 0,15358,15523,90403,45793,15187,195.7,0,0,89220,89220,0,194.8,194.8,0,0,0,0,0,89220,194.8,0,0,,,
2008,42,b) 1,12341,12434,85123,87503,37,0.3,3477,24.3,22209,382,21827,0.4,25.4,26968,15815,11153,18.1,30.8,-4759,-5.4,50.8,0,2684,2684,13466
2008,42,c) 2,11733,12216,103525,105973,389,3,2113,16.2,16586,1738,14848,1.6,15.7,21482,9928,11554,9.4,20.3,-4896,-4.6,31.4,0,1660,1660,7987
2008,42,d) 3,10816,11129,99687,101736,330,2.8,1535,13.1,14945,1498,13447,1.5,14.7,19043,9102,9941,8.9,18.7,-4098,-4,29.4,0,1235,1235,8117
2008,42,e) 4,9172,9517,84686,85974,298,3,1301,13,12429,1369,11060,1.6,14.5,15004,6410,8594,7.5,17.5,-2575,-3,29,0,1033,1033,5585
2008,42,f) 5,8303,8736,90343,91755,300,3.3,956,10.5,11604,1600,10004,1.7,12.6,14427,6104,8323,6.7,15.7,-2823,-3.1,25.2,0,753,753,5368
2008,42,g) 6 to 10,35740,38283,442527,448826,1080,2.7,3521,8.9,50625,6909,43716,1.5,11.3,63222,22182,41040,4.9,14.1,-12597,-2.8,22.6,0,2656,2660,18018
2008,42,h) 11 to 15,25360,27107,348498,348807,719,2.6,2086,7.5,44141,8159,35982,2.3,12.7,44759,14048,30711,4,12.8,-618,-0.1,25.4,0,1531,1531,11481
2008,42,i) 16 to 20,21376,24092,324799,327361,641,2.6,1717,7,36722,6739,29983,2.1,11.2,41846,12398,29448,3.8,12.8,-5124,-1.6,22.4,0,1175,1175,6950
2008,42,j) 21 to 25,18811,23623,457967,457308,778,3.2,1481,6.2,53749,17043,36706,3.7,11.8,52431,17490,34941,3.8,11.5,1318,0.3,23,0,887,890,5713
2008,42,k) 26+,15442,22800,528803,523662,769,3.4,1059,4.6,61909,16137,45772,3.1,11.8,51626,9304,42322,1.8,9.9,10283,1.9,19.8,0,691,695,5098
2008,42,l) Left Censored,29494,72887,2578366,2571257,4112,5.7,3079,4.3,265156,73274,191882,2.8,10.3,250940,48692,202248,1.9,9.8,14216,0.5,19.6,0,1057,1062,12916
2008,44,a) 0,1662,1671,9811,4958,1615,193.3,0,0,9706,9706,0,195.8,195.8,0,0,0,0,0,9706,195.8,0,0,,,
2008,44,b) 1,1274,1282,9994,10542,3,0.2,460,30.1,1893,,,,18,2989,1803,1186,17.1,28.4,-1096,-10.4,36,1,329,329,1409
2008,44,c) 2,1243,1298,8283,8735,53,3.7,309,21.7,1489,,,,17,2392,1308,1084,15,27.4,-903,-10.4,34,1,210,210,1030
2008,44,d) 3,1126,1135,7306,7854,30,2.4,236,19.1,860,105,755,1.3,10.9,1956,1018,938,13,24.9,-1096,-14,21.8,0,193,193,879
2008,44,e) 4,1048,1069,9793,9830,40,3.5,171,15.1,1498,142,1356,1.4,15.2,1571,634,937,6.4,16,-73,-0.8,30.4,0,133,133,535
2008,44,f) 5,936,964,7931,8217,34,3.4,135,13.3,911,123,788,1.5,11.1,1482,462,1020,5.6,18,-571,-6.9,22.2,0,98,98,374
2008,44,g) 6 to 10,3653,3837,33042,34005,132,3.3,421,10.6,3936,508,3428,1.5,11.6,5861,2207,3654,6.5,17.2,-1925,-5.6,23.2,0,306,306,1795
2008,44,h) 11 to 15,2625,2675,25862,26623,63,2.3,239,8.7,2843,709,2134,2.7,10.7,4365,1374,2991,5.2,16.4,-1522,-5.7,21.4,0,165,165,1166
2008,44,i) 16 to 20,2257,2426,37070,37059,78,3.1,211,8.5,4753,993,3760,2.7,12.8,4731,1579,3152,4.3,12.8,22,0,25.6,0,123,125,677
2008,44,j) 21 to 25,1905,2242,33358,33825,51,2.2,146,6.4,3299,910,2389,2.7,9.8,4232,1226,3006,3.6,12.5,-933,-2.7,19.6,0,84,84,522
2008,44,k) 26+,1560,2002,39612,40415,60,3,91,4.5,4550,1125,3425,2.8,11.3,6155,871,5284,2.2,15.2,-1605,-3.9,22.6,0,58,58,340
2008,44,l) Left Censored,3501,5995,213753,215630,285,4.7,303,5,18819,6718,12101,3.1,8.7,22573,3584,18989,1.7,10.5,-3754,-1.8,17.4,0,95,95,790
2008,45,a) 0,6627,6658,36619,18538,6484,194.8,0,0,36162,36162,0,195.1,195.1,0,0,0,0,0,36162,195.1,0,0,,,
2008,45,b) 1,5559,5646,42629,43810,25,0.4,1742,26.4,10899,358,10541,0.8,24.9,13260,7295,5965,16.7,30.3,-2361,-5.4,49.8,0,1410,1410,6215
2008,45,c) 2,4957,5183,39520,41781,176,3.1,1091,19.3,6830,862,5968,2.1,16.3,11352,5491,5861,13.1,27.2,-4522,-10.9,32.6,0,894,894,4738
2008,45,d) 3,4393,4528,39738,40952,122,2.5,770,15.8,6751,662,6089,1.6,16.5,9179,3430,5749,8.4,22.4,-2428,-5.9,33,0,635,635,2868
2008,45,e) 4,3601,3704,34618,35714,95,2.4,591,14.9,4976,560,4416,1.6,13.9,7168,3114,4054,8.7,20.1,-2192,-6.2,27.8,0,479,479,2477
2008,45,f) 5,3324,3535,37169,38690,107,2.9,428,11.6,4892,482,4410,1.2,12.6,7934,3254,4680,8.4,20.5,-3042,-7.9,25.2,0,343,343,2659
2008,45,g) 6 to 10,13311,14289,167390,170670,456,3.1,1480,10,22928,4184,18744,2.5,13.4,29488,8319,21169,4.9,17.3,-6560,-3.9,26.8,0,1148,1148,6836
2008,45,h) 11 to 15,8785,9400,125456,129096,258,2.7,821,8.5,12351,2739,9612,2.1,9.6,19631,5822,13809,4.5,15.2,-7280,-5.6,19.2,0,625,626,4055
2008,45,i) 16 to 20,6289,7582,112647,112582,239,3.1,531,6.9,15675,3299,12376,2.9,13.9,15544,3439,12105,3.1,13.8,131,0.1,27.6,0,358,358,2220
2008,45,j) 21 to 25,5803,7706,132337,132391,244,3.1,410,5.3,14683,2015,12668,1.5,11.1,14790,3934,10856,3,11.2,-107,-0.1,22.2,0,279,280,2298
2008,45,k) 26+,4319,7052,147832,146797,276,3.9,315,4.5,18202,5036,13166,3.4,12.4,16132,2578,13554,1.8,11,2070,1.4,22,0,193,193,1154
2008,45,l) Left Censored,7690,22061,730983,726581,1240,5.7,915,4.2,80766,20111,60655,2.8,11.1,71962,11686,60276,1.6,9.9,8804,1.2,19.8,0,237,239,2559
2008,46,a) 0,1603,1626,9106,4617,1577,194,0,0,8979,8979,0,194.5,194.5,0,0,0,0,0,8979,194.5,0,0,,,
2008,46,b) 1,1338,1353,8144,8105,2,0.1,401,25.4,2157,,,,26.6,2079,1303,776,16.1,25.7,78,0.9,51.4,1,275,275,975
2008,46,c) 2,1231,1255,9503,9405,52,3.8,262,19.2,2187,,,,23.3,1990,866,1124,9.2,21.2,197,2.1,42.4,1,191,191,654
2008,46,d) 3,1004,1015,5551,5804,42,3.9,175,16.3,919,198,721,3.4,15.8,1425,688,737,11.9,24.6,-506,-8.8,31.6,0,130,134,603
2008,46,e) 4,956,988,7063,6931,36,3.5,128,12.4,1355,177,1178,2.6,19.5,1091,403,688,5.8,15.7,264,3.8,31.4,0,92,92,314
2008,46,f) 5,877,929,6336,6466,33,3.4,117,12.1,866,123,743,1.9,13.4,1125,447,678,6.9,17.4,-259,-4,26.8,0,91,91,390
2008,46,g) 6 to 10,3600,3755,32748,33058,156,4.1,346,9,4114,684,3430,2.1,12.4,4733,1492,3241,4.5,14.3,-619,-1.9,24.8,0,258,258,1180
2008,46,h) 11 to 15,2527,2634,25674,25899,112,4.2,237,8.8,2825,409,2416,1.6,10.9,3275,1005,2270,3.9,12.6,-450,-1.7,21.8,0,144,144,716
2008,46,i) 16 to 20,1844,2014,23831,23810,99,4.8,176,8.6,3329,1032,2297,4.3,14,3286,1410,1876,5.9,13.8,43,0.2,27.6,0,113,113,1055
2008,46,j) 21 to 25,1419,1717,23572,23601,63,3.6,115,6.6,2437,421,2016,1.8,10.3,2495,793,1702,3.4,10.6,-58,-0.3,20.6,0,66,66,374
2008,46,k) 26+,1334,1818,26745,26913,54,2.9,92,5,2359,384,1975,1.4,8.8,2695,781,1914,2.9,10,-336,-1.2,17.6,0,60,60,348
2008,46,l) Left Censored,2686,5142,155929,154115,216,4.2,167,3.3,15190,3302,11888,2.1,9.9,11562,2860,8702,1.9,7.5,3628,2.4,15,0,74,74,1175
2008,47,a) 0,8200,8283,53707,27088,8136,196.5,0,0,53238,53238,0,196.5,196.5,0,0,0,0,0,53238,196.5,0,0,,,
2008,47,b) 1,6431,6563,47696,51703,43,0.6,2139,27.8,10808,312,10496,0.6,20.9,18822,11655,7167,22.5,36.4,-8014,-15.5,41.8,0,1805,1805,10529
2008,47,c) 2,5807,6079,55627,57185,198,3,1257,19,10471,918,9553,1.6,18.3,13587,5980,7607,10.5,23.8,-3116,-5.5,36.6,0,1082,1082,5448
2008,47,d) 3,4978,5156,52003,52292,135,2.4,876,15.8,10219,809,9410,1.5,19.5,10797,4460,6337,8.5,20.6,-578,-1.1,39,0,745,745,4049
2008,47,e) 4,4288,4469,51119,49739,129,2.7,682,14.4,12548,685,11863,1.4,25.2,9787,3751,6036,7.5,19.7,2761,5.5,39.4,0,569,569,3118
2008,47,f) 5,3852,4080,43234,44019,139,3.3,524,12.3,6709,1156,5553,2.6,15.2,8279,2437,5842,5.5,18.8,-1570,-3.6,30.4,0,443,443,1967
2008,47,g) 6 to 10,14905,16482,204517,212435,545,3.2,1761,10.3,26901,6462,20439,3,12.7,42737,17073,25664,8,20.1,-15836,-7.4,25.4,0,1432,1437,14686
2008,47,h) 11 to 15,11305,12316,157668,164316,424,3.4,1086,8.6,21039,4819,16220,2.9,12.8,34334,9078,25256,5.5,20.9,-13295,-8.1,25.6,0,811,811,5716
2008,47,i) 16 to 20,8470,10395,186499,189618,384,3.6,729,6.9,23938,4387,19551,2.3,12.6,30175,7697,22478,4.1,15.9,-6237,-3.3,25.2,0,493,493,5330
2008,47,j) 21 to 25,8133,10408,193054,193186,344,3.3,570,5.4,21508,5689,15819,2.9,11.1,21772,5175,16597,2.7,11.3,-264,-0.2,22.2,0,389,395,2873
2008,47,k) 26+,6295,11006,266895,261476,729,6.7,520,4.8,43806,16666,27140,6.4,16.8,32967,5083,27884,1.9,12.6,10839,4.2,25.2,0,292,292,1747
2008,47,l) Left Censored,10902,31671,1177902,1179755,1894,6,1262,4,122192,36096,86096,3.1,10.4,125898,18453,107445,1.6,10.7,-3706,-0.3,20.8,0,346,347,4349
2008,48,a) 0,36515,36945,253432,128908,36223,196.1,0,0,249048,249048,0,193.2,193.2,0,0,0,0,0,249048,193.2,0,0,,,
2008,48,b) 1,28252,28646,237270,247322,110,0.3,8372,25.2,63487,1606,61881,0.6,25.7,83590,49706,33884,20.1,33.8,-20103,-8.1,51.4,0,6975,6975,43849
2008,48,c) 2,24566,25775,243463,249147,846,3,4799,17.3,50373,5900,44473,2.4,20.2,61740,28954,32786,11.6,24.8,-11367,-4.6,40.4,0,3946,3946,25261
2008,48,d) 3,21118,22345,258540,261983,779,3.3,3539,14.9,50942,9699,41243,3.7,19.4,57828,25830,31998,9.9,22.1,-6886,-2.7,38.8,0,3003,3003,22499
2008,48,e) 4,18373,19074,207944,211907,669,3.3,2718,13.5,35870,4713,31157,2.2,16.9,43795,18558,25237,8.8,20.7,-7925,-3.8,33.8,0,2276,2276,16160
2008,48,f) 5,16204,17460,205853,209010,555,3,2369,12.9,33342,5575,27767,2.7,16,39655,17042,22613,8.2,19,-6313,-3,32,0,1924,1924,14851
2008,48,g) 6 to 10,61837,67524,912986,922782,2163,3.1,7045,10.1,137094,27093,110001,2.9,14.9,156685,57408,99277,6.2,17,-19591,-2.1,29.8,0,5516,5526,45391
2008,48,h) 11 to 15,42750,47601,722322,723237,1641,3.4,4119,8.4,107722,22335,85387,3.1,14.9,109552,32962,76590,4.6,15.1,-1830,-0.2,29.8,0,3100,3100,23620
2008,48,i) 16 to 20,30813,37372,670515,672804,1561,4.1,2860,7.5,91931,21677,70254,3.2,13.7,96508,28790,67718,4.3,14.3,-4577,-0.6,27.4,0,1890,1890,15100
2008,48,j) 21 to 25,25475,35441,731520,719161,1345,3.8,1921,5.4,106625,40746,65879,5.7,14.8,81908,17586,64322,2.4,11.4,24717,3.4,22.8,0,1227,1247,8737
2008,48,k) 26+,22663,37111,816442,811737,1643,4.4,1929,5.2,109245,28429,80816,3.5,13.5,99835,23523,76312,2.9,12.3,9410,1.2,24.6,0,1075,1081,8088
2008,48,l) Left Censored,27038,102127,3827285,3810483,6744,6.7,5073,5,497869,148386,349483,3.9,13.1,464265,104377,359888,2.7,12.2,33604,0.9,24.4,0,1009,1063,14231
2008,49,a) 0,6341,6396,31803,16130,6189,193.5,0,0,31347,31347,0,194.3,194.3,0,0,0,0,0,31347,194.3,0,0,,,
2008,49,b) 1,5040,5079,32295,34212,17,0.3,1913,31.2,8474,164,8310,0.5,24.8,12307,7933,4374,23.2,36,-3833,-11.2,49.6,0,1493,1493,7033
2008,49,c) 2,4318,4462,34402,36426,159,3.2,1026,20.9,6660,732,5928,2,18.3,10708,4826,5882,13.2,29.4,-4048,-11.1,36.6,0,774,774,4042
2008,49,d) 3,3470,3541,31458,32424,126,3.3,652,17.1,6014,366,5648,1.1,18.5,7945,3792,4153,11.7,24.5,-1931,-6,37,0,509,509,3209
2008,49,e) 4,2893,2958,26888,27723,102,3.2,477,15.2,5128,463,4665,1.7,18.5,6797,3028,3769,10.9,24.5,-1669,-6,37,0,365,365,2510
2008,49,f) 5,2591,2668,32690,33095,91,3.2,383,13.6,4901,913,3988,2.8,14.8,5711,1972,3739,6,17.3,-810,-2.5,29.6,0,285,285,1655
2008,49,g) 6 to 10,9362,9872,126666,126925,313,3.1,1030,10.1,19853,2739,17114,2.2,15.6,20370,7487,12883,5.9,16,-517,-0.4,31.2,0,725,725,5653
2008,49,h) 11 to 15,5597,5921,93436,94889,170,2.8,542,8.9,15186,1823,13363,1.9,16,18091,4599,13492,4.8,19.1,-2905,-3.1,32,0,388,388,3420
2008,49,i) 16 to 20,3290,3901,90261,91279,129,3.2,270,6.8,9422,1049,8373,1.1,10.3,11457,3129,8328,3.4,12.6,-2035,-2.3,20.6,0,183,183,1794
2008,49,j) 21 to 25,2356,3296,81097,80442,118,3.6,170,5.1,11312,4319,6993,5.4,14.1,10001,2020,7981,2.5,12.4,1311,1.7,24.8,0,110,110,855
2008,49,k) 26+,2431,3548,86528,85930,145,4.1,183,5.1,10978,2453,8525,2.9,12.8,9782,2879,6903,3.4,11.4,1196,1.4,22.8,0,104,106,1683
2008,49,l) Left Censored,3753,10447,432932,431222,579,5.6,527,5.1,51133,10313,40820,2.4,11.9,47713,12565,35148,2.9,11.1,3420,0.8,22.2,0,96,96,1345
2008,50,a) 0,1158,1162,5386,2801,1122,193.1,0,0,5171,5171,0,184.6,184.6,0,0,0,0,0,5171,184.6,0,0,,,
2008,50,b) 1,979,988,8272,7972,2,0.2,299,25.9,2201,,,,27.6,1601,970,631,12.2,20.1,600,7.5,40.2,1,213,213,807
2008,50,c) 2,888,903,4893,5142,31,3.1,200,20.2,806,,,,15.7,1304,599,705,11.6,25.4,-498,-9.7,31.4,1,139,139,493
2008,50,d) 3,765,774,4890,5026,26,3.2,120,14.7,761,135,626,2.7,15.1,1033,483,550,9.6,20.6,-272,-5.5,30.2,0,86,86,410
2008,50,e) 4,744,755,4707,4933,27,3.4,107,13.4,568,63,505,1.3,11.5,1020,457,563,9.3,20.7,-452,-9.2,23,0,81,81,372
2008,50,f) 5,673,695,4596,4691,23,3.2,88,12.1,610,70,540,1.5,13,799,301,498,6.4,17,-189,-4,26,0,65,65,255
2008,50,g) 6 to 10,2869,2989,26884,27241,101,3.3,290,9.4,3069,400,2669,1.5,11.3,3782,1567,2215,5.8,13.9,-713,-2.6,22.6,0,210,210,1360
2008,50,h) 11 to 15,2158,2288,19103,19612,52,2.2,188,8,2021,160,1861,0.8,10.3,3038,931,2107,4.7,15.5,-1017,-5.2,20.6,0,127,127,709
2008,50,i) 16 to 20,1891,2012,19252,19745,56,2.7,175,8.5,1976,543,1433,2.8,10,2961,1086,1875,5.5,15,-985,-5,20,0,108,108,829
2008,50,j) 21 to 25,1588,1842,40335,39769,71,3.8,114,6.1,3464,1035,2429,2.6,8.7,2331,573,1758,1.4,5.9,1133,2.8,11.8,0,74,74,415
2008,50,k) 26+,1205,1579,27610,27173,38,2.4,89,5.5,3216,644,2572,2.4,11.8,2341,494,1847,1.8,8.6,875,3.2,17.2,0,52,52,358
2008,50,l) Left Censored,2089,3766,107367,107586,189,5,202,5.4,9033,3472,5561,3.2,8.4,9472,2032,7440,1.9,8.8,-439,-0.4,16.8,0,53,53,574
2008,51,a) 0,12482,12587,69562,35377,12265,194.9,0,0,68371,68371,0,193.3,193.3,0,0,0,0,0,68371,193.3,0,0,,,
2008,51,b) 1,9968,10037,64028,65467,37,0.3,3143,26.8,16934,324,16610,0.5,25.9,19811,11359,8452,17.4,30.3,-2877,-4.4,51.8,0,2479,2479,9732
2008,51,c) 2,9381,9806,74824,77191,347,3.3,2024,19,13813,1995,11818,2.6,17.9,18547,8647,9900,11.2,24,-4734,-6.1,35.8,0,1628,1628,7363
2008,51,d) 3,8113,8324,67042,69179,257,2.9,1429,16,10631,1406,9225,2,15.4,14905,6183,8722,8.9,21.5,-4274,-6.1,30.8,0,1147,1147,5292
2008,51,e) 4,6959,7124,59803,61408,228,3,1095,14.5,8583,808,7775,1.3,14,11792,5177,6615,8.4,19.2,-3209,-5.2,28,0,885,885,4484
2008,51,f) 5,5883,6165,59080,59600,208,3.2,823,12.7,9849,1435,8414,2.4,16.5,10889,4061,6828,6.8,18.3,-1040,-1.8,33,0,654,654,3542
2008,51,g) 6 to 10,23726,25550,294358,296680,771,2.9,2687,10.1,40119,5651,34468,1.9,13.5,44763,14082,30681,4.7,15.1,-4644,-1.6,27,0,2039,2040,11085
2008,51,h) 11 to 15,16826,17995,228356,230777,552,3,1517,8.2,28226,6016,22210,2.6,12.2,33067,10531,22536,4.6,14.3,-4841,-2.1,24.4,0,1105,1110,7613
2008,51,i) 16 to 20,12595,14634,236087,235491,454,3,1071,7.2,31542,5236,26306,2.2,13.4,30349,8110,22239,3.4,12.9,1193,0.5,25.8,0,702,702,4528
2008,51,j) 21 to 25,10763,13887,261155,260880,445,3.2,810,5.8,32652,6368,26284,2.4,12.5,32102,8133,23969,3.1,12.3,550,0.2,24.6,0,502,511,4058
2008,51,k) 26+,7993,12641,298607,298237,487,3.8,652,5.1,33719,9169,24550,3.1,11.3,32978,6796,26182,2.3,11.1,741,0.2,22.2,0,359,360,2786
2008,51,l) Left Censored,13318,40996,1432486,1449325,2366,5.8,2266,5.5,162590,46692,115898,3.2,11.2,196268,47420,148848,3.3,13.5,-33678,-2.3,22.4,0,417,429,4213
2008,53,a) 0,13532,13599,63960,32482,13252,194.9,0,0,62956,62956,0,193.8,193.8,0,0,0,0,0,62956,193.8,0,0,,,
2008,53,b) 1,10523,10603,60792,64514,15,0.1,3548,28.2,14772,37,14735,0.1,22.9,22216,13500,8716,20.9,34.4,-7444,-11.5,45.8,0,2775,2775,11578
2008,53,c) 2,9751,10054,68455,70979,425,3.9,1977,18.2,12865,1538,11327,2.2,18.1,17912,8492,9420,12,25.2,-5047,-7.1,36.2,0,1526,1526,6958
2008,53,d) 3,8104,8316,61163,62562,319,3.6,1452,16.3,10962,1430,9532,2.3,17.5,13760,5899,7861,9.4,22,-2798,-4.5,35,0,1122,1122,4866
2008,53,e) 4,6683,6832,53916,55532,270,3.8,1003,13.9,8640,1327,7313,2.4,15.6,11871,5195,6676,9.4,21.4,-3231,-5.8,31.2,0,783,783,4380
2008,53,f) 5,5825,6095,52977,54380,241,3.8,831,13,9202,939,8263,1.7,16.9,12007,4699,7308,8.6,22.1,-2805,-5.2,33.8,0,649,649,4025
2008,53,g) 6 to 10,23617,25142,259470,264069,981,3.8,2672,10.3,34828,5216,29612,2,13.2,44025,14605,29420,5.5,16.7,-9197,-3.5,26.4,0,1963,1964,11289
2008,53,h) 11 to 15,16042,17277,194176,197057,596,3.4,1572,8.8,24020,4686,19334,2.4,12.2,29781,10427,19354,5.3,15.1,-5761,-2.9,24.4,0,1069,1069,6358
2008,53,i) 16 to 20,11366,12923,188836,186772,483,3.7,978,7.4,27875,5207,22668,2.8,14.9,23746,6968,16778,3.7,12.7,4129,2.2,25.4,0,612,612,4036
2008,53,j) 21 to 25,8899,11608,225617,224387,414,3.5,758,6.4,23251,4131,19120,1.8,10.4,20790,6111,14679,2.7,9.3,2461,1.1,18.6,0,479,479,3735
2008,53,k) 26+,7636,11367,281568,280595,493,4.3,709,6.2,31006,8446,22560,3,11.1,29060,7726,21334,2.8,10.4,1946,0.7,20.8,0,390,391,2703
2008,53,l) Left Censored,10776,29456,1007516,1006690,1607,5.5,1285,4.4,103006,21433,81573,2.1,10.2,101354,20450,80904,2,10.1,1652,0.1,20.2,0,310,311,6141
2008,54,a) 0,1872,1893,11124,5652,1843,194.7,0,0,10945,10945,0,193.6,193.6,0,0,0,0,0,10945,193.6,0,0,,,
2008,54,b) 1,1523,1528,11026,11273,2,0.1,503,27.9,2781,,,,24.7,3275,2044,1231,18.1,29.1,-494,-4.4,49.4,1,413,413,1865
2008,54,c) 2,1551,1646,14060,14727,33,1.8,327,18.3,2243,211,2032,1.4,15.2,3577,1453,2124,9.9,24.3,-1334,-9.1,30.4,0,267,267,1228
2008,54,d) 3,1447,1487,11719,12096,46,2.9,211,13.5,1841,174,1667,1.4,15.2,2595,794,1801,6.6,21.5,-754,-6.3,30.4,0,174,174,688
2008,54,e) 4,1196,1274,10702,10661,31,2.3,182,13.5,1747,214,1533,2,16.4,1665,657,1008,6.2,15.6,82,0.8,31.2,0,144,144,511
2008,54,f) 5,1025,1116,8706,8914,24,2.1,123,10.6,1368,,,,15.3,1783,651,1132,7.3,20,-415,-4.7,30.6,1,99,99,583
2008,54,g) 6 to 10,4286,4681,47595,48519,135,2.8,527,10.8,6236,852,5384,1.8,12.9,8084,2954,5130,6.1,16.7,-1848,-3.8,25.8,0,429,429,2599
2008,54,h) 11 to 15,3405,3556,34252,35519,89,2.4,327,8.9,3478,493,2985,1.4,9.8,6011,2109,3902,5.9,16.9,-2533,-7.1,19.6,0,261,261,1340
2008,54,i) 16 to 20,2718,3059,37934,38465,98,3.1,235,7.5,4486,780,3706,2,11.7,5548,1869,3679,4.9,14.4,-1062,-2.7,23.4,0,172,172,870
2008,54,j) 21 to 25,2577,3166,53852,53734,79,2.5,171,5.3,5398,503,4895,0.9,10,5162,1009,4153,1.9,9.6,236,0.4,19.2,0,116,116,613
2008,54,k) 26+,2279,3592,60279,60183,192,5.4,185,5.2,7930,1847,6083,3.1,13.2,7738,1994,5744,3.3,12.9,192,0.3,25.8,0,113,113,772
2008,54,l) Left Censored,4523,9969,278733,277705,379,3.8,384,3.9,26716,6075,20641,2.2,9.6,24660,3586,21074,1.3,8.9,2056,0.7,17.8,0,142,142,858
2008,55,a) 0,7307,7378,42705,21661,7155,194,0,0,42088,42088,0,194.3,194.3,0,0,0,0,0,42088,194.3,0,0,,,
2008,55,b) 1,6083,6155,42987,45088,19,0.3,1897,26.4,9778,465,9313,1,21.7,13980,7501,6479,16.6,31,-4202,-9.3,43.4,0,1414,1414,6349
2008,55,c) 2,5848,6152,50037,51489,212,3.2,1187,17.9,8679,1307,7372,2.5,16.9,11582,5446,6136,10.6,22.5,-2903,-5.6,33.8,0,880,880,4601
2008,55,d) 3,5144,5233,39528,41438,178,3.2,888,15.9,5455,527,4928,1.3,13.2,9275,4989,4286,12,22.4,-3820,-9.2,26.4,0,683,683,4297
2008,55,e) 4,4446,4595,42386,43619,162,3.4,622,12.9,5553,843,4710,1.9,12.7,8019,2733,5286,6.3,18.4,-2466,-5.7,25.4,0,491,491,2373
2008,55,f) 5,4054,4265,38414,39378,126,2.8,535,12,5263,499,4764,1.3,13.4,7190,2844,4346,7.2,18.3,-1927,-4.9,26.8,0,380,380,2378
2008,55,g) 6 to 10,17706,19053,207251,210449,516,2.6,1888,9.6,23876,2982,20894,1.4,11.3,30272,10433,19839,5,14.4,-6396,-3.1,22.6,0,1389,1390,8426
2008,55,h) 11 to 15,13455,14290,157573,158985,435,3,1237,8.4,18927,3175,15752,2,11.9,21750,6548,15202,4.1,13.7,-2823,-1.8,23.8,0,852,852,4667
2008,55,i) 16 to 20,10664,12032,161633,162120,334,2.7,963,7.8,19155,4240,14915,2.6,11.8,20129,5614,14515,3.5,12.4,-974,-0.6,23.6,0,590,592,3963
2008,55,j) 21 to 25,8397,10727,201942,202164,327,3,625,5.7,19344,4063,15281,2,9.6,19787,5657,14130,2.8,9.8,-443,-0.2,19.2,0,376,412,2976
2008,55,k) 26+,7140,10809,237446,236716,384,3.5,558,5.1,24895,4713,20182,2,10.5,23434,6342,17092,2.7,9.9,1461,0.6,19.8,0,332,341,3190
2008,55,l) Left Censored,14375,32434,1275304,1274239,1483,4.6,1253,3.9,112564,28535,84029,2.2,8.8,110434,22312,88122,1.8,8.7,2130,0.1,17.4,0,435,438,6511
2008,56,a) 0,1486,1494,6438,3277,1457,195,0,0,6322,6322,0,192.9,192.9,0,0,0,0,0,6322,192.9,0,0,,,
2008,56,b) 1,1245,1253,7131,7112,4,0.3,355,24.5,2081,,,,29.3,2043,936,1107,13.2,28.7,38,0.6,57.4,1,246,246,697
2008,56,c) 2,1127,1167,8175,8315,39,3.1,224,17.7,1635,,,,19.7,1915,814,1101,9.8,23,-280,-3.3,39.4,1,165,165,656
2008,56,d) 3,920,939,6352,6416,35,3.6,132,13.4,1355,522,833,8.1,21.1,1482,508,974,7.9,23.1,-127,-2,42.2,0,99,99,428
2008,56,e) 4,724,737,4397,4674,24,3,122,15.4,621,47,574,1,13.3,1174,509,665,10.9,25.1,-553,-11.8,26.6,0,96,96,387
2008,56,f) 5,683,697,4837,4964,21,2.9,82,11.3,620,40,580,0.8,12.5,874,306,568,6.2,17.6,-254,-5.1,25,0,60,60,259
2008,56,g) 6 to 10,2859,2958,24388,24867,120,3.9,323,10.5,3686,566,3120,2.3,14.8,4644,1648,2996,6.6,18.7,-958,-3.9,29.6,0,227,227,1352
2008,56,h) 11 to 15,1897,1981,17357,17405,72,3.5,178,8.7,2144,390,1754,2.2,12.3,2239,702,1537,4,12.9,-95,-0.6,24.6,0,123,123,532
2008,56,i) 16 to 20,1256,1369,17799,17482,48,3.4,103,7.4,2549,511,2038,2.9,14.6,1914,554,1360,3.2,10.9,635,3.7,21.8,0,69,69,352
2008,56,j) 21 to 25,1030,1260,18267,18195,41,3.2,81,6.3,2218,251,1967,1.4,12.2,2073,739,1334,4.1,11.4,145,0.8,22.8,0,51,52,378
2008,56,k) 26+,1141,1535,25148,25014,63,4.1,83,5.4,3728,1174,2554,4.7,14.9,3459,793,2666,3.2,13.8,269,1.1,27.6,0,49,49,631
2008,56,l) Left Censored,1664,3220,77396,75729,185,5.7,198,6.1,11788,3524,8264,4.7,15.6,8454,2293,6161,3,11.2,3334,4.4,22.4,0,42,42,176
2009,01,a) 0,4981,5085,31684,15966,4990,196.3,0,0,31436,31436,0,196.9,196.9,0,0,0,0,0,31436,196.9,0,0,,,
2009,01,b) 1,4361,4450,29605,31968,12,0.2,1514,28.7,7437,318,7119,1,23.3,12162,7125,5037,22.3,38,-4725,-14.7,46.6,0,1245,1245,5799
2009,01,c) 2,4202,4269,32678,35545,118,2.5,991,21,4819,825,3994,2.3,13.6,10553,4429,6124,12.5,29.7,-5734,-16.1,27.2,0,839,839,3852
2009,01,d) 3,3682,3873,30050,33296,104,2.5,785,18.6,3878,511,3367,1.5,11.6,10370,5186,5184,15.6,31.1,-6492,-19.5,23.2,0,647,647,4175
2009,01,e) 4,3294,3425,32007,34392,93,2.5,627,17,4542,1387,3155,4,13.2,9312,3102,6210,9,27.1,-4770,-13.9,26.4,0,514,514,2407
2009,01,f) 5,2911,3024,29006,30911,64,2,481,14.9,3389,482,2907,1.6,11,7199,2176,5023,7,23.3,-3810,-12.3,22,0,398,398,1655
2009,01,g) 6 to 10,11714,12601,140563,148323,327,2.5,1564,11.8,14442,2569,11873,1.7,9.7,29961,8814,21147,5.9,20.2,-15519,-10.5,19.4,0,1194,1195,6801
2009,01,h) 11 to 15,9327,10225,118694,125068,263,2.5,993,9.4,13642,2102,11540,1.7,10.9,26390,6686,19704,5.3,21.1,-12748,-10.2,21.8,0,765,765,4082
2009,01,i) 16 to 20,6479,7510,105860,109848,188,2.4,606,7.9,9191,1650,7541,1.5,8.4,17166,3777,13389,3.4,15.6,-7975,-7.2,16.8,0,450,456,2256
2009,01,j) 21 to 25,6143,7716,166582,171847,164,2.1,448,5.7,11623,3349,8274,1.9,6.8,22153,3178,18975,1.8,12.9,-10530,-6.1,13.6,0,295,295,1697
2009,01,k) 26+,5501,8940,175599,179814,287,3.2,437,4.8,15001,4355,10646,2.4,8.3,23431,4200,19231,2.3,13,-8430,-4.7,16.6,0,238,238,1204
2009,01,l) Left Censored,7915,22600,712924,733793,987,4.3,1212,5.3,56429,16635,39794,2.3,7.7,98167,17611,80556,2.4,13.4,-41738,-5.7,15.4,0,255,267,2694
2009,02,a) 0,1062,1083,4890,2479,1054,194.6,0,0,4822,4822,0,194.5,194.5,0,0,0,0,0,4822,194.5,0,0,,,
2009,02,b) 1,869,895,5045,5357,4,0.4,333,30.8,1466,,,,27.4,2090,1344,746,25.1,39,-624,-11.6,54.8,1,226,226,1125
2009,02,c) 2,775,789,4881,5050,34,3.9,193,22.2,780,,,,15.4,1118,542,576,10.7,22.1,-338,-6.7,30.8,1,127,127,415
2009,02,d) 3,717,748,5947,6016,33,4.1,148,18.4,1140,137,1003,2.3,18.9,1277,454,823,7.5,21.2,-137,-2.3,37.8,0,98,98,337
2009,02,e) 4,581,591,4148,4297,21,3.3,121,18.8,607,101,506,2.4,14.1,904,412,492,9.6,21,-297,-6.9,28.2,0,81,81,309
2009,02,f) 5,589,607,4387,4493,27,4.2,79,12.4,688,86,602,1.9,15.3,900,246,654,5.5,20,-212,-4.7,30.6,0,50,50,154
2009,02,g) 6 to 10,2354,2505,28188,27297,87,3.3,286,11,5839,1300,4539,4.8,21.4,4056,1250,2806,4.6,14.9,1783,6.5,29.8,0,171,172,853
2009,02,h) 11 to 15,1708,1825,19124,19400,68,3.6,154,8.2,2164,211,1953,1.1,11.2,2715,628,2087,3.2,14,-551,-2.8,22.4,0,94,94,466
2009,02,i) 16 to 20,1171,1287,12305,12578,43,3.3,123,9.3,1271,168,1103,1.3,10.1,1817,377,1440,3,14.4,-546,-4.3,20.2,0,73,73,243
2009,02,j) 21 to 25,1110,1334,25290,25069,36,2.6,88,6.5,2875,206,2669,0.8,11.5,2433,730,1703,2.9,9.7,442,1.8,19.4,0,55,55,660
2009,02,k) 26+,1145,1818,41547,41656,90,4.9,95,5.2,7393,2483,4910,6,17.7,7610,2624,4986,6.3,18.3,-217,-0.6,35.4,0,34,34,275
2009,02,l) Left Censored,1273,3242,94439,94378,220,6.8,210,6.5,10391,2691,7700,2.9,11,10268,2145,8123,2.3,10.9,123,0.1,21.8,0,29,48,386
2009,04,a) 0,8312,8393,56990,28782,8201,195.4,0,0,56416,56416,0,196,196,0,0,0,0,0,56416,196,0,0,,,
2009,04,b) 1,7491,7698,57691,62386,39,0.4,3071,32.8,13874,361,13513,0.6,22.2,23263,13220,10043,21.2,37.3,-9389,-15.1,44.4,0,2488,2488,11694
2009,04,c) 2,6691,6842,50246,56341,214,2.7,2071,26.6,7781,808,6973,1.4,13.8,19970,9321,10649,16.5,35.4,-12189,-21.6,27.6,0,1731,1731,8371
2009,04,d) 3,6391,6599,54071,59628,233,3.2,1677,22.8,8067,1287,6780,2.2,13.5,19181,8378,10803,14.1,32.2,-11114,-18.7,27,0,1356,1356,6995
2009,04,e) 4,5139,5357,46540,52113,154,2.6,1287,21.7,5179,804,4375,1.5,9.9,16324,6670,9654,12.8,31.3,-11145,-21.4,19.8,0,1047,1047,5232
2009,04,f) 5,4507,4749,46250,50440,131,2.5,904,17.6,4952,827,4125,1.6,9.8,13332,4929,8403,9.8,26.4,-8380,-16.6,19.6,0,708,708,4332
2009,04,g) 6 to 10,16339,17395,202516,234195,505,2.7,2762,14.9,19472,3769,15703,1.6,8.3,82829,43294,39535,18.5,35.4,-63357,-27.1,16.6,0,2030,2035,12509
2009,04,h) 11 to 15,10975,12140,171255,186259,360,2.8,1460,11.5,16692,3807,12885,2,9,46700,11432,35268,6.1,25.1,-30008,-16.1,18,0,997,998,7437
2009,04,i) 16 to 20,6751,8707,136531,149378,255,2.8,832,9.2,12044,2684,9360,1.8,8.1,37738,6891,30847,4.6,25.3,-25694,-17.2,16.2,0,532,538,4277
2009,04,j) 21 to 25,5670,8229,178274,185091,346,4.1,631,7.5,20148,6894,13254,3.7,10.9,33782,8806,24976,4.8,18.3,-13634,-7.4,21.8,0,365,365,3502
2009,04,k) 26+,5199,8958,223187,231333,396,4.4,607,6.7,22658,8049,14609,3.5,9.8,38949,7454,31495,3.2,16.8,-16291,-7,19.6,0,279,287,2112
2009,04,l) Left Censored,5912,23065,874717,898489,1693,7.3,1770,7.7,85893,30814,55079,3.4,9.6,133436,30077,103359,3.3,14.9,-47543,-5.3,19.2,0,187,209,3590
2009,05,a) 0,3471,3526,19824,10124,3434,194.8,0,0,19401,19401,0,191.6,191.6,0,0,0,0,0,19401,191.6,0,0,,,
2009,05,b) 1,2934,2949,19764,21021,7,0.2,940,27.1,4865,149,4716,0.7,23.1,7378,4528,2850,21.5,35.1,-2513,-12,46.2,0,768,768,4133
2009,05,c) 2,2618,2660,18418,19908,71,2.4,624,21.2,2654,276,2378,1.4,13.3,5633,2680,2953,13.5,28.3,-2979,-15,26.6,0,514,514,2323
2009,05,d) 3,2544,2728,20169,21571,71,2.4,510,17.3,2581,511,2070,2.4,12,5385,2476,2909,11.5,25,-2804,-13,24,0,411,411,2014
2009,05,e) 4,2273,2341,17367,19052,65,2.6,380,15.2,1835,183,1652,1,9.6,5204,2259,2945,11.9,27.3,-3369,-17.7,19.2,0,313,313,1931
2009,05,f) 5,1967,2060,16857,17425,45,2,318,14.5,2463,133,2330,0.8,14.1,3598,1394,2204,8,20.6,-1135,-6.5,28.2,0,257,257,1169
2009,05,g) 6 to 10,7972,8583,74306,78474,288,3.2,970,10.9,7432,1730,5702,2.2,9.5,15767,5234,10533,6.7,20.1,-8335,-10.6,19,0,731,734,4548
2009,05,h) 11 to 15,5766,6454,63017,66804,160,2.4,592,8.9,5235,1074,4161,1.6,7.8,12808,3443,9365,5.2,19.2,-7573,-11.4,15.6,0,443,443,2642
2009,05,i) 16 to 20,4238,4835,55226,57313,156,3.1,406,8.2,5501,1122,4379,2,9.6,9675,2264,7411,4,16.9,-4174,-7.3,19.2,0,289,289,1545
2009,05,j) 21 to 25,3663,4616,86010,88778,151,3.2,267,5.7,8554,4312,4242,4.9,9.6,14090,3280,10810,3.7,15.9,-5536,-6.3,19.2,0,185,189,1205
2009,05,k) 26+,3738,5535,119176,127852,160,2.9,297,5.3,11289,2751,8538,2.2,8.8,28640,6689,21951,5.2,22.4,-17351,-13.6,17.6,0,177,177,1059
2009,05,l) Left Censored,5351,14004,460646,468232,663,4.7,729,5.2,36656,10446,26210,2.2,7.8,51829,9487,42342,2,11.1,-15173,-3.3,15.6,0,178,183,1357
2009,06,a) 0,53588,54020,320169,162208,52957,196.1,0,0,315923,315923,0,194.8,194.8,0,0,0,0,0,315923,194.8,0,0,,,
2009,06,b) 1,45752,46385,307327,335404,112,0.2,16137,29.2,72484,1823,70661,0.5,21.6,128638,67101,61537,20,38.4,-56154,-16.8,43.2,0,12793,12800,55623
2009,06,c) 2,40875,41331,296454,322051,1404,3.1,10509,22.9,53933,5685,48248,1.8,16.7,105127,53414,51713,16.6,32.6,-51194,-15.9,33.4,0,8402,8402,43621
2009,06,d) 3,39691,41142,333732,360588,1452,3.2,8648,19.3,49446,7409,42037,2.1,13.7,103158,45565,57593,12.6,28.6,-53712,-14.9,27.4,0,6802,6804,37233
2009,06,e) 4,33818,35885,319986,347056,1297,3.4,6688,17.3,48508,11018,37490,3.2,14,102647,40041,62606,11.5,29.6,-54139,-15.6,28,0,5202,5209,28181
2009,06,f) 5,29019,29981,305683,317985,970,3,4872,15.2,55069,5373,49696,1.7,17.3,79673,27980,51693,8.8,25.1,-24604,-7.8,34.6,0,3740,3740,22679
2009,06,g) 6 to 10,111246,117869,1265636,1345548,3831,3.1,15576,12.6,149565,30559,119006,2.3,11.1,309389,101489,207900,7.5,23,-159824,-11.9,22.2,0,11313,11345,78935
2009,06,h) 11 to 15,70309,76786,1023386,1090467,2396,3,7829,9.8,100331,24457,75874,2.2,9.2,234493,54175,180318,5,21.5,-134162,-12.3,18.4,0,5551,5557,38177
2009,06,i) 16 to 20,51141,59550,946658,980150,1919,3.1,5521,9,120651,23721,96930,2.4,12.3,187634,44685,142949,4.6,19.1,-66983,-6.8,24.6,0,3619,3651,28088
2009,06,j) 21 to 25,44545,57927,1173559,1214218,1783,3,4310,7.3,103950,28165,75785,2.3,8.6,185268,39625,145643,3.3,15.3,-81318,-6.7,17.2,0,2627,2636,20847
2009,06,k) 26+,43521,66750,1507157,1566890,2091,3.1,4159,6.1,126064,34927,91137,2.2,8,245529,47489,198040,3,15.7,-119465,-7.7,16,0,2357,2375,17929
2009,06,l) Left Censored,42725,135057,5089420,5235290,7319,5.4,8657,6.4,458348,147899,310449,2.8,8.8,750089,161445,588644,3.1,14.3,-291741,-5.5,17.6,0,1635,1728,17475
2009,08,a) 0,9565,9612,48555,24603,9354,194.6,0,0,47905,47905,0,194.7,194.7,0,0,0,0,0,47905,194.7,0,0,,,
2009,08,b) 1,8290,8349,47738,51631,29,0.3,3203,31.7,11672,377,11295,0.7,22.6,19458,12483,6975,24.2,37.7,-7786,-15.1,45.2,0,2362,2377,10258
2009,08,c) 2,7349,7405,49728,52008,262,3.2,1930,23.4,10562,3997,6565,7.7,20.3,15122,7182,7940,13.8,29.1,-4560,-8.8,40.6,0,1406,1406,6187
2009,08,d) 3,6873,7067,49236,53016,279,3.6,1496,19.5,8114,1548,6566,2.9,15.3,15674,7180,8494,13.5,29.6,-7560,-14.3,30.6,0,1118,1119,5822
2009,08,e) 4,6155,6269,50887,53149,222,3.3,1182,17.5,7930,822,7108,1.5,14.9,12453,4871,7582,9.2,23.4,-4523,-8.5,29.8,0,860,860,3891
2009,08,f) 5,5130,5275,42317,45324,192,3.4,931,16.5,4549,626,3923,1.4,10,10563,4206,6357,9.3,23.3,-6014,-13.3,20,0,678,678,3470
2009,08,g) 6 to 10,20593,21582,189786,200629,752,3.3,2982,13.1,21276,4405,16871,2.2,10.6,42961,13127,29834,6.5,21.4,-21685,-10.8,21.2,0,1939,1940,9053
2009,08,h) 11 to 15,13899,15196,168004,176286,567,3.6,1645,10.4,20229,7370,12859,4.2,11.5,36792,8619,28173,4.9,20.9,-16563,-9.4,23,0,1040,1040,5425
2009,08,i) 16 to 20,8900,10265,144814,151868,361,3.4,918,8.7,14023,3593,10430,2.4,9.2,28130,7561,20569,5,18.5,-14107,-9.3,18.4,0,576,576,5938
2009,08,j) 21 to 25,6708,8641,147624,153566,302,3.4,608,6.9,15176,5665,9511,3.7,9.9,27060,8080,18980,5.3,17.6,-11884,-7.7,19.8,0,372,372,3037
2009,08,k) 26+,6626,10542,237996,248722,380,3.6,581,5.5,20773,5599,15174,2.3,8.4,42225,7796,34429,3.1,17,-21452,-8.6,16.8,0,300,300,2564
2009,08,l) Left Censored,7602,22689,793434,806269,1418,6.2,1424,6.3,77665,19039,58626,2.4,9.6,103334,27567,75767,3.4,12.8,-25669,-3.2,19.2,0,243,243,9216
2009,09,a) 0,4028,4042,25803,13011,3962,196,0,0,25584,25584,0,196.6,196.6,0,0,0,0,0,25584,196.6,0,0,,,
2009,09,b) 1,3625,3670,22071,26154,12,0.3,1211,28,4658,60,4598,0.2,17.8,12823,4913,7910,18.8,49,-8165,-31.2,35.6,0,936,936,4211
2009,09,c) 2,3091,3121,24894,26761,75,2.2,705,20.5,3970,567,3403,2.1,14.8,7704,3877,3827,14.5,28.8,-3734,-14,29.6,0,547,551,2432
2009,09,d) 3,3107,3292,27224,28260,88,2.5,550,15.6,3544,318,3226,1.1,12.5,5616,1999,3617,7.1,19.9,-2072,-7.4,25,0,434,434,1731
2009,09,e) 4,2797,2864,25471,27043,74,2.4,483,15.7,3019,305,2714,1.1,11.2,6163,2745,3418,10.2,22.8,-3144,-11.6,22.4,0,372,372,2305
2009,09,f) 5,2407,2466,19592,20286,69,2.6,364,13.9,2848,561,2287,2.8,14,4236,1556,2680,7.7,20.9,-1388,-6.9,28,0,287,287,1346
2009,09,g) 6 to 10,10070,10559,120580,129126,248,2.2,1285,11.6,10931,1587,9344,1.2,8.5,28022,7348,20674,5.7,21.7,-17091,-13.2,17,0,950,950,5921
2009,09,h) 11 to 15,8002,8538,92025,96688,228,2.6,781,8.8,10171,1454,8717,1.5,10.5,19497,3837,15660,4,20.2,-9326,-9.7,21,0,526,529,2777
2009,09,i) 16 to 20,6536,7145,87684,91936,169,2.3,564,7.7,8264,2506,5758,2.7,9,16768,4240,12528,4.6,18.2,-8504,-9.2,18,0,361,361,2759
2009,09,j) 21 to 25,6233,7354,120218,124376,195,2.6,539,7.2,8823,2419,6404,1.9,7.1,17138,4456,12682,3.6,13.8,-8315,-6.7,14.2,0,309,309,2768
2009,09,k) 26+,5782,8062,152696,156972,225,2.8,411,5,12671,2870,9801,1.8,8.1,21223,2943,18280,1.9,13.5,-8552,-5.4,16.2,0,226,228,1361
2009,09,l) Left Censored,9922,20577,750593,767592,932,4.5,1237,6,59016,14916,44100,1.9,7.7,93013,19473,73540,2.5,12.1,-33997,-4.4,15.4,0,286,299,3531
2009,10,a) 0,1252,1264,8514,4301,1235,195.4,0,0,8426,8426,0,195.9,195.9,0,0,0,0,0,8426,195.9,0,0,,,
2009,10,b) 1,1108,1125,8044,8504,4,0.3,338,25.8,2359,78,2281,0.9,27.7,3278,1850,1428,21.8,38.5,-919,-10.8,55.4,0,255,255,1598
2009,10,c) 2,888,920,7046,7841,22,2.1,226,22,767,93,674,1.2,9.8,2357,1277,1080,16.3,30.1,-1590,-20.3,19.6,0,181,181,1197
2009,10,d) 3,898,916,6817,7324,22,2.2,172,17.3,639,39,600,0.5,8.7,1652,612,1040,8.4,22.6,-1013,-13.9,17.4,0,135,135,515
2009,10,e) 4,799,801,5879,6027,24,2.7,169,19.2,1155,95,1060,1.6,19.2,1451,740,711,12.3,24.1,-296,-4.9,38.4,0,129,129,668
2009,10,f) 5,716,733,7103,7882,21,2.6,145,18.2,565,59,506,0.7,7.2,2122,1022,1100,13,26.9,-1557,-19.7,14.4,0,101,101,452
2009,10,g) 6 to 10,2945,3074,27075,28404,91,2.8,417,12.9,2951,473,2478,1.7,10.4,5608,1828,3780,6.4,19.7,-2657,-9.3,20.8,0,292,292,1266
2009,10,h) 11 to 15,2049,2237,27523,28911,72,3.1,225,9.7,2951,568,2383,2,10.2,5727,1429,4298,4.9,19.8,-2776,-9.6,20.4,0,151,151,979
2009,10,i) 16 to 20,1514,1674,20495,20376,53,3.1,147,8.5,3200,1810,1390,8.9,15.7,2961,590,2371,2.9,14.5,239,1.2,29,0,99,99,354
2009,10,j) 21 to 25,1309,1584,22063,23553,42,2.6,98,6.1,1181,292,889,1.2,5,4161,579,3582,2.5,17.7,-2980,-12.7,10,0,59,59,324
2009,10,k) 26+,1264,1776,41419,42111,55,3.1,100,5.6,3230,777,2453,1.8,7.7,4614,627,3987,1.5,11,-1384,-3.3,15.4,0,43,43,209
2009,10,l) Left Censored,2607,5846,188674,191948,366,6.3,371,6.3,18313,8217,10096,4.3,9.5,24860,5332,19528,2.8,13,-6547,-3.5,19,0,46,48,265
2009,11,a) 0,900,900,6237,3150,886,196.9,0,0,6175,6175,0,196,196,0,0,0,0,0,6175,196,0,0,,,
2009,11,b) 1,762,768,6707,7079,1,0.1,214,24.1,1716,,,,24.2,2459,1515,944,21.4,34.7,-743,-10.5,48.4,1,171,171,1380
2009,11,c) 2,736,741,6136,6206,23,2.9,136,17,1088,,,,17.5,1228,467,761,7.5,19.8,-140,-2.3,35,1,103,103,326
2009,11,d) 3,708,726,6791,6872,24,3.1,118,15.2,1373,176,1197,2.6,20,1534,594,940,8.6,22.3,-161,-2.3,40,0,95,95,525
2009,11,e) 4,862,875,8558,8827,23,2.5,111,12,1385,82,1303,0.9,15.7,1922,661,1261,7.5,21.8,-537,-6.1,31.4,0,95,95,601
2009,11,f) 5,337,340,6217,6339,7,2,38,10.8,555,14,541,0.2,8.8,799,196,603,3.1,12.6,-244,-3.8,17.6,0,24,24,141
2009,11,g) 6 to 10,2364,2530,40304,40835,101,3.9,237,9.1,5567,1268,4299,3.1,13.6,6629,1620,5009,4,16.2,-1062,-2.6,27.2,0,162,165,1162
2009,11,h) 11 to 15,1818,1956,32197,32910,51,2.5,138,6.9,3406,458,2948,1.4,10.3,4831,675,4156,2.1,14.7,-1425,-4.4,20.6,0,98,98,461
2009,11,i) 16 to 20,1343,1491,31798,31929,43,2.8,91,6,4088,1325,2763,4.1,12.8,4350,633,3717,2,13.6,-262,-0.8,25.6,0,56,56,276
2009,11,j) 21 to 25,1263,1462,28126,28805,43,2.9,93,6.2,2050,286,1764,1,7.1,3408,1098,2310,3.8,11.8,-1358,-4.7,14.2,0,53,53,372
2009,11,k) 26+,1526,1981,74889,74910,94,4.7,131,6.5,7795,2405,5390,3.2,10.4,7837,1517,6320,2,10.5,-42,-0.1,20.8,0,42,42,251
2009,11,l) Left Censored,2913,5928,230480,228822,542,9.2,438,7.5,25590,6688,18902,2.9,11.2,22274,4788,17486,2.1,9.7,3316,1.5,19.4,0,59,59,397
2009,12,a) 0,34030,34239,185096,93773,33378,195,0,0,182646,182646,0,194.8,194.8,0,0,0,0,0,182646,194.8,0,0,,,
2009,12,b) 1,27725,28021,163494,183337,64,0.2,11650,33.8,38018,1032,36986,0.6,20.7,77703,45091,32612,24.6,42.4,-39685,-21.7,41.4,0,9255,9255,38458
2009,12,c) 2,24623,25049,175773,193965,977,3.4,7689,27,24920,3221,21699,1.7,12.8,61303,31925,29378,16.5,31.6,-36383,-18.8,25.6,0,6155,6155,27517
2009,12,d) 3,22822,23373,162359,181684,954,3.7,6291,24.1,26490,3982,22508,2.2,14.6,65140,23137,42003,12.7,35.9,-38650,-21.3,29.2,0,4916,4917,18551
2009,12,e) 4,20867,21572,163770,173302,858,3.6,5017,21.2,27541,4329,23212,2.5,15.9,46604,19308,27296,11.1,26.9,-19063,-11,31.8,0,3875,3875,16266
2009,12,f) 5,19776,20243,139093,150111,701,3.2,4396,19.9,17535,2782,14753,1.9,11.7,39571,15898,23673,10.6,26.4,-22036,-14.7,23.4,0,3299,3299,12480
2009,12,g) 6 to 10,62340,65549,617475,669708,2146,3.1,10211,14.6,70761,17087,53674,2.6,10.6,175226,63535,111691,9.5,26.2,-104465,-15.6,21.2,0,7543,7562,48151
2009,12,h) 11 to 15,40491,43957,510339,533569,1441,3.1,5025,11,65597,18036,47561,3.4,12.3,112057,29965,82092,5.6,21,-46460,-8.7,24.6,0,3473,3485,19986
2009,12,i) 16 to 20,28939,34149,500540,527586,1150,3.3,3153,9,46524,12514,34010,2.4,8.8,100615,21680,78935,4.1,19.1,-54091,-10.3,17.6,0,2068,2069,12706
2009,12,j) 21 to 25,21554,27801,584534,609545,1046,3.7,2192,7.7,56820,18028,38792,3,9.3,106842,22489,84353,3.7,17.5,-50022,-8.2,18.6,0,1357,1357,11138
2009,12,k) 26+,18183,29553,633503,660581,1167,3.9,2007,6.7,62315,20786,41529,3.1,9.4,116470,20709,95761,3.1,17.6,-54155,-8.2,18.8,0,1066,1171,8425
2009,12,l) Left Censored,18571,73911,2641497,2729547,4822,6.5,5187,7,236163,87711,148452,3.2,8.7,412263,77172,335091,2.8,15.1,-176100,-6.4,17.4,0,723,813,9215
2009,13,a) 0,13045,13174,79306,40085,12876,195.5,0,0,78443,78443,0,195.7,195.7,0,0,0,0,0,78443,195.7,0,0,,,
2009,13,b) 1,11596,11763,76942,86861,34,0.2,4540,31.8,16630,,,,19.1,36468,21284,15184,24.5,42,-19838,-22.9,38.2,1,3694,3696,18101
2009,13,c) 2,10387,10555,85074,85874,327,2.7,2966,24.9,26895,,,,31.3,28495,14992,13503,17.5,33.2,-1600,-1.9,62.6,1,2330,2333,12873
2009,13,d) 3,9344,9719,80828,88372,337,3.1,2347,21.8,12427,1842,10585,2.1,14.1,27514,14100,13414,16,31.1,-15087,-17,28.2,0,1881,1884,12647
2009,13,e) 4,8248,8587,78105,82746,247,2.6,1824,19.4,13072,5208,7864,6.3,15.8,22353,9216,13137,11.1,27,-9281,-11.2,31.6,0,1437,1437,7174
2009,13,f) 5,7242,7434,62477,68798,209,2.6,1380,17.2,7306,959,6347,1.4,10.6,19947,8529,11418,12.4,29,-12641,-18.4,21.2,0,1088,1088,7063
2009,13,g) 6 to 10,27646,29442,326124,345796,842,2.7,4226,13.5,37882,5979,31903,1.7,11,77225,26717,50508,7.7,22.3,-39343,-11.3,22,0,3166,3174,21783
2009,13,h) 11 to 15,18997,20858,251570,268337,671,3.1,2382,11,25963,7089,18874,2.6,9.7,59497,20448,39049,7.6,22.2,-33534,-12.5,19.4,0,1710,1710,13532
2009,13,i) 16 to 20,12248,14834,229379,241087,520,3.4,1332,8.7,24753,8059,16694,3.3,10.3,48168,11225,36943,4.7,20,-23415,-9.7,20.6,0,913,913,6399
2009,13,j) 21 to 25,10348,13326,274327,282990,452,3.3,924,6.8,31077,13936,17141,4.9,11,48402,8720,39682,3.1,17.1,-17325,-6.1,22,0,602,605,4569
2009,13,k) 26+,9035,14813,349264,362965,517,3.4,962,6.4,35448,10560,24888,2.9,9.8,62849,10505,52344,2.9,17.3,-27401,-7.5,19.6,0,476,536,3953
2009,13,l) Left Censored,12261,41858,1505876,1540965,2453,5.8,2689,6.4,138788,49834,88954,3.2,9,208966,39605,169361,2.6,13.6,-70178,-4.6,18,0,411,438,4613
2009,15,a) 0,1516,1526,8274,4166,1502,196.9,0,0,8216,8216,0,197.2,197.2,0,0,0,0,0,8216,197.2,0,0,,,
2009,15,b) 1,1312,1328,8484,9038,4,0.3,435,27.9,1870,20,1850,0.2,20.7,2978,1616,1362,17.9,32.9,-1108,-12.2,41.4,0,353,353,1439
2009,15,c) 2,1275,1278,9644,10433,45,3.2,311,22,1337,106,1231,1,12.8,2914,1358,1556,13,27.9,-1577,-15.1,25.6,0,244,244,1082
2009,15,d) 3,1174,1242,11177,11774,38,2.8,227,16.9,1775,366,1409,3.1,15.1,2969,1076,1893,9.1,25.2,-1194,-10.1,30.2,0,167,167,884
2009,15,e) 4,1050,1071,10558,11306,29,2.5,175,15.3,1151,365,786,3.2,10.2,2647,812,1835,7.2,23.4,-1496,-13.2,20.4,0,137,137,626
2009,15,f) 5,941,987,8452,8922,29,2.8,147,14,1111,126,985,1.4,12.5,2051,643,1408,7.2,23,-940,-10.5,25,0,106,106,530
2009,15,g) 6 to 10,3843,4147,42067,44917,104,2.4,442,10.3,3834,641,3193,1.4,8.5,9533,2696,6837,6,21.2,-5699,-12.7,17,0,331,331,2088
2009,15,h) 11 to 15,2747,2967,37198,37872,110,3.6,224,7.4,3756,825,2931,2.2,9.9,5104,1143,3961,3,13.5,-1348,-3.6,19.8,0,168,168,806
2009,15,i) 16 to 20,2182,2521,31931,33316,83,3.2,179,7,3071,615,2456,1.8,9.2,5841,1762,4079,5.3,17.5,-2770,-8.3,18.4,0,116,116,1356
2009,15,j) 21 to 25,1891,2365,45066,46482,60,2.5,140,5.8,3482,1217,2265,2.6,7.5,6313,1105,5208,2.4,13.6,-2831,-6.1,15,0,92,92,742
2009,15,k) 26+,2304,3289,57309,59902,68,2,162,4.9,3666,568,3098,0.9,6.1,8851,1289,7562,2.2,14.8,-5185,-8.7,12.2,0,103,103,687
2009,15,l) Left Censored,3017,6958,214945,220184,346,5,337,4.8,17286,6869,10417,3.1,7.9,27764,5446,22318,2.5,12.6,-10478,-4.7,15.8,0,74,78,378
2009,16,a) 0,2595,2606,14566,7449,2546,195.4,0,0,14235,14235,0,191.1,191.1,0,0,0,0,0,14235,191.1,0,0,,,
2009,16,b) 1,2402,2418,12393,14166,4,0.1,1077,35.9,2534,,,,17.9,6080,3211,2869,22.7,42.9,-3546,-25,35.8,1,793,793,2662
2009,16,c) 2,2398,2416,13836,15466,94,3.4,739,27,1981,,,,12.8,5241,2463,2778,15.9,33.9,-3260,-21.1,25.6,1,532,532,1890
2009,16,d) 3,2308,2381,14587,16316,90,3.4,656,24.6,1911,208,1703,1.3,11.7,5368,2467,2901,15.1,32.9,-3457,-21.2,23.4,0,474,474,1971
2009,16,e) 4,1902,1944,13969,15114,63,3,432,20.2,2354,212,2142,1.4,15.6,4643,1940,2703,12.8,30.7,-2289,-15.1,31.2,0,302,302,1554
2009,16,f) 5,1580,1629,12637,13683,51,2.9,316,17.9,1321,240,1081,1.8,9.7,3412,1231,2181,9,24.9,-2091,-15.2,19.4,0,214,214,978
2009,16,g) 6 to 10,5960,6326,60618,64098,222,3.3,878,13.2,6149,1193,4956,1.9,9.6,13108,4259,8849,6.6,20.4,-6959,-10.8,19.2,0,555,555,3170
2009,16,h) 11 to 15,4096,4335,39582,41996,128,2.8,515,11.4,3812,597,3215,1.4,9.1,8639,2139,6500,5.1,20.6,-4827,-11.5,18.2,0,346,346,1622
2009,16,i) 16 to 20,2673,2971,32918,34892,84,2.7,286,9.3,3295,583,2712,1.7,9.4,7242,1880,5362,5.4,20.8,-3947,-11.4,18.8,0,155,155,1335
2009,16,j) 21 to 25,1844,2304,40643,42458,70,3,151,6.4,3329,1256,2073,3,7.8,6959,1152,5807,2.7,16.4,-3630,-8.6,15.6,0,82,82,636
2009,16,k) 26+,1942,2948,62166,64849,78,2.6,178,5.9,4282,796,3486,1.2,6.6,9648,1431,8217,2.2,14.9,-5366,-8.3,13.2,0,90,90,404
2009,16,l) Left Censored,2784,6870,183334,188255,307,4.5,350,5.1,13710,4965,8745,2.6,7.3,23552,4137,19415,2.2,12.5,-9842,-5.2,14.6,0,64,64,526
2009,17,a) 0,16247,16357,87498,44301,15919,194.6,0,0,86395,86395,0,195,195,0,0,0,0,0,86395,195,0,0,,,
2009,17,b) 1,13972,14168,92840,100972,43,0.3,4720,28.2,19458,547,18911,0.5,19.3,35722,21288,14434,21.1,35.4,-16264,-16.1,38.6,0,3442,3442,18177
2009,17,c) 2,12249,12379,86479,94924,418,3.1,2882,21.2,14230,1546,12684,1.6,15,31120,15043,16077,15.8,32.8,-16890,-17.8,30,0,2118,2118,12994
2009,17,d) 3,11684,12132,101324,106047,461,3.5,2251,17.3,16895,1817,15078,1.7,15.9,26340,12370,13970,11.7,24.8,-9445,-8.9,31.8,0,1670,1670,10521
2009,17,e) 4,10565,10874,97446,102077,368,3.2,1877,16.1,13054,2341,10713,2.3,12.8,22315,9184,13131,9,21.9,-9261,-9.1,25.6,0,1401,1401,7317
2009,17,f) 5,9377,9614,80671,84989,274,2.7,1500,14.6,9514,919,8595,1.1,11.2,18150,6561,11589,7.7,21.4,-8636,-10.2,22.4,0,1093,1093,4878
2009,17,g) 6 to 10,36613,38953,421309,445492,1190,2.9,4762,11.7,42592,8648,33944,1.9,9.6,90959,29036,61923,6.5,20.4,-48367,-10.8,19.2,0,3296,3302,21329
2009,17,h) 11 to 15,28363,30538,358478,379195,916,2.9,3002,9.5,31572,5079,26493,1.3,8.3,73006,18770,54236,4.9,19.3,-41434,-11,16.6,0,1964,1974,12271
2009,17,i) 16 to 20,21909,24734,338206,350570,819,3.2,2063,8.1,35351,7315,28036,2.1,10.1,60078,12567,47511,3.6,17.1,-24727,-7,20.2,0,1262,1266,7556
2009,17,j) 21 to 25,17803,21823,417901,429986,678,3,1473,6.6,35262,13169,22093,3.1,8.2,59432,11917,47515,2.8,13.8,-24170,-5.6,16.4,0,914,916,6619
2009,17,k) 26+,17239,25349,625143,644235,708,2.8,1400,5.4,52632,15756,36876,2.4,8.2,90817,16855,73962,2.6,14.1,-38185,-5.9,16.4,0,776,776,6586
2009,17,l) Left Censored,26875,65143,2404286,2483445,2831,4.3,4139,6.3,189281,60933,128348,2.5,7.6,347600,67375,280225,2.7,14,-158319,-6.4,15.2,0,900,929,9767
2009,18,a) 0,6443,6520,41560,21042,6377,195.6,0,0,41036,41036,0,195,195,0,0,0,0,0,41036,195,0,0,,,
2009,18,b) 1,6111,6214,45150,49331,25,0.3,1820,25.2,9689,356,9333,0.7,19.6,18051,8823,9228,17.9,36.6,-8362,-17,39.2,0,1430,1433,6807
2009,18,c) 2,5388,5513,42608,45965,196,3.2,1246,20.6,7250,586,6664,1.3,15.8,13963,5795,8168,12.6,30.4,-6713,-14.6,31.6,0,999,999,4947
2009,18,d) 3,5214,5504,47267,50068,186,3.1,1078,18.1,6668,690,5978,1.4,13.3,12270,5358,6912,10.7,24.5,-5602,-11.2,26.6,0,803,803,4522
2009,18,e) 4,4480,4619,39570,41780,144,2.9,757,15.4,5410,1030,4380,2.5,12.9,9830,3609,6221,8.6,23.5,-4420,-10.6,25.8,0,578,578,2981
2009,18,f) 5,3938,4072,35857,38806,125,2.9,677,15.6,4880,985,3895,2.5,12.6,10778,5219,5559,13.4,27.8,-5898,-15.2,25.2,0,537,537,2965
2009,18,g) 6 to 10,16283,17317,179003,187042,451,2.5,2124,11.7,23089,3617,19472,1.9,12.3,39166,12995,26171,6.9,20.9,-16077,-8.6,24.6,0,1550,1554,10804
2009,18,h) 11 to 15,12740,14094,162695,168915,400,2.7,1314,9,17919,4711,13208,2.8,10.6,30359,7819,22540,4.6,18,-12440,-7.4,21.2,0,894,894,4962
2009,18,i) 16 to 20,9944,11606,153514,162270,326,2.7,997,8.3,15255,3176,12079,2,9.4,32766,8002,24764,4.9,20.2,-17511,-10.8,18.8,0,607,609,3652
2009,18,j) 21 to 25,8690,11237,199072,208868,265,2.3,663,5.8,17595,5323,12272,2.5,8.4,37186,8153,29033,3.9,17.8,-19591,-9.4,16.8,0,403,411,3417
2009,18,k) 26+,8235,12576,276859,289394,325,2.5,711,5.6,25494,5186,20308,1.8,8.8,50564,12117,38447,4.2,17.5,-25070,-8.7,17.6,0,313,359,2457
2009,18,l) Left Censored,13498,35043,1222245,1257185,1486,4.2,1724,4.9,95192,25721,69471,2,7.6,165071,23045,142026,1.8,13.1,-69879,-5.5,15.2,0,441,451,3923
2009,19,a) 0,3523,3574,21320,10724,3504,196.1,0,0,21192,21192,0,197.6,197.6,0,0,0,0,0,21192,197.6,0,0,,,
2009,19,b) 1,3219,3259,20306,22895,10,0.3,1055,27.5,4778,125,4653,0.5,20.9,9956,5328,4628,23.3,43.5,-5178,-22.6,41.8,0,804,804,4676
2009,19,c) 2,2919,2947,21001,22738,110,3.5,572,18,3771,620,3151,2.7,16.6,7245,3503,3742,15.4,31.9,-3474,-15.3,33.2,0,439,439,3256
2009,19,d) 3,2964,3209,24225,25106,101,3,499,14.6,3600,426,3174,1.7,14.3,5361,2412,2949,9.6,21.4,-1761,-7.1,28.6,0,372,372,1716
2009,19,e) 4,2551,2605,20627,21538,104,3.8,380,13.8,3121,622,2499,2.9,14.5,4943,1775,3168,8.2,23,-1822,-8.5,29,0,279,279,1357
2009,19,f) 5,2290,2362,17843,18601,72,2.9,309,12.5,2372,266,2106,1.4,12.8,3888,1293,2595,7,20.9,-1516,-8.1,25.6,0,230,230,1129
2009,19,g) 6 to 10,9195,9820,96703,99203,305,3,1015,10,12438,1374,11064,1.4,12.5,17438,5015,12423,5.1,17.6,-5000,-5.1,25,0,695,695,4065
2009,19,h) 11 to 15,7609,8215,80433,82646,302,3.6,700,8.3,9659,1332,8327,1.6,11.7,14085,3981,10104,4.8,17,-4426,-5.3,23.4,0,449,450,2809
2009,19,i) 16 to 20,5647,6232,68115,70613,175,2.7,472,7.4,7299,1177,6122,1.7,10.3,12294,2346,9948,3.3,17.4,-4995,-7.1,20.6,0,282,282,1310
2009,19,j) 21 to 25,4679,5856,113529,116218,143,2.4,339,5.7,10945,4485,6460,3.9,9.4,16322,2884,13438,2.5,14,-5377,-4.6,18.8,0,202,203,1109
2009,19,k) 26+,5199,8359,138631,140272,230,2.7,343,4.1,12312,2676,9636,1.9,8.8,15593,1981,13612,1.4,11.1,-3281,-2.3,17.6,0,233,233,1248
2009,19,l) Left Censored,9163,19426,657490,664073,588,3,807,4.1,52695,11176,41519,1.7,7.9,65861,8290,57571,1.2,9.9,-13166,-2,15.8,0,251,253,2481
2009,20,a) 0,3607,3630,20919,10602,3543,195.2,0,0,20634,20634,0,194.6,194.6,0,0,0,0,0,20634,194.6,0,0,,,
2009,20,b) 1,3172,3218,20419,21796,5,0.1,1028,27.2,4967,68,4899,0.3,22.8,7721,4545,3176,20.9,35.4,-2754,-12.6,45.6,0,803,803,3886
2009,20,c) 2,2963,2991,20639,21609,108,3.3,627,19.3,3571,361,3210,1.7,16.5,5510,2917,2593,13.5,25.5,-1939,-9,33,0,487,487,2632
2009,20,d) 3,2807,2945,21570,27471,83,2.6,511,16.2,3243,430,2813,1.6,11.8,15045,2066,12979,7.5,54.8,-11802,-43,23.6,0,386,393,1676
2009,20,e) 4,2487,2551,21728,23309,59,2.2,424,15.5,2701,291,2410,1.2,11.6,5863,2109,3754,9,25.2,-3162,-13.6,23.2,0,318,318,1570
2009,20,f) 5,2250,2295,19215,21063,55,2.3,339,13.9,2401,185,2216,0.9,11.4,6097,1783,4314,8.5,28.9,-3696,-17.5,22.8,0,257,257,1467
2009,20,g) 6 to 10,9239,9654,101338,102846,256,2.6,1004,10,13661,1116,12545,1.1,13.3,16677,5621,11056,5.5,16.2,-3016,-2.9,26.6,0,747,747,4712
2009,20,h) 11 to 15,6954,7532,88819,92635,192,2.5,673,8.7,8089,1934,6155,2.1,8.7,15721,3822,11899,4.1,17,-7632,-8.3,17.4,0,482,482,3153
2009,20,i) 16 to 20,5166,5907,77760,80942,181,3,476,7.9,7634,1617,6017,2,9.4,13997,3266,10731,4,17.3,-6363,-7.9,18.8,0,287,287,1762
2009,20,j) 21 to 25,4286,5215,80555,82018,135,2.5,307,5.8,7245,1402,5843,1.7,8.8,10171,1765,8406,2.2,12.4,-2926,-3.6,17.6,0,197,198,1145
2009,20,k) 26+,4638,6990,132381,134897,186,2.6,363,5.1,12855,2431,10424,1.8,9.5,17887,3276,14611,2.4,13.3,-5032,-3.8,19,0,196,196,1345
2009,20,l) Left Censored,7545,16880,530581,536880,690,4.1,768,4.5,42622,11799,30823,2.2,7.9,55220,7827,47393,1.5,10.3,-12598,-2.4,15.8,0,222,222,1791
2009,21,a) 0,4186,4208,25515,12893,4126,196.1,0,0,25244,25244,0,195.8,195.8,0,0,0,0,0,25244,195.8,0,0,,,
2009,21,b) 1,3740,3841,28711,30888,11,0.2,1107,24.9,7050,79,6971,0.3,22.8,11404,5914,5490,19.1,36.9,-4354,-14.1,45.6,0,892,892,5128
2009,21,c) 2,3398,3446,24976,27364,102,2.7,761,20.2,3854,446,3408,1.6,14.1,8629,4692,3937,17.1,31.5,-4775,-17.4,28.2,0,632,632,4343
2009,21,d) 3,3234,3388,27358,28830,110,3,594,16.4,4010,705,3305,2.4,13.9,6954,2673,4281,9.3,24.1,-2944,-10.2,27.8,0,478,478,2388
2009,21,e) 4,2917,3014,25789,27457,67,2.1,513,15.9,3101,505,2596,1.8,11.3,6437,2461,3976,9,23.4,-3336,-12.1,22.6,0,418,418,2111
2009,21,f) 5,2555,2692,24016,24837,79,2.8,415,14.5,3792,514,3278,2.1,15.3,5434,2238,3196,9,21.9,-1642,-6.6,30.6,0,330,330,1919
2009,21,g) 6 to 10,10468,11131,113099,118978,300,2.6,1230,10.6,11726,2232,9494,1.9,9.9,23483,6615,16868,5.6,19.7,-11757,-9.8,19.8,0,909,911,5157
2009,21,h) 11 to 15,8096,8938,103592,109281,231,2.5,778,8.4,10126,2508,7618,2.3,9.3,21503,6186,15317,5.7,19.7,-11377,-10.4,18.6,0,559,559,3050
2009,21,i) 16 to 20,6144,7367,95008,98897,291,3.9,542,7.2,9830,2280,7550,2.3,9.9,17607,3096,14511,3.1,17.8,-7777,-7.9,19.8,0,373,373,1929
2009,21,j) 21 to 25,5611,6934,127855,132776,195,2.8,370,5.3,9880,2386,7494,1.8,7.4,19722,3409,16313,2.6,14.9,-9842,-7.5,14.8,0,261,262,1636
2009,21,k) 26+,4979,7798,163618,168145,281,3.5,524,6.6,16436,4954,11482,2.9,9.8,25490,4056,21434,2.4,15.2,-9054,-5.4,19.6,0,235,256,1538
2009,21,l) Left Censored,8055,21194,716822,730773,1013,4.8,967,4.6,59683,19481,40202,2.7,8.2,87584,13927,73657,1.9,12,-27901,-3.8,16.4,0,241,241,2046
2009,22,a) 0,5409,5475,38601,19547,5368,196.1,0,0,38109,38109,0,195,195,0,0,0,0,0,38109,195,0,0,,,
2009,22,b) 1,4781,4920,39039,40333,26,0.5,1361,24,9822,397,9425,1,24.4,12410,6446,5964,16,30.8,-2588,-6.4,48.8,0,1092,1092,5072
2009,22,c) 2,4463,4505,39430,40789,131,2.7,913,18.7,7475,890,6585,2.2,18.3,10192,5136,5056,12.6,25,-2717,-6.7,36.6,0,750,750,4547
2009,22,d) 3,3737,4026,39136,40362,104,2.4,639,14.9,6337,493,5844,1.2,15.7,8788,3290,5498,8.2,21.8,-2451,-6.1,31.4,0,524,524,2670
2009,22,e) 4,3317,3408,35711,36064,78,2.2,485,13.5,6325,1519,4806,4.2,17.5,7030,2650,4380,7.3,19.5,-705,-2,35,0,383,383,2271
2009,22,f) 5,3002,3114,33219,34377,85,2.6,413,12.6,4521,469,4052,1.4,13.2,6837,2288,4549,6.7,19.9,-2316,-6.7,26.4,0,324,324,1982
2009,22,g) 6 to 10,12297,13112,161591,165537,345,2.5,1363,10,19001,3014,15987,1.8,11.5,26893,8817,18076,5.3,16.2,-7892,-4.7,23,0,1042,1042,6549
2009,22,h) 11 to 15,9361,10081,128264,130289,266,2.6,767,7.4,14608,2927,11681,2.2,11.2,18658,4835,13823,3.7,14.3,-4050,-3.1,22.4,0,580,580,3121
2009,22,i) 16 to 20,6629,7738,115827,117515,212,2.7,532,6.7,12119,1815,10304,1.5,10.3,15494,3896,11598,3.3,13.2,-3375,-2.9,20.6,0,382,382,2775
2009,22,j) 21 to 25,5928,7425,143474,145352,220,2.9,396,5.3,15932,4776,11156,3.3,11,19688,6250,13438,4.3,13.5,-3756,-2.5,22,0,270,270,2190
2009,22,k) 26+,6708,9695,194069,196314,256,2.6,449,4.6,21858,3345,18513,1.7,11.1,26347,5176,21171,2.6,13.4,-4489,-2.3,22.2,0,242,242,1763
2009,22,l) Left Censored,8484,21865,655916,663257,913,4.2,1040,4.7,56447,14361,42086,2.2,8.5,71129,13046,58083,2,10.7,-14682,-2.2,17,0,276,277,2924
2009,23,a) 0,1810,1825,8905,4484,1790,196.2,0,0,8842,8842,0,197.2,197.2,0,0,0,0,0,8842,197.2,0,0,,,
2009,23,b) 1,1722,1737,8516,9221,5,0.2,589,28.6,1709,84,1625,0.9,18.5,3118,1819,1299,19.7,33.8,-1409,-15.3,37,0,410,410,1461
2009,23,c) 2,1552,1563,9535,10051,50,2.9,402,22.9,1569,101,1468,1,15.6,2601,1236,1365,12.3,25.9,-1032,-10.3,31.2,0,282,282,997
2009,23,d) 3,1581,1669,10355,11064,64,3.6,324,18,1372,149,1223,1.3,12.4,2789,1158,1631,10.5,25.2,-1417,-12.8,24.8,0,234,234,1001
2009,23,e) 4,1323,1333,8731,8887,44,3.1,237,16.6,1604,108,1496,1.2,18,1916,843,1073,9.5,21.6,-312,-3.6,36,0,170,170,606
2009,23,f) 5,1215,1239,8977,9265,38,2.9,200,15.2,1098,148,950,1.6,11.9,1673,643,1030,6.9,18.1,-575,-6.2,23.8,0,144,144,536
2009,23,g) 6 to 10,5008,5237,38464,40532,163,3,680,12.4,4082,692,3390,1.7,10.1,8218,3422,4796,8.4,20.3,-4136,-10.2,20.2,0,446,446,2505
2009,23,h) 11 to 15,3803,4045,37156,38880,112,2.7,378,9,2996,491,2505,1.3,7.7,6444,1646,4798,4.2,16.6,-3448,-8.9,15.4,0,249,249,1198
2009,23,i) 16 to 20,2721,3068,31644,32605,90,2.9,251,8,2900,900,2000,2.8,8.9,4822,964,3858,3,14.8,-1922,-5.9,17.8,0,147,147,586
2009,23,j) 21 to 25,2529,3093,48873,50024,89,2.8,216,6.8,4457,818,3639,1.6,8.9,6759,1300,5459,2.6,13.5,-2302,-4.6,17.8,0,123,123,480
2009,23,k) 26+,2178,3368,60025,60625,126,3.7,173,5.1,6522,2165,4357,3.6,10.8,7722,1073,6649,1.8,12.7,-1200,-1.9,21.6,0,100,100,598
2009,23,l) Left Censored,3269,7122,209160,214222,258,3.6,411,5.7,13152,2895,10257,1.4,6.1,23275,3883,19392,1.8,10.9,-10123,-4.8,12.2,0,131,132,1678
2009,24,a) 0,6638,6715,39019,19814,6545,194.9,0,0,38410,38410,0,193.9,193.9,0,0,0,0,0,38410,193.9,0,0,,,
2009,24,b) 1,5831,6041,40682,43308,18,0.3,1997,27.9,9503,353,9150,0.8,21.9,14754,7848,6906,18.1,34.1,-5251,-12.2,43.8,0,1545,1545,6243
2009,24,c) 2,5434,5513,39086,42177,182,3,1256,20.7,6266,906,5360,2.1,14.9,12447,5186,7261,12.3,29.5,-6181,-14.6,29.8,0,955,955,4251
2009,24,d) 3,5399,5635,43578,46001,184,3,1051,17.3,6517,670,5847,1.5,14.2,11363,4856,6507,10.6,24.7,-4846,-10.5,28.4,0,806,806,4180
2009,24,e) 4,4858,4994,39294,41792,126,2.3,892,16.5,5183,812,4371,1.9,12.4,10178,4050,6128,9.7,24.4,-4995,-12,24.8,0,672,672,3034
2009,24,f) 5,4332,4426,36539,38589,121,2.6,749,15.8,5238,450,4788,1.2,13.6,9337,4187,5150,10.9,24.2,-4099,-10.6,27.2,0,545,554,3176
2009,24,g) 6 to 10,17095,17993,196185,204879,487,2.6,2231,11.8,23557,3391,20166,1.7,11.5,40945,12369,28576,6,20,-17388,-8.5,23,0,1554,1560,9252
2009,24,h) 11 to 15,12525,13500,160992,166990,352,2.5,1241,8.9,16849,2717,14132,1.6,10.1,28845,7238,21607,4.3,17.3,-11996,-7.2,20.2,0,806,807,5124
2009,24,i) 16 to 20,9378,10641,168023,176025,261,2.4,846,7.7,12897,1737,11160,1,7.3,28900,5398,23502,3.1,16.4,-16003,-9.1,14.6,0,510,510,2697
2009,24,j) 21 to 25,7914,9650,183384,189034,249,2.5,636,6.5,16170,3832,12338,2,8.6,27470,6701,20769,3.5,14.5,-11300,-5.9,17.2,0,391,392,3289
2009,24,k) 26+,6773,9949,217925,223391,336,3.3,525,5.2,18213,5105,13108,2.3,8.2,29145,5678,23467,2.5,13,-10932,-4.8,16.4,0,284,287,2531
2009,24,l) Left Censored,9923,26659,950169,966542,1726,6.5,1644,6.2,85681,27552,58129,2.9,8.9,118427,27897,90530,2.9,12.3,-32746,-3.4,17.8,0,328,341,3553
2009,25,a) 0,7623,7666,40199,20261,7527,196.4,0,0,39877,39877,0,196.8,196.8,0,0,0,0,0,39877,196.8,0,0,,,
2009,25,b) 1,6763,6842,43684,46569,21,0.3,2143,26.8,8783,288,8495,0.6,18.9,14552,7364,7188,15.8,31.2,-5769,-12.3,37.8,0,1581,1582,6030
2009,25,c) 2,6186,6231,43448,45142,197,2.9,1340,19.6,7635,759,6876,1.7,16.9,11022,4978,6044,11,24.4,-3387,-7.5,33.8,0,1005,1005,4013
2009,25,d) 3,6331,6476,46233,48803,213,3.1,1188,17,6721,782,5939,1.6,13.8,11860,4740,7120,9.7,24.3,-5139,-10.5,27.6,0,905,905,4001
2009,25,e) 4,5533,5629,46542,48736,159,2.6,894,14.9,6403,540,5863,1.1,13.1,10791,4212,6579,8.6,22.1,-4388,-9,26.2,0,666,666,3413
2009,25,f) 5,4899,5070,47988,51012,137,2.5,766,14.2,6336,930,5406,1.8,12.4,12383,4007,8376,7.9,24.3,-6047,-11.9,24.8,0,548,548,2928
2009,25,g) 6 to 10,20219,21207,228197,238203,591,2.7,2469,11.1,24844,3436,21408,1.4,10.4,44856,15940,28916,6.7,18.8,-20012,-8.4,20.8,0,1725,1730,12687
2009,25,h) 11 to 15,15629,16564,191083,198071,436,2.5,1559,9.1,19901,3471,16430,1.8,10,33877,9813,24064,5,17.1,-13976,-7.1,20,0,1048,1051,6931
2009,25,i) 16 to 20,11176,12549,182764,188126,329,2.6,964,7.5,17705,3813,13892,2,9.4,28428,7445,20983,4,15.1,-10723,-5.7,18.8,0,615,615,4116
2009,25,j) 21 to 25,11184,13696,264175,270180,406,2.9,910,6.5,22211,4302,17909,1.6,8.2,34221,6989,27232,2.6,12.7,-12010,-4.5,16.4,0,504,504,3091
2009,25,k) 26+,9832,14794,409762,416429,423,2.8,787,5.3,31309,9398,21911,2.3,7.5,44642,10578,34064,2.5,10.7,-13333,-3.2,15,0,415,419,2712
2009,25,l) Left Censored,16600,36575,1407789,1430820,1750,4.8,2087,5.7,118965,37594,81371,2.6,8.3,165028,32089,132939,2.2,11.5,-46063,-3.2,16.6,0,536,579,6833
2009,26,a) 0,10298,10363,70747,35840,10097,194.9,0,0,69814,69814,0,194.8,194.8,0,0,0,0,0,69814,194.8,0,0,,,
2009,26,b) 1,8949,9082,69923,74994,25,0.2,3083,28.7,16803,367,16436,0.5,22.4,26945,15731,11214,21,35.9,-10142,-13.5,44.8,0,2331,2331,13641
2009,26,c) 2,7927,8047,82703,85342,282,3.2,1898,21.4,20233,5858,14375,6.9,23.7,25511,8888,16623,10.4,29.9,-5278,-6.2,47.4,0,1485,1485,7510
2009,26,d) 3,7693,7844,68037,71878,263,3.1,1455,17.3,11197,1042,10155,1.4,15.6,18879,7619,11260,10.6,26.3,-7682,-10.7,31.2,0,1126,1126,6629
2009,26,e) 4,6824,6990,66114,72350,214,2.8,1339,17.7,10433,2307,8126,3.2,14.4,22905,11654,11251,16.1,31.7,-12472,-17.3,28.8,0,1034,1035,10123
2009,26,f) 5,6065,6248,61703,67452,197,2.9,1155,17.1,8130,1055,7075,1.6,12.1,19628,8752,10876,13,29.1,-11498,-17,24.2,0,882,882,7886
2009,26,g) 6 to 10,24855,26385,273533,287584,789,2.8,3578,12.9,36492,6067,30425,2.1,12.7,64593,23396,41197,8.1,22.5,-28101,-9.8,25.4,0,2533,2540,19610
2009,26,h) 11 to 15,20337,21846,241253,253760,672,3,2386,10.5,26467,5369,21098,2.1,10.4,51481,13074,38407,5.2,20.3,-25014,-9.9,20.8,0,1557,1573,10027
2009,26,i) 16 to 20,15562,17779,216303,232031,498,2.7,1718,9.3,21891,3922,17969,1.7,9.4,53347,14685,38662,6.3,23,-31456,-13.6,18.8,0,1049,1055,7468
2009,26,j) 21 to 25,13643,17253,293698,303291,499,2.8,1224,6.9,28777,7613,21164,2.5,9.5,47963,10147,37816,3.3,15.8,-19186,-6.3,19,0,756,761,5393
2009,26,k) 26+,12852,18237,331472,341252,502,2.7,1109,6,32295,6876,25419,2,9.5,51855,7874,43981,2.3,15.2,-19560,-5.7,19,0,629,648,4150
2009,26,l) Left Censored,19182,48235,1594858,1659314,1819,3.7,3407,6.9,121598,36178,85420,2.2,7.3,250509,44941,205568,2.7,15.1,-128911,-7.8,14.6,0,706,707,6980
2009,27,a) 0,7117,7191,44149,22319,7012,195,0,0,43661,43661,0,195.6,195.6,0,0,0,0,0,43661,195.6,0,0,,,
2009,27,b) 1,5917,5982,41036,45806,17,0.2,2104,29.5,10468,989,9479,2.2,22.9,20007,11499,8508,25.1,43.7,-9539,-20.8,45.8,0,1485,1485,9615
2009,27,c) 2,5506,5591,45396,48315,233,3.8,1327,21.6,7371,921,6450,1.9,15.3,13208,6342,6866,13.1,27.3,-5837,-12,30.6,0,922,922,5245
2009,27,d) 3,5423,5803,42795,45120,245,3.9,1081,17.4,5845,894,4951,2,13,10495,4807,5688,10.7,23.3,-4650,-10.3,26,0,757,757,3900
2009,27,e) 4,4920,5082,41556,42749,198,3.7,835,15.4,5749,974,4775,2.3,13.4,8134,3778,4356,8.8,19,-2385,-5.6,26.8,0,578,578,3087
2009,27,f) 5,4416,4610,37554,39127,166,3.4,753,15.4,5026,642,4384,1.6,12.8,8171,3560,4611,9.1,20.9,-3145,-8.1,25.6,0,483,492,2770
2009,27,g) 6 to 10,18344,19272,192626,201909,646,3.2,2391,11.9,21197,3448,17749,1.7,10.5,39763,11692,28071,5.8,19.7,-18566,-9.2,21,0,1511,1512,9201
2009,27,h) 11 to 15,13863,15251,167950,174170,494,3.1,1471,9.3,16657,2819,13838,1.6,9.6,29097,9070,20027,5.2,16.7,-12440,-7.1,19.2,0,882,894,7082
2009,27,i) 16 to 20,10036,11442,151605,156925,350,3,919,7.8,14548,3295,11253,2.1,9.3,25188,5443,19745,3.5,16.1,-10640,-6.8,18.6,0,516,519,2831
2009,27,j) 21 to 25,7889,9851,196550,204210,272,2.7,628,6.3,15632,3887,11745,1.9,7.7,30951,5797,25154,2.8,15.2,-15319,-7.5,15.4,0,343,348,2685
2009,27,k) 26+,7509,11426,264308,272972,344,3,583,5,20660,5222,15438,1.9,7.6,37987,5869,32118,2.2,13.9,-17327,-6.3,15.2,0,318,318,2720
2009,27,l) Left Censored,12343,29080,1163351,1197382,1166,4,1467,5,102537,23580,78957,2,8.6,170601,23266,147335,1.9,14.2,-68064,-5.6,17.2,0,317,327,3771
2009,28,a) 0,2979,2996,20247,10212,2925,195.3,0,0,20071,20071,0,196.5,196.5,0,0,0,0,0,20071,196.5,0,0,,,
2009,28,b) 1,2602,2663,17281,19184,9,0.3,896,28.5,4004,37,3967,0.2,20.9,7810,4494,3316,23.4,40.7,-3806,-19.8,41.8,0,747,747,3938
2009,28,c) 2,2410,2484,16231,17789,68,2.5,605,21.9,2493,184,2309,1,14,5608,2736,2872,15.4,31.5,-3115,-17.5,28,0,500,500,2383
2009,28,d) 3,2167,2291,20139,21468,49,2,427,17.2,2458,337,2121,1.6,11.4,5116,2040,3076,9.5,23.8,-2658,-12.4,22.8,0,343,343,1697
2009,28,e) 4,1893,1929,18116,19749,47,2.3,332,16,2509,896,1613,4.5,12.7,5774,1973,3801,10,29.2,-3265,-16.5,25.4,0,270,270,1637
2009,28,f) 5,1739,1838,15994,17198,69,3.6,264,13.7,2016,417,1599,2.4,11.7,4424,1091,3333,6.3,25.7,-2408,-14,23.4,0,217,217,981
2009,28,g) 6 to 10,7152,7628,75792,79673,199,2.5,883,11.1,8088,1245,6843,1.6,10.2,15850,5191,10659,6.5,19.9,-7762,-9.7,20.4,0,639,644,3936
2009,28,h) 11 to 15,5222,5689,57882,61432,127,2.2,534,9.1,5786,1207,4579,2,9.4,12886,4652,8234,7.6,21,-7100,-11.6,18.8,0,403,403,2147
2009,28,i) 16 to 20,3751,4253,61808,63858,124,2.9,316,7.3,5812,1585,4227,2.5,9.1,9911,1539,8372,2.4,15.5,-4099,-6.4,18.2,0,235,235,1137
2009,28,j) 21 to 25,3543,4188,67567,69220,109,2.6,229,5.4,6110,2154,3956,3.1,8.8,9415,2160,7255,3.1,13.6,-3305,-4.8,17.6,0,165,165,1838
2009,28,k) 26+,3491,5222,103796,106667,252,4.8,273,5.2,10796,5529,5267,5.2,10.1,16538,3479,13059,3.3,15.5,-5742,-5.4,20.2,0,166,168,1149
2009,28,l) Left Censored,5371,14271,422518,430881,580,4.1,651,4.6,35165,11719,23446,2.7,8.2,51890,9657,42233,2.2,12,-16725,-3.8,16.4,0,147,158,1593
2009,29,a) 0,7711,7767,45069,22737,7590,195.4,0,0,44664,44664,0,196.4,196.4,0,0,0,0,0,44664,196.4,0,0,,,
2009,29,b) 1,6393,6458,41206,46471,15,0.2,2451,31.5,9667,342,9325,0.7,20.8,20196,11182,9014,24.1,43.5,-10529,-22.7,41.6,0,1982,1982,10041
2009,29,c) 2,5993,6103,39080,42677,220,3.3,1408,21.1,6987,593,6394,1.4,16.4,14180,7713,6467,18.1,33.2,-7193,-16.8,32.8,0,1122,1122,6938
2009,29,d) 3,5798,6097,45943,49197,206,3.1,1221,18.5,6482,939,5543,1.9,13.2,12989,5570,7419,11.3,26.4,-6507,-13.2,26.4,0,981,981,4716
2009,29,e) 4,5211,5391,42291,46330,168,2.9,1012,17.4,5285,733,4552,1.6,11.4,13363,4931,8432,10.6,28.8,-8078,-17.4,22.8,0,790,790,4382
2009,29,f) 5,4586,4703,44777,46180,150,3,773,15.4,7698,651,7047,1.4,16.7,10504,4758,5746,10.3,22.7,-2806,-6,33.4,0,584,584,4255
2009,29,g) 6 to 10,17309,18321,175689,185306,540,2.8,2372,12.3,20264,2459,17805,1.3,10.9,39498,13260,26238,7.2,21.3,-19234,-10.4,21.8,0,1780,1783,10897
2009,29,h) 11 to 15,12893,14029,163170,170999,359,2.5,1377,9.5,16907,2760,14147,1.6,9.9,32565,8773,23792,5.1,19,-15658,-9.1,19.8,0,996,997,6557
2009,29,i) 16 to 20,9422,10988,140721,147219,319,2.8,891,7.9,14105,3925,10180,2.7,9.6,27101,7208,19893,4.9,18.4,-12996,-8.8,19.2,0,554,554,3826
2009,29,j) 21 to 25,8693,11151,192986,197006,318,2.8,681,6,19981,6350,13631,3.2,10.1,28020,5689,22331,2.9,14.2,-8039,-4.1,20.2,0,440,442,2448
2009,29,k) 26+,7946,12938,290184,295868,434,3.3,609,4.7,25633,7028,18605,2.4,8.7,37000,8271,28729,2.8,12.5,-11367,-3.8,17.4,0,345,348,2094
2009,29,l) Left Censored,12596,31914,1136724,1157698,1325,4.1,1673,5.2,94680,24201,70479,2.1,8.2,136628,28336,108292,2.4,11.8,-41948,-3.6,16.4,0,398,407,3969
2009,30,a) 0,2038,2040,7871,4042,1983,194.4,0,0,7658,7658,0,189.5,189.5,0,0,0,0,0,7658,189.5,0,0,,,
2009,30,b) 1,1828,1861,9051,9835,9,0.4,714,31.8,1741,47,1694,0.5,17.7,3308,1773,1535,18,33.6,-1567,-15.9,35.4,0,484,484,1317
2009,30,c) 2,1741,1758,8475,9278,71,3.6,472,24,1325,278,1047,3,14.3,2930,1357,1573,14.6,31.6,-1605,-17.3,28.6,0,305,305,921
2009,30,d) 3,1747,1813,16020,16418,60,3,425,21.2,2150,235,1915,1.4,13.1,2946,1201,1745,7.3,17.9,-796,-4.8,26.2,0,271,271,866
2009,30,e) 4,1491,1503,8521,9490,42,2.6,272,16.8,1101,134,967,1.4,11.6,3038,919,2119,9.7,32,-1937,-20.4,23.2,0,200,200,726
2009,30,f) 5,1344,1387,8320,8975,51,3.4,248,16.7,1029,146,883,1.6,11.5,2338,895,1443,10,26.1,-1309,-14.6,23,0,151,151,601
2009,30,g) 6 to 10,4863,5014,34900,37354,138,2.6,657,12.5,3459,512,2947,1.4,9.3,8367,2447,5920,6.6,22.4,-4908,-13.1,18.6,0,398,398,1853
2009,30,h) 11 to 15,3654,3827,30957,32423,108,2.7,361,9.1,3530,444,3086,1.4,10.9,6462,1778,4684,5.5,19.9,-2932,-9,21.8,0,208,208,868
2009,30,i) 16 to 20,2234,2427,23425,24930,86,3.5,203,8.2,1959,358,1601,1.4,7.9,4969,1510,3459,6.1,19.9,-3010,-12,15.8,0,112,112,556
2009,30,j) 21 to 25,1757,2073,30451,31447,57,2.7,169,7.9,2326,364,1962,1.2,7.4,4317,804,3513,2.6,13.7,-1991,-6.3,14.8,0,100,100,624
2009,30,k) 26+,1954,2804,42170,43191,96,3.4,155,5.5,4400,907,3493,2.1,10.2,6441,663,5778,1.5,14.9,-2041,-4.7,20.4,0,92,92,385
2009,30,l) Left Censored,2538,5274,119795,121262,174,3.3,225,4.2,9193,1513,7680,1.2,7.6,12127,2278,9849,1.9,10,-2934,-2.4,15.2,0,55,55,402
2009,31,a) 0,2510,2523,13008,6560,2466,195.5,0,0,12896,12896,0,196.6,196.6,0,0,0,0,0,12896,196.6,0,0,,,
2009,31,b) 1,2179,2201,12417,14513,2,0.1,620,24.4,2970,,,,20.5,7161,2285,4876,15.7,49.3,-4191,-28.8,41,1,455,455,2015
2009,31,c) 2,2050,2089,12548,13560,78,3.5,380,17,1955,,,,14.4,3979,1685,2294,12.4,29.3,-2024,-14.9,28.8,1,270,270,1376
2009,31,d) 3,1953,2054,14063,14684,74,3.4,288,13.4,1858,211,1647,1.4,12.7,3099,1291,1808,8.8,21.1,-1241,-8.4,25.4,0,213,213,1057
2009,31,e) 4,1749,1781,11876,12217,73,3.9,271,14.4,1840,495,1345,4.1,15.1,2521,1091,1430,8.9,20.6,-681,-5.5,30.2,0,203,203,954
2009,31,f) 5,1603,1632,13132,13136,57,3.3,200,11.8,2153,544,1609,4.1,16.4,2161,852,1309,6.5,16.5,-8,-0.1,32.8,0,148,148,676
2009,31,g) 6 to 10,6559,6877,65903,67989,226,3.2,697,9.8,6368,1057,5311,1.6,9.4,10540,3501,7039,5.1,15.5,-4172,-6.1,18.8,0,471,471,2652
2009,31,h) 11 to 15,5005,5471,58564,60999,174,3.1,461,8.2,6137,1347,4790,2.2,10.1,11006,3091,7915,5.1,18,-4869,-7.9,20.2,0,278,281,2111
2009,31,i) 16 to 20,3751,4250,51543,52927,144,3.3,302,7,4787,1102,3685,2.1,9,7554,1643,5911,3.1,14.3,-2767,-5.3,18,0,182,182,1213
2009,31,j) 21 to 25,3011,3655,73587,74752,79,2.1,218,5.9,5783,2361,3422,3.2,7.7,8113,1634,6479,2.2,10.9,-2330,-3.2,15.4,0,150,150,1225
2009,31,k) 26+,3243,4938,91569,93551,190,3.8,229,4.6,9797,3205,6592,3.4,10.5,13760,4151,9609,4.4,14.7,-3963,-4.2,21,0,124,128,738
2009,31,l) Left Censored,5495,11216,363752,367422,380,3.4,540,4.8,30293,6204,24089,1.7,8.2,37633,9408,28225,2.6,10.2,-7340,-2,16.4,0,151,151,1230
2009,32,a) 0,4463,4518,31268,15768,4439,196.5,0,0,31000,31000,0,196.6,196.6,0,0,0,0,0,31000,196.6,0,0,1,1,0
2009,32,b) 1,3795,3847,33684,35369,10,0.2,1571,33.5,10475,184,10291,0.5,29.6,13844,6838,7006,19.3,39.1,-3369,-9.5,59.2,0,1288,1288,5911
2009,32,c) 2,3214,3278,29127,32877,96,2.5,1060,28.1,5098,328,4770,1,15.5,12598,6812,5786,20.7,38.3,-7500,-22.8,31,0,885,885,6265
2009,32,d) 3,3065,3200,29539,34233,115,3.2,812,22.9,4032,838,3194,2.4,11.8,13420,3916,9504,11.4,39.2,-9388,-27.4,23.6,0,650,650,3356
2009,32,e) 4,2617,2766,27215,30143,94,3.1,594,19.7,3431,713,2718,2.4,11.4,9287,3495,5792,11.6,30.8,-5856,-19.4,22.8,0,484,484,3087
2009,32,f) 5,2198,2272,26848,29912,88,3.6,451,18.4,2460,438,2022,1.5,8.2,8587,2301,6286,7.7,28.7,-6127,-20.5,16.4,0,358,358,1908
2009,32,g) 6 to 10,7599,8128,119061,127522,291,3.4,1217,14.2,17096,2518,14578,2,13.4,34017,10072,23945,7.9,26.7,-16921,-13.3,26.8,0,934,939,7931
2009,32,h) 11 to 15,4423,5099,83608,92070,209,3.9,622,11.7,6709,1767,4942,1.9,7.3,23632,4028,19604,4.4,25.7,-16923,-18.4,14.6,0,450,463,2978
2009,32,i) 16 to 20,2634,3307,60479,68286,132,3.9,318,9.3,4681,1244,3437,1.8,6.9,20295,3093,17202,4.5,29.7,-15614,-22.8,13.8,0,188,188,1477
2009,32,j) 21 to 25,2021,2969,63938,68200,143,4.8,203,6.8,5740,1907,3833,2.8,8.4,14263,2302,11961,3.4,20.9,-8523,-12.5,16.8,0,119,119,1035
2009,32,k) 26+,2166,3893,118450,122407,240,6.1,295,7.5,14095,4825,9270,3.9,11.5,22009,4522,17487,3.7,18,-7914,-6.5,23,0,109,115,1705
2009,32,l) Left Censored,3025,9348,415375,434288,682,7.3,655,7,34433,13973,20460,3.2,7.9,72258,10334,61924,2.4,16.6,-37825,-8.7,15.8,0,56,64,747
2009,33,a) 0,1730,1740,9307,4690,1707,196.2,0,0,9234,9234,0,196.9,196.9,0,0,0,0,0,9234,196.9,0,0,,,
2009,33,b) 1,1635,1648,12390,12811,5,0.3,512,26.5,2454,16,2438,0.1,19.2,3296,1711,1585,13.4,25.7,-842,-6.5,38.4,0,410,410,1532
2009,33,c) 2,1420,1437,8826,9480,37,2.3,331,20.9,1411,334,1077,3.5,14.9,2718,1143,1575,12.1,28.7,-1307,-13.8,29.8,0,255,255,969
2009,33,d) 3,1494,1573,12394,13190,47,2.8,303,17.8,1441,212,1229,1.6,10.9,3033,1370,1663,10.4,23,-1592,-12.1,21.8,0,236,236,1129
2009,33,e) 4,1288,1318,10118,10883,33,2.3,229,16.1,1200,156,1044,1.4,11,2730,1170,1560,10.8,25.1,-1530,-14.1,22,0,182,182,856
2009,33,f) 5,1155,1175,7696,8256,42,3.4,191,15.3,855,167,688,2,10.4,1975,851,1124,10.3,23.9,-1120,-13.5,20.8,0,149,149,692
2009,33,g) 6 to 10,4484,4684,43022,45374,139,2.8,588,12,4217,605,3612,1.3,9.3,8921,3044,5877,6.7,19.7,-4704,-10.4,18.6,0,418,418,2469
2009,33,h) 11 to 15,3820,4042,39260,40898,110,2.6,394,9.4,3928,1046,2882,2.6,9.6,7204,1964,5240,4.8,17.6,-3276,-8,19.2,0,260,260,1457
2009,33,i) 16 to 20,2645,2917,36899,38548,81,2.7,234,7.8,3003,429,2574,1.1,7.8,6300,1087,5213,2.8,16.3,-3297,-8.5,15.6,0,148,148,786
2009,33,j) 21 to 25,2656,3145,52571,55687,106,3.3,224,7,3785,1006,2779,1.8,6.8,10017,2476,7541,4.4,18,-6232,-11.2,13.6,0,139,139,803
2009,33,k) 26+,1972,2886,56837,58073,113,3.9,166,5.7,5471,1791,3680,3.1,9.4,7943,1159,6784,2,13.7,-2472,-4.3,18.8,0,90,90,507
2009,33,l) Left Censored,3300,7324,270814,275047,363,4.9,484,6.6,22589,4920,17669,1.8,8.2,31055,5607,25448,2,11.3,-8466,-3.1,16.4,0,80,85,671
2009,34,a) 0,12666,12737,66699,33837,12418,195,0,0,65724,65724,0,194.2,194.2,0,0,0,0,0,65724,194.2,0,0,,,
2009,34,b) 1,10898,10972,71065,83382,13,0.1,4110,31.1,14690,109,14581,0.1,17.6,39324,15543,23781,18.6,47.2,-24634,-29.6,35.2,0,3186,3186,13374
2009,34,c) 2,9970,10055,70728,76176,329,3,2447,22,11133,1035,10098,1.4,14.6,22028,10422,11606,13.7,28.9,-10895,-14.3,29.2,0,1930,1930,7772
2009,34,d) 3,9621,9924,74200,79406,325,3,2025,18.8,9806,1206,8600,1.5,12.3,20217,7687,12530,9.7,25.5,-10411,-13.2,24.6,0,1556,1556,5947
2009,34,e) 4,8676,8847,67412,71063,264,2.8,1635,17.1,10279,1784,8495,2.5,14.5,17581,7917,9664,11.1,24.7,-7302,-10.2,29,0,1269,1269,5688
2009,34,f) 5,7428,7532,62807,67010,186,2.3,1249,15.5,7936,833,7103,1.2,11.8,16342,7623,8719,11.4,24.4,-8406,-12.6,23.6,0,954,954,6533
2009,34,g) 6 to 10,29680,30806,310023,327654,853,2.6,4173,12.8,32559,4807,27752,1.5,9.9,67821,24490,43331,7.5,20.7,-35262,-10.8,19.8,0,3123,3131,19671
2009,34,h) 11 to 15,22326,23679,268556,285506,581,2.4,2462,10,26102,3469,22633,1.2,9.1,60001,17928,42073,6.3,21,-33899,-11.9,18.2,0,1702,1710,14640
2009,34,i) 16 to 20,15357,16414,210235,218792,411,2.4,1488,8.8,20105,4399,15706,2,9.2,37218,9187,28031,4.2,17,-17113,-7.8,18.4,0,1013,1013,5957
2009,34,j) 21 to 25,13678,16187,297998,307126,450,2.7,1277,7.7,26499,6565,19934,2.1,8.6,44754,11101,33653,3.6,14.6,-18255,-6,17.2,0,776,778,4927
2009,34,k) 26+,12521,16628,352317,362172,468,2.8,1038,6.1,33608,9725,23883,2.7,9.3,53318,8783,44535,2.4,14.7,-19710,-5.4,18.6,0,627,630,3482
2009,34,l) Left Censored,18549,42077,1549581,1583522,2378,5.6,2656,6.3,139071,46500,92571,2.9,8.8,206952,42159,164793,2.7,13.1,-67881,-4.3,17.6,0,719,736,6972
2009,35,a) 0,2396,2412,13525,6849,2350,194.9,0,0,13353,13353,0,195,195,0,0,0,0,0,13353,195,0,0,,,
2009,35,b) 1,2064,2109,13984,14825,9,0.4,827,32.3,3571,181,3390,1.2,24.1,5253,3059,2194,20.6,35.4,-1682,-11.3,48.2,0,637,637,2457
2009,35,c) 2,1953,1965,24450,24773,60,2.8,456,21,3856,331,3525,1.3,15.6,4501,2065,2436,8.3,18.2,-645,-2.6,31.2,0,356,356,1722
2009,35,d) 3,1850,1937,16097,16889,75,3.5,419,19.8,2603,589,2014,3.5,15.4,4187,1709,2478,10.1,24.8,-1584,-9.4,30.8,0,340,340,1383
2009,35,e) 4,1646,1702,14251,15144,41,2.3,273,15.1,1771,146,1625,1,11.7,3557,1195,2362,7.9,23.5,-1786,-11.8,23.4,0,203,203,964
2009,35,f) 5,1416,1500,13440,14443,56,3.5,241,15.1,1643,232,1411,1.6,11.4,3649,1029,2620,7.1,25.3,-2006,-13.9,22.8,0,183,183,751
2009,35,g) 6 to 10,5489,5844,59448,64050,162,2.6,732,11.9,5690,997,4693,1.6,8.9,14893,5881,9012,9.2,23.3,-9203,-14.4,17.8,0,529,529,3934
2009,35,h) 11 to 15,4215,4568,60718,62637,155,3.3,457,9.7,5709,1535,4174,2.5,9.1,9547,2258,7289,3.6,15.2,-3838,-6.1,18.2,0,329,329,1673
2009,35,i) 16 to 20,3028,3518,44397,45552,102,2.8,270,7.5,5873,1091,4782,2.4,12.9,8182,1456,6726,3.2,18,-2309,-5.1,25.8,0,192,192,1002
2009,35,j) 21 to 25,2493,3214,57988,59461,73,2.2,183,5.6,5122,917,4205,1.5,8.6,8068,1536,6532,2.6,13.6,-2946,-5,17.2,0,117,117,1082
2009,35,k) 26+,2633,3906,69272,71575,112,2.8,203,5.1,5278,1284,3994,1.8,7.4,9883,1576,8307,2.2,13.8,-4605,-6.4,14.8,0,126,126,646
2009,35,l) Left Censored,3349,8309,228761,232047,430,5.2,395,4.8,22454,5942,16512,2.6,9.7,29025,5972,23053,2.6,12.5,-6571,-2.8,19.4,0,76,80,865
2009,36,a) 0,33699,33813,169240,86089,33048,195.5,0,0,166302,166302,0,193.2,193.2,0,0,0,0,0,166302,193.2,0,0,1,1,0
2009,36,b) 1,27697,27938,169978,185170,39,0.1,8618,26.4,36862,272,36590,0.1,19.9,67245,29077,38168,15.7,36.3,-30383,-16.4,39.8,0,6504,6506,24815
2009,36,c) 2,23610,23748,146176,156065,809,3.1,5277,20.3,23718,2873,20845,1.8,15.2,43496,20772,22724,13.3,27.9,-19778,-12.7,30.4,0,4073,4073,17521
2009,36,d) 3,22103,22867,168674,177376,725,2.9,4187,17,23606,3473,20133,2,13.3,41009,17210,23799,9.7,23.1,-17403,-9.8,26.6,0,3232,3233,14125
2009,36,e) 4,19389,19816,159465,170223,504,2.4,3367,15.8,24941,3270,21671,1.9,14.7,46457,14638,31819,8.6,27.3,-21516,-12.6,29.4,0,2596,2596,12480
2009,36,f) 5,17128,17364,138023,145343,454,2.5,2638,14.3,17603,1912,15691,1.3,12.1,32243,11966,20277,8.2,22.2,-14640,-10.1,24.2,0,1991,1991,9906
2009,36,g) 6 to 10,65170,67480,668620,696171,1761,2.5,8293,11.7,76259,12405,63854,1.8,11,131360,41328,90032,5.9,18.9,-55101,-7.9,22,0,6040,6050,32524
2009,36,h) 11 to 15,45737,48518,555348,579256,1188,2.4,4522,9,57153,9069,48084,1.6,9.9,104969,29057,75912,5,18.1,-47816,-8.2,19.8,0,3178,3178,21353
2009,36,i) 16 to 20,33112,35845,431119,447168,838,2.3,2864,7.8,38221,7290,30931,1.6,8.5,70318,16477,53841,3.7,15.7,-32097,-7.2,17,0,1913,1919,12040
2009,36,j) 21 to 25,29805,34111,591330,604480,839,2.4,2215,6.4,44742,8201,36541,1.4,7.4,71041,16878,54163,2.8,11.8,-26299,-4.4,14.8,0,1409,1409,11629
2009,36,k) 26+,25988,36698,813409,832509,955,2.6,1937,5.2,62445,14032,48413,1.7,7.5,100645,17037,83608,2,12.1,-38200,-4.6,15,0,1184,1184,7391
2009,36,l) Left Censored,40846,88840,3334359,3395990,4413,4.9,5428,6.1,265335,78621,186714,2.3,7.8,388597,79612,308985,2.3,11.4,-123262,-3.6,15.6,0,1581,1628,15640
2009,37,a) 0,11346,11496,67901,34402,11212,195.1,0,0,66998,66998,0,194.8,194.8,0,0,0,0,0,66998,194.8,0,0,,,
2009,37,b) 1,10385,10574,67279,74301,32,0.3,3745,29.7,14398,526,13872,0.7,19.4,28442,16066,12376,21.6,38.3,-14044,-18.9,38.8,0,2950,2950,14143
2009,37,c) 2,9601,9723,61780,68814,291,2.7,2487,22.9,9009,1024,7985,1.5,13.1,23076,10534,12542,15.3,33.5,-14067,-20.4,26.2,0,1972,1972,8788
2009,37,d) 3,8936,9399,76159,82089,287,2.8,1942,18.9,9826,1275,8551,1.6,12,21685,8754,12931,10.7,26.4,-11859,-14.4,24,0,1506,1514,7037
2009,37,e) 4,7983,8186,66498,72835,185,2.1,1537,17.3,8028,1395,6633,1.9,11,20702,7828,12874,10.7,28.4,-12674,-17.4,22,0,1187,1187,6205
2009,37,f) 5,6730,7017,64350,69815,198,2.6,1205,16,7031,935,6096,1.3,10.1,17960,6255,11705,9,25.7,-10929,-15.6,20.2,0,932,932,5039
2009,37,g) 6 to 10,26425,28234,291781,310488,716,2.4,3682,12.4,30150,5696,24454,1.8,9.7,67564,19491,48073,6.3,21.8,-37414,-12.1,19.4,0,2727,2737,15413
2009,37,h) 11 to 15,18834,20905,262734,273579,575,2.6,2176,10,26023,4108,21915,1.5,9.5,47712,11169,36543,4.1,17.4,-21689,-7.9,19,0,1563,1563,7585
2009,37,i) 16 to 20,12740,15071,208226,219308,420,2.7,1308,8.4,16950,4016,12934,1.8,7.7,39114,8497,30617,3.9,17.8,-22164,-10.1,15.4,0,885,885,5752
2009,37,j) 21 to 25,12415,15683,289088,298711,403,2.5,1035,6.5,24879,8192,16687,2.7,8.3,44125,7103,37022,2.4,14.8,-19246,-6.5,16.6,0,683,683,3402
2009,37,k) 26+,10097,16608,375331,384098,575,3.4,976,5.8,38962,14374,24588,3.7,10.1,56495,12673,43822,3.3,14.7,-17533,-4.6,20.2,0,518,531,4211
2009,37,l) Left Censored,14622,45430,1521282,1565217,2666,5.9,2366,5.2,114716,39164,75552,2.5,7.3,202588,37635,164953,2.4,12.9,-87872,-5.6,14.6,0,514,535,3884
2009,38,a) 0,1172,1180,6144,3116,1139,193.1,0,0,6056,6056,0,194.4,194.4,0,0,0,0,0,6056,194.4,0,0,,,
2009,38,b) 1,975,991,6180,6498,6,0.5,276,24.1,1469,34,1435,0.5,22.6,2105,1113,992,17.1,32.4,-636,-9.8,45.2,0,176,176,924
2009,38,c) 2,889,901,6418,6978,33,3.4,197,20,1482,94,1388,1.3,21.2,2602,1635,967,23.4,37.3,-1120,-16.1,42.4,0,136,136,1468
2009,38,d) 3,860,911,6499,6851,37,3.9,138,14.4,860,186,674,2.7,12.6,1564,885,679,12.9,22.8,-704,-10.2,25.2,0,89,89,732
2009,38,e) 4,759,773,5307,5282,31,3.8,102,12.6,944,73,871,1.4,17.9,893,337,556,6.4,16.9,51,1,33.8,0,71,71,256
2009,38,f) 5,629,656,5113,5248,27,3.9,83,12.1,601,59,542,1.1,11.5,870,344,526,6.6,16.6,-269,-5.1,23,0,59,59,258
2009,38,g) 6 to 10,2641,2756,21873,22200,113,4,267,9.4,2876,639,2237,2.9,13,3529,1118,2411,5,15.9,-653,-2.9,26,0,158,158,792
2009,38,h) 11 to 15,2102,2215,21214,21193,98,4.3,197,8.7,3103,893,2210,4.2,14.6,3061,839,2222,4,14.4,42,0.2,28.8,0,102,102,500
2009,38,i) 16 to 20,1692,1808,18824,19386,70,3.8,169,9.1,2302,237,2065,1.2,11.9,3425,1060,2365,5.5,17.7,-1123,-5.8,23.8,0,91,92,722
2009,38,j) 21 to 25,1350,1560,19787,20365,39,2.5,104,6.5,1753,277,1476,1.4,8.6,2909,554,2355,2.7,14.3,-1156,-5.7,17.2,0,69,69,350
2009,38,k) 26+,1564,2143,36609,36547,54,2.5,91,4.2,3849,719,3130,2,10.5,3725,578,3147,1.6,10.2,124,0.3,20.4,0,60,60,362
2009,38,l) Left Censored,2526,4803,140717,141462,149,3.1,208,4.3,11952,3205,8747,2.3,8.4,13441,3471,9970,2.5,9.5,-1489,-1.1,16.8,0,74,74,854
2009,39,a) 0,10146,10262,73701,37159,10052,195.9,0,0,73085,73085,0,196.7,196.7,0,0,0,0,0,73085,196.7,0,0,1,1,0
2009,39,b) 1,9098,9277,74640,81589,50,0.5,3028,27.8,17628,466,17162,0.6,21.6,31526,16325,15201,20,38.6,-13898,-17,43.2,0,2410,2410,14449
2009,39,c) 2,8222,8385,65629,71886,259,2.8,1792,19.6,9880,1204,8676,1.7,13.7,22393,10605,11788,14.8,31.2,-12513,-17.5,27.4,0,1416,1416,7605
2009,39,d) 3,8253,8671,83029,88078,292,3.1,1539,16.5,11988,2055,9933,2.3,13.6,22085,9633,12452,10.9,25.1,-10097,-11.5,27.2,0,1216,1217,7752
2009,39,e) 4,7544,7866,79387,82941,229,2.7,1186,14.2,10765,1597,9168,1.9,13,17872,6450,11422,7.8,21.5,-7107,-8.5,26,0,932,932,5214
2009,39,f) 5,6583,6827,63635,66992,182,2.5,1081,14.8,7361,606,6755,0.9,11,14075,5509,8566,8.2,21,-6714,-10,22,0,829,829,4408
2009,39,g) 6 to 10,27263,29293,317200,333122,758,2.5,3546,11.5,32154,4172,27982,1.3,9.7,63997,21706,42291,6.5,19.2,-31843,-9.5,19.4,0,2547,2571,16121
2009,39,h) 11 to 15,22423,25184,288479,301645,799,3.1,2512,9.6,28988,7217,21771,2.4,9.6,55319,15755,39564,5.2,18.3,-26331,-8.7,19.2,0,1684,1729,10770
2009,39,i) 16 to 20,17314,20728,283072,291097,961,4.6,1667,7.9,34562,9913,24649,3.4,11.9,50611,12082,38529,4.2,17.4,-16049,-5.5,23.8,0,1099,1102,6815
2009,39,j) 21 to 25,15658,19772,342858,358199,487,2.4,1227,6.1,24047,5268,18779,1.5,6.7,54729,11038,43691,3.1,15.3,-30682,-8.6,13.4,0,800,801,6471
2009,39,k) 26+,15260,23583,511983,530935,729,3,1372,5.7,45329,15303,30026,2.9,8.5,83232,16329,66903,3.1,15.7,-37903,-7.2,17,0,690,784,5644
2009,39,l) Left Censored,25942,65841,2262358,2323954,2658,4,3712,5.6,187946,58030,129916,2.5,8.1,311137,63464,247673,2.7,13.4,-123191,-5.3,16.2,0,1004,1028,16011
2009,40,a) 0,5075,5119,29746,15095,5009,195.7,0,0,29303,29303,0,194.1,194.1,0,0,0,0,0,29303,194.1,0,0,,,
2009,40,b) 1,4433,4499,31993,33324,16,0.3,1385,26.4,8028,76,7952,0.2,24.1,10689,6313,4376,18.9,32.1,-2661,-8,48.2,0,1104,1104,5341
2009,40,c) 2,3929,3981,33338,35112,124,2.9,817,18.9,5739,604,5135,1.7,16.3,9287,4215,5072,12,26.4,-3548,-10.1,32.6,0,656,656,3860
2009,40,d) 3,3641,3818,31666,33186,118,2.9,603,14.8,4058,463,3595,1.4,12.2,7097,2827,4270,8.5,21.4,-3039,-9.2,24.4,0,483,483,2237
2009,40,e) 4,3202,3324,34837,36566,129,3.7,463,13.3,4730,1432,3298,3.9,12.9,8188,3116,5072,8.5,22.4,-3458,-9.5,25.8,0,370,370,2530
2009,40,f) 5,2579,2668,24433,25867,83,2.9,386,13.7,2989,339,2650,1.3,11.6,5856,2352,3504,9.1,22.6,-2867,-11,23.2,0,306,306,2096
2009,40,g) 6 to 10,10860,11586,118573,123786,336,2.8,1200,10,14080,3640,10440,2.9,11.4,24505,9853,14652,8,19.8,-10425,-8.4,22.8,0,919,921,8713
2009,40,h) 11 to 15,8006,8927,91122,94240,235,2.6,731,8,9964,1503,8461,1.6,10.6,16200,3559,12641,3.8,17.2,-6236,-6.6,21.2,0,529,529,2638
2009,40,i) 16 to 20,5937,6899,90201,92418,260,3.7,533,7.6,10840,2357,8483,2.6,11.7,15274,4312,10962,4.7,16.5,-4434,-4.8,23.4,0,362,362,1993
2009,40,j) 21 to 25,5144,6302,109837,110335,176,2.8,334,5.2,11885,3356,8529,3,10.8,12880,2286,10594,2.1,11.7,-995,-0.9,21.6,0,229,229,1175
2009,40,k) 26+,5642,8313,169657,174418,219,2.6,480,5.7,15887,4868,11019,2.8,9.1,25409,6134,19275,3.5,14.6,-9522,-5.5,18.2,0,265,271,3204
2009,40,l) Left Censored,6880,17609,516874,523681,711,4,761,4.3,42279,9406,32873,1.8,8.1,55892,13944,41948,2.7,10.7,-13613,-2.6,16.2,0,187,188,1878
2009,41,a) 0,6083,6106,28046,14159,5992,196.3,0,0,27775,27775,0,196.2,196.2,0,0,0,0,0,27775,196.2,0,0,,,
2009,41,b) 1,5518,5580,28206,31554,14,0.2,2070,30.9,5959,74,5885,0.2,18.9,12655,6250,6405,19.8,40.1,-6696,-21.2,37.8,0,1594,1594,4955
2009,41,c) 2,4963,5020,28145,31711,180,3.2,1337,23.8,4334,479,3855,1.5,13.7,11465,4704,6761,14.8,36.2,-7131,-22.5,27.4,0,1032,1032,3973
2009,41,d) 3,4789,5149,33179,35876,194,3.4,1125,20,4649,555,4094,1.5,13,10042,4359,5683,12.2,28,-5393,-15,26,0,859,859,3635
2009,41,e) 4,4151,4266,28756,31215,125,2.7,892,19.1,3565,376,3189,1.2,11.4,8482,3252,5230,10.4,27.2,-4917,-15.8,22.8,0,650,657,2578
2009,41,f) 5,3514,3639,29373,32037,105,2.7,600,15.4,2735,307,2428,1,8.5,8063,2163,5900,6.8,25.2,-5328,-16.7,17,0,442,442,1704
2009,41,g) 6 to 10,13890,14701,120973,130879,470,3,2039,13.1,12138,2367,9771,1.8,9.3,31949,10667,21282,8.2,24.4,-19811,-15.1,18.6,0,1370,1371,7332
2009,41,h) 11 to 15,10361,11237,127956,135183,313,2.7,1194,10.2,11337,2512,8825,1.9,8.4,25791,5085,20706,3.8,19.1,-14454,-10.7,16.8,0,803,803,3561
2009,41,i) 16 to 20,6915,7917,92274,97853,271,3.3,744,9.1,10310,2172,8138,2.2,10.5,21468,4037,17431,4.1,21.9,-11158,-11.4,21,0,476,477,2787
2009,41,j) 21 to 25,5480,6923,121861,127523,165,2.3,485,6.8,10087,2460,7627,1.9,7.9,21411,3478,17933,2.7,16.8,-11324,-8.9,15.8,0,291,291,1733
2009,41,k) 26+,5761,8606,170800,179740,235,2.7,455,5.2,12381,3213,9168,1.8,6.9,30261,3700,26561,2.1,16.8,-17880,-9.9,13.8,0,260,262,1365
2009,41,l) Left Censored,7065,18214,561095,576073,782,4.3,910,5,49835,12652,37183,2.2,8.7,79791,14943,64848,2.6,13.9,-29956,-5.2,17.4,0,173,174,1530
2009,42,a) 0,13126,13238,79036,40122,12981,196.1,0,0,77828,77828,0,194,194,0,0,0,0,0,77828,194,0,0,,,
2009,42,b) 1,11705,11879,82531,86146,39,0.3,3373,24.6,20621,469,20152,0.5,23.9,27850,15238,12612,17.7,32.3,-7229,-8.4,47.8,0,2552,2571,13054
2009,42,c) 2,10500,10597,74162,79103,318,2.8,2157,18.7,11510,1468,10042,1.9,14.6,21391,10081,11310,12.7,27,-9881,-12.4,29.2,0,1654,1654,8622
2009,42,d) 3,10306,10793,94823,98877,303,2.6,1692,14.7,13300,1088,12212,1.1,13.5,21407,8504,12903,8.6,21.7,-8107,-8.2,27,0,1296,1296,7180
2009,42,e) 4,9660,9997,87513,93390,273,2.6,1404,13.3,10348,1963,8385,2.1,11.1,22102,6963,15139,7.5,23.7,-11754,-12.6,22.2,0,1087,1087,5724
2009,42,f) 5,8273,8615,76650,80506,220,2.4,1121,12.4,8268,710,7558,0.9,10.3,15979,6617,9362,8.2,19.8,-7711,-9.5,20.6,0,862,862,5745
2009,42,g) 6 to 10,34538,36501,401010,416431,965,2.5,3688,9.7,43723,7426,36297,1.8,10.5,74565,23701,50864,5.7,17.9,-30842,-7.4,21,0,2639,2651,17658
2009,42,h) 11 to 15,26000,28561,366439,376988,698,2.4,2383,8.1,34847,5841,29006,1.5,9.2,55945,16336,39609,4.3,14.8,-21098,-5.6,18.4,0,1601,1639,12255
2009,42,i) 16 to 20,20466,23089,296235,305879,646,2.7,1622,6.9,29201,7493,21708,2.4,9.5,48489,12182,36307,4,15.9,-19288,-6.4,19,0,1046,1046,7780
2009,42,j) 21 to 25,19230,23527,427564,442186,651,2.7,1526,6.4,34493,9572,24921,2.2,7.8,63736,16863,46873,3.8,14.4,-29243,-6.6,15.6,0,892,905,6259
2009,42,k) 26+,17274,25621,575872,588370,697,2.7,1363,5.3,52745,16864,35881,2.9,9,77741,13492,64249,2.3,13.2,-24996,-4.2,18,0,773,790,5428
2009,42,l) Left Censored,28500,71336,2469057,2510136,3204,4.5,3602,5,191851,47840,144011,1.9,7.6,274009,62870,211139,2.5,10.9,-82158,-3.3,15.2,0,936,980,9087
2009,44,a) 0,1245,1256,6632,3355,1226,195.2,0,0,6555,6555,0,195.4,195.4,0,0,0,0,0,6555,195.4,0,0,,,
2009,44,b) 1,1177,1185,8084,8837,1,0.1,429,30.1,1346,,,,15.2,2852,1473,1379,16.7,32.3,-1506,-17.1,30.4,1,316,316,1277
2009,44,c) 2,1042,1051,9202,9510,41,3.5,260,22.3,1389,,,,14.6,2005,832,1173,8.7,21.1,-616,-6.5,29.2,1,198,198,675
2009,44,d) 3,1066,1124,7697,7950,63,5.2,225,18.6,1182,211,971,2.7,14.9,1687,686,1001,8.6,21.2,-505,-6.3,29.8,0,165,165,531
2009,44,e) 4,969,977,6858,7111,33,3.1,187,17.7,1177,71,1106,1,16.6,1683,657,1026,9.2,23.7,-506,-7.1,33.2,0,152,152,533
2009,44,f) 5,909,928,8147,8914,25,2.5,159,15.9,1171,121,1050,1.4,13.1,2704,1464,1240,16.4,30.3,-1533,-17.2,26.2,0,121,121,1378
2009,44,g) 6 to 10,3465,3625,31349,32242,102,2.7,518,13.5,4761,1771,2990,5.5,14.8,6546,2349,4197,7.3,20.3,-1785,-5.5,29.6,0,365,365,1895
2009,44,h) 11 to 15,2644,2826,26825,28324,81,2.8,266,9.1,2550,248,2302,0.9,9,5548,1182,4366,4.2,19.6,-2998,-10.6,18,0,166,166,936
2009,44,i) 16 to 20,2086,2210,28775,30117,64,2.8,231,10.1,3228,488,2740,1.6,10.7,5912,1324,4588,4.4,19.6,-2684,-8.9,21.4,0,128,128,834
2009,44,j) 21 to 25,1949,2228,31595,34422,48,2.1,193,8.4,2600,397,2203,1.2,7.6,8253,4270,3983,12.4,24,-5653,-16.4,15.2,0,110,110,3312
2009,44,k) 26+,1765,2237,42381,43448,54,2.4,115,5.1,4543,730,3813,1.7,10.5,6676,949,5727,2.2,15.4,-2133,-4.9,21,0,73,73,444
2009,44,l) Left Censored,3352,5733,202918,206435,243,4.2,354,6.1,14383,3455,10928,1.7,7,21417,4646,16771,2.3,10.4,-7034,-3.4,14,0,112,113,628
2009,45,a) 0,5363,5505,40345,20963,5376,195.3,0,0,38765,38765,0,184.9,184.9,0,0,0,0,0,38765,184.9,0,0,,,
2009,45,b) 1,4710,4747,27556,31839,8,0.1,1746,30.6,5743,,,,18,14308,7293,7015,22.9,44.9,-8565,-26.9,36,1,1407,1407,6332
2009,45,c) 2,4444,4537,33363,37875,158,3.1,1243,24.4,5200,,,,13.7,14224,6852,7372,18.1,37.6,-9024,-23.9,27.4,1,1017,1017,5951
2009,45,d) 3,4103,4247,33115,36287,130,2.8,1043,22.1,4459,537,3922,1.5,12.3,10802,4671,6131,12.9,29.8,-6343,-17.5,24.6,0,769,833,3876
2009,45,e) 4,3793,3939,35250,37489,131,3.1,696,16.4,4347,842,3505,2.2,11.6,8824,3149,5675,8.4,23.5,-4477,-11.9,23.2,0,547,547,2441
2009,45,f) 5,3140,3240,29046,31548,79,2.3,522,15,2727,294,2433,0.9,8.6,7730,2700,5030,8.6,24.5,-5003,-15.9,17.2,0,420,420,2161
2009,45,g) 6 to 10,12822,13613,151605,162460,339,2.4,1745,12.2,14633,2354,12279,1.4,9,36342,10631,25711,6.5,22.4,-21709,-13.4,18,0,1298,1298,8365
2009,45,h) 11 to 15,8931,9750,124573,130347,256,2.5,1042,10.3,11829,2483,9346,1.9,9.1,23377,5495,17882,4.2,17.9,-11548,-8.8,18.2,0,734,734,3495
2009,45,i) 16 to 20,6095,7253,95772,100521,198,2.7,579,7.8,8314,1895,6419,1.9,8.3,17812,4113,13699,4.1,17.7,-9498,-9.4,16.6,0,397,397,1904
2009,45,j) 21 to 25,5847,7773,127415,131970,204,2.6,490,6.2,11608,3201,8407,2.4,8.8,20717,3014,17703,2.3,15.7,-9109,-6.9,17.6,0,344,344,1914
2009,45,k) 26+,4822,7780,154839,160729,237,3,489,6.2,15643,6206,9437,3.9,9.7,27424,5410,22014,3.4,17.1,-11781,-7.4,19.4,0,244,247,1613
2009,45,l) Left Censored,7397,21662,682225,703674,1119,5.2,1104,5.1,51167,16425,34742,2.3,7.3,94064,18044,76020,2.6,13.4,-42897,-6.1,14.6,0,249,265,2739
2009,46,a) 0,1467,1474,7503,3798,1445,196.1,0,0,7410,7410,0,195.1,195.1,0,0,0,0,0,7410,195.1,0,0,,,
2009,46,b) 1,1145,1152,8092,8153,3,0.2,394,28.6,2800,,,,34.3,2921,1920,1001,23.5,35.8,-121,-1.5,68.6,1,287,287,1675
2009,46,c) 2,1143,1157,7098,7616,49,3.9,245,19.5,1129,,,,14.8,2165,1343,822,17.6,28.4,-1036,-13.6,29.6,1,185,185,1201
2009,46,d) 3,1102,1127,8539,9040,43,3.6,163,13.7,1034,138,896,1.5,11.4,2036,724,1312,8,22.5,-1002,-11.1,22.8,0,124,124,654
2009,46,e) 4,879,891,5028,5294,30,3.1,152,15.9,722,69,653,1.3,13.6,1254,571,683,10.8,23.7,-532,-10.1,27.2,0,111,111,446
2009,46,f) 5,860,896,6573,6795,34,3.6,118,12.6,773,74,699,1.1,11.4,1216,323,893,4.8,17.9,-443,-6.5,22.8,0,81,81,258
2009,46,g) 6 to 10,3549,3714,30347,31236,95,2.5,385,10,3771,490,3281,1.6,12.1,5548,2033,3515,6.5,17.8,-1777,-5.7,24.2,0,258,258,1487
2009,46,h) 11 to 15,2621,2747,26454,27923,99,3.5,267,9.4,2424,456,1968,1.6,8.7,5362,1878,3484,6.7,19.2,-2938,-10.5,17.4,0,154,154,912
2009,46,i) 16 to 20,1847,1990,20492,20868,69,3.4,182,8.9,2163,221,1942,1.1,10.4,2915,721,2194,3.5,14,-752,-3.6,20.8,0,94,94,381
2009,46,j) 21 to 25,1455,1696,23003,23480,42,2.4,87,5.1,1859,299,1560,1.3,7.9,2813,448,2365,1.9,12,-954,-4.1,15.8,0,58,58,302
2009,46,k) 26+,1483,2080,32522,32528,62,3,93,4.4,3922,1949,1973,6,12.1,3934,871,3063,2.7,12.1,-12,0,24.2,0,54,54,267
2009,46,l) Left Censored,2625,5086,154067,154639,176,3.4,211,4.1,12626,3020,9606,2,8.2,13770,1704,12066,1.1,8.9,-1144,-0.7,16.4,0,70,70,417
2009,47,a) 0,6400,6548,39786,20090,6446,196.9,0,0,39393,39393,0,196.1,196.1,0,0,0,0,0,39393,196.1,0,0,,,
2009,47,b) 1,5935,6044,38567,45619,34,0.5,2084,29.1,8135,183,7952,0.4,17.8,22238,11863,10375,26,48.7,-14103,-30.9,35.6,0,1757,1757,10778
2009,47,c) 2,5243,5388,38489,42790,191,3.2,1336,22.4,6427,1259,5168,2.9,15,15029,7501,7528,17.5,35.1,-8602,-20.1,30,0,1140,1140,6595
2009,47,d) 3,4851,5104,46357,50339,154,2.8,1114,19.9,5684,566,5118,1.1,11.3,13647,6128,7519,12.2,27.1,-7963,-15.8,22.6,0,920,920,4925
2009,47,e) 4,4336,4518,45904,48525,145,3,786,16.3,5871,1072,4799,2.2,12.1,11113,4046,7067,8.3,22.9,-5242,-10.8,24.2,0,636,642,3311
2009,47,f) 5,3753,3981,37646,44323,160,3.8,648,15.3,4648,817,3831,1.8,10.5,18001,3330,14671,7.5,40.6,-13353,-30.1,21,0,519,530,2942
2009,47,g) 6 to 10,14429,15727,181812,191468,421,2.6,1875,11.4,20945,3908,17037,2,10.9,40257,11720,28537,6.1,21,-19312,-10.1,21.8,0,1456,1458,9702
2009,47,h) 11 to 15,11328,12668,151008,161493,360,2.8,1160,8.9,15369,2908,12461,1.8,9.5,36339,9646,26693,6,22.5,-20970,-13,19,0,879,879,8142
2009,47,i) 16 to 20,8313,10235,161480,168155,375,3.6,781,7.5,19035,5495,13540,3.3,11.3,32385,5225,27160,3.1,19.3,-13350,-8,22.6,0,517,517,3436
2009,47,j) 21 to 25,8153,10356,187010,193260,310,3,592,5.6,18273,5719,12554,3,9.5,30772,5581,25191,2.9,15.9,-12499,-6.4,19,0,403,403,2880
2009,47,k) 26+,7099,12123,275305,288458,442,3.6,680,5.6,25108,7328,17780,2.5,8.7,51414,6152,45262,2.1,17.8,-26306,-9.1,17.4,0,304,311,1794
2009,47,l) Left Censored,10501,30847,1106891,1136793,1473,4.8,1767,5.7,88134,27448,60686,2.4,7.8,147938,29335,118603,2.6,13,-59804,-5.2,15.6,0,345,362,4201
2009,48,a) 0,31994,32357,217927,110161,31811,196.6,0,0,215533,215533,0,195.7,195.7,0,0,0,0,0,215533,195.7,0,0,,,
2009,48,b) 1,27158,27685,221726,238274,113,0.3,8503,26.3,50272,1785,48487,0.7,21.1,83368,40247,43121,16.9,35,-33096,-13.9,42.2,0,7004,7004,34732
2009,48,c) 2,23624,24073,204325,219119,719,2.7,5293,20.1,36767,4088,32679,1.9,16.8,66354,30391,35963,13.9,30.3,-29587,-13.5,33.6,0,4390,4391,26724
2009,48,d) 3,21414,22682,219808,231662,709,2.9,3771,15.6,32324,4181,28143,1.8,14,56032,21514,34518,9.3,24.2,-23708,-10.2,28,0,3069,3069,17796
2009,48,e) 4,18685,19836,233937,244475,552,2.6,2960,14.1,33862,6559,27303,2.7,13.9,54938,20382,34556,8.3,22.5,-21076,-8.6,27.8,0,2384,2384,16634
2009,48,f) 5,16379,17111,185049,195053,458,2.5,2360,13.1,23610,2758,20852,1.4,12.1,43618,16421,27197,8.4,22.4,-20008,-10.3,24.2,0,1903,1909,14532
2009,48,g) 6 to 10,61435,66784,854573,891077,2014,2.9,7474,10.8,97873,17108,80765,1.9,11,170881,51716,119165,5.8,19.2,-73008,-8.2,22,0,5663,5692,38513
2009,48,h) 11 to 15,43378,49141,713025,736779,1564,3.1,4377,8.7,92575,20813,71762,2.8,12.6,140082,36621,103461,5,19,-47507,-6.4,25.2,0,3085,3086,24984
2009,48,i) 16 to 20,31070,37335,608545,634776,1324,3.5,2946,7.7,63600,17622,45978,2.8,10,116061,24830,91231,3.9,18.3,-52461,-8.3,20,0,1913,1923,12584
2009,48,j) 21 to 25,24949,34198,688541,715113,1187,3.4,2051,5.9,67927,18004,49923,2.5,9.5,121071,22892,98179,3.2,16.9,-53144,-7.4,19,0,1281,1286,11034
2009,48,k) 26+,25497,42243,906927,929339,1480,3.5,2393,5.6,92157,31330,60827,3.4,9.9,136980,28407,108573,3.1,14.7,-44823,-4.8,19.8,0,1326,1336,8887
2009,48,l) Left Censored,26038,101002,3740528,3770400,6433,6.4,6089,6,410815,139449,271366,3.7,10.9,470558,104688,365870,2.8,12.5,-59743,-1.6,21.8,0,925,1072,9943
2009,49,a) 0,4825,4855,26175,13283,4733,195,0,0,25785,25785,0,194.1,194.1,0,0,0,0,0,25785,194.1,0,0,,,
2009,49,b) 1,4174,4237,26934,29161,13,0.2,1995,37.5,6632,,,,22.7,11085,6218,4867,21.3,38,-4453,-15.3,45.4,1,1503,1503,4823
2009,49,c) 2,3862,3906,26282,29253,140,3.1,1313,29.2,4632,,,,15.8,10574,5343,5231,18.3,36.1,-5942,-20.3,31.6,1,975,975,4425
2009,49,d) 3,3511,3645,27886,30943,148,3.7,911,22.5,4494,690,3804,2.2,14.5,10607,5198,5409,16.8,34.3,-6113,-19.8,29,0,700,700,3674
2009,49,e) 4,2908,2984,27129,29282,96,2.9,626,19.2,3520,479,3041,1.6,12,7825,2939,4886,10,26.7,-4305,-14.7,24,0,465,465,2440
2009,49,f) 5,2458,2523,24157,25599,84,3.1,494,18,4272,358,3914,1.4,16.7,7155,2545,4610,9.9,28,-2883,-11.3,33.4,0,369,369,2135
2009,49,g) 6 to 10,9293,9695,117664,120336,260,2.5,1339,13.1,20493,1907,18586,1.6,17,25836,8386,17450,7,21.5,-5343,-4.5,34,0,903,906,6875
2009,49,h) 11 to 15,5779,6304,95234,101897,244,3.7,682,10.5,8296,1738,6558,1.7,8.1,21621,4943,16678,4.9,21.2,-13325,-13.1,16.2,0,447,447,3787
2009,49,i) 16 to 20,3377,3854,81431,86250,112,2.8,302,7.6,6395,998,5397,1.2,7.4,16032,2139,13893,2.5,18.6,-9637,-11.2,14.8,0,197,197,1291
2009,49,j) 21 to 25,2391,3260,79638,82944,109,3.3,200,6,8538,1846,6692,2.2,10.3,15149,2832,12317,3.4,18.3,-6611,-8,20.6,0,102,102,1158
2009,49,k) 26+,2662,4058,94401,96741,149,3.6,249,6.1,8526,2917,5609,3,8.8,13206,2304,10902,2.4,13.7,-4680,-4.9,17.6,0,126,126,862
2009,49,l) Left Censored,3631,10473,420251,425441,774,7.5,584,5.6,40480,13604,26876,3.2,9.5,50860,13908,36952,3.3,12,-10380,-2.5,19,0,107,107,1331
2009,50,a) 0,942,948,7234,3636,926,195.4,0,0,7196,7196,0,197.9,197.9,0,0,0,0,0,7196,197.9,0,0,,,
2009,50,b) 1,827,832,4978,5311,0,0,296,29.6,976,0,976,0,18.4,1642,933,709,17.6,30.9,-666,-12.5,36.8,0,216,216,765
2009,50,c) 2,831,842,8056,8158,27,3,175,19.1,1300,59,1241,0.7,15.9,1503,550,953,6.7,18.4,-203,-2.5,31.8,0,128,128,436
2009,50,d) 3,778,793,4491,4687,29,3.4,135,15.9,583,67,516,1.4,12.4,975,345,630,7.4,20.8,-392,-8.4,24.8,0,102,102,300
2009,50,e) 4,662,672,4276,4577,24,3.3,118,16.3,489,42,447,0.9,10.7,1090,431,659,9.4,23.8,-601,-13.1,21.4,0,79,79,331
2009,50,f) 5,643,652,4092,4410,16,2.3,117,16.6,421,58,363,1.3,9.5,1057,528,529,12,24,-636,-14.5,19,0,81,84,446
2009,50,g) 6 to 10,2733,2815,25708,26197,75,2.5,321,10.9,2642,191,2451,0.7,10.1,3619,1087,2532,4.1,13.8,-977,-3.7,20.2,0,201,201,745
2009,50,h) 11 to 15,2145,2296,18060,19092,59,2.5,224,9.4,1286,208,1078,1.1,6.7,3350,1004,2346,5.3,17.5,-2064,-10.8,13.4,0,147,150,752
2009,50,i) 16 to 20,1846,1985,18133,18538,70,3.5,150,7.4,1916,386,1530,2.1,10.3,2725,639,2086,3.4,14.7,-809,-4.4,20.6,0,83,83,400
2009,50,j) 21 to 25,1603,1800,37120,38221,41,2.2,144,7.8,2433,133,2300,0.3,6.4,4635,2115,2520,5.5,12.1,-2202,-5.7,12.8,0,80,80,381
2009,50,k) 26+,1363,1827,31192,31993,63,3.4,109,5.9,3000,947,2053,3,9.4,4601,738,3863,2.3,14.4,-1601,-5,18.8,0,61,61,398
2009,50,l) Left Censored,2031,3745,101113,103356,222,6,187,5,6412,2017,4395,2,6.2,10897,2031,8866,2,10.5,-4485,-4.3,12.4,0,48,48,424
2009,51,a) 0,10224,10317,58165,29422,10121,196.2,0,0,57487,57487,0,195.4,195.4,0,0,0,0,0,57487,195.4,0,0,,,
2009,51,b) 1,9099,9218,57086,62903,28,0.3,3101,28.4,13089,390,12699,0.6,20.8,24723,13667,11056,21.7,39.3,-11634,-18.5,41.6,0,2461,2462,11755
2009,51,c) 2,8216,8306,55300,59304,303,3.3,1984,21.6,10412,1142,9270,1.9,17.6,18419,9457,8962,15.9,31.1,-8007,-13.5,35.2,0,1569,1569,7902
2009,51,d) 3,8005,8402,67175,70842,252,2.8,1611,17.7,9214,1364,7850,1.9,13,16548,7088,9460,10,23.4,-7334,-10.4,26,0,1287,1287,5472
2009,51,e) 4,7083,7303,58960,62833,223,2.9,1241,15.9,8232,1095,7137,1.7,13.1,15977,5741,10236,9.1,25.4,-7745,-12.3,26.2,0,960,960,4798
2009,51,f) 5,6124,6293,54296,56944,174,2.6,1009,15,7761,1071,6690,1.9,13.6,13057,5199,7858,9.1,22.9,-5296,-9.3,27.2,0,773,773,4369
2009,51,g) 6 to 10,22810,24353,259572,268349,679,2.7,2949,11.6,31329,5000,26329,1.9,11.7,48883,15060,33823,5.6,18.2,-17554,-6.5,23.4,0,2091,2097,11533
2009,51,h) 11 to 15,17007,18547,239351,249377,508,2.7,1689,8.8,23729,4813,18916,1.9,9.5,43780,10785,32995,4.3,17.6,-20051,-8.1,19,0,1189,1190,7575
2009,51,i) 16 to 20,12279,14194,210668,218457,380,2.6,1163,8,22566,6764,15802,3.1,10.3,38144,7536,30608,3.4,17.5,-15578,-7.2,20.6,0,735,735,4417
2009,51,j) 21 to 25,11021,14109,261840,267030,354,2.5,843,5.9,26600,8523,18077,3.2,10,36979,6665,30314,2.5,13.8,-10379,-3.8,20,0,508,512,3036
2009,51,k) 26+,8995,14241,315660,323842,482,3.4,759,5.3,27910,9167,18743,2.8,8.6,44274,9134,35140,2.8,13.7,-16364,-5.1,17.2,0,425,427,2524
2009,51,l) Left Censored,12901,41013,1376675,1399651,2872,7.1,2209,5.4,130207,50166,80041,3.6,9.3,176159,36817,139342,2.6,12.6,-45952,-3.3,18.6,0,380,394,4562
2009,53,a) 0,10247,10317,48923,24805,10058,195,0,0,48237,48237,0,194.5,194.5,0,0,0,0,0,48237,194.5,0,0,,,
2009,53,b) 1,9376,9473,52583,58035,37,0.3,3808,33,11885,442,11443,0.8,20.5,22789,12967,9822,22.3,39.3,-10904,-18.8,41,0,2913,2913,10639
2009,53,c) 2,8406,8487,50708,55514,303,3.2,2373,24.9,9640,1159,8481,2.1,17.4,19251,9436,9815,17,34.7,-9611,-17.3,34.8,0,1805,1805,7393
2009,53,d) 3,8072,8382,58801,63435,272,3,1908,20.7,8332,875,7457,1.4,13.1,17600,7796,9804,12.3,27.7,-9268,-14.6,26.2,0,1438,1438,6460
2009,53,e) 4,6955,7181,52412,56528,266,3.4,1347,17.4,6810,1206,5604,2.1,12,15041,5688,9353,10.1,26.6,-8231,-14.6,24,0,1022,1024,4183
2009,53,f) 5,5819,5961,45425,49665,174,2.7,1018,15.9,4975,648,4327,1.3,10,13454,5411,8043,10.9,27.1,-8479,-17.1,20,0,731,731,4279
2009,53,g) 6 to 10,22691,24163,226282,239910,846,3.3,3187,12.6,25569,5486,20083,2.3,10.7,52825,14148,38677,5.9,22,-27256,-11.3,21.4,0,2202,2202,10910
2009,53,h) 11 to 15,16170,17576,195665,205882,538,3,1809,9.9,19283,4079,15204,2,9.4,39716,9829,29887,4.8,19.3,-20433,-9.9,18.8,0,1207,1207,6914
2009,53,i) 16 to 20,11383,12916,162542,172753,402,3,1125,8.5,15519,2716,12803,1.6,9,35941,7551,28390,4.4,20.8,-20422,-11.8,18,0,715,715,4467
2009,53,j) 21 to 25,8802,11242,214853,220369,354,3.1,751,6.6,17467,4802,12665,2.2,7.9,28498,4360,24138,2,12.9,-11031,-5,15.8,0,477,477,2409
2009,53,k) 26+,8517,13006,304302,310497,423,3.2,812,6.1,28897,7839,21058,2.5,9.3,41288,8596,32692,2.8,13.3,-12391,-4,18.6,0,426,428,2419
2009,53,l) Left Censored,10402,28896,971260,987161,1586,5.5,1665,5.8,117683,24538,93145,2.5,11.9,149487,26011,123476,2.6,15.1,-31804,-3.2,23.8,0,308,323,5040
2009,54,a) 0,1547,1554,9834,4957,1531,197,0,0,9755,9755,0,196.8,196.8,0,0,0,0,0,9755,196.8,0,0,,,
2009,54,b) 1,1383,1406,9745,10341,5,0.3,445,27,2224,19,2205,0.2,21.5,3415,1714,1701,16.6,33,-1191,-11.5,43,0,357,357,1527
2009,54,c) 2,1296,1309,10802,10942,52,3.7,272,19.2,2231,373,1858,3.4,20.4,2511,1060,1451,9.7,22.9,-280,-2.5,40.8,0,222,222,935
2009,54,d) 3,1330,1426,13519,13750,53,3.5,269,17.5,2366,272,2094,2,17.2,2827,1155,1672,8.4,20.6,-461,-3.4,34.4,0,213,213,940
2009,54,e) 4,1278,1317,10355,11000,32,2.3,197,14.1,1105,117,988,1.1,10,2395,848,1547,7.7,21.8,-1290,-11.8,20,0,151,151,670
2009,54,f) 5,1082,1177,10193,10480,44,3.6,163,13.2,1592,162,1430,1.5,15.2,2165,1033,1132,9.9,20.7,-573,-5.5,30.4,0,140,140,916
2009,54,g) 6 to 10,4133,4398,40671,42981,99,2.2,459,10,4406,571,3835,1.3,10.3,9026,2589,6437,6,21,-4620,-10.7,20.6,0,350,350,1806
2009,54,h) 11 to 15,3403,3750,37051,38375,90,2.3,319,8.3,3534,558,2976,1.5,9.2,6182,1662,4520,4.3,16.1,-2648,-6.9,18.4,0,238,238,1287
2009,54,i) 16 to 20,2635,2972,34321,35033,76,2.5,247,8.1,3661,565,3096,1.6,10.5,5085,1186,3899,3.4,14.5,-1424,-4,21,0,172,172,775
2009,54,j) 21 to 25,2553,3125,54682,54910,68,2.1,178,5.6,5889,1760,4129,3.2,10.7,6345,1140,5205,2.1,11.6,-456,-0.9,21.4,0,116,118,574
2009,54,k) 26+,2583,3950,66944,67192,100,2.5,185,4.6,7026,806,6220,1.2,10.5,7522,1513,6009,2.3,11.2,-496,-0.7,21,0,105,105,678
2009,54,l) Left Censored,4396,9991,272233,274188,520,5.2,381,3.8,23269,7360,15909,2.7,8.5,27178,3379,23799,1.2,9.9,-3909,-1.4,17,0,138,138,631
2009,55,a) 0,6126,6168,36587,18682,6026,195.4,0,0,35810,35810,0,191.7,191.7,0,0,0,0,0,35810,191.7,0,0,,,
2009,55,b) 1,5412,5503,36593,39182,30,0.5,1724,26.8,8185,247,7938,0.6,20.9,13362,8156,5206,20.8,34.1,-5177,-13.2,41.8,0,1315,1320,7109
2009,55,c) 2,5107,5168,37735,40570,176,3.1,1150,20.3,5485,518,4967,1.3,13.5,11155,5144,6011,12.7,27.5,-5670,-14,27,0,877,877,4279
2009,55,d) 3,5068,5388,45811,48076,172,3,920,15.9,6067,885,5182,1.8,12.6,10596,4328,6268,9,22,-4529,-9.4,25.2,0,728,728,3797
2009,55,e) 4,4539,4643,36169,37638,165,3.3,757,15.3,4841,619,4222,1.6,12.9,7778,3233,4545,8.6,20.7,-2937,-7.8,25.8,0,557,557,2633
2009,55,f) 5,3942,4091,37712,39860,106,2.4,603,13.9,4257,528,3729,1.3,10.7,8552,3165,5387,7.9,21.5,-4295,-10.8,21.4,0,445,445,2658
2009,55,g) 6 to 10,16974,18116,182824,191163,470,2.5,1977,10.5,18068,2409,15659,1.3,9.5,34746,10251,24495,5.4,18.2,-16678,-8.7,19,0,1347,1348,7536
2009,55,h) 11 to 15,13269,14390,157353,165530,399,2.7,1354,9.1,13723,2453,11270,1.5,8.3,30076,7093,22983,4.3,18.2,-16353,-9.9,16.6,0,883,883,5164
2009,55,i) 16 to 20,10645,11915,150787,157068,335,2.7,1007,8.2,11935,2026,9909,1.3,7.6,24496,5639,18857,3.6,15.6,-12561,-8,15.2,0,612,616,3474
2009,55,j) 21 to 25,8473,10705,189444,195703,247,2.3,626,5.7,15278,3431,11847,1.8,7.8,27796,5170,22626,2.6,14.2,-12518,-6.4,15.6,0,388,389,2215
2009,55,k) 26+,7957,11950,254427,259155,313,2.6,654,5.4,22930,5460,17470,2.1,8.8,32386,6607,25779,2.5,12.5,-9456,-3.7,17.6,0,338,338,3294
2009,55,l) Left Censored,13933,31886,1201851,1231947,1338,4.2,1521,4.8,76997,20348,56649,1.7,6.3,137188,28206,108982,2.3,11.1,-60191,-4.8,12.6,0,414,419,5137
2009,56,a) 0,1246,1267,5956,3002,1248,197,0,0,5908,5908,0,196.8,196.8,0,0,0,0,0,5908,196.8,0,0,,,
2009,56,b) 1,1071,1082,5513,5854,4,0.3,373,29,1276,32,1244,0.5,21.8,1958,971,987,16.6,33.4,-682,-11.6,43.6,0,274,274,711
2009,56,c) 2,1051,1059,5889,6506,50,4.3,241,20.8,860,143,717,2.2,13.2,2094,823,1271,12.6,32.2,-1234,-19,26.4,0,194,194,688
2009,56,d) 3,979,1024,6869,7516,34,3.1,180,16.4,913,152,761,2,12.1,2206,827,1379,11,29.4,-1293,-17.3,24.2,0,134,134,726
2009,56,e) 4,798,820,5225,5781,24,2.7,147,16.7,651,68,583,1.2,11.3,1762,626,1136,10.8,30.5,-1111,-19.2,22.6,0,117,117,541
2009,56,f) 5,646,657,4072,4227,25,3.6,105,15.1,664,125,539,3,15.7,973,368,605,8.7,23,-309,-7.3,31.4,0,80,80,313
2009,56,g) 6 to 10,2833,2905,22324,23189,86,2.9,287,9.6,3025,272,2753,1.2,13,4755,1382,3373,6,20.5,-1730,-7.5,26,0,198,198,1026
2009,56,h) 11 to 15,1964,2075,17725,18148,68,3.2,182,8.5,2036,328,1708,1.8,11.2,2881,885,1996,4.9,15.9,-845,-4.7,22.4,0,117,117,653
2009,56,i) 16 to 20,1301,1390,17236,17635,49,3.5,106,7.5,1747,147,1600,0.8,9.9,2545,800,1745,4.5,14.4,-798,-4.5,19.8,0,64,64,380
2009,56,j) 21 to 25,1025,1219,17663,17993,29,2.4,54,4.4,1352,257,1095,1.4,7.5,2011,348,1663,1.9,11.2,-659,-3.7,15,0,36,36,246
2009,56,k) 26+,1287,1757,27741,28188,54,3,90,5.1,2747,338,2409,1.2,9.7,3641,671,2970,2.4,12.9,-894,-3.2,19.4,0,57,58,297
2009,56,l) Left Censored,1605,3166,72244,73799,151,4.8,158,5,7120,1237,5883,1.7,9.6,10229,2124,8105,2.9,13.9,-3109,-4.3,19.2,0,42,42,574
2010,01,a) 0,4378,4464,30082,15124,4402,197.2,0,0,29917,29917,0,197.8,197.8,0,0,0,0,0,29917,197.8,0,0,,,
2010,01,b) 1,3695,3912,25299,28454,137,3,1220,27.1,5858,593,5265,2.1,20.6,12168,7512,4656,26.4,42.8,-6310,-22.2,41.2,0,976,976,6524
2010,01,c) 2,3651,3729,26508,27559,134,3.3,869,21.3,5052,458,4594,1.7,18.3,7153,3794,3359,13.8,26,-2101,-7.7,36.6,0,726,726,3184
2010,01,d) 3,3610,3688,29683,31172,123,3.1,720,18.1,4527,614,3913,2,14.5,7504,3223,4281,10.3,24.1,-2977,-9.6,29,0,592,592,2842
2010,01,e) 4,3213,3411,28203,29161,99,2.7,563,15.5,4088,657,3431,2.3,14,6003,2722,3281,9.3,20.6,-1915,-6.6,28,0,458,460,2415
2010,01,f) 5,2986,3106,29439,30621,95,2.9,429,13.2,4385,487,3898,1.6,14.3,6748,3118,3630,10.2,22,-2363,-7.7,28.6,0,337,346,2780
2010,01,g) 6 to 10,11455,12247,130644,133732,333,2.6,1330,10.5,15200,2973,12227,2.2,11.4,21376,6814,14562,5.1,16,-6176,-4.6,22.8,0,1032,1035,5632
2010,01,h) 11 to 15,9185,10190,117218,124186,272,2.6,970,9.2,11969,2617,9352,2.1,9.6,25904,10977,14927,8.8,20.9,-13935,-11.3,19.2,0,712,713,8546
2010,01,i) 16 to 20,6527,7462,106390,106809,209,2.7,581,7.6,13125,3130,9995,2.9,12.3,13962,3744,10218,3.5,13.1,-837,-0.8,24.6,0,412,412,2790
2010,01,j) 21 to 25,5407,7054,142508,144514,267,3.8,395,5.6,11822,3082,8740,2.1,8.2,15834,3107,12727,2.1,11,-4012,-2.8,16.4,0,271,271,1328
2010,01,k) 26+,6882,10493,207428,210557,309,2.9,496,4.7,18450,5691,12759,2.7,8.8,24708,4719,19989,2.2,11.7,-6258,-2.9,17.6,0,285,286,2885
2010,01,l) Left Censored,7652,22150,685207,695732,878,4,1008,4.5,52603,11272,41331,1.6,7.6,73652,14642,59010,2.1,10.6,-21049,-3,15.2,0,244,258,2369
2010,02,a) 0,976,991,4770,2445,956,192.9,0,0,4651,4651,0,190.2,190.2,0,0,0,0,0,4651,190.2,0,0,,,
2010,02,b) 1,774,799,4625,4735,4,0.4,260,27.6,1039,16,1023,0.3,21.9,1258,704,554,14.9,26.6,-219,-4.7,43.8,0,175,175,551
2010,02,c) 2,751,783,4646,4832,45,5.4,163,19.4,1003,156,847,3.2,20.8,1374,797,577,16.5,28.4,-371,-7.6,41.6,0,107,107,651
2010,02,d) 3,711,725,4813,4847,40,5.3,104,13.7,857,112,745,2.3,17.7,924,487,437,10,19.1,-67,-1.4,35.4,0,70,70,386
2010,02,e) 4,643,674,5486,5721,34,4.8,112,15.8,970,103,867,1.8,17,1439,655,784,11.4,25.2,-469,-8.2,34,0,81,81,483
2010,02,f) 5,539,549,4137,4164,29,5.1,77,13.5,711,111,600,2.7,17.1,765,278,487,6.7,18.4,-54,-1.3,34.2,0,48,48,213
2010,02,g) 6 to 10,2425,2557,27834,27473,120,4.6,247,9.5,4704,735,3969,2.7,17.1,3981,1071,2910,3.9,14.5,723,2.6,29,0,144,144,544
2010,02,h) 11 to 15,1736,1890,21419,21693,91,4.7,166,8.6,2737,735,2002,3.4,12.6,3284,889,2395,4.1,15.1,-547,-2.5,25.2,0,95,95,554
2010,02,i) 16 to 20,1254,1362,12625,12589,64,4.6,100,7.3,1689,199,1490,1.6,13.4,1617,572,1045,4.5,12.8,72,0.6,25.6,0,53,53,375
2010,02,j) 21 to 25,1010,1178,23712,23804,37,3.1,75,6.3,2165,122,2043,0.5,9.1,2348,302,2046,1.3,9.9,-183,-0.8,18.2,0,36,44,195
2010,02,k) 26+,1335,2104,44419,44654,79,3.7,93,4.4,5525,1126,4399,2.5,12.4,5994,777,5217,1.7,13.4,-469,-1,24.8,0,49,49,272
2010,02,l) Left Censored,1250,3250,94168,94292,159,4.9,123,3.8,8433,1419,7014,1.5,8.9,8680,1375,7305,1.5,9.2,-247,-0.3,17.8,0,16,16,62
2010,04,a) 0,7616,7727,61638,31147,7541,195.2,0,0,60983,60983,0,195.8,195.8,0,0,0,0,0,60983,195.8,0,0,,,
2010,04,b) 1,5945,6034,49157,52361,29,0.4,2220,30.8,11431,483,10948,0.9,21.8,17839,10006,7833,19.1,34.1,-6408,-12.3,43.6,0,1755,1755,8596
2010,04,c) 2,6166,6363,46174,49387,259,3.7,1630,23.2,7805,1028,6777,2.1,15.8,14231,7142,7089,14.5,28.8,-6426,-13,31.6,0,1277,1277,6120
2010,04,d) 3,5622,5767,43656,46916,230,3.6,1315,20.9,6691,1094,5597,2.3,14.3,13210,7278,5932,15.5,28.2,-6519,-13.9,28.6,0,1021,1021,6081
2010,04,e) 4,5482,5692,49681,51784,235,3.8,1167,19,8689,1392,7297,2.7,16.8,12895,6159,6736,11.9,24.9,-4206,-8.1,33.6,0,941,941,5225
2010,04,f) 5,4471,4682,41653,44073,156,3.1,846,16.9,5925,908,5017,2.1,13.4,10764,4754,6010,10.8,24.4,-4839,-11,26.8,0,626,627,4032
2010,04,g) 6 to 10,16323,17454,191151,200353,733,4,2451,13.4,24369,6112,18257,3.1,12.2,42773,13804,28969,6.9,21.3,-18404,-9.1,24.4,0,1806,1806,10852
2010,04,h) 11 to 15,10933,12142,161213,168315,511,4.1,1469,11.6,19414,5102,14312,3,11.5,33617,10113,23504,6,20,-14203,-8.5,23,0,984,993,7098
2010,04,i) 16 to 20,6894,8211,129859,133648,328,3.9,716,8.5,14373,4642,9731,3.5,10.8,21951,4169,17782,3.1,16.4,-7578,-5.6,21.6,0,487,487,3080
2010,04,j) 21 to 25,5502,8281,165355,171068,348,4.2,554,6.6,14544,5754,8790,3.4,8.5,25969,4792,21177,2.8,15.2,-11425,-6.7,17,0,313,327,2513
2010,04,k) 26+,5958,10181,244126,250627,461,4.5,718,7,24390,7467,16923,3,9.7,37392,11675,25717,4.7,14.9,-13002,-5.2,19.4,0,280,298,1840
2010,04,l) Left Censored,5740,22654,853035,861472,1477,6.5,1389,6.1,94511,28527,65984,3.3,11,111384,24962,86422,2.9,12.9,-16873,-1.9,22,0,142,157,1189
2010,05,a) 0,3177,3234,22009,11112,3166,195.8,0,0,21794,21794,0,196.1,196.1,0,0,0,0,0,21794,196.1,0,0,,,
2010,05,b) 1,2571,2655,18711,19503,12,0.4,842,27.1,4093,233,3860,1.2,21,5677,3580,2097,18.4,29.1,-1584,-8.1,42,0,650,650,2972
2010,05,c) 2,2507,2528,17714,18824,85,3.1,537,19.6,2964,274,2690,1.5,15.7,5183,2274,2909,12.1,27.5,-2219,-11.8,31.4,0,434,434,1763
2010,05,d) 3,2298,2345,17926,18139,87,3.5,422,16.9,3065,417,2648,2.3,16.9,3491,1618,1873,8.9,19.2,-426,-2.3,33.8,0,332,332,1388
2010,05,e) 4,2284,2479,18710,19301,94,3.6,350,13.5,2649,636,2013,3.3,13.7,3830,1740,2090,9,19.8,-1181,-6.1,27.4,0,280,280,1419
2010,05,f) 5,2049,2121,16018,16637,83,3.7,286,12.9,1968,284,1684,1.7,11.8,3205,1391,1814,8.4,19.3,-1237,-7.5,23.6,0,204,204,1015
2010,05,g) 6 to 10,7938,8432,72662,74897,256,2.9,852,9.8,8413,1455,6958,1.9,11.2,12882,4999,7883,6.7,17.2,-4469,-6,22.4,0,653,653,4336
2010,05,h) 11 to 15,5829,6618,65200,65792,203,3,565,8.3,8254,2346,5908,3.6,12.5,9437,3075,6362,4.7,14.3,-1183,-1.8,25,0,353,353,2430
2010,05,i) 16 to 20,4419,5001,53503,54572,160,3.1,375,7.4,6329,2165,4164,4,11.6,8467,1996,6471,3.7,15.5,-2138,-3.9,23.2,0,261,261,1339
2010,05,j) 21 to 25,3203,4110,81836,82564,123,3,248,6,7094,2279,4815,2.8,8.6,8550,2085,6465,2.5,10.4,-1456,-1.8,17.2,0,171,171,1389
2010,05,k) 26+,4529,6497,129237,129416,198,3,317,4.8,14248,3586,10662,2.8,11,14606,3148,11458,2.4,11.3,-358,-0.3,22,0,189,190,1144
2010,05,l) Left Censored,5199,13893,447989,452366,612,4.4,570,4.1,36311,7807,28504,1.7,8,45065,7871,37194,1.7,10,-8754,-2,16,0,136,138,2299
2010,06,a) 0,49320,50062,296259,149393,49253,196.8,0,0,293733,293733,0,196.6,196.6,0,0,0,0,0,293733,196.6,0,0,,,
2010,06,b) 1,39287,39743,267578,291164,94,0.2,13352,28.5,58264,1390,56874,0.5,20,105436,61351,44085,21.1,36.2,-47172,-16.2,40,0,10116,10128,50835
2010,06,c) 2,38470,39199,278843,292170,1633,3.8,8881,20.8,51492,7738,43754,2.6,17.6,78146,38174,39972,13.1,26.7,-26654,-9.1,35.2,0,6855,6865,30588
2010,06,d) 3,35265,35745,263321,278690,1489,3.9,7181,18.6,43246,7446,35800,2.7,15.5,73983,39394,34589,14.1,26.5,-30737,-11,31,0,5464,5464,33292
2010,06,e) 4,34951,36423,307141,320670,1408,3.6,6188,16,44346,8197,36149,2.6,13.8,71403,29190,42213,9.1,22.3,-27057,-8.5,27.6,0,4612,4619,22532
2010,06,f) 5,30041,32032,286994,303358,1176,3.5,5009,14.8,40900,5671,35229,1.9,13.5,73627,37220,36407,12.3,24.3,-32727,-10.8,27,0,3671,3676,27310
2010,06,g) 6 to 10,111002,117149,1204766,1267928,4245,3.5,14965,12.2,155902,37692,118210,3,12.3,282226,94127,188099,7.4,22.3,-126324,-10,24.6,0,10592,10598,71829
2010,06,h) 11 to 15,72174,79210,1000714,1036343,2721,3.3,8080,9.9,110734,24679,86055,2.4,10.7,181991,55750,126241,5.4,17.6,-71257,-6.9,21.4,0,5400,5430,38961
2010,06,i) 16 to 20,49747,57138,850283,887507,2009,3.4,4974,8.5,83388,17233,66155,1.9,9.4,157835,44498,113337,5,17.8,-74447,-8.4,18.8,0,3332,3340,27266
2010,06,j) 21 to 25,43396,55373,1078073,1100977,1912,3.4,4023,7.1,92011,19629,72382,1.8,8.4,137819,33301,104518,3,12.5,-45808,-4.1,16.8,0,2498,2504,17191
2010,06,k) 26+,49340,75794,1707120,1721982,2729,3.6,4536,5.9,183881,54765,129116,3.2,10.7,213604,57185,156419,3.3,12.4,-29723,-1.7,21.4,0,2372,2411,17245
2010,06,l) Left Censored,41059,131911,4869390,4957494,6652,5,7505,5.7,439406,129954,309452,2.6,8.9,615613,125256,490357,2.5,12.4,-176207,-3.5,17.8,0,1538,1575,19928
2010,08,a) 0,9152,9219,49800,25248,9033,196,0,0,49104,49104,0,194.5,194.5,0,0,0,0,0,49104,194.5,0,0,,,
2010,08,b) 1,6902,6958,41074,44559,15,0.2,2493,30.1,8793,118,8675,0.3,19.7,15763,10114,5649,22.7,35.4,-6970,-15.7,39.4,0,1794,1794,8542
2010,08,c) 2,6888,6958,43012,45431,322,4.2,1735,22.7,7385,1395,5990,3.1,16.3,12222,6647,5575,14.6,26.9,-4837,-10.6,32.6,0,1271,1276,5449
2010,08,d) 3,6313,6379,44999,47500,311,4.5,1350,19.6,6898,1498,5400,3.2,14.5,11900,5790,6110,12.2,25.1,-5002,-10.6,29,0,984,984,4771
2010,08,e) 4,6015,6209,44862,47092,291,4.4,1166,17.6,6479,1050,5429,2.2,13.8,10938,4731,6207,10,23.2,-4459,-9.4,27.6,0,796,796,3612
2010,08,f) 5,5411,5535,47158,49119,216,3.7,970,16.4,6537,731,5806,1.5,13.3,10459,3992,6467,8.1,21.3,-3922,-8,26.6,0,679,679,3274
2010,08,g) 6 to 10,20348,21292,180635,188214,876,3.9,2819,12.7,22254,4711,17543,2.5,11.8,37411,13830,23581,7.3,19.9,-15157,-8.1,23.6,0,1818,1818,10621
2010,08,h) 11 to 15,13871,15141,160023,166106,605,3.9,1688,10.8,17757,3493,14264,2.1,10.7,29922,8406,21516,5.1,18,-12165,-7.3,21.4,0,995,995,5206
2010,08,i) 16 to 20,9312,10548,141675,144496,434,4,945,8.8,14194,3098,11096,2.1,9.8,19835,5213,14622,3.6,13.7,-5641,-3.9,19.6,0,563,563,3524
2010,08,j) 21 to 25,6510,8247,136793,140888,281,3.3,583,6.9,11807,2779,9028,2,8.4,19996,5910,14086,4.2,14.2,-8189,-5.8,16.8,0,310,316,3179
2010,08,k) 26+,7666,11911,264382,265064,430,3.6,783,6.5,33737,7442,26295,2.8,12.7,35101,9052,26049,3.4,13.2,-1364,-0.5,25.4,0,321,322,2140
2010,08,l) Left Censored,7376,22484,767727,779847,1447,6.5,1323,5.9,79908,26168,53740,3.4,10.2,104148,20135,84013,2.6,13.4,-24240,-3.2,20.4,0,194,194,1413
2010,09,a) 0,3797,3868,24799,12468,3793,196.1,0,0,24662,24662,0,197.8,197.8,0,0,0,0,0,24662,197.8,0,0,,,
2010,09,b) 1,3064,3076,21175,23061,9,0.3,901,25.3,4827,38,4789,0.2,20.9,8598,4942,3656,21.4,37.3,-3771,-16.4,41.8,0,662,663,3864
2010,09,c) 2,3117,3162,21523,21814,107,3.1,635,18.6,4064,798,3266,3.7,18.6,4645,2273,2372,10.4,21.3,-581,-2.7,37.2,0,482,483,1862
2010,09,d) 3,2704,2736,20800,22080,115,3.9,519,17.7,3023,699,2324,3.2,13.7,5583,2619,2964,11.9,25.3,-2560,-11.6,27.4,0,403,403,2201
2010,09,e) 4,2791,2974,25464,26346,121,3.9,461,14.7,3226,465,2761,1.8,12.2,4989,1681,3308,6.4,18.9,-1763,-6.7,24.4,0,324,324,1135
2010,09,f) 5,2501,2570,23824,24680,78,2.9,379,14,3072,555,2517,2.2,12.4,4784,2454,2330,9.9,19.4,-1712,-7,24.8,0,283,283,2167
2010,09,g) 6 to 10,9774,10243,101626,104186,335,3.1,1172,11,11220,1679,9541,1.6,10.8,16340,5630,10710,5.4,15.7,-5120,-4.9,21.6,0,830,830,4368
2010,09,h) 11 to 15,7964,8524,100369,102999,271,3.1,734,8.4,9145,1702,7443,1.7,8.9,14404,3922,10482,3.8,14,-5259,-5.1,17.8,0,489,489,3065
2010,09,i) 16 to 20,6259,6820,81067,82419,178,2.6,470,6.8,7781,1584,6197,1.9,9.4,10485,2225,8260,2.7,12.7,-2704,-3.3,18.8,0,316,316,1795
2010,09,j) 21 to 25,6095,7145,117579,118695,252,3.5,465,6.4,10007,2747,7260,2.3,8.4,12239,3131,9108,2.6,10.3,-2232,-1.9,16.8,0,286,287,1918
2010,09,k) 26+,6719,9329,167072,170079,306,3.2,498,5.3,15412,4187,11225,2.5,9.1,21425,5745,15680,3.4,12.6,-6013,-3.5,18.2,0,271,273,2842
2010,09,l) Left Censored,9605,20008,732717,741099,794,3.9,1048,5.2,59180,12970,46210,1.8,8,75943,13834,62109,1.9,10.2,-16763,-2.2,16,0,296,297,3409
2010,10,a) 0,1155,1161,8099,4068,1142,196.7,0,0,8062,,,,198.2,0,0,0,0,0,8062,198.2,0,1,,,
2010,10,b) 1,941,954,7390,7871,2,0.2,291,26.2,1582,,,,20.1,2543,1203,1340,15.3,32.3,-961,-12.2,40.2,1,232,232,947
2010,10,c) 2,955,972,6852,7463,38,3.6,195,18.6,1050,110,940,1.5,14.1,2272,1544,728,20.7,30.4,-1222,-16.3,28.2,0,159,159,1458
2010,10,d) 3,784,822,6995,7032,34,3.9,138,15.8,1151,379,772,5.4,16.4,1225,560,665,8,17.4,-74,-1,32.8,0,94,94,470
2010,10,e) 4,812,829,6758,6774,28,3.2,121,13.9,823,103,720,1.5,12.1,855,325,530,4.8,12.6,-32,-0.5,24.2,0,92,92,280
2010,10,f) 5,735,741,5578,5738,38,4.9,101,13.1,766,123,643,2.1,13.3,1086,338,748,5.9,18.9,-320,-5.6,26.6,0,77,77,300
2010,10,g) 6 to 10,2921,3030,28209,28915,112,3.6,372,11.8,4333,1560,2773,5.4,15,5745,2184,3561,7.6,19.9,-1412,-4.9,30,0,288,288,1924
2010,10,h) 11 to 15,2049,2235,24332,25284,82,3.6,232,10.1,2265,301,1964,1.2,9,4169,1211,2958,4.8,16.5,-1904,-7.5,18,0,153,153,538
2010,10,i) 16 to 20,1474,1650,21076,21429,59,3.5,140,8.3,2166,523,1643,2.4,10.1,2872,810,2062,3.8,13.4,-706,-3.3,20.2,0,92,92,278
2010,10,j) 21 to 25,1305,1570,21490,21861,38,2.4,96,6,1826,605,1221,2.8,8.4,2567,652,1915,3,11.7,-741,-3.3,16.8,0,48,48,366
2010,10,k) 26+,1444,2008,43879,44466,78,3.8,122,6,3460,883,2577,2,7.8,4634,1192,3442,2.7,10.4,-1174,-2.6,15.6,0,53,53,319
2010,10,l) Left Censored,2529,5602,178913,183258,286,5.1,411,7.3,13492,3363,10129,1.8,7.4,22182,5629,16553,3.1,12.1,-8690,-4.7,14.8,0,48,48,407
2010,11,a) 0,957,973,7314,3672,959,197.1,0,0,7285,7285,0,198.4,198.4,0,0,0,0,0,7285,198.4,0,0,,,
2010,11,b) 1,712,712,5684,5920,0,0,179,22.2,1474,0,1474,0,24.9,1946,665,1281,11.2,32.9,-472,-8,49.8,0,135,135,539
2010,11,c) 2,663,672,6634,6687,25,3.5,124,17.2,1160,369,791,5.5,17.3,1266,639,627,9.6,18.9,-106,-1.6,34.6,0,94,94,420
2010,11,d) 3,669,677,6170,6180,28,3.9,98,13.8,1062,99,963,1.6,17.2,1081,481,600,7.8,17.5,-19,-0.3,34.4,0,71,71,277
2010,11,e) 4,652,670,6554,6704,25,3.6,84,12.1,1054,94,960,1.4,15.7,1353,484,869,7.2,20.2,-299,-4.5,31.4,0,62,63,402
2010,11,f) 5,806,826,7920,8247,29,3.4,83,9.8,977,147,830,1.8,11.8,1630,678,952,8.2,19.8,-653,-8,23.6,0,65,65,638
2010,11,g) 6 to 10,2119,2212,32251,32910,64,2.8,202,8.9,3709,543,3166,1.6,11.3,5027,1291,3736,3.9,15.3,-1318,-4,22.6,0,147,147,1054
2010,11,h) 11 to 15,1863,2049,37440,37854,87,4.2,148,7.1,4468,1636,2832,4.3,11.8,5295,1120,4175,3,14,-827,-2.2,23.6,0,99,99,716
2010,11,i) 16 to 20,1364,1527,30706,31197,68,4.4,96,6.2,3016,741,2275,2.4,9.7,3997,576,3421,1.8,12.8,-981,-3.1,19.4,0,63,63,213
2010,11,j) 21 to 25,1215,1427,27497,27285,74,5.2,82,5.7,2958,685,2273,2.5,10.8,2533,503,2030,1.8,9.3,425,1.5,18.6,0,54,54,194
2010,11,k) 26+,1736,2298,82141,81267,155,6.8,143,6.3,9424,1284,8140,1.6,11.6,7675,1648,6027,2,9.4,1749,2.2,18.8,0,53,53,296
2010,11,l) Left Censored,2854,5912,227340,229150,461,7.8,423,7.2,21320,6761,14559,3,9.3,24939,5624,19315,2.5,10.9,-3619,-1.6,18.6,0,59,59,1155
2010,12,a) 0,34135,34545,206025,104135,33805,195.7,0,0,203781,203781,0,195.7,195.7,0,0,0,0,0,203781,195.7,0,0,,,
2010,12,b) 1,24534,24768,172607,177546,51,0.2,8895,30.2,47901,1348,46553,0.8,27,57778,35082,22696,19.8,32.5,-9877,-5.5,54,0,6996,6996,30265
2010,12,c) 2,23162,23454,149564,156302,1151,4.5,5949,23.1,33161,4369,28792,2.8,21.2,46636,26709,19927,17.1,29.8,-13475,-8.6,42.4,0,4662,4662,23142
2010,12,d) 3,21143,21598,148970,161865,1099,4.7,4728,20.3,21016,3978,17038,2.5,13,46806,19304,27502,11.9,28.9,-25790,-15.9,26,0,3596,3596,16344
2010,12,e) 4,20198,20743,138050,150622,1147,5.2,4000,18.1,25134,4859,20275,3.2,16.7,50277,24211,26066,16.1,33.4,-25143,-16.7,33.4,0,2987,2987,20556
2010,12,f) 5,18280,18936,156159,160490,915,4.5,3653,18.1,23608,4746,18862,3,14.7,32270,13961,18309,8.7,20.1,-8662,-5.4,29.4,0,2645,2646,10882
2010,12,g) 6 to 10,65347,68213,580801,604264,2873,4,9760,13.7,88786,20669,68117,3.4,14.7,135711,50233,85478,8.3,22.5,-46925,-7.8,29.4,0,6909,6920,38412
2010,12,h) 11 to 15,40806,44453,543477,561938,1776,3.9,4838,10.5,66804,27874,38930,5,11.9,103725,27261,76464,4.9,18.5,-36921,-6.6,23.8,0,3195,3197,18106
2010,12,i) 16 to 20,29000,33129,452794,464572,1171,3.4,3074,9,60890,14202,46688,3.1,13.1,84445,31410,53035,6.8,18.2,-23555,-5.1,26.2,0,2002,2010,14313
2010,12,j) 21 to 25,21482,27867,549902,547427,1105,3.9,2057,7.3,73451,12995,60456,2.4,13.4,68501,16861,51640,3.1,12.5,4950,0.9,25,0,1281,1291,9475
2010,12,k) 26+,21193,34059,710985,724213,1369,4,2061,6,74331,23906,50425,3.3,10.3,100786,29176,71610,4,13.9,-26455,-3.6,20.6,0,1011,1016,9632
2010,12,l) Left Censored,17830,71940,2606901,2620173,4164,5.8,4654,6.5,259508,75893,183615,2.9,9.9,286052,64692,221360,2.5,10.9,-26544,-1,19.8,0,647,675,7774
2010,13,a) 0,12215,12333,69191,35145,12095,196.1,0,0,68092,68092,0,193.7,193.7,0,0,0,0,0,68092,193.7,0,0,,,
2010,13,b) 1,9484,9842,69536,74042,249,2.2,3346,29.1,16640,1452,15188,2,22.5,25651,14762,10889,19.9,34.6,-9011,-12.1,45,0,2663,2663,12915
2010,13,c) 2,9672,9851,64402,70886,392,3.6,2389,22.1,10821,1557,9264,2.2,15.3,23789,15013,8776,21.2,33.6,-12968,-18.3,30.6,0,1849,1849,12938
2010,13,d) 3,8947,9122,63505,74872,413,4.2,1887,19.2,11324,1951,9373,2.6,15.1,34058,10011,24047,13.4,45.5,-22734,-30.4,30.2,0,1424,1424,8031
2010,13,e) 4,8135,8488,70215,74882,335,3.7,1601,17.6,9698,1642,8056,2.2,13,19032,8735,10297,11.7,25.4,-9334,-12.4,26,0,1207,1207,7089
2010,13,f) 5,7334,7804,72168,74936,433,5.3,1216,14.9,9878,2540,7338,3.4,13.2,15414,6581,8833,8.8,20.6,-5536,-7.4,26.4,0,923,923,5860
2010,13,g) 6 to 10,27481,29083,328403,329421,1004,3.3,3738,12.3,53536,8564,44972,2.6,16.3,55571,18566,37005,5.6,16.9,-2035,-0.6,32.6,0,2658,2658,14090
2010,13,h) 11 to 15,19145,21154,250322,258504,720,3.3,2210,10.1,28447,6025,22422,2.3,11,44812,13948,30864,5.4,17.3,-16365,-6.3,22,0,1451,1451,10094
2010,13,i) 16 to 20,12472,14682,219145,222045,474,3.2,1210,8,25727,5307,20420,2.4,11.6,31527,7377,24150,3.3,14.2,-5800,-2.6,23.2,0,789,791,4797
2010,13,j) 21 to 25,9637,12740,256957,263948,449,3.5,845,6.5,22836,7040,15796,2.7,8.7,36818,8617,28201,3.3,13.9,-13982,-5.2,17.4,0,525,527,5449
2010,13,k) 26+,10879,17060,381146,385812,609,3.5,1029,6,39215,9594,29621,2.5,10.2,48547,10456,38091,2.7,12.6,-9332,-2.4,20.4,0,465,474,3457
2010,13,l) Left Censored,11817,40583,1463642,1480583,1956,4.8,2518,6.2,128880,49971,78909,3.4,8.7,162761,38311,124450,2.6,11,-33881,-2.3,17.4,0,358,382,6001
2010,15,a) 0,1368,1381,10523,5283,1366,197.8,0,0,10481,,,,198.4,0,0,0,0,0,10481,198.4,0,1,,,
2010,15,b) 1,1131,1147,11394,9863,8,0.6,367,27.4,5472,,,,55.5,2410,1493,917,15.1,24.4,3062,31.1,48.8,1,284,284,1264
2010,15,c) 2,1101,1130,7542,8016,51,4.2,252,20.5,1298,244,1054,3,16.2,2245,873,1372,10.9,28,-947,-11.8,32.4,0,199,199,753
2010,15,d) 3,1157,1165,9350,9489,56,4.6,176,14.4,1707,533,1174,5.6,18,1984,930,1054,9.8,20.9,-277,-2.9,36,0,140,140,788
2010,15,e) 4,1043,1112,9621,10377,48,4.1,176,15,1116,171,945,1.6,10.8,2628,1287,1341,12.4,25.3,-1512,-14.5,21.6,0,129,129,791
2010,15,f) 5,936,958,9930,10257,33,3.3,155,15.3,1247,231,1016,2.3,12.2,1901,660,1241,6.4,18.5,-654,-6.3,24.4,0,114,114,522
2010,15,g) 6 to 10,3824,4114,40430,41713,117,2.7,448,10.5,4740,967,3773,2.3,11.4,7305,2628,4677,6.3,17.5,-2565,-6.1,22.8,0,317,317,2093
2010,15,h) 11 to 15,2758,2979,31460,31929,80,2.6,247,8.1,3854,448,3406,1.4,12.1,4792,1211,3581,3.8,15,-938,-2.9,24.2,0,155,155,852
2010,15,i) 16 to 20,2134,2487,37043,37795,73,2.9,158,6.2,3312,673,2639,1.8,8.8,4815,919,3896,2.4,12.7,-1503,-3.9,17.6,0,107,108,733
2010,15,j) 21 to 25,1920,2354,39497,41105,70,2.9,150,6.3,2796,738,2058,1.8,6.8,6012,2198,3814,5.3,14.6,-3216,-7.8,13.6,0,103,103,1932
2010,15,k) 26+,2504,3563,61370,62874,108,3,199,5.5,4536,989,3547,1.6,7.2,7544,1636,5908,2.6,12,-3008,-4.8,14.4,0,102,102,1037
2010,15,l) Left Censored,2941,6833,206994,211111,319,4.6,376,5.5,15511,4292,11219,2,7.3,23745,6193,17552,2.9,11.2,-8234,-3.9,14.6,0,57,57,411
2010,16,a) 0,2274,2303,11608,5843,2263,196.5,0,0,11530,,,,197.3,0,0,0,0,0,11530,197.3,0,1,,,
2010,16,b) 1,1817,1830,14834,14642,3,0.1,727,32.8,4705,,,,32.1,4321,2717,1604,18.6,29.5,384,2.6,59,1,542,542,2238
2010,16,c) 2,2059,2076,11553,11860,127,5.7,479,21.3,2492,365,2127,3.1,21,3106,1448,1658,12.2,26.2,-614,-5.2,42,0,353,353,1088
2010,16,d) 3,2030,2050,12962,13407,122,5.5,494,22.1,2042,421,1621,3.1,15.2,2932,1542,1390,11.5,21.9,-890,-6.7,30.4,0,346,346,1223
2010,16,e) 4,2022,2089,14058,14266,128,5.7,434,19.4,2450,363,2087,2.5,17.2,2866,1496,1370,10.5,20.1,-416,-2.9,34.4,0,292,292,1054
2010,16,f) 5,1712,1757,12778,13437,107,5.8,310,16.8,1665,432,1233,3.2,12.4,2982,995,1987,7.4,22.2,-1317,-9.8,24.8,0,219,219,725
2010,16,g) 6 to 10,5929,6268,60029,61626,292,4.5,838,12.8,6893,1146,5747,1.9,11.2,10087,3630,6457,5.9,16.4,-3194,-5.2,22.4,0,556,556,2709
2010,16,h) 11 to 15,4235,4524,43288,44494,157,3.4,443,9.5,4490,710,3780,1.6,10.1,6902,1980,4922,4.5,15.5,-2412,-5.4,20.2,0,252,258,1204
2010,16,i) 16 to 20,2817,3090,28904,30084,161,5.1,284,9,2929,604,2325,2,9.7,5288,1603,3685,5.3,17.6,-2359,-7.9,19.4,0,151,151,917
2010,16,j) 21 to 25,1806,2261,35799,36838,84,3.7,114,5,3662,806,2856,2.2,9.9,5739,705,5034,1.9,15.6,-2077,-5.7,19.8,0,67,67,467
2010,16,k) 26+,2261,3306,63370,66181,113,3.4,199,5.9,6332,2268,4064,3.4,9.6,11954,1572,10382,2.4,18.1,-5622,-8.5,19.2,0,79,84,723
2010,16,l) Left Censored,2712,6773,179336,181425,291,4.3,302,4.5,15072,2767,12305,1.5,8.3,19250,3816,15434,2.1,10.6,-4178,-2.3,16.6,0,62,62,808
2010,17,a) 0,15412,15682,95316,48029,15389,196.3,0,0,94574,94574,0,196.9,196.9,0,0,0,0,0,94574,196.9,0,0,,,
2010,17,b) 1,11986,12126,77688,82933,43,0.3,3981,27.9,17528,357,17171,0.4,21.1,28018,17053,10965,20.6,33.8,-10490,-12.7,42.2,0,2758,2758,13625
2010,17,c) 2,12048,12260,83547,87731,559,4.2,2485,18.8,13251,2272,10979,2.6,15.1,21620,10682,10938,12.2,24.6,-8369,-9.5,30.2,0,1808,1808,8823
2010,17,d) 3,10825,10969,80422,83368,475,4.1,1927,16.5,12645,1833,10812,2.2,15.2,18536,8481,10055,10.2,22.2,-5891,-7,30.4,0,1367,1367,6781
2010,17,e) 4,10469,10982,86553,93524,498,4.3,1698,14.7,12004,2259,9745,2.4,12.8,25945,10792,15153,11.5,27.7,-13941,-14.9,25.6,0,1170,1170,9486
2010,17,f) 5,9491,9777,86214,91319,336,3.3,1432,13.9,10445,1189,9256,1.3,11.4,20654,6564,14090,7.2,22.6,-10209,-11.2,22.8,0,964,965,4949
2010,17,g) 6 to 10,36498,38579,396368,407128,1351,3.4,4470,11.2,46465,7927,38538,1.9,11.4,67986,23746,44240,5.8,16.7,-21521,-5.3,22.8,0,2911,2926,17460
2010,17,h) 11 to 15,28002,30455,362212,371508,1081,3.4,2964,9.5,43588,7708,35880,2.1,11.7,62179,19536,42643,5.3,16.7,-18591,-5,23.4,0,1774,1774,13795
2010,17,i) 16 to 20,21780,24269,312142,319267,825,3.3,1931,7.8,32327,5720,26607,1.8,10.1,46576,11438,35138,3.6,14.6,-14249,-4.5,20.2,0,1117,1118,7083
2010,17,j) 21 to 25,17064,21042,392716,404270,733,3.4,1377,6.4,36663,12466,24197,3.1,9.1,59771,18170,41601,4.5,14.8,-23108,-5.7,18.2,0,810,811,6521
2010,17,k) 26+,20153,28920,680731,685673,907,3.1,1590,5.4,62888,17001,45887,2.5,9.2,72772,15051,57721,2.2,10.6,-9884,-1.4,18.4,0,779,796,6169
2010,17,l) Left Censored,25926,63567,2302492,2347557,2729,4.3,3398,5.3,169539,43965,125574,1.9,7.2,259669,53790,205879,2.3,11.1,-90130,-3.9,14.4,0,815,831,11548
2010,18,a) 0,6031,6145,43060,21773,6052,197,0,0,42574,42574,0,195.5,195.5,0,0,0,0,0,42574,195.5,0,0,,,
2010,18,b) 1,4877,4963,35378,38218,20,0.3,1459,25.4,8432,208,8224,0.5,22.1,14112,8794,5318,23,36.9,-5680,-14.8,44.2,0,1113,1113,7762
2010,18,c) 2,5210,5338,40461,43071,180,3.1,1102,19.1,7221,845,6376,2,16.8,12440,7363,5077,17.1,28.9,-5219,-12.1,33.6,0,842,842,6460
2010,18,d) 3,4755,4890,38185,40417,200,3.8,824,15.9,5666,894,4772,2.2,14,10130,5682,4448,14.1,25.1,-4464,-11.1,28,0,607,607,5042
2010,18,e) 4,4675,4983,43967,45577,179,3.4,707,13.5,5259,597,4662,1.3,11.5,8478,3555,4923,7.8,18.6,-3219,-7.1,23,0,505,505,2958
2010,18,f) 5,4008,4155,36794,38282,144,3.3,629,14.3,5341,647,4694,1.7,14,8317,3847,4470,10,21.7,-2976,-7.7,28,0,456,456,3176
2010,18,g) 6 to 10,16050,16985,165791,170848,550,3.1,1785,10.2,20000,3059,16941,1.8,11.7,30113,9412,20701,5.5,17.6,-10113,-5.9,23.4,0,1250,1250,7692
2010,18,h) 11 to 15,12584,13940,162108,165893,441,3.1,1253,8.8,19218,2667,16551,1.6,11.6,26787,8868,17919,5.3,16.1,-7569,-4.5,23.2,0,826,826,6474
2010,18,i) 16 to 20,9981,11302,140853,146681,370,3.2,905,7.8,13416,2882,10534,2,9.1,25072,6448,18624,4.4,17.1,-11656,-8,18.2,0,548,548,4053
2010,18,j) 21 to 25,7974,10510,191896,193925,266,2.5,638,6,19186,3208,15978,1.7,9.9,23244,5703,17541,2.9,12,-4058,-2.1,19.8,0,395,395,2416
2010,18,k) 26+,9984,14906,301891,307820,466,3.1,686,4.6,27124,5990,21134,1.9,8.8,38981,6057,32924,2,12.7,-11857,-3.9,17.6,0,370,370,2590
2010,18,l) Left Censored,13008,34313,1188262,1198686,1219,3.5,1474,4.3,97769,19371,78398,1.6,8.2,118616,20912,97704,1.7,9.9,-20847,-1.7,16.4,0,426,441,4353
2010,19,a) 0,3328,3353,19449,9816,3271,195.1,0,0,19267,19267,0,196.3,196.3,0,0,0,0,0,19267,196.3,0,0,,,
2010,19,b) 1,2751,2813,19531,20143,12,0.4,721,22.6,4678,164,4514,0.8,23.2,5902,3024,2878,15,29.3,-1224,-6.1,46.4,0,521,521,2553
2010,19,c) 2,2812,2858,18846,19638,114,3.7,533,17.4,3382,480,2902,2.4,17.2,4965,2037,2928,10.4,25.3,-1583,-8.1,34.4,0,404,404,1725
2010,19,d) 3,2599,2632,18769,19700,105,3.8,428,15.4,2850,714,2136,3.6,14.5,4711,1736,2975,8.8,23.9,-1861,-9.4,29,0,311,311,1439
2010,19,e) 4,2693,2939,22667,23539,102,3.3,394,12.8,2806,433,2373,1.8,11.9,4550,1738,2812,7.4,19.3,-1744,-7.4,23.8,0,277,277,1406
2010,19,f) 5,2337,2395,18530,19555,85,3.4,297,11.9,2286,411,1875,2.1,11.7,4335,1816,2519,9.3,22.2,-2049,-10.5,23.4,0,197,198,1465
2010,19,g) 6 to 10,9221,9782,90733,93169,331,3.3,973,9.6,11147,1361,9786,1.5,12,16019,4445,11574,4.8,17.2,-4872,-5.2,24,0,606,606,3063
2010,19,h) 11 to 15,7488,8158,85849,85838,275,3.3,666,8,13489,1394,12095,1.6,15.7,13466,3567,9899,4.2,15.7,23,0,31.4,0,407,407,2127
2010,19,i) 16 to 20,5814,6334,60675,64566,248,3.8,526,8.1,6493,1273,5220,2,10.1,14274,8025,6249,12.4,22.1,-7781,-12,20.2,0,322,322,6911
2010,19,j) 21 to 25,4185,5306,102970,105162,125,2.3,273,5.1,6966,1504,5462,1.4,6.6,11350,2216,9134,2.1,10.8,-4384,-4.2,13.2,0,168,168,1300
2010,19,k) 26+,6261,9548,151986,154450,235,2.4,388,4,12334,2978,9356,1.9,8,17262,2933,14329,1.9,11.2,-4928,-3.2,16,0,200,200,1311
2010,19,l) Left Censored,8914,19324,642798,648726,713,3.7,667,3.5,44330,8268,36062,1.3,6.8,56186,8984,47202,1.4,8.7,-11856,-1.9,13.6,0,224,229,2256
2010,20,a) 0,3323,3343,19093,9642,3275,195.9,0,0,18902,18902,0,196,196,0,0,0,0,0,18902,196,0,0,,,
2010,20,b) 1,2717,2743,17763,19188,5,0.2,809,25.4,3804,18,3786,0.1,19.8,6653,4138,2515,21.6,34.7,-2849,-14.9,39.6,0,606,606,3608
2010,20,c) 2,2722,2770,17528,18935,101,3.4,552,18.5,2700,345,2355,1.8,14.3,5514,2842,2672,15,29.1,-2814,-14.8,28.6,0,435,435,2512
2010,20,d) 3,2594,2622,18705,19555,92,3.3,481,17.1,2823,455,2368,2.3,14.4,4523,2299,2224,11.8,23.1,-1700,-8.7,28.8,0,364,370,1686
2010,20,e) 4,2573,2723,20571,21240,116,4.1,349,12.3,2621,457,2164,2.2,12.3,3959,1457,2502,6.9,18.6,-1338,-6.3,24.6,0,268,268,1169
2010,20,f) 5,2259,2323,21133,21428,81,3.3,327,13.4,2863,221,2642,1,13.4,3452,1442,2010,6.7,16.1,-589,-2.7,26.8,0,235,235,1181
2010,20,g) 6 to 10,9147,9541,99262,102889,297,3,1040,10.5,10940,2675,8265,2.6,10.6,18193,4602,13591,4.5,17.7,-7253,-7.1,21.2,0,745,745,3529
2010,20,h) 11 to 15,6989,7578,83705,85726,235,3,663,8.5,7856,1219,6637,1.4,9.2,11897,3491,8406,4.1,13.9,-4041,-4.7,18.4,0,404,404,2302
2010,20,i) 16 to 20,5293,5902,76417,78151,214,3.6,412,6.9,7639,1387,6252,1.8,9.8,11107,3441,7666,4.4,14.2,-3468,-4.4,19.6,0,271,272,2371
2010,20,j) 21 to 25,3891,4880,73929,75453,130,2.6,281,5.7,6430,1048,5382,1.4,8.5,9477,2668,6809,3.5,12.6,-3047,-4.1,17,0,178,178,1268
2010,20,k) 26+,5534,8029,144087,147045,247,3.1,350,4.3,12526,2829,9697,1.9,8.5,18441,2222,16219,1.5,12.5,-5915,-4,17,0,196,196,934
2010,20,l) Left Censored,7340,16691,513658,520191,668,4,697,4.2,42475,10944,31531,2.1,8.2,55540,12865,42675,2.5,10.7,-13065,-2.5,16.4,0,171,176,1596
2010,21,a) 0,4041,4114,28714,14453,4058,197.3,0,0,28523,28523,0,197.4,197.4,0,0,0,0,0,28523,197.4,0,0,,,
2010,21,b) 1,3168,3197,21818,23445,10,0.3,965,26.1,4932,221,4711,0.9,21,8185,5158,3027,22,34.9,-3253,-13.9,42,0,773,773,4259
2010,21,c) 2,3207,3326,24480,26534,124,3.5,670,18.7,3828,640,3188,2.4,14.4,7936,4923,3013,18.6,29.9,-4108,-15.5,28.8,0,524,524,4364
2010,21,d) 3,3001,3055,22708,23854,99,3,515,15.8,3349,297,3052,1.2,14,5640,2886,2754,12.1,23.6,-2291,-9.6,28,0,410,410,2572
2010,21,e) 4,2862,3019,25403,26388,92,2.9,468,14.6,3461,528,2933,2,13.1,5430,2419,3011,9.2,20.6,-1969,-7.5,26.2,0,349,349,1943
2010,21,f) 5,2610,2703,23009,24540,63,2.2,390,13.6,2627,298,2329,1.2,10.7,5688,2495,3193,10.2,23.2,-3061,-12.5,21.4,0,296,296,1988
2010,21,g) 6 to 10,10250,10824,103667,107411,327,2.9,1161,10.3,12298,2260,10038,2.1,11.4,19786,7546,12240,7,18.4,-7488,-7,22.8,0,855,855,5479
2010,21,h) 11 to 15,8078,9053,105575,107926,254,2.7,810,8.7,11559,1600,9959,1.5,10.7,16261,5252,11009,4.9,15.1,-4702,-4.4,21.4,0,530,530,3491
2010,21,i) 16 to 20,6099,7037,83819,85830,237,3.3,551,7.7,9718,1992,7726,2.3,11.3,13740,3281,10459,3.8,16,-4022,-4.7,22.6,0,338,338,2156
2010,21,j) 21 to 25,5040,6457,121590,123435,171,2.6,412,6.3,11058,2186,8872,1.8,9,14748,2786,11962,2.3,11.9,-3690,-2.9,18,0,229,229,1441
2010,21,k) 26+,6162,9385,188362,189722,422,4.5,489,5.2,18724,4295,14429,2.3,9.9,21444,4904,16540,2.6,11.3,-2720,-1.4,19.8,0,238,246,1875
2010,21,l) Left Censored,7811,20810,699665,705384,814,3.9,911,4.4,61227,20154,41073,2.9,8.7,72665,11072,61593,1.6,10.3,-11438,-1.6,17.4,0,218,219,2456
2010,22,a) 0,5084,5211,35903,18100,5115,196.3,0,0,35606,35606,0,196.7,196.7,0,0,0,0,0,35606,196.7,0,0,,,
2010,22,b) 1,4068,4149,32552,35139,7,0.1,1247,25.9,7388,94,7294,0.3,21,12561,5880,6681,16.7,35.7,-5173,-14.7,42,0,1009,1009,4991
2010,22,c) 2,4117,4254,36580,37768,134,2.9,822,17.9,6592,674,5918,1.8,17.5,8967,3963,5004,10.5,23.7,-2375,-6.2,35,0,653,653,3302
2010,22,d) 3,3930,3981,36668,38072,126,3,675,15.9,6065,1170,4895,3.1,15.9,8873,3862,5011,10.1,23.3,-2808,-7.4,31.8,0,525,527,3226
2010,22,e) 4,3347,3641,35582,37215,114,3,505,13.2,4676,760,3916,2,12.6,7941,2777,5164,7.5,21.3,-3265,-8.7,25.2,0,401,401,2335
2010,22,f) 5,3040,3143,33895,34769,111,3.4,382,11.7,4614,627,3987,1.8,13.3,6361,1846,4515,5.3,18.3,-1747,-5,26.6,0,289,289,1484
2010,22,g) 6 to 10,12283,13090,156286,162528,377,2.8,1245,9.2,17435,2939,14496,1.8,10.7,29919,10724,19195,6.6,18.4,-12484,-7.7,21.4,0,888,888,9076
2010,22,h) 11 to 15,9330,10094,121550,125144,237,2.3,785,7.6,11909,1859,10050,1.5,9.5,19096,4930,14166,3.9,15.3,-7187,-5.8,19,0,543,543,3616
2010,22,i) 16 to 20,7016,7976,114672,118060,243,3,481,6,10663,2108,8555,1.8,9,17439,2844,14595,2.4,14.8,-6776,-5.8,18,0,316,316,1950
2010,22,j) 21 to 25,5294,6769,134970,137461,191,2.8,386,5.6,12802,5175,7627,3.8,9.3,17783,3749,14034,2.7,12.9,-4981,-3.6,18.6,0,205,205,1570
2010,22,k) 26+,7872,11184,206899,212521,320,2.8,514,4.6,17645,4032,13613,1.9,8.3,28888,5109,23779,2.4,13.6,-11243,-5.3,16.6,0,301,307,2558
2010,22,l) Left Censored,8240,21692,638085,644468,944,4.4,905,4.2,52024,12869,39155,2,8.1,64790,10298,54492,1.6,10.1,-12766,-2,16.2,0,230,236,1648
2010,23,a) 0,1714,1756,9132,4606,1722,196.1,0,0,9052,,,,196.5,0,0,0,0,0,9052,196.5,0,1,,,
2010,23,b) 1,1359,1379,8416,8644,5,0.3,423,26.4,1800,,,,20.8,2256,1324,932,15.3,26.1,-456,-5.3,41.6,1,279,279,985
2010,23,c) 2,1501,1519,8058,8287,75,4.6,299,18.4,1466,325,1141,3.9,17.7,1924,934,990,11.3,23.2,-458,-5.5,35.4,0,212,212,666
2010,23,d) 3,1439,1451,9276,9439,92,6.1,220,14.6,1382,223,1159,2.4,14.6,1707,774,933,8.2,18.1,-325,-3.5,29.2,0,155,155,644
2010,23,e) 4,1444,1533,9873,10140,68,4.3,204,12.8,1370,274,1096,2.7,13.5,1904,678,1226,6.7,18.8,-534,-5.3,27,0,132,132,494
2010,23,f) 5,1215,1228,7780,8260,54,4.2,162,12.7,948,213,735,2.6,11.5,1908,594,1314,7.2,23.1,-960,-11.6,23,0,118,118,494
2010,23,g) 6 to 10,4917,5136,38768,39235,201,3.8,555,10.5,4794,1074,3720,2.7,12.2,5727,1853,3874,4.7,14.6,-933,-2.4,24.4,0,364,364,1399
2010,23,h) 11 to 15,3937,4206,37879,38557,145,3.4,364,8.5,3726,531,3195,1.4,9.7,5082,1692,3390,4.4,13.2,-1356,-3.5,19.4,0,226,226,1339
2010,23,i) 16 to 20,2613,2915,29537,29986,108,3.6,205,6.9,3043,794,2249,2.6,10.1,3941,1066,2875,3.6,13.1,-898,-3,20.2,0,128,128,751
2010,23,j) 21 to 25,2555,3151,46373,46720,106,3.3,183,5.7,4042,872,3170,1.9,8.7,4735,1020,3715,2.2,10.1,-693,-1.4,17.4,0,105,105,687
2010,23,k) 26+,2585,3844,64956,66643,150,3.9,209,5.4,6337,1911,4426,2.9,9.5,9710,2514,7196,3.8,14.6,-3373,-5.1,19,0,104,104,994
2010,23,l) Left Censored,3157,6978,201999,205061,336,4.8,384,5.5,13786,4410,9376,2.2,6.7,19910,4940,14970,2.4,9.7,-6124,-3,13.4,0,88,88,904
2010,24,a) 0,6171,6346,37162,18736,6202,195.5,0,0,36853,36853,0,196.7,196.7,0,0,0,0,0,36853,196.7,0,0,,,
2010,24,b) 1,5040,5114,36542,37347,13,0.2,1498,25.3,8783,158,8625,0.4,23.5,10392,5619,4773,15,27.8,-1609,-4.3,47,0,1122,1122,4461
2010,24,c) 2,5041,5258,37801,39048,221,3.9,1050,18.6,7583,1201,6382,3.1,19.4,10076,3725,6351,9.5,25.8,-2493,-6.4,38.8,0,788,788,3111
2010,24,d) 3,4786,4868,36435,37788,199,3.8,861,16.6,6034,936,5098,2.5,16,8739,4321,4418,11.4,23.1,-2705,-7.1,32,0,636,636,3780
2010,24,e) 4,4821,5050,39262,41438,205,3.8,805,15.1,5305,819,4486,2,12.8,9656,4332,5324,10.5,23.3,-4351,-10.5,25.6,0,582,582,3705
2010,24,f) 5,4481,4612,38277,39143,187,3.9,601,12.5,5887,931,4956,2.4,15,7618,2568,5050,6.6,19.5,-1731,-4.5,30,0,454,454,2170
2010,24,g) 6 to 10,17069,17795,180182,184711,664,3.6,2049,11.1,23535,3833,19702,2.1,12.7,32592,10075,22517,5.5,17.6,-9057,-4.9,25.4,0,1411,1415,7406
2010,24,h) 11 to 15,12690,13842,169663,175297,474,3.3,1235,8.7,16138,3175,12963,1.8,9.2,27405,7266,20139,4.1,15.6,-11267,-6.4,18.4,0,772,785,5125
2010,24,i) 16 to 20,9215,10412,149240,152598,330,3.1,799,7.5,14335,2611,11724,1.7,9.4,21050,5734,15316,3.8,13.8,-6715,-4.4,18.8,0,474,474,4032
2010,24,j) 21 to 25,7792,9329,182260,182774,316,3.3,671,7.1,19005,4767,14238,2.6,10.4,20033,4230,15803,2.3,11,-1028,-0.6,20.8,0,376,376,2693
2010,24,k) 26+,7935,11587,245301,247185,435,3.7,631,5.4,25032,6648,18384,2.7,10.1,28800,5800,23000,2.3,11.7,-3768,-1.6,20.2,0,318,327,2213
2010,24,l) Left Censored,9655,25923,916891,934372,1341,5.1,1713,6.6,78016,21213,56803,2.3,8.3,112978,25539,87439,2.7,12.1,-34962,-3.8,16.6,0,269,270,2480
2010,25,a) 0,7555,7636,42719,21489,7507,196.6,0,0,42461,42461,0,197.6,197.6,0,0,0,0,0,42461,197.6,0,0,,,
2010,25,b) 1,5788,5837,36528,38406,21,0.3,1724,25.5,8240,622,7618,1.6,21.5,11996,6666,5330,17.4,31.2,-3756,-9.7,43,0,1234,1234,5603
2010,25,c) 2,5872,5954,37962,40427,241,3.8,1136,17.8,7213,1478,5735,3.7,17.8,12143,4679,7464,11.6,30,-4930,-12.2,35.6,0,827,828,3966
2010,25,d) 3,5423,5472,40650,42132,218,3.7,994,17,5962,828,5134,2,14.2,8926,4048,4878,9.6,21.2,-2964,-7,28.4,0,712,712,3300
2010,25,e) 4,5689,5881,43379,44603,293,4.8,882,14.3,6263,985,5278,2.2,14,8711,4071,4640,9.1,19.5,-2448,-5.5,28,0,649,650,3255
2010,25,f) 5,5050,5141,44772,45530,194,3.6,688,12.8,6598,658,5940,1.4,14.5,8113,3310,4803,7.3,17.8,-1515,-3.3,29,0,493,494,2315
2010,25,g) 6 to 10,19940,20869,220553,225677,729,3.4,2312,10.7,24928,3752,21176,1.7,11,35175,11284,23891,5,15.6,-10247,-4.6,22,0,1520,1520,8243
2010,25,h) 11 to 15,15551,16545,196206,199294,520,3.1,1446,8.5,21877,3728,18149,1.9,11,28052,8738,19314,4.4,14.1,-6175,-3.1,22,0,936,945,6149
2010,25,i) 16 to 20,11036,12285,168730,171758,370,3,865,6.9,17530,4717,12813,2.7,10.2,23585,5622,17963,3.3,13.7,-6055,-3.5,20.4,0,581,582,4075
2010,25,j) 21 to 25,10977,13227,245633,248174,459,3.4,835,6.2,21992,6468,15524,2.6,8.9,27074,4826,22248,1.9,10.9,-5082,-2,17.8,0,495,495,3043
2010,25,k) 26+,11374,17094,459238,458878,671,3.9,942,5.5,47123,9958,37165,2.2,10.3,46402,10030,36372,2.2,10.1,721,0.2,20.2,0,470,489,3024
2010,25,l) Left Censored,16002,35909,1370495,1383701,1601,4.4,1790,5,122989,34820,88169,2.5,8.9,149401,29520,119881,2.1,10.8,-26412,-1.9,17.8,0,517,517,9231
2010,26,a) 0,9451,9542,61894,31206,9352,196,0,0,61376,61376,0,196.7,196.7,0,0,0,0,0,61376,196.7,0,0,,,
2010,26,b) 1,7690,7768,66058,68190,18,0.2,2434,26.8,18888,223,18665,0.3,27.7,23151,11628,11523,17.1,34,-4263,-6.3,55.4,0,1794,1794,9533
2010,26,c) 2,7637,7789,63014,66356,320,3.8,1635,19.4,10693,1576,9117,2.4,16.1,17377,8653,8724,13,26.2,-6684,-10.1,32.2,0,1201,1201,7594
2010,26,d) 3,6978,7088,79649,80886,280,3.7,1278,16.9,12521,1193,11328,1.5,15.5,14994,6310,8684,7.8,18.5,-2473,-3,31,0,915,915,5321
2010,26,e) 4,6868,7060,61756,65069,334,4.5,1142,15.3,10170,1895,8275,2.9,15.6,16796,8203,8593,12.6,25.8,-6626,-10.2,31.2,0,852,852,7253
2010,26,f) 5,6154,6322,60807,63268,215,3.2,898,13.5,9800,778,9022,1.2,15.5,14722,5709,9013,9,23.3,-4922,-7.8,31,0,660,660,4841
2010,26,g) 6 to 10,24219,25651,256639,268701,928,3.5,3226,12.1,30680,5506,25174,2,11.4,54804,19398,35406,7.2,20.4,-24124,-9,22.8,0,2206,2206,15109
2010,26,h) 11 to 15,19818,21399,239154,246241,752,3.4,2215,10,27763,4899,22864,2,11.3,41939,11853,30086,4.8,17,-14176,-5.7,22.6,0,1434,1434,8309
2010,26,i) 16 to 20,15314,17200,205995,211897,641,3.6,1582,9,23918,5075,18843,2.4,11.3,35722,9887,25835,4.7,16.9,-11804,-5.6,22.6,0,936,937,5253
2010,26,j) 21 to 25,12911,16261,255482,262034,532,3.2,1077,6.5,24254,5762,18492,2.2,9.3,37357,8857,28500,3.4,14.3,-13103,-5,18.6,0,632,632,5433
2010,26,k) 26+,15083,21260,383357,389966,585,2.7,1126,5.2,37153,7840,29313,2,9.5,50371,10415,39956,2.7,12.9,-13218,-3.4,19,0,623,628,5297
2010,26,l) Left Censored,18385,46699,1548721,1564526,1504,3.2,2410,5.1,138517,34235,104282,2.2,8.9,170127,39282,130845,2.5,10.9,-31610,-2,17.8,0,669,677,6581
2010,27,a) 0,6455,6618,41556,20929,6491,196.2,0,0,41254,41254,0,197.1,197.1,0,0,0,0,0,41254,197.1,0,0,,,
2010,27,b) 1,5237,5325,37531,41452,26,0.4,1724,27.6,7917,210,7707,0.5,19.1,15759,7962,7797,19.2,38,-7842,-18.9,38.2,0,1171,1171,6480
2010,27,c) 2,5097,5178,38255,39950,245,4.4,1068,19.1,6137,989,5148,2.5,15.4,9526,4149,5377,10.4,23.8,-3389,-8.4,30.8,0,734,734,3391
2010,27,d) 3,4938,5031,42098,43706,251,4.7,845,15.9,6685,837,5848,1.9,15.3,9900,5379,4521,12.3,22.7,-3215,-7.4,30.6,0,588,588,4897
2010,27,e) 4,4913,5277,39453,41010,244,4.4,779,14.1,5288,961,4327,2.3,12.9,8401,3813,4588,9.3,20.5,-3113,-7.6,25.8,0,521,521,3011
2010,27,f) 5,4486,4655,40337,40913,191,3.9,640,13.1,6338,650,5688,1.6,15.5,7490,3054,4436,7.5,18.3,-1152,-2.8,31,0,411,411,2475
2010,27,g) 6 to 10,18266,19245,181932,186680,833,4.2,2190,11,20736,3849,16887,2.1,11.1,30232,10793,19439,5.8,16.2,-9496,-5.1,22.2,0,1340,1340,7907
2010,27,h) 11 to 15,13804,15189,169452,172764,604,3.9,1407,9,18103,3828,14275,2.2,10.5,24727,7134,17593,4.1,14.3,-6624,-3.8,21,0,807,807,5094
2010,27,i) 16 to 20,10354,11811,151492,153587,404,3.4,850,7.1,17256,3109,14147,2,11.2,21446,5122,16324,3.3,14,-4190,-2.8,22.4,0,495,495,3044
2010,27,j) 21 to 25,7624,9528,181795,184881,327,3.4,562,5.8,15782,3551,12231,1.9,8.5,21954,3858,18096,2.1,11.9,-6172,-3.4,17,0,335,335,2228
2010,27,k) 26+,8858,13206,300014,302167,359,2.7,642,4.8,25993,4528,21465,1.5,8.6,30299,6366,23933,2.1,10,-4306,-1.4,17.2,0,305,305,2510
2010,27,l) Left Censored,12039,28419,1137686,1144609,1096,3.9,1189,4.2,101795,32569,69226,2.8,8.9,115641,32281,83360,2.8,10.1,-13846,-1.2,17.8,0,243,244,2783
2010,28,a) 0,2771,2826,18439,9295,2774,196.3,0,0,18288,18288,0,196.8,196.8,0,0,0,0,0,18288,196.8,0,0,,,
2010,28,b) 1,2248,2274,15901,17905,10,0.4,682,25.9,2661,88,2573,0.5,14.9,6669,2700,3969,15.1,37.2,-4008,-22.3,29.8,0,538,538,2258
2010,28,c) 2,2207,2273,15825,16399,77,3.1,482,19.5,3055,427,2628,2.6,18.6,4203,2070,2133,12.6,25.6,-1148,-7,37.2,0,402,402,1841
2010,28,d) 3,2114,2194,13987,14795,82,3.5,399,17.1,2063,498,1565,3.4,13.9,3679,1722,1957,11.6,24.9,-1616,-11,27.8,0,323,323,1383
2010,28,e) 4,1929,2053,19594,20061,76,3.5,325,15,3117,686,2431,3.4,15.5,4050,1926,2124,9.6,20.2,-933,-4.7,31,0,267,267,1599
2010,28,f) 5,1726,1822,16472,17297,123,6.6,250,13.3,2317,482,1835,2.8,13.4,3966,1917,2049,11.1,22.9,-1649,-9.5,26.8,0,201,203,1683
2010,28,g) 6 to 10,7051,7481,72174,74076,225,2.9,788,10.2,8402,1282,7120,1.7,11.3,12206,3920,8286,5.3,16.5,-3804,-5.2,22.6,0,599,599,3118
2010,28,h) 11 to 15,5274,5840,58800,60519,176,2.9,501,8.4,6192,1505,4687,2.5,10.2,9629,2462,7167,4.1,15.9,-3437,-5.7,20.4,0,356,356,1702
2010,28,i) 16 to 20,3874,4361,59112,59694,142,3.2,324,7.3,6616,1037,5579,1.7,11.1,7779,1981,5798,3.3,13,-1163,-1.9,22.2,0,217,217,1060
2010,28,j) 21 to 25,2988,3559,64886,65938,87,2.4,212,5.9,5222,740,4482,1.1,7.9,7325,2126,5199,3.2,11.1,-2103,-3.2,15.8,0,136,136,1039
2010,28,k) 26+,4384,6345,114065,115854,242,3.8,316,5,10848,2684,8164,2.3,9.4,14425,2710,11715,2.3,12.5,-3577,-3.1,18.8,0,176,180,1351
2010,28,l) Left Censored,5196,13952,406045,411682,472,3.4,577,4.1,27740,6947,20793,1.7,6.7,39013,6591,32422,1.6,9.5,-11273,-2.8,13.4,0,149,150,2077
2010,29,a) 0,7820,7906,41347,20808,7798,197.3,0,0,41079,41079,0,197.4,197.4,0,0,0,0,0,41079,197.4,0,0,,,
2010,29,b) 1,5608,5764,41468,43210,80,1.2,1970,29.1,8936,655,8281,1.5,20.7,12420,7290,5130,16.9,28.7,-3484,-8,41.4,0,1562,1562,6222
2010,29,c) 2,5350,5421,37809,39754,212,3.6,1265,21.3,6828,989,5839,2.5,17.2,10718,5384,5334,13.5,27,-3890,-9.8,34.4,0,993,993,4577
2010,29,d) 3,5157,5265,34985,36923,201,3.5,1067,18.8,5619,866,4753,2.3,15.2,9494,5069,4425,13.7,25.7,-3875,-10.5,30.4,0,821,826,4446
2010,29,e) 4,5146,5457,42113,43974,213,3.7,860,14.9,5824,729,5095,1.7,13.2,9545,4023,5522,9.1,21.7,-3721,-8.5,26.4,0,644,644,3191
2010,29,f) 5,4664,4836,37734,39882,175,3.4,740,14.5,4720,830,3890,2.1,11.8,9015,4134,4881,10.4,22.6,-4295,-10.8,23.6,0,557,557,3425
2010,29,g) 6 to 10,17261,18203,169448,178287,629,3.3,2244,11.8,19743,3741,16002,2.1,11.1,37421,15160,22261,8.5,21,-17678,-9.9,22.2,0,1598,1598,12453
2010,29,h) 11 to 15,12901,14095,158877,162551,498,3.4,1275,8.8,17628,3660,13968,2.3,10.8,24975,7100,17875,4.4,15.4,-7347,-4.6,21.6,0,858,858,5018
2010,29,i) 16 to 20,9386,10724,135846,138727,299,2.7,852,7.8,14031,3692,10339,2.7,10.1,19792,5814,13978,4.2,14.3,-5761,-4.2,20.2,0,558,558,3891
2010,29,j) 21 to 25,8073,10647,184634,188571,354,3.3,626,5.8,17217,4263,12954,2.3,9.1,25090,4495,20595,2.4,13.3,-7873,-4.2,18.2,0,379,379,2748
2010,29,k) 26+,9511,14638,309557,310500,570,3.9,700,4.8,29638,9734,19904,3.1,9.5,31523,5449,26074,1.8,10.2,-1885,-0.7,19,0,376,377,2425
2010,29,l) Left Censored,12179,31347,1094972,1113425,1322,4.2,1469,4.7,88971,22538,66433,2,8,125877,19443,106434,1.7,11.3,-36906,-3.3,16,0,350,368,3138
2010,30,a) 0,1824,1833,9573,4889,1787,195,0,0,9369,,,,191.6,0,0,0,0,0,9369,191.6,0,1,,,
2010,30,b) 1,1485,1487,7170,7456,3,0.2,514,29.2,1543,,,,20.7,2114,1326,788,17.8,28.4,-571,-7.7,41.4,1,341,341,1022
2010,30,c) 2,1555,1592,8468,8769,77,4.5,354,20.5,1407,359,1048,4.1,16,2009,1030,979,11.7,22.9,-602,-6.9,32,0,253,253,764
2010,30,d) 3,1548,1570,8559,8647,101,6.1,310,18.6,1878,751,1127,8.7,21.7,2053,837,1216,9.7,23.7,-175,-2,43.4,0,201,201,604
2010,30,e) 4,1575,1642,15055,15602,91,5.3,269,15.6,1437,428,1009,2.7,9.2,2531,824,1707,5.3,16.2,-1094,-7,18.4,0,169,169,512
2010,30,f) 5,1347,1357,7776,8164,65,4.5,208,14.5,1166,214,952,2.6,14.3,1942,836,1106,10.2,23.8,-776,-9.5,28.6,0,124,124,577
2010,30,g) 6 to 10,5027,5180,34099,35143,235,4.4,601,11.2,4116,856,3260,2.4,11.7,6203,2287,3916,6.5,17.7,-2087,-6,23.4,0,352,352,1567
2010,30,h) 11 to 15,3722,3939,32251,33219,130,3.2,344,8.5,3319,504,2815,1.5,10,5254,1089,4165,3.3,15.8,-1935,-5.8,20,0,211,211,784
2010,30,i) 16 to 20,2364,2504,23523,23630,103,4,189,7.4,2458,513,1945,2.2,10.4,2671,662,2009,2.8,11.3,-213,-0.9,20.8,0,115,115,497
2010,30,j) 21 to 25,1670,1931,24295,24788,68,3.5,115,5.9,1892,321,1571,1.3,7.6,2877,522,2355,2.1,11.6,-985,-4,15.2,0,66,66,388
2010,30,k) 26+,2250,3210,48339,48919,91,2.8,161,5,4604,781,3823,1.6,9.4,5763,1139,4624,2.3,11.8,-1159,-2.4,18.8,0,86,86,546
2010,30,l) Left Censored,2466,5199,117315,118536,181,3.5,202,3.9,8911,1709,7202,1.4,7.5,11353,1368,9985,1.2,9.6,-2442,-2.1,15,0,56,56,353
2010,31,a) 0,2355,2379,11146,5620,2336,196.4,0,0,11053,,,,196.7,0,0,0,0,0,11053,196.7,0,1,,,
2010,31,b) 1,1977,1992,11217,12059,6,0.3,495,21.9,2145,,,,17.8,3829,2095,1734,17.4,31.8,-1684,-14,35.6,1,329,329,1720
2010,31,c) 2,1927,1952,11829,12208,73,3.5,345,16.6,1873,318,1555,2.6,15.3,2631,1354,1277,11.1,21.6,-758,-6.3,30.6,0,254,254,1152
2010,31,d) 3,1851,1889,12189,12356,74,3.7,288,14.5,2131,271,1860,2.2,17.2,2464,1039,1425,8.4,19.9,-333,-2.7,34.4,0,210,210,857
2010,31,e) 4,1783,1882,13682,14103,66,3.4,238,12.1,1642,158,1484,1.1,11.6,2484,984,1500,7,17.6,-842,-6,23.2,0,157,157,767
2010,31,f) 5,1615,1652,11376,11627,53,3.1,189,11,1779,152,1627,1.3,15.3,2280,1004,1276,8.6,19.6,-501,-4.3,30.6,0,143,143,918
2010,31,g) 6 to 10,6623,6919,56293,57815,236,3.3,700,9.8,6925,841,6084,1.5,12,9969,3884,6085,6.7,17.2,-3044,-5.2,24,0,441,446,2382
2010,31,h) 11 to 15,5055,5550,67558,68808,204,3.6,425,7.5,5766,1044,4722,1.5,8.4,8265,2196,6069,3.2,12,-2499,-3.6,16.8,0,249,249,1601
2010,31,i) 16 to 20,3859,4271,40974,41928,169,3.9,312,7.2,4165,768,3397,1.8,9.9,6073,1360,4713,3.2,14.5,-1908,-4.6,19.8,0,176,176,677
2010,31,j) 21 to 25,2861,3573,77052,78678,114,3.2,161,4.5,4770,924,3846,1.2,6.1,8021,1056,6965,1.3,10.2,-3251,-4.1,12.2,0,90,90,618
2010,31,k) 26+,3844,5650,99809,99923,227,4,254,4.5,10716,2913,7803,2.9,10.7,10943,1462,9481,1.5,11,-227,-0.3,21.4,0,129,129,571
2010,31,l) Left Censored,5368,11136,357351,359714,453,4.1,437,3.9,27912,8671,19241,2.4,7.8,32637,4660,27977,1.3,9.1,-4725,-1.3,15.6,0,123,131,1118
2010,32,a) 0,4241,4293,34981,17702,4213,196.3,0,0,34558,34558,0,195.2,195.2,0,0,0,0,0,34558,195.2,0,0,,,
2010,32,b) 1,3161,3221,25109,27876,11,0.3,1249,32.3,6351,57,6294,0.2,22.8,11885,6209,5676,22.3,42.6,-5534,-19.8,45.6,0,1011,1011,5519
2010,32,c) 2,3073,3144,29134,31560,129,3.7,840,24,5046,693,4353,2.2,16,9898,4446,5452,14.1,31.4,-4852,-15.4,32,0,662,662,3702
2010,32,d) 3,2703,2775,23918,26579,106,3.5,627,20.7,3744,625,3119,2.4,14.1,9066,5183,3883,19.5,34.1,-5322,-20,28.2,0,494,494,4800
2010,32,e) 4,2622,2757,27398,28954,115,3.9,569,19.1,4540,773,3767,2.7,15.7,7652,2941,4711,10.2,26.4,-3112,-10.7,31.4,0,435,436,2300
2010,32,f) 5,2235,2360,22788,24745,99,3.9,467,18.4,3329,716,2613,2.9,13.5,7243,2859,4384,11.6,29.3,-3914,-15.8,27,0,375,376,2438
2010,32,g) 6 to 10,7651,8108,113649,120165,305,3.6,1268,14.8,11512,2726,8786,2.3,9.6,24543,8099,16444,6.7,20.4,-13031,-10.8,19.2,0,924,924,6453
2010,32,h) 11 to 15,4592,5298,80075,82330,221,4,597,10.9,10366,1882,8484,2.3,12.6,14876,4551,10325,5.5,18.1,-4510,-5.5,25.2,0,406,406,3313
2010,32,i) 16 to 20,2593,3083,58190,61220,112,3.5,296,9.3,5295,974,4321,1.6,8.6,11354,2989,8365,4.9,18.5,-6059,-9.9,17.2,0,199,199,1895
2010,32,j) 21 to 25,1999,2879,54332,55960,109,3.7,208,7.1,5233,1458,3775,2.6,9.4,8488,1839,6649,3.3,15.2,-3255,-5.8,18.8,0,120,120,1104
2010,32,k) 26+,2430,4480,126707,131738,282,6.3,276,6.2,11668,4979,6689,3.8,8.9,21730,2892,18838,2.2,16.5,-10062,-7.6,17.8,0,103,103,980
2010,32,l) Left Censored,2928,9274,400832,405663,695,7.5,585,6.3,44667,19471,25196,4.8,11,54328,8393,45935,2.1,13.4,-9661,-2.4,22,0,58,63,681
2010,33,a) 0,1681,1716,9711,4961,1680,195.8,0,0,9500,9500,0,191.5,191.5,0,0,0,0,0,9500,191.5,0,0,,,
2010,33,b) 1,1334,1347,8044,8299,6,0.4,368,23.8,1885,25,1860,0.3,22.7,2395,1160,1235,14,28.9,-510,-6.2,45.4,0,287,287,970
2010,33,c) 2,1406,1421,11619,12027,42,2.7,282,18.4,1680,112,1568,0.9,14,2496,1301,1195,10.8,20.8,-816,-6.8,28,0,214,214,1092
2010,33,d) 3,1261,1280,8216,8412,45,3.3,201,14.8,1141,159,982,1.9,13.6,1532,582,950,6.9,18.2,-391,-4.6,27.2,0,150,150,479
2010,33,e) 4,1330,1407,11780,11990,48,3.2,213,14.3,1541,161,1380,1.3,12.9,1961,724,1237,6,16.4,-420,-3.5,25.8,0,157,157,532
2010,33,f) 5,1162,1191,8832,9466,35,2.8,166,13.3,957,147,810,1.6,10.1,2225,909,1316,9.6,23.5,-1268,-13.4,20.2,0,128,128,817
2010,33,g) 6 to 10,4449,4628,40652,41734,152,3.2,549,11.4,4477,724,3753,1.7,10.7,6641,2256,4385,5.4,15.9,-2164,-5.2,21.4,0,393,394,1869
2010,33,h) 11 to 15,3730,3973,39877,40002,141,3.5,346,8.5,5007,884,4123,2.2,12.5,5256,1066,4190,2.7,13.1,-249,-0.6,25,0,245,245,714
2010,33,i) 16 to 20,2717,2908,32815,33344,86,2.9,181,6.1,3387,462,2925,1.4,10.2,4445,1265,3180,3.8,13.3,-1058,-3.1,20.4,0,123,123,597
2010,33,j) 21 to 25,2567,3091,49906,49851,101,3.2,196,6.2,6053,2321,3732,4.7,12.1,5943,1145,4798,2.3,11.9,110,0.2,23.8,0,116,121,752
2010,33,k) 26+,2380,3397,66852,67275,127,3.7,179,5.2,9347,1146,8201,1.7,13.9,10192,1866,8326,2.8,15.1,-845,-1.2,27.8,0,89,89,985
2010,33,l) Left Censored,3206,7150,270091,271066,344,4.8,394,5.5,24086,5650,18436,2.1,8.9,26036,6158,19878,2.3,9.6,-1950,-0.7,17.8,0,83,83,1970
2010,34,a) 0,12080,12201,67636,34180,11982,196.4,0,0,66912,66912,0,195.8,195.8,0,0,0,0,0,66912,195.8,0,0,,,
2010,34,b) 1,9397,9469,59712,62535,17,0.2,3004,27.1,13492,226,13266,0.4,21.6,19137,11187,7950,17.9,30.6,-5645,-9,43.2,0,2240,2252,9430
2010,34,c) 2,9242,9322,72087,72590,402,4,2104,20.7,17933,1635,16298,2.3,24.7,18939,10336,8603,14.2,26.1,-1006,-1.4,49.4,0,1615,1615,8337
2010,34,d) 3,8704,8793,62150,66049,362,3.8,1658,17.6,9344,1018,8326,1.5,14.1,17141,8301,8840,12.6,26,-7797,-11.9,28.2,0,1265,1268,7179
2010,34,e) 4,8495,8787,68436,71155,335,3.6,1502,16.1,8628,1319,7309,1.9,12.1,14065,6288,7777,8.8,19.8,-5437,-7.7,24.2,0,1124,1124,5117
2010,34,f) 5,7708,7876,63471,65400,304,3.6,1267,15.2,9051,1912,7139,2.9,13.8,12908,5809,7099,8.9,19.7,-3857,-5.9,27.6,0,954,954,4940
2010,34,g) 6 to 10,28929,29819,289664,297861,1006,3.2,3768,12.1,33402,7408,25994,2.5,11.2,49795,17549,32246,5.9,16.7,-16393,-5.5,22.4,0,2668,2668,13518
2010,34,h) 11 to 15,22709,24320,271914,281111,798,3.2,2286,9.1,29289,5085,24204,1.8,10.4,47683,16891,30792,6,17,-18394,-6.6,20.8,0,1539,1539,13902
2010,34,i) 16 to 20,15005,16003,197970,203961,472,2.9,1323,8.1,18812,3424,15388,1.7,9.2,30793,6943,23850,3.4,15.1,-11981,-5.9,18.4,0,898,898,4912
2010,34,j) 21 to 25,13512,15605,264622,266847,542,3.4,1165,7.3,27254,6085,21169,2.3,10.2,31704,9043,22661,3.4,11.9,-4450,-1.7,20.4,0,702,711,5037
2010,34,k) 26+,14323,19213,412650,416174,663,3.4,1157,6,38071,12931,25140,3.1,9.1,45119,10017,35102,2.4,10.8,-7048,-1.7,18.2,0,645,646,4300
2010,34,l) Left Censored,17782,40349,1501731,1521476,1885,4.6,3058,7.5,131713,37130,94583,2.4,8.7,171204,47721,123483,3.1,11.3,-39491,-2.6,17.4,0,709,714,7916
2010,35,a) 0,2059,2084,13135,6663,2045,196.3,0,0,12944,12944,0,194.3,194.3,0,0,0,0,0,12944,194.3,0,0,,,
2010,35,b) 1,1753,1772,12017,12525,4,0.2,599,28.6,2711,20,2691,0.2,21.6,3726,2156,1570,17.2,29.7,-1015,-8.1,43.2,0,468,468,1889
2010,35,c) 2,1754,1795,13168,13435,98,5,425,21.8,2509,484,2025,3.6,18.7,3042,1703,1339,12.7,22.6,-533,-3.9,37.4,0,315,315,1289
2010,35,d) 3,1673,1684,23973,24291,65,3.6,358,19.6,2235,200,2035,0.8,9.2,2870,1447,1423,6,11.8,-635,-2.6,18.4,0,264,264,1019
2010,35,e) 4,1648,1737,14712,15400,74,4,292,15.9,1892,248,1644,1.6,12.3,3268,1532,1736,9.9,21.2,-1376,-8.9,24.6,0,208,208,1046
2010,35,f) 5,1440,1500,12292,13265,57,3.6,269,16.8,1986,420,1566,3.2,15,3932,1692,2240,12.8,29.6,-1946,-14.6,30,0,213,213,1506
2010,35,g) 6 to 10,5480,5866,54670,56607,204,3.3,693,11.4,6987,2046,4941,3.6,12.3,10861,4350,6511,7.7,19.2,-3874,-6.9,24.6,0,501,502,3697
2010,35,h) 11 to 15,4109,4423,56836,57866,152,3.3,438,9.6,5627,753,4874,1.3,9.7,7686,1915,5771,3.3,13.3,-2059,-3.6,19.4,0,294,294,1408
2010,35,i) 16 to 20,3070,3493,42365,43839,119,3.3,303,8.4,4966,823,4143,1.9,11.3,7914,1999,5915,4.6,18.1,-2948,-6.8,22.6,0,177,177,1097
2010,35,j) 21 to 25,2362,3104,59418,60092,80,2.5,171,5.4,5184,999,4185,1.7,8.6,6531,1135,5396,1.9,10.9,-1347,-2.3,17.2,0,106,106,674
2010,35,k) 26+,3058,4400,78321,79185,133,3,263,5.9,6812,1128,5684,1.4,8.6,8540,1818,6722,2.3,10.8,-1728,-2.2,17.2,0,136,136,713
2010,35,l) Left Censored,3294,8234,217894,223492,362,4.4,374,4.5,18367,4982,13385,2.2,8.2,29562,3982,25580,1.8,13.2,-11195,-5,16.4,0,57,57,1150
2010,36,a) 0,34034,34448,179086,90207,33892,196.8,0,0,177759,177759,0,197.1,197.1,0,0,0,0,0,177759,197.1,0,0,,,
2010,36,b) 1,25743,25869,154325,161829,42,0.1,7453,25,34856,1504,33352,0.9,21.5,49863,26566,23297,16.4,30.8,-15007,-9.3,43,0,5569,5577,22499
2010,36,c) 2,23840,24083,155570,161868,985,3.8,5037,19.4,27119,3439,23680,2.1,16.8,39714,21249,18465,13.1,24.5,-12595,-7.7,33.6,0,3848,3848,17748
2010,36,d) 3,20768,20920,135513,140727,852,3.8,3786,17,21883,2684,19199,1.9,15.5,32310,17295,15015,12.3,23,-10427,-7.5,31,0,2846,2846,14910
2010,36,e) 4,19718,20516,155743,161153,802,3.7,3205,14.8,21507,3877,17630,2.4,13.3,32327,14616,17711,9.1,20.1,-10820,-6.8,26.6,0,2420,2420,11732
2010,36,f) 5,17473,17892,149153,154187,656,3.5,2628,13.9,20521,2859,17662,1.9,13.3,30589,12199,18390,7.9,19.8,-10068,-6.5,26.6,0,1955,1955,9263
2010,36,g) 6 to 10,65401,67368,624900,646320,2259,3.2,8011,11.4,71803,9933,61870,1.5,11.1,114643,42550,72093,6.6,17.7,-42840,-6.6,22.2,0,5761,5766,33931
2010,36,h) 11 to 15,46645,49773,578589,589945,1495,2.9,4421,8.6,59468,9553,49915,1.6,10.1,82179,28387,53792,4.8,13.9,-22711,-3.8,20.2,0,3034,3040,18982
2010,36,i) 16 to 20,32334,34852,422180,431173,1008,2.8,2601,7.3,41738,8543,33195,2,9.7,59723,16617,43106,3.9,13.9,-17985,-4.2,19.4,0,1760,1764,12088
2010,36,j) 21 to 25,29697,33702,569609,575006,1057,3.1,2081,6.1,49062,10512,38550,1.8,8.5,59855,17915,41940,3.1,10.4,-10793,-1.9,17,0,1228,1231,9371
2010,36,k) 26+,30270,42033,894695,902119,1106,2.6,2146,5,76874,15230,61644,1.7,8.5,91722,17715,74007,2,10.2,-14848,-1.7,17,0,1275,1284,10838
2010,36,l) Left Censored,39301,86660,3247008,3281073,3540,4.1,4806,5.5,283728,82074,201654,2.5,8.6,351857,81951,269906,2.5,10.7,-68129,-2.1,17.2,0,1440,1446,17271
2010,37,a) 0,11331,11498,75119,37793,11308,196.7,0,0,74653,74653,0,197.5,197.5,0,0,0,0,0,74653,197.5,0,0,,,
2010,37,b) 1,8543,8707,57844,62586,30,0.3,2627,26,12215,762,11453,1.2,19.5,21699,11303,10396,18.1,34.7,-9484,-15.2,39,0,2008,2008,9509
2010,37,c) 2,8784,8979,63127,66782,376,3.8,2020,20.7,10095,1467,8628,2.2,15.1,17404,8867,8537,13.3,26.1,-7309,-11,30.2,0,1508,1508,7298
2010,37,d) 3,8283,8415,56873,59487,323,3.6,1696,18.7,9487,1699,7788,2.9,15.9,14714,7491,7223,12.6,24.7,-5227,-8.8,31.8,0,1276,1276,6427
2010,37,e) 4,7937,8505,68583,72069,414,4.6,1368,15.3,9526,2274,7252,3.2,13.2,16497,7451,9046,10.3,22.9,-6971,-9.7,26.4,0,1015,1015,6041
2010,37,f) 5,7148,7357,61099,63616,267,3.4,1142,14.7,8510,1701,6809,2.7,13.4,13543,5353,8190,8.4,21.3,-5033,-7.9,26.8,0,861,862,4321
2010,37,g) 6 to 10,26084,27703,271283,282857,912,3.2,3253,11.3,30991,6160,24831,2.2,11,54138,19950,34188,7.1,19.1,-23147,-8.1,22,0,2307,2312,15300
2010,37,h) 11 to 15,19135,21359,264428,271540,683,3.1,2121,9.6,25746,6033,19713,2.2,9.5,39970,11784,28186,4.3,14.7,-14224,-5.2,19,0,1402,1407,8351
2010,37,i) 16 to 20,12649,14626,198618,203117,465,3.1,1177,7.9,20419,6808,13611,3.4,10.1,29417,7276,22141,3.6,14.5,-8998,-4.4,20.2,0,768,770,4238
2010,37,j) 21 to 25,10777,14019,268687,274942,430,3,1025,7.2,24322,6829,17493,2.5,8.8,36832,7219,29613,2.6,13.4,-12510,-4.6,17.6,0,610,637,4326
2010,37,k) 26+,12893,20182,411410,416313,710,3.5,1047,5.1,37808,9866,27942,2.4,9.1,47613,10242,37371,2.5,11.4,-9805,-2.3,18.2,0,541,541,3326
2010,37,l) Left Censored,14076,44223,1456992,1482251,2346,5.3,2878,6.5,139025,34571,104454,2.3,9.4,189543,42370,147173,2.9,12.8,-50518,-3.4,18.8,0,469,475,5099
2010,38,a) 0,1076,1090,5272,2678,1055,193.6,0,0,5189,,,,193.8,0,0,0,0,0,5189,193.8,0,1,,,
2010,38,b) 1,894,904,5701,5876,3,0.3,259,24.9,1226,,,,20.9,1576,665,911,11.3,26.8,-350,-5.9,41.8,1,164,164,481
2010,38,c) 2,874,890,6642,6422,38,4,141,15,1566,93,1473,1.4,24.4,1125,554,571,8.6,17.5,441,6.9,35,0,93,93,431
2010,38,d) 3,814,827,5714,5959,53,6.2,126,14.6,934,115,819,1.9,15.7,1423,444,979,7.5,23.9,-489,-8.2,31.4,0,81,81,341
2010,38,e) 4,828,874,6603,6526,51,5.7,85,9.6,1073,205,868,3.1,16.4,919,296,623,4.5,14.1,154,2.3,28.2,0,54,54,208
2010,38,f) 5,721,735,5119,5168,35,4.6,72,9.6,1091,489,602,9.5,21.1,1188,485,703,9.4,23,-97,-1.9,42.2,0,43,43,388
2010,38,g) 6 to 10,2720,2833,22071,22133,125,4.3,256,8.9,3095,512,2583,2.3,14,3218,1005,2213,4.5,14.5,-123,-0.5,28,0,145,145,614
2010,38,h) 11 to 15,2063,2227,20904,21174,133,5.9,162,7.2,2524,678,1846,3.2,11.9,3063,512,2551,2.4,14.5,-539,-2.6,23.8,0,95,95,350
2010,38,i) 16 to 20,1877,1969,19139,19174,122,6.2,138,7,2561,505,2056,2.6,13.4,2630,394,2236,2.1,13.7,-69,-0.3,26.8,0,69,69,261
2010,38,j) 21 to 25,1261,1471,18735,18750,39,2.6,68,4.6,1997,413,1584,2.2,10.7,2027,357,1670,1.9,10.8,-30,-0.1,21.4,0,43,43,254
2010,38,k) 26+,1820,2424,40946,40844,73,3,118,4.8,4707,1237,3470,3,11.5,4502,800,3702,2,11,205,0.5,22,0,64,64,422
2010,38,l) Left Censored,2482,4771,139478,140061,173,3.6,170,3.6,10291,1743,8548,1.2,7.3,11457,2732,8725,2,8.2,-1166,-0.9,14.6,0,47,47,407
2010,39,a) 0,9576,9873,76889,38682,9724,197,0,0,76415,76415,0,197.5,197.5,0,0,0,0,0,76415,197.5,0,0,,,
2010,39,b) 1,7652,7790,64769,68509,35,0.4,2326,25.8,14502,755,13747,1.1,21.2,21981,12857,9124,18.8,32.1,-7479,-10.9,42.4,0,1702,1702,10933
2010,39,c) 2,7853,8055,67858,70483,287,3.3,1520,17.6,12005,1392,10613,2,17,17255,7813,9442,11.1,24.5,-5250,-7.5,34,0,1149,1149,6753
2010,39,d) 3,7129,7311,60964,63073,280,3.6,1371,17.5,10515,1388,9127,2.2,16.7,14732,7362,7370,11.7,23.4,-4217,-6.7,33.4,0,1057,1057,6263
2010,39,e) 4,7299,7733,76272,79337,273,3.3,1192,14.6,10313,1756,8557,2.2,13,16442,7062,9380,8.9,20.7,-6129,-7.7,26,0,894,894,6084
2010,39,f) 5,6818,7157,75760,77395,231,3.1,953,12.7,10907,1799,9108,2.3,14.1,14177,4722,9455,6.1,18.3,-3270,-4.2,28.2,0,690,690,3664
2010,39,g) 6 to 10,26578,28331,292499,304172,892,3,3212,10.9,34629,6090,28539,2,11.4,57975,22417,35558,7.4,19.1,-23346,-7.7,22.8,0,2218,2219,15036
2010,39,h) 11 to 15,21984,24705,279482,287826,827,3.3,2211,8.7,27544,7048,20496,2.4,9.6,44231,11157,33074,3.9,15.4,-16687,-5.8,19.2,0,1440,1445,8468
2010,39,i) 16 to 20,17178,20456,269996,276110,664,3.2,1554,7.5,28852,5923,22929,2.1,10.4,41080,14221,26859,5.2,14.9,-12228,-4.5,20.8,0,941,942,11033
2010,39,j) 21 to 25,14731,19143,337069,341578,649,3.4,1136,5.9,31973,12091,19882,3.5,9.4,40991,8007,32984,2.3,12,-9018,-2.6,18.8,0,657,657,4569
2010,39,k) 26+,17851,26829,547261,555476,733,2.7,1452,5.3,52714,12361,40353,2.2,9.5,69144,14396,54748,2.6,12.4,-16430,-2.9,19,0,723,731,6325
2010,39,l) Left Censored,24986,64068,2182015,2212492,2523,3.9,3024,4.7,169261,39512,129749,1.8,7.7,230214,39605,190609,1.8,10.4,-60953,-2.7,15.4,0,821,831,9197
2010,40,a) 0,4596,4652,30241,15279,4549,195.6,0,0,29925,29925,0,195.9,195.9,0,0,0,0,0,29925,195.9,0,0,,,
2010,40,b) 1,3822,3877,25513,27184,21,0.5,1179,26.2,5247,498,4749,1.8,19.3,8588,5207,3381,19.2,31.6,-3341,-12.3,38.6,0,899,899,4448
2010,40,c) 2,3751,3820,28101,30098,144,3.5,853,20.5,4696,921,3775,3.1,15.6,8689,4636,4053,15.4,28.9,-3993,-13.3,31.2,0,650,650,3776
2010,40,d) 3,3456,3526,28928,31190,125,3.3,589,15.7,3950,822,3128,2.6,12.7,8474,3956,4518,12.7,27.2,-4524,-14.5,25.4,0,445,445,3386
2010,40,e) 4,3282,3483,29118,30386,143,3.9,497,13.6,3640,759,2881,2.5,12,6175,2809,3366,9.2,20.3,-2535,-8.3,24,0,379,379,2010
2010,40,f) 5,2903,3021,27812,29747,96,3,414,13.1,3086,550,2536,1.8,10.4,6956,3130,3826,10.5,23.4,-3870,-13,20.8,0,306,317,2540
2010,40,g) 6 to 10,10688,11385,105832,110313,322,2.7,1167,9.9,11280,1734,9546,1.6,10.2,20242,6537,13705,5.9,18.3,-8962,-8.1,20.4,0,853,853,5219
2010,40,h) 11 to 15,8079,8983,94246,97367,281,3.1,768,8.3,9940,2044,7896,2.1,10.2,16181,5083,11098,5.2,16.6,-6241,-6.4,20.4,0,496,496,3042
2010,40,i) 16 to 20,6057,6915,88255,89642,226,3.2,514,7.3,9574,2005,7569,2.2,10.7,12348,2962,9386,3.3,13.8,-2774,-3.1,21.4,0,325,325,1772
2010,40,j) 21 to 25,4545,5617,98554,102085,173,3,332,5.8,9078,3707,5371,3.6,8.9,16142,3721,12421,3.6,15.8,-7064,-6.9,17.8,0,208,208,1898
2010,40,k) 26+,6836,9871,185692,188243,297,3,469,4.7,15841,4489,11352,2.4,8.4,20943,3912,17031,2.1,11.1,-5102,-2.7,16.8,0,274,274,1770
2010,40,l) Left Censored,6673,17345,491365,503091,640,3.7,694,4,36400,10547,25853,2.1,7.2,59851,9416,50435,1.9,11.9,-23451,-4.7,14.4,0,187,192,1487
2010,41,a) 0,5666,5748,28747,14486,5646,196.5,0,0,28522,28522,0,196.9,196.9,0,0,0,0,0,28522,196.9,0,0,,,
2010,41,b) 1,4555,4590,23860,25865,13,0.2,1414,26.4,5537,71,5466,0.3,21.4,9547,6069,3478,23.5,36.9,-4010,-15.5,42.8,0,1048,1048,5223
2010,41,c) 2,4697,4767,25325,26616,228,4.4,1068,20.7,4670,682,3988,2.6,17.5,7251,3753,3498,14.1,27.2,-2581,-9.7,35,0,795,795,3109
2010,41,d) 3,4326,4407,26506,27634,213,4.5,892,18.9,4613,631,3982,2.3,16.7,6868,3365,3503,12.2,24.9,-2255,-8.2,33.4,0,655,655,2776
2010,41,e) 4,4257,4673,31899,32479,261,5.3,755,15.4,5134,1345,3789,4.1,15.8,6294,2560,3734,7.9,19.4,-1160,-3.6,31.6,0,542,542,2007
2010,41,f) 5,3712,3822,25452,27143,156,3.9,623,15.4,3182,458,2724,1.7,11.7,6563,2543,4020,9.4,24.2,-3381,-12.5,23.4,0,442,445,2044
2010,41,g) 6 to 10,13783,14695,137386,133076,699,4.6,1724,11.4,31636,3736,27900,2.8,23.8,23015,7346,15669,5.5,17.3,8621,6.5,34.6,0,1181,1183,5407
2010,41,h) 11 to 15,10366,11220,124408,127285,413,3.6,1113,9.6,14149,1669,12480,1.3,11.1,19903,5054,14849,4,15.6,-5754,-4.5,22.2,0,696,714,3783
2010,41,i) 16 to 20,7230,8263,88908,91286,279,3.3,652,7.7,10396,1561,8835,1.7,11.4,15152,3644,11508,4,16.6,-4756,-5.2,22.8,0,420,420,2442
2010,41,j) 21 to 25,5256,6521,99500,102239,245,3.7,438,6.6,9737,3068,6669,3,9.5,15215,3256,11959,3.2,14.9,-5478,-5.4,19,0,253,253,1681
2010,41,k) 26+,6517,9705,199667,200888,341,3.5,553,5.6,20370,3987,16383,2,10.1,22811,4340,18471,2.2,11.4,-2441,-1.3,20.2,0,274,274,2036
2010,41,l) Left Censored,6883,17949,542784,549987,856,4.8,861,4.8,44504,14618,29886,2.7,8.1,58909,12777,46132,2.3,10.7,-14405,-2.6,16.2,0,187,195,5176
2010,42,a) 0,11955,12290,82997,41760,12099,196.9,0,0,82475,82475,0,197.5,197.5,0,0,0,0,0,82475,197.5,0,0,,,
2010,42,b) 1,10046,10179,72025,75666,29,0.2,2871,24.5,15831,360,15471,0.5,20.9,23113,12521,10592,16.5,30.5,-7282,-9.6,41.8,0,2162,2162,10377
2010,42,c) 2,10118,10282,68922,75279,375,3.4,1943,17.6,11445,1303,10142,1.7,15.2,24158,16040,8118,21.3,32.1,-12713,-16.9,30.4,0,1484,1484,14580
2010,42,d) 3,9337,9459,70426,72464,347,3.5,1538,15.3,10037,1304,8733,1.8,13.9,14112,6997,7115,9.7,19.5,-4075,-5.6,27.8,0,1164,1164,5889
2010,42,e) 4,9337,9819,92988,93097,320,3.1,1301,12.6,15461,1190,14271,1.3,16.6,15679,6615,9064,7.1,16.8,-218,-0.2,33.2,0,959,959,5698
2010,42,f) 5,8816,9185,81524,84717,294,3.1,1161,12.1,10714,1637,9077,1.9,12.6,17100,6382,10718,7.5,20.2,-6386,-7.6,25.2,0,873,873,5338
2010,42,g) 6 to 10,34149,35921,372491,386337,1092,2.9,3550,9.6,39832,8391,31441,2.2,10.3,67524,28802,38722,7.5,17.5,-27692,-7.2,20.6,0,2446,2446,23965
2010,42,h) 11 to 15,26532,29468,363034,365417,922,3.1,2211,7.4,40824,7724,33100,2.1,11.2,45590,12455,33135,3.4,12.5,-4766,-1.3,22.4,0,1452,1453,8963
2010,42,i) 16 to 20,19736,22232,293856,298375,674,3,1468,6.5,30837,6890,23947,2.3,10.3,39874,11879,27995,4,13.4,-9037,-3.1,20.6,0,958,958,8733
2010,42,j) 21 to 25,18483,22539,398241,402757,788,3.5,1332,5.8,43585,15841,27744,3.9,10.8,52616,9881,42735,2.5,13.1,-9031,-2.3,21.6,0,797,797,5781
2010,42,k) 26+,20573,30202,648277,653115,1021,3.4,1448,4.8,64058,18219,45839,2.8,9.8,73733,17543,56190,2.7,11.3,-9675,-1.5,19.6,0,746,756,6688
2010,42,l) Left Censored,27641,69638,2396849,2426588,2790,4,3467,5,190455,47900,142555,2,7.8,249932,55004,194928,2.3,10.3,-59477,-2.5,15.6,0,756,761,9417
2010,44,a) 0,1261,1275,7030,3604,1251,196.2,0,0,6852,,,,190.1,0,0,0,0,0,6852,190.1,0,1,,,
2010,44,b) 1,920,939,5807,6316,9,0.8,304,27.7,1466,,,,23.2,2484,1746,738,27.6,39.3,-1018,-16.1,46.4,1,226,226,1278
2010,44,c) 2,988,996,7357,7733,45,4.1,248,22.7,1063,105,958,1.4,13.7,1814,940,874,12.2,23.5,-751,-9.8,27.4,0,192,192,787
2010,44,d) 3,923,932,7123,7148,46,4.6,172,17.4,1496,157,1339,2.2,20.9,1545,709,836,9.9,21.6,-49,-0.7,41.8,0,117,117,541
2010,44,e) 4,931,996,7224,7419,56,5.3,180,17,959,211,748,2.8,12.9,1348,595,753,8,18.2,-389,-5.3,25.8,0,122,122,464
2010,44,f) 5,893,900,6483,6667,32,3.4,116,12.4,921,237,684,3.6,13.8,1289,377,912,5.7,19.3,-368,-5.5,27.6,0,86,86,332
2010,44,g) 6 to 10,3459,3616,29611,31471,132,3.5,424,11.3,3327,382,2945,1.2,10.6,7047,2043,5004,6.5,22.4,-3720,-11.8,21.2,0,291,291,1751
2010,44,h) 11 to 15,2627,2850,27541,28125,124,4.3,270,9.3,3381,849,2532,3,12,4549,1141,3408,4.1,16.2,-1168,-4.2,24,0,188,188,948
2010,44,i) 16 to 20,2014,2112,24156,25038,69,3.2,173,8,2293,372,1921,1.5,9.2,4056,883,3173,3.5,16.2,-1763,-7,18.4,0,109,109,475
2010,44,j) 21 to 25,1951,2185,30732,31026,101,4.6,160,7.2,3255,1215,2040,3.9,10.5,3843,878,2965,2.8,12.4,-588,-1.9,21,0,107,107,690
2010,44,k) 26+,2044,2630,48881,50165,96,3.6,126,4.8,5620,2609,3011,5.2,11.2,8188,1442,6746,2.9,16.3,-2568,-5.1,22.4,0,64,64,462
2010,44,l) Left Censored,3248,5627,194120,197569,239,4.2,288,5.1,12054,3930,8124,2,6.1,18952,2831,16121,1.4,9.6,-6898,-3.5,12.2,0,87,87,1003
2010,45,a) 0,5047,5091,31101,15656,4997,196.3,0,0,30890,30890,0,197.3,197.3,0,0,0,0,0,30890,197.3,0,0,,,
2010,45,b) 1,4031,4188,35245,37566,22,0.5,1234,25.5,5715,267,5448,0.7,15.2,10356,5909,4447,15.7,27.6,-4641,-12.4,30.4,0,971,971,5179
2010,45,c) 2,4004,4045,24775,26245,179,4.1,939,21.4,4094,707,3387,2.7,15.6,7034,3697,3337,14.1,26.8,-2940,-11.2,31.2,0,768,768,3247
2010,45,d) 3,3816,3898,29444,30878,154,3.7,816,19.4,4425,674,3751,2.2,14.3,7293,3608,3685,11.7,23.6,-2868,-9.3,28.6,0,618,618,2808
2010,45,e) 4,3633,3774,29566,30818,148,3.7,639,16,4137,1056,3081,3.4,13.4,6641,2616,4025,8.5,21.5,-2504,-8.1,26.8,0,499,501,2275
2010,45,f) 5,3372,3539,31913,33581,130,3.5,541,14.5,3843,594,3249,1.8,11.4,7179,2977,4202,8.9,21.4,-3336,-10,22.8,0,402,402,2486
2010,45,g) 6 to 10,12535,13263,137786,142513,405,2.9,1601,11.6,16551,3698,12853,2.6,11.6,26004,10028,15976,7,18.2,-9453,-6.6,23.2,0,1167,1167,8075
2010,45,h) 11 to 15,9014,9923,124479,129215,319,3.1,995,9.7,11636,3328,8308,2.6,9,21107,5285,15822,4.1,16.3,-9471,-7.3,18,0,680,684,3945
2010,45,i) 16 to 20,6112,6964,88522,90652,226,3.2,603,8.4,9129,2337,6792,2.6,10.1,13389,3510,9879,3.9,14.8,-4260,-4.7,20.2,0,417,417,2293
2010,45,j) 21 to 25,5174,7179,118786,119664,279,3.8,455,6.3,14024,3332,10692,2.8,11.7,15780,3392,12388,2.8,13.2,-1756,-1.5,23.4,0,275,302,1478
2010,45,k) 26+,6077,9471,184809,185687,397,4.2,476,5,21672,7724,13948,4.2,11.7,23428,3846,19582,2.1,12.6,-1756,-0.9,23.4,0,264,270,1719
2010,45,l) Left Censored,7147,21279,653400,662708,913,4.3,1102,5.2,58874,20194,38680,3,8.9,77491,11771,65720,1.8,11.7,-18617,-2.8,17.8,0,218,224,2195
2010,46,a) 0,1290,1336,8053,4072,1312,196.4,0,0,7963,,,,195.6,0,0,0,0,0,7963,195.6,0,1,,,
2010,46,b) 1,1105,1114,6643,7004,4,0.3,336,26,1693,,,,24.2,2414,1306,1108,18.6,34.5,-721,-10.3,48.4,1,222,222,1069
2010,46,c) 2,1015,1022,6021,7006,43,4,184,17,936,146,790,2.1,13.4,2906,1427,1479,20.4,41.5,-1970,-28.1,26.8,0,128,128,1322
2010,46,d) 3,1027,1041,6459,6861,43,3.9,175,15.9,847,129,718,1.9,12.3,1650,871,779,12.7,24,-803,-11.7,24.6,0,117,117,638
2010,46,e) 4,1002,1023,7620,8284,36,3.4,148,13.8,960,54,906,0.7,11.6,2288,687,1601,8.3,27.6,-1328,-16,23.2,0,96,96,514
2010,46,f) 5,812,822,4750,4862,32,3.7,105,12.3,649,67,582,1.4,13.3,873,326,547,6.7,18,-224,-4.7,26.6,0,67,67,223
2010,46,g) 6 to 10,3595,3791,29794,30657,139,3.6,376,9.7,3605,735,2870,2.4,11.8,5331,1567,3764,5.1,17.4,-1726,-5.6,23.6,0,231,231,1206
2010,46,h) 11 to 15,2658,2790,25892,26025,113,4,218,7.7,2837,640,2197,2.5,10.9,3102,1001,2101,3.8,11.9,-265,-1,21.8,0,143,143,805
2010,46,i) 16 to 20,1959,2088,21279,21908,88,4.2,163,7.7,2035,503,1532,2.3,9.3,3292,910,2382,4.2,15,-1257,-5.7,18.6,0,96,96,518
2010,46,j) 21 to 25,1342,1542,21297,21932,56,3.6,82,5.3,2118,894,1224,4.1,9.7,3387,767,2620,3.5,15.4,-1269,-5.7,19.4,0,52,52,465
2010,46,k) 26+,1807,2505,35126,35000,109,4.4,100,4,3998,993,3005,2.8,11.4,3745,1438,2307,4.1,10.7,253,0.7,21.4,0,58,58,403
2010,46,l) Left Censored,2573,5021,150493,152064,143,2.8,182,3.6,9504,1254,8250,0.8,6.3,12646,1777,10869,1.2,8.3,-3142,-2,12.6,0,60,60,881
2010,47,a) 0,6224,6331,42912,21651,6237,197,0,0,42522,42522,0,196.4,196.4,0,0,0,0,0,42522,196.4,0,0,,,
2010,47,b) 1,4699,4894,35333,37429,50,0.9,1596,27.9,8689,502,8187,1.3,23.2,12880,8486,4394,22.7,34.4,-4191,-11.2,46.4,0,1311,1311,7601
2010,47,c) 2,4973,5086,35947,37721,188,3.4,1198,21.5,7296,1101,6195,2.9,19.3,10843,6245,4598,16.6,28.7,-3547,-9.4,38.6,0,959,959,4796
2010,47,d) 3,4486,4629,33979,36194,145,2.9,928,18.5,5275,610,4665,1.7,14.6,9705,4337,5368,12,26.8,-4430,-12.2,29.2,0,737,737,3483
2010,47,e) 4,4223,4460,43123,44876,129,2.7,782,16.4,6278,432,5846,1,14,9784,4207,5577,9.4,21.8,-3506,-7.8,28,0,589,589,3254
2010,47,f) 5,3834,4127,42265,43960,229,5.3,611,14.2,7087,2060,5027,4.7,16.1,10477,4766,5711,10.8,23.8,-3390,-7.7,32.2,0,467,474,4159
2010,47,g) 6 to 10,14294,15484,173048,178659,500,3.1,1777,11,21496,4475,17021,2.5,12,32718,12317,20401,6.9,18.3,-11222,-6.3,24,0,1357,1360,10347
2010,47,h) 11 to 15,11197,12765,152449,155227,435,3.3,1146,8.8,20052,5648,14404,3.6,12.9,25608,7564,18044,4.9,16.5,-5556,-3.6,25.8,0,803,803,5787
2010,47,i) 16 to 20,8243,9894,143072,149320,303,3,739,7.3,16137,2155,13982,1.4,10.8,28633,5080,23553,3.4,19.2,-12496,-8.4,21.6,0,511,511,2872
2010,47,j) 21 to 25,7160,9397,170565,172589,274,2.9,542,5.7,17019,5238,11781,3,9.9,21067,3869,17198,2.2,12.2,-4048,-2.3,19.8,0,339,339,2316
2010,47,k) 26+,9010,14455,313667,317589,479,3.3,713,4.9,32769,7738,25031,2.4,10.3,40613,9482,31131,3,12.8,-7844,-2.5,20.6,0,336,349,4598
2010,47,l) Left Censored,10162,30134,1069174,1081018,1207,4,1373,4.5,87916,21829,66087,2,8.1,111606,23230,88376,2.1,10.3,-23690,-2.2,16.2,0,294,297,3379
2010,48,a) 0,30741,31402,230405,115940,30969,197.2,0,0,228931,228931,0,197.5,197.5,0,0,0,0,0,228931,197.5,0,0,,,
2010,48,b) 1,23976,24425,198522,207297,131,0.5,7468,26.3,47003,1231,45772,0.6,22.7,64553,35137,29416,17,31.1,-17550,-8.4,45.4,0,6020,6020,29828
2010,48,c) 2,23100,23694,211650,217509,832,3.2,4963,19.3,45507,5422,40085,2.5,20.9,57225,30653,26572,14.1,26.3,-11718,-5.4,41.8,0,4058,4058,27401
2010,48,d) 3,20719,21210,185422,194214,729,3.2,3696,16.3,30499,4727,25772,2.4,15.7,48082,21919,26163,11.3,24.8,-17583,-9.1,31.4,0,3040,3040,19512
2010,48,e) 4,19148,20464,204790,212684,650,3,2933,13.6,28206,4391,23815,2.1,13.3,43994,17455,26539,8.2,20.7,-15788,-7.4,26.6,0,2287,2287,14371
2010,48,f) 5,16832,17893,210895,221670,543,2.9,2533,13.5,30474,4175,26299,1.9,13.7,52023,20459,31564,9.2,23.5,-21549,-9.8,27.4,0,1889,1894,16134
2010,48,g) 6 to 10,62517,67613,825348,845712,2171,3.1,7081,10.1,108129,20774,87355,2.5,12.8,148856,49352,99504,5.8,17.6,-40727,-4.8,25.6,0,5263,5266,40209
2010,48,h) 11 to 15,43804,49774,723994,743072,1725,3.4,4269,8.4,87254,23439,63815,3.2,11.7,125412,34203,91209,4.6,16.9,-38158,-5.2,23.4,0,2949,2964,24848
2010,48,i) 16 to 20,31804,38017,573104,587283,1321,3.4,2766,7.2,63905,14903,49002,2.5,10.9,92263,24124,68139,4.1,15.7,-28358,-4.8,21.8,0,1810,1810,14178
2010,48,j) 21 to 25,23182,31803,641876,653316,1158,3.6,1861,5.8,73150,25849,47301,4,11.2,96030,22687,73343,3.5,14.7,-22880,-3.5,22.4,0,1107,1108,8031
2010,48,k) 26+,30142,49158,1030190,1035152,1833,3.7,2438,4.9,115506,34681,80825,3.4,11.2,125429,28462,96967,2.7,12.1,-9923,-0.9,22.4,0,1262,1287,12710
2010,48,l) Left Censored,25187,99729,3621418,3676145,5627,5.7,5310,5.3,349832,110805,239027,3,9.5,459287,100157,359130,2.7,12.5,-109455,-3,19,0,806,835,13711
2010,49,a) 0,4672,4716,29779,15038,4618,195.8,0,0,29483,29483,0,196.1,196.1,0,0,0,0,0,29483,196.1,0,0,,,
2010,49,b) 1,3392,3427,21557,23665,9,0.2,1347,32.5,5320,72,5248,0.3,22.5,9535,5895,3640,24.9,40.3,-4215,-17.8,45,0,1009,1009,5080
2010,49,c) 2,3468,3539,22084,24141,207,5.3,927,23.9,4107,768,3339,3.2,17,8220,4292,3928,17.8,34,-4113,-17,34,0,704,704,3607
2010,49,d) 3,3259,3305,23616,24929,191,5.3,791,21.9,3943,490,3453,2,15.8,6568,3045,3523,12.2,26.3,-2625,-10.5,31.6,0,587,587,2530
2010,49,e) 4,3061,3208,25261,26902,150,4.4,599,17.5,3409,622,2787,2.3,12.7,6691,2622,4069,9.7,24.9,-3282,-12.2,25.4,0,408,408,1979
2010,49,f) 5,2559,2640,23932,25564,116,4.1,473,16.8,3041,408,2633,1.6,11.9,6304,2721,3583,10.6,24.7,-3263,-12.8,23.8,0,346,346,2392
2010,49,g) 6 to 10,9412,9791,106203,115503,438,4.3,1352,13.2,12737,2279,10458,2,11,31337,9119,22218,7.9,27.1,-18600,-16.1,22,0,879,879,7142
2010,49,h) 11 to 15,5863,6449,93591,96491,259,3.9,698,10.5,8518,1670,6848,1.7,8.8,14318,4372,9946,4.5,14.8,-5800,-6,17.6,0,448,448,3291
2010,49,i) 16 to 20,3525,3975,74115,75501,140,3.4,324,8,7613,1970,5643,2.6,10.1,10385,1993,8392,2.6,13.8,-2772,-3.7,20.2,0,196,196,1208
2010,49,j) 21 to 25,2398,3186,71483,72015,108,3.4,175,5.4,7542,1876,5666,2.6,10.5,8605,1499,7106,2.1,11.9,-1063,-1.4,21,0,104,104,950
2010,49,k) 26+,3012,4559,114355,117072,200,4.3,298,6.5,11781,2914,8867,2.5,10.1,17214,4873,12341,4.2,14.7,-5433,-4.6,20.2,0,113,135,1575
2010,49,l) Left Censored,3559,10266,401206,408705,504,4.9,528,5.1,32497,9675,22822,2.4,8,47494,8572,38922,2.1,11.6,-14997,-3.6,16,0,79,79,1667
2010,50,a) 0,859,859,4185,2102,846,197,0,0,4166,,,,198.2,0,0,0,0,0,4166,198.2,0,1,,,
2010,50,b) 1,713,721,6640,6970,3,0.4,213,25.5,988,,,,14.2,1648,1055,593,15.1,23.6,-660,-9.4,28.4,1,140,140,799
2010,50,c) 2,725,731,4656,4844,38,4.9,151,19.3,647,95,552,2,13.4,1023,455,568,9.4,21.1,-376,-7.7,26.8,0,100,100,344
2010,50,d) 3,742,751,7643,7851,33,4.1,124,15.6,677,85,592,1.1,8.6,1092,397,695,5.1,13.9,-415,-5.3,17.2,0,88,88,322
2010,50,e) 4,687,707,4141,4293,28,3.7,117,15.6,574,68,506,1.6,13.4,878,415,463,9.7,20.5,-304,-7.1,26.8,0,80,80,357
2010,50,f) 5,619,630,4129,4195,34,5.2,84,12.9,664,123,541,2.9,15.8,795,292,503,7,19,-131,-3.2,31.6,0,58,58,197
2010,50,g) 6 to 10,2756,2835,26895,26661,128,4.4,263,9.1,3369,605,2764,2.3,12.6,2901,928,1973,3.5,10.9,468,1.7,21.8,0,164,164,719
2010,50,h) 11 to 15,2129,2243,18100,18207,67,2.9,183,8,2078,423,1655,2.3,11.4,2292,697,1595,3.8,12.6,-214,-1.2,22.8,0,116,116,406
2010,50,i) 16 to 20,1762,1932,15633,15929,61,3.1,131,6.7,1638,343,1295,2.2,10.3,2229,676,1553,4.2,14,-591,-3.7,20.6,0,71,71,313
2010,50,j) 21 to 25,1593,1740,27367,27563,69,3.9,115,6.5,1723,389,1334,1.4,6.3,2115,403,1712,1.5,7.7,-392,-1.4,12.6,0,65,65,277
2010,50,k) 26+,1668,2207,42788,43326,68,3.1,113,5.1,3514,934,2580,2.2,8.1,4589,945,3644,2.2,10.6,-1075,-2.5,16.2,0,64,68,605
2010,50,l) Left Censored,1991,3729,100155,101283,157,4.2,142,3.8,6484,1984,4500,2,6.4,8740,1281,7459,1.3,8.6,-2256,-2.2,12.8,0,52,54,562
2010,51,a) 0,9275,9466,55754,28083,9302,196.5,0,0,55342,55342,0,197.1,197.1,0,0,0,0,0,55342,197.1,0,0,,,
2010,51,b) 1,7756,7868,48867,52490,22,0.2,2321,25.5,12023,181,11842,0.3,22.9,19268,9712,9556,18.5,36.7,-7245,-13.8,45.8,0,1786,1786,8365
2010,51,c) 2,7836,7964,54011,55663,332,3.9,1625,18.9,9542,1236,8306,2.2,17.1,12846,5926,6920,10.6,23.1,-3304,-6,34.2,0,1249,1249,4739
2010,51,d) 3,7261,7354,52632,53961,285,3.6,1287,16.4,8937,1076,7861,2,16.6,11595,5184,6411,9.6,21.5,-2658,-4.9,33.2,0,980,980,4171
2010,51,e) 4,7118,7510,64043,65466,275,3.5,1180,14.9,9740,1087,8653,1.7,14.9,12585,5219,7366,8,19.2,-2845,-4.3,29.8,0,862,869,4254
2010,51,f) 5,6381,6605,56455,57749,243,3.5,951,13.7,8460,1224,7236,2.1,14.6,11048,4242,6806,7.3,19.1,-2588,-4.5,29.2,0,699,699,3611
2010,51,g) 6 to 10,23173,24418,248745,253243,863,3.4,2685,10.6,32649,4766,27883,1.9,12.9,41645,13621,28024,5.4,16.4,-8996,-3.5,25.8,0,1919,1919,10508
2010,51,h) 11 to 15,17114,18941,234613,243324,579,3,1629,8.4,24670,4142,20528,1.7,10.1,42092,17409,24683,7.2,17.3,-17422,-7.2,20.2,0,1072,1072,12342
2010,51,i) 16 to 20,12249,14084,202378,207403,439,3.1,1074,7.5,22775,5644,17131,2.7,11,32824,7945,24879,3.8,15.8,-10049,-4.8,22,0,652,653,4528
2010,51,j) 21 to 25,10402,13223,243117,247848,433,3.2,864,6.4,21181,5589,15592,2.3,8.5,30643,6257,24386,2.5,12.4,-9462,-3.9,17,0,500,500,3535
2010,51,k) 26+,10895,16829,361775,362798,669,4,861,5.1,38171,11016,27155,3,10.5,40216,10003,30213,2.8,11.1,-2045,-0.6,21,0,431,445,3704
2010,51,l) Left Censored,12536,40256,1330784,1345046,2285,5.7,2398,6,131091,41380,89711,3.1,9.7,159615,43393,116222,3.2,11.9,-28524,-2.2,19.4,0,325,333,3908
2010,53,a) 0,9711,9833,49030,24716,9627,195.8,0,0,48628,48628,0,196.7,196.7,0,0,0,0,0,48628,196.7,0,0,,,
2010,53,b) 1,7549,7620,43675,45933,23,0.3,2527,28.2,9524,301,9223,0.7,20.7,14039,8179,5860,17.8,30.6,-4515,-9.9,41.4,0,1902,1913,6623
2010,53,c) 2,7898,8015,47033,49605,392,4.5,1916,21.9,8947,1561,7386,3.1,18,14091,7002,7089,14.1,28.4,-5144,-10.4,36,0,1458,1458,5825
2010,53,d) 3,7349,7436,46282,48585,372,4.7,1473,18.5,7500,1408,6092,2.9,15.4,12105,5765,6340,11.9,24.9,-4605,-9.5,30.8,0,1084,1084,4652
2010,53,e) 4,7164,7495,54689,56501,355,4.5,1238,15.6,7733,1410,6323,2.5,13.7,11356,4137,7219,7.3,20.1,-3623,-6.4,27.4,0,888,888,3331
2010,53,f) 5,6255,6483,48605,50159,268,3.9,1001,14.7,7359,1476,5883,2.9,14.7,10467,4181,6286,8.3,20.9,-3108,-6.2,29.4,0,708,708,3341
2010,53,g) 6 to 10,22706,24074,214769,221182,1013,4.1,2832,11.4,28510,5837,22673,2.6,12.9,41335,13719,27616,6.2,18.7,-12825,-5.8,25.8,0,1951,1952,10017
2010,53,h) 11 to 15,16431,17937,195011,200681,700,3.8,1809,9.8,20712,4837,15875,2.4,10.3,32052,8778,23274,4.4,16,-11340,-5.7,20.6,0,1106,1107,6075
2010,53,i) 16 to 20,11790,13275,159974,165046,484,3.6,1106,8.2,15693,3965,11728,2.4,9.5,25836,6233,19603,3.8,15.7,-10143,-6.2,19,0,691,696,3958
2010,53,j) 21 to 25,8237,10210,186062,189443,300,2.9,639,6.2,16404,3980,12424,2.1,8.7,23166,4423,18743,2.3,12.2,-6762,-3.5,17.4,0,402,402,2508
2010,53,k) 26+,9959,15139,347980,349950,527,3.4,890,5.8,39225,14689,24536,4.2,11.2,43165,10264,32901,2.9,12.3,-3940,-1.1,22.4,0,411,421,3175
2010,53,l) Left Censored,10117,28411,915405,940324,1410,5,1380,4.9,68670,21742,46928,2.3,7.3,118508,21828,96680,2.3,12.6,-49838,-5.3,14.6,0,275,282,4147
2010,54,a) 0,1364,1424,11182,5648,1405,197.3,0,0,11069,11069,0,196,196,0,0,0,0,0,11069,196,0,0,,,
2010,54,b) 1,1164,1174,8074,8896,7,0.5,357,26.2,1528,54,1474,0.6,17.2,3172,1839,1333,20.7,35.7,-1644,-18.5,34.4,0,274,274,1574
2010,54,c) 2,1165,1187,9528,9693,44,3.4,263,20.3,2008,114,1894,1.2,20.7,2337,1262,1075,13,24.1,-329,-3.4,41.4,0,207,207,1097
2010,54,d) 3,1121,1131,9169,10018,36,2.9,227,18.6,1544,130,1414,1.3,15.4,3241,1892,1349,18.9,32.4,-1697,-17,30.8,0,168,168,1530
2010,54,e) 4,1187,1290,12707,12845,49,3.6,193,14.2,2149,550,1599,4.3,16.7,2424,1095,1329,8.5,18.9,-275,-2.2,33.4,0,139,139,840
2010,54,f) 5,1157,1198,10081,10187,44,3.5,156,12.4,1491,143,1348,1.4,14.6,1703,575,1128,5.6,16.7,-212,-2.1,29.2,0,120,120,468
2010,54,g) 6 to 10,4190,4462,39053,40037,128,2.8,427,9.3,4739,817,3922,2,11.8,6706,1848,4858,4.6,16.7,-1967,-4.9,23.6,0,326,326,1569
2010,54,h) 11 to 15,3321,3744,38794,39804,87,2.3,316,8.2,3823,475,3348,1.2,9.6,5842,1667,4175,4.2,14.7,-2019,-5.1,19.2,0,224,224,1270
2010,54,i) 16 to 20,2582,2906,30495,31075,100,3.4,226,7.6,3741,838,2903,2.7,12,4900,1008,3892,3.2,15.8,-1159,-3.8,24,0,137,137,612
2010,54,j) 21 to 25,2320,2799,50705,51947,63,2.2,131,4.6,3511,797,2714,1.5,6.8,5994,1324,4670,2.5,11.5,-2483,-4.7,13.6,0,93,93,651
2010,54,k) 26+,3115,4665,73560,74917,185,3.9,230,4.9,6887,2040,4847,2.7,9.2,9600,1792,7808,2.4,12.8,-2713,-3.6,18.4,0,123,143,901
2010,54,l) Left Censored,4259,9829,263268,267506,329,3.3,415,4.2,21792,5166,16626,1.9,8.1,30268,6131,24137,2.3,11.3,-8476,-3.2,16.2,0,121,121,2088
2010,55,a) 0,5613,5704,36142,18216,5596,196.2,0,0,35852,35852,0,196.8,196.8,0,0,0,0,0,35852,196.8,0,0,,,
2010,55,b) 1,4646,4696,30813,33153,12,0.2,1374,25.3,7014,60,6954,0.2,21.2,11694,6858,4836,20.7,35.3,-4680,-14.1,42.4,0,993,993,5322
2010,55,c) 2,4677,4775,33794,35309,183,3.6,929,18.1,4916,520,4396,1.5,13.9,7946,4138,3808,11.7,22.5,-3030,-8.6,27.8,0,716,718,3611
2010,55,d) 3,4510,4565,33592,35472,162,3.3,797,16.4,4843,662,4181,1.9,13.7,8602,4868,3734,13.7,24.3,-3759,-10.6,27.4,0,569,569,4163
2010,55,e) 4,4589,4926,42116,43968,186,3.6,673,13.1,4623,779,3844,1.8,10.5,8326,3000,5326,6.8,18.9,-3703,-8.4,21,0,477,477,2195
2010,55,f) 5,4140,4251,34731,35647,147,3.3,584,13.1,4442,533,3909,1.5,12.5,6273,2391,3882,6.7,17.6,-1831,-5.1,25,0,425,425,1887
2010,55,g) 6 to 10,16610,17528,173513,176668,574,3.2,1837,10.1,19419,2702,16717,1.5,11,25729,8437,17292,4.8,14.6,-6310,-3.6,22,0,1268,1268,6507
2010,55,h) 11 to 15,13266,14610,168014,169664,458,3.1,1190,8,20539,4651,15888,2.7,12.1,23839,8254,15585,4.9,14.1,-3300,-2,24.2,0,753,753,4622
2010,55,i) 16 to 20,10702,11848,141269,145809,415,3.4,920,7.6,12784,2255,10529,1.5,8.8,21863,6754,15109,4.6,15,-9079,-6.2,17.6,0,532,532,2637
2010,55,j) 21 to 25,8048,10252,185449,186277,315,3,536,5.2,16232,3977,12255,2.1,8.7,17888,2931,14957,1.6,9.6,-1656,-0.9,17.4,0,301,301,1798
2010,55,k) 26+,9486,13823,271772,276131,381,2.7,661,4.7,22474,5188,17286,1.9,8.1,31192,8359,22833,3,11.3,-8718,-3.2,16.2,0,343,343,5747
2010,55,l) Left Censored,13546,31485,1167874,1182008,1169,3.7,1193,3.8,80266,18897,61369,1.6,6.8,108534,19724,88810,1.7,9.2,-28268,-2.4,13.6,0,345,348,5024
2010,56,a) 0,1047,1050,4967,2506,1027,195.6,0,0,4922,4922,0,196.4,196.4,0,0,0,0,0,4922,196.4,0,0,,,
2010,56,b) 1,920,932,4734,5251,5,0.5,310,28.3,921,31,890,0.6,17.5,1954,1098,856,20.9,37.2,-1033,-19.7,35,0,218,218,766
2010,56,c) 2,916,928,4727,5130,37,3.7,198,19.7,719,103,616,2,14,1525,744,781,14.5,29.7,-806,-15.7,28,0,146,146,483
2010,56,d) 3,903,911,5172,5524,30,3,181,18.4,955,159,796,2.9,17.3,1658,569,1089,10.3,30,-703,-12.7,34.6,0,129,129,459
2010,56,e) 4,861,895,5948,6385,28,2.9,151,15.8,692,82,610,1.3,10.8,1566,616,950,9.6,24.5,-874,-13.7,21.6,0,97,97,403
2010,56,f) 5,699,720,4678,4969,24,3.1,127,16.5,574,71,503,1.4,11.6,1155,519,636,10.4,23.2,-581,-11.6,23.2,0,96,96,454
2010,56,g) 6 to 10,2779,2837,20554,21611,104,3.5,350,11.8,2321,401,1920,1.9,10.7,4435,1248,3187,5.8,20.5,-2114,-9.8,21.4,0,215,215,866
2010,56,h) 11 to 15,1963,2086,16192,17377,78,3.6,183,8.6,1631,351,1280,2,9.4,4000,1533,2467,8.8,23,-2369,-13.6,18.8,0,116,116,742
2010,56,i) 16 to 20,1334,1426,13333,13649,35,2.4,131,8.9,1279,109,1170,0.8,9.4,1910,455,1455,3.3,14,-631,-4.6,18.8,0,91,91,368
2010,56,j) 21 to 25,965,1152,19026,19350,23,2,55,4.7,1565,377,1188,1.9,8.1,2213,171,2042,0.9,11.4,-648,-3.3,16.2,0,33,33,109
2010,56,k) 26+,1424,1936,28353,29031,55,2.8,105,5.4,2440,579,1861,2,8.4,3795,533,3262,1.8,13.1,-1355,-4.7,16.8,0,47,47,170
2010,56,l) Left Censored,1582,3142,69691,71251,131,4.2,148,4.7,5711,1302,4409,1.8,8,8830,1513,7317,2.1,12.4,-3119,-4.4,16,0,30,30,218
2011,01,a) 0,4478,4533,27738,13971,4475,197.4,0,0,27535,27535,0,197.1,197.1,0,0,0,0,0,27535,197.1,0,0,,,
2011,01,b) 1,3333,3450,26324,28329,39,1,1054,26.6,5775,386,5389,1.4,20.4,9784,5588,4196,19.7,34.5,-4009,-14.1,40.8,0,825,825,4923
2011,01,c) 2,3189,3392,24618,24926,129,3.5,706,19.3,5040,588,4452,2.4,20.2,5656,3088,2568,12.4,22.7,-616,-2.5,40.4,0,554,554,2361
2011,01,d) 3,3167,3255,26445,26477,109,3.1,624,17.9,4714,947,3767,3.6,17.8,4778,2470,2308,9.3,18,-64,-0.2,35.6,0,494,494,2092
2011,01,e) 4,3165,3239,25977,27530,99,2.9,585,16.9,4095,354,3741,1.3,14.9,7200,4475,2725,16.3,26.2,-3105,-11.3,29.8,0,432,432,2329
2011,01,f) 5,2867,3065,27201,27909,96,3,476,14.7,3746,422,3324,1.5,13.4,5162,2391,2771,8.6,18.5,-1416,-5.1,26.8,0,351,351,1798
2011,01,g) 6 to 10,11389,12152,130852,131862,357,2.8,1500,11.8,18021,2592,15429,2,13.7,20041,7649,12392,5.8,15.2,-2020,-1.5,27.4,0,1059,1059,5517
2011,01,h) 11 to 15,8986,10056,129636,127314,357,3.5,923,9,21303,8907,12396,7,16.7,16658,4778,11880,3.8,13.1,4645,3.6,26.2,0,638,638,3615
2011,01,i) 16 to 20,6530,7441,103030,103911,204,2.7,656,8.6,11095,1839,9256,1.8,10.7,12857,3099,9758,3,12.4,-1762,-1.7,21.4,0,437,437,2201
2011,01,j) 21 to 25,5253,6663,134850,136621,217,3.2,459,6.8,10780,1726,9054,1.3,7.9,14322,2950,11372,2.2,10.5,-3542,-2.6,15.8,0,287,287,1675
2011,01,k) 26+,7576,11525,225394,228037,435,3.7,677,5.8,20880,6615,14265,2.9,9.2,26165,5863,20302,2.6,11.5,-5285,-2.3,18.4,0,330,346,2432
2011,01,l) Left Censored,7416,21780,678565,679149,859,3.9,1024,4.7,59559,12340,47219,1.8,8.8,60726,14165,46561,2.1,8.9,-1167,-0.1,17.6,0,230,238,1154
2011,02,a) 0,941,953,4178,2116,929,195,0,0,4124,,,,194.9,0,0,0,0,0,4124,194.9,0,1,,,
2011,02,b) 1,695,711,4161,4465,2,0.2,281,33,1016,,,,22.8,1624,804,820,18,36.4,-608,-13.6,45.6,1,170,170,517
2011,02,c) 2,690,725,4741,4711,48,6.3,138,18.1,1185,355,830,7.5,25.2,1124,388,736,8.2,23.9,61,1.3,47.8,0,88,88,246
2011,02,d) 3,686,710,4631,4644,39,5.2,124,16.6,867,138,729,3,18.7,892,411,481,8.9,19.2,-25,-0.5,37.4,0,83,83,255
2011,02,e) 4,649,665,4809,4831,35,5,103,14.8,832,108,724,2.2,17.2,876,323,553,6.7,18.1,-44,-0.9,34.4,0,61,61,178
2011,02,f) 5,598,629,5491,5494,30,4.6,82,12.6,855,63,792,1.1,15.6,860,300,560,5.5,15.7,-5,-0.1,31.2,0,48,48,221
2011,02,g) 6 to 10,2353,2465,20278,20609,106,4.2,295,11.6,3107,328,2779,1.6,15.1,3768,1529,2239,7.4,18.3,-661,-3.2,30.2,0,167,172,990
2011,02,h) 11 to 15,1737,1907,28923,29337,60,3,207,10.5,2486,316,2170,1.1,8.5,3313,1499,1814,5.1,11.3,-827,-2.8,17,0,124,124,1056
2011,02,i) 16 to 20,1250,1341,10862,11307,51,3.7,110,8,1161,201,960,1.8,10.3,2050,417,1633,3.7,18.1,-889,-7.8,20.6,0,55,55,180
2011,02,j) 21 to 25,1010,1225,23284,23419,110,9.2,63,5.3,3323,1304,2019,5.6,14.2,3592,506,3086,2.2,15.3,-269,-1.1,28.4,0,33,33,211
2011,02,k) 26+,1521,2407,48006,48618,118,4.9,117,4.9,5484,1557,3927,3.2,11.3,6707,1506,5201,3.1,13.8,-1223,-2.5,22.6,0,50,50,222
2011,02,l) Left Censored,1228,3240,94539,94152,119,3.7,110,3.4,7788,1618,6170,1.7,8.3,7013,1077,5936,1.1,7.4,775,0.9,14.8,0,22,22,134
2011,04,a) 0,7834,7920,46816,23609,7789,196.7,0,0,46415,46415,0,196.6,196.6,0,0,0,0,0,46415,196.6,0,0,,,
2011,04,b) 1,5478,5604,47647,54292,28,0.4,2144,32.2,10824,845,9979,1.6,19.9,24113,10025,14088,18.5,44.4,-13289,-24.5,39.8,0,1618,1618,8031
2011,04,c) 2,4989,5097,44885,46834,211,3.8,1223,22,7396,941,6455,2,15.8,11293,6321,4972,13.5,24.1,-3897,-8.3,31.6,0,932,932,5396
2011,04,d) 3,5248,5465,45011,46122,264,4.5,1220,20.7,9175,1122,8053,2.4,19.9,11396,6122,5274,13.3,24.7,-2221,-4.8,39.8,0,939,939,5262
2011,04,e) 4,4986,5119,40131,41238,269,5,979,18,6866,1517,5349,3.7,16.6,9079,4695,4384,11.4,22,-2213,-5.4,33.2,0,741,745,3987
2011,04,f) 5,4898,5099,49920,49798,224,4.2,863,16,9104,1142,7962,2.3,18.3,8859,4245,4614,8.5,17.8,245,0.5,35.6,0,634,634,3489
2011,04,g) 6 to 10,16466,17654,188136,191169,751,4.1,2509,13.6,24736,3976,20760,2.1,12.9,30801,12819,17982,6.7,16.1,-6065,-3.2,25.8,0,1756,1756,10015
2011,04,h) 11 to 15,10994,12200,168805,171741,504,4,1358,10.8,20895,5680,15215,3.3,12.2,26767,11329,15438,6.6,15.6,-5872,-3.4,24.4,0,917,919,8776
2011,04,i) 16 to 20,7027,8250,127335,128637,413,4.9,793,9.4,16132,5805,10327,4.5,12.5,18735,6398,12337,5,14.6,-2603,-2.1,25,0,510,510,3649
2011,04,j) 21 to 25,5359,8078,156377,156767,273,3.3,599,7.3,16173,3120,13053,2,10.3,16952,4922,12030,3.1,10.8,-779,-0.5,20.6,0,345,357,2958
2011,04,k) 26+,6713,11238,290428,282054,460,4,773,6.8,46310,9797,36513,3.5,16.4,29561,6489,23072,2.3,10.5,16749,5.9,21,0,336,345,2552
2011,04,l) Left Censored,5518,22465,873047,862319,1471,6.6,1372,6.1,103099,27239,75860,3.2,12,81643,20465,61178,2.4,9.5,21456,2.5,19,0,143,163,1790
2011,05,a) 0,3231,3263,20072,10131,3213,196.9,0,0,19883,19883,0,196.3,196.3,0,0,0,0,0,19883,196.3,0,0,,,
2011,05,b) 1,2393,2466,18808,20596,23,0.8,795,27.9,4323,313,4010,1.5,21,7899,4660,3239,22.6,38.4,-3576,-17.4,42,0,598,598,3669
2011,05,c) 2,2224,2311,17185,17964,98,4,477,19.2,2768,442,2326,2.5,15.4,4326,2136,2190,11.9,24.1,-1558,-8.7,30.8,0,371,371,1714
2011,05,d) 3,2159,2181,16308,16995,80,3.4,444,18.9,2660,630,2030,3.7,15.7,4034,1959,2075,11.5,23.7,-1374,-8,31.4,0,347,347,1405
2011,05,e) 4,2047,2095,18164,18356,92,4.1,369,16.6,3011,339,2672,1.8,16.4,3395,1722,1673,9.4,18.5,-384,-2.1,32.8,0,268,268,1303
2011,05,f) 5,2071,2247,18070,18482,70,3,324,13.7,2544,440,2104,2.4,13.8,3367,1638,1729,8.9,18.2,-823,-4.4,27.6,0,223,223,1223
2011,05,g) 6 to 10,8027,8550,74359,75362,252,2.8,972,11,9463,1286,8177,1.7,12.6,11469,4917,6552,6.5,15.2,-2006,-2.6,25.2,0,673,673,3589
2011,05,h) 11 to 15,5729,6499,65073,66172,202,3,603,9,6887,918,5969,1.4,10.4,9084,3016,6068,4.6,13.7,-2197,-3.3,20.8,0,389,389,1933
2011,05,i) 16 to 20,4382,4941,54333,54483,138,2.7,434,8.6,6061,864,5197,1.6,11.1,6361,1671,4690,3.1,11.7,-300,-0.6,22.2,0,295,296,1229
2011,05,j) 21 to 25,3182,3909,72842,72758,127,3.2,309,7.7,7728,1893,5835,2.6,10.6,7560,2632,4928,3.6,10.4,168,0.2,20.8,0,201,207,1195
2011,05,k) 26+,4949,7172,148477,147459,239,3.3,397,5.5,15407,2150,13257,1.5,10.4,13370,2962,10408,2,9.1,2037,1.3,18.2,0,241,249,1629
2011,05,l) Left Censored,5047,13802,448730,447194,661,4.8,613,4.5,44396,12616,31780,2.8,9.9,41323,8191,33132,1.8,9.2,3073,0.7,18.4,0,142,142,1815
2011,06,a) 0,51633,52262,298377,150088,51629,197.6,0,0,296578,296578,0,197.6,197.6,0,0,0,0,0,296578,197.6,0,0,,,
2011,06,b) 1,36725,37611,272691,288073,230,0.5,12647,28.9,67183,4647,62536,1.6,23.3,97947,58724,39223,20.4,34,-30764,-10.7,46.6,0,9103,9103,46061
2011,06,c) 2,33923,34498,248851,255925,1655,4.5,7404,20,50591,7825,42766,3.1,19.8,64739,36412,28327,14.2,25.3,-14148,-5.5,39.6,0,5545,5549,28685
2011,06,d) 3,34051,34856,263999,271237,1636,4.4,6364,17.2,47335,6545,40790,2.4,17.5,61810,32845,28965,12.1,22.8,-14475,-5.3,35,0,4724,4724,25856
2011,06,e) 4,31714,32237,249391,256360,1453,4.3,5382,15.8,40362,5953,34409,2.3,15.7,54300,25065,29235,9.8,21.2,-13938,-5.5,31.4,0,3897,3897,20290
2011,06,f) 5,31602,33130,293024,300017,1483,4.3,5156,14.8,44796,9610,35186,3.2,14.9,58781,28987,29794,9.7,19.6,-13985,-4.7,29.8,0,3646,3649,21278
2011,06,g) 6 to 10,113533,120660,1225178,1244296,4864,3.9,14920,11.9,166869,28066,138803,2.3,13.4,205104,84540,120564,6.8,16.5,-38235,-3.1,26.8,0,10238,10281,60402
2011,06,h) 11 to 15,74121,81664,1061724,1069422,3102,3.7,8020,9.6,131829,25482,106347,2.4,12.3,147224,52163,95061,4.9,13.8,-15395,-1.5,24.6,0,5313,5330,36615
2011,06,i) 16 to 20,48478,55233,788956,802615,2112,3.7,4833,8.6,79804,14727,65077,1.8,9.9,107121,31224,75897,3.9,13.3,-27317,-3.4,19.8,0,3155,3171,21695
2011,06,j) 21 to 25,43449,55421,1102144,1093893,1873,3.3,4298,7.6,126083,18746,107337,1.7,11.5,109582,33472,76110,3.1,10,16501,1.5,20,0,2579,2591,18061
2011,06,k) 26+,54413,82994,1910933,1903170,2955,3.5,5353,6.4,221026,48894,172132,2.6,11.6,205501,66261,139240,3.5,10.8,15525,0.8,21.6,0,2746,2768,23375
2011,06,l) Left Censored,39295,130256,4849136,4832400,7152,5.5,7073,5.4,509932,122547,387385,2.5,10.6,476459,123876,352583,2.6,9.9,33473,0.7,19.8,0,1582,1651,26196
2011,08,a) 0,9105,9180,47968,24195,9040,196.9,0,0,47546,47546,0,196.5,196.5,0,0,0,0,0,47546,196.5,0,0,,,
2011,08,b) 1,6620,6714,43228,46484,33,0.4,2538,31.9,10946,352,10594,0.8,23.5,17460,10244,7216,22,37.6,-6514,-14.1,47,0,1762,1762,7956
2011,08,c) 2,5948,6027,39497,40280,325,5,1354,20.9,8046,1289,6757,3.2,20,9612,4827,4785,12,23.9,-1566,-3.9,40,0,962,962,3933
2011,08,d) 3,6122,6215,42314,42681,360,5.5,1180,17.9,7957,1822,6135,4.3,18.6,8690,4501,4189,10.5,20.4,-733,-1.8,37.2,0,849,849,3785
2011,08,e) 4,5717,5795,44515,44679,319,5.2,991,16.3,7715,831,6884,1.9,17.3,8043,4018,4025,9,18,-328,-0.7,34.6,0,670,670,3097
2011,08,f) 5,5478,5679,44586,44804,304,5.1,885,14.9,7459,1419,6040,3.2,16.6,7894,3574,4320,8,17.6,-435,-1,33.2,0,579,579,2701
2011,08,g) 6 to 10,20492,21445,185090,188674,1007,4.5,2864,12.9,24835,4569,20266,2.4,13.2,32003,13116,18887,7,17,-7168,-3.8,26.4,0,1827,1828,9843
2011,08,h) 11 to 15,14049,15256,159857,161521,662,4.2,1759,11.2,19737,3412,16325,2.1,12.2,23065,8717,14348,5.4,14.3,-3328,-2.1,24.4,0,995,996,5902
2011,08,i) 16 to 20,9394,10474,133571,134738,444,4.1,1050,9.8,16910,4286,12624,3.2,12.6,19244,6846,12398,5.1,14.3,-2334,-1.7,25.2,0,628,630,5170
2011,08,j) 21 to 25,6526,8393,144870,145183,292,3.4,618,7.2,14482,2614,11868,1.8,10,15108,3720,11388,2.6,10.4,-626,-0.4,20,0,356,356,1715
2011,08,k) 26+,8502,12869,272939,276607,503,3.9,855,6.6,28566,5924,22642,2.1,10.3,35901,9555,26346,3.5,13,-7335,-2.7,20.6,0,419,424,2917
2011,08,l) Left Censored,7101,22433,785576,780314,1342,6,1239,5.5,86117,20679,65438,2.7,11,75593,14998,60595,1.9,9.7,10524,1.3,19.4,0,224,225,2825
2011,09,a) 0,3780,3798,22776,11443,3757,197.8,0,0,22667,22667,0,198.1,198.1,0,0,0,0,0,22667,198.1,0,0,,,
2011,09,b) 1,2888,2963,22720,23779,12,0.4,916,26.8,5322,177,5145,0.7,22.4,7440,3720,3720,15.6,31.3,-2118,-8.9,44.8,0,640,640,2865
2011,09,c) 2,2657,2673,20691,20878,107,3.7,536,18.7,3720,478,3242,2.3,17.8,4094,2056,2038,9.8,19.6,-374,-1.8,35.6,0,416,416,1701
2011,09,d) 3,2783,2832,21652,21810,118,3.9,475,15.9,3583,331,3252,1.5,16.4,3898,1714,2184,7.9,17.9,-315,-1.5,32.8,0,357,357,1400
2011,09,e) 4,2443,2476,20707,20845,96,3.7,381,14.6,2948,246,2702,1.2,14.1,3223,1432,1791,6.9,15.5,-275,-1.4,28.2,0,268,268,1096
2011,09,f) 5,2522,2700,24958,25447,102,3.6,405,14.3,3213,368,2845,1.4,12.6,4190,2112,2078,8.3,16.5,-977,-3.9,25.2,0,279,279,1468
2011,09,g) 6 to 10,9770,10198,97535,99306,369,3.5,1142,10.8,11757,1627,10130,1.6,11.8,15298,5310,9988,5.3,15.4,-3541,-3.6,23.6,0,819,819,4258
2011,09,h) 11 to 15,7809,8453,109779,109585,262,3,775,8.9,13065,1741,11324,1.6,11.9,12676,3825,8851,3.5,11.6,389,0.3,23.2,0,499,499,2731
2011,09,i) 16 to 20,6038,6502,74904,76359,165,2.5,595,8.9,7036,689,6347,0.9,9.2,9945,3550,6395,4.6,13,-2909,-3.8,18.4,0,358,366,2252
2011,09,j) 21 to 25,5902,6918,116811,116902,197,2.8,537,7.6,10426,1706,8720,1.5,8.9,10607,3028,7579,2.6,9.1,-181,-0.2,17.8,0,329,329,2094
2011,09,k) 26+,7465,10272,186334,185218,285,2.7,616,5.9,18590,4680,13910,2.5,10,16357,3540,12817,1.9,8.8,2233,1.2,17.6,0,331,331,1528
2011,09,l) Left Censored,9274,19598,723890,728072,819,4.2,1068,5.4,60512,16711,43801,2.3,8.3,68875,20316,48559,2.8,9.5,-8363,-1.2,16.6,0,270,270,3394
2011,10,a) 0,1223,1227,7427,3735,1212,197.6,0,0,7384,,,,197.7,0,0,0,0,0,7384,197.7,0,1,,,
2011,10,b) 1,837,844,6502,7300,2,0.2,318,31.7,1524,,,,20.9,3120,2001,1119,27.4,42.7,-1596,-21.8,41.8,1,226,226,1617
2011,10,c) 2,818,831,6449,6665,25,2.8,160,17.9,986,73,913,1.1,14.8,1417,780,637,11.7,21.3,-431,-6.5,29.6,0,126,126,707
2011,10,d) 3,843,860,6485,6624,31,3.4,152,16.6,854,117,737,1.8,12.9,1132,480,652,7.2,17.1,-278,-4.2,25.8,0,104,104,318
2011,10,e) 4,710,748,7027,7008,40,5.1,120,15.3,1304,107,1197,1.5,18.6,1265,708,557,10.1,18.1,39,0.5,36.2,0,95,95,333
2011,10,f) 5,727,746,6385,6613,23,2.9,118,15,664,55,609,0.8,10,1120,488,632,7.4,16.9,-456,-6.9,20,0,77,77,363
2011,10,g) 6 to 10,2867,2967,26229,26706,99,3.2,387,12.5,2925,212,2713,0.8,11,3878,1425,2453,5.3,14.5,-953,-3.5,22,0,282,282,1081
2011,10,h) 11 to 15,2079,2246,23415,23935,75,3.3,206,8.9,3087,462,2625,1.9,12.9,4127,1114,3013,4.7,17.2,-1040,-4.3,25.8,0,132,132,827
2011,10,i) 16 to 20,1497,1705,21930,22458,57,3.3,123,7.1,2075,433,1642,1.9,9.2,3130,604,2526,2.7,13.9,-1055,-4.7,18.4,0,76,76,440
2011,10,j) 21 to 25,1283,1482,22661,22431,47,3.1,106,7,2356,319,2037,1.4,10.5,1895,485,1410,2.2,8.4,461,2.1,16.8,0,56,56,197
2011,10,k) 26+,1612,2239,50084,49387,56,2.5,126,5.5,5022,985,4037,2,10.2,3627,938,2689,1.9,7.3,1395,2.9,14.6,0,63,63,474
2011,10,l) Left Censored,2440,5463,176586,178227,322,5.9,384,7,16551,4365,12186,2.4,9.3,19832,5698,14134,3.2,11.1,-3281,-1.8,18.6,0,53,53,242
2011,11,a) 0,980,984,6720,3431,966,196.3,0,0,6579,,,,191.8,0,0,0,0,0,6579,191.8,0,1,,,
2011,11,b) 1,754,769,7300,7470,7,0.8,208,23.9,2097,,,,28.1,2436,1601,835,21.4,32.6,-339,-4.5,56.2,1,152,152,1095
2011,11,c) 2,649,649,6172,5862,22,3.2,87,12.8,1673,238,1435,4.1,28.5,1053,548,505,9.3,18,620,10.5,36,0,56,56,339
2011,11,d) 3,593,602,6494,6570,25,3.9,104,16.3,1046,168,878,2.6,15.9,1197,478,719,7.3,18.2,-151,-2.3,31.8,0,71,71,371
2011,11,e) 4,624,636,6547,6377,24,3.7,67,10.2,1181,218,963,3.4,18.5,840,369,471,5.8,13.2,341,5.3,26.4,0,48,48,288
2011,11,f) 5,595,612,6623,6529,21,3.3,82,12.8,1126,206,920,3.2,17.2,937,410,527,6.3,14.4,189,2.8,28.8,0,56,56,305
2011,11,g) 6 to 10,2361,2459,32758,32205,83,3.3,229,9.1,4905,865,4040,2.7,15.2,3799,1657,2142,5.1,11.8,1106,3.4,23.6,0,161,161,1341
2011,11,h) 11 to 15,1856,2055,38353,38568,58,2.8,167,7.9,4100,356,3744,0.9,10.6,4529,1033,3496,2.7,11.7,-429,-1.1,21.2,0,112,112,829
2011,11,i) 16 to 20,1359,1500,29730,30112,44,2.9,99,6.5,3042,205,2837,0.7,10.1,3805,1398,2407,4.6,12.6,-763,-2.5,20.2,0,69,69,955
2011,11,j) 21 to 25,1193,1404,26457,26525,62,4.4,79,5.6,3592,1105,2487,4.2,13.5,3727,805,2922,3,14.1,-135,-0.6,27,0,49,49,479
2011,11,k) 26+,1928,2583,87017,88220,115,4.4,138,5.3,5070,979,4091,1.1,5.7,7476,979,6497,1.1,8.5,-2406,-2.8,11.4,0,52,52,276
2011,11,l) Left Censored,2824,5941,237595,232660,439,7.4,350,5.9,28153,7552,20601,3.2,12.1,18284,2710,15574,1.2,7.9,9869,4.2,15.8,0,38,38,380
2011,12,a) 0,35655,36046,194813,98104,35545,197.2,0,0,193419,193419,0,197.2,197.2,0,0,0,0,0,193419,197.2,0,0,,,
2011,12,b) 1,24686,25150,173343,188725,89,0.3,9451,31.7,40105,4373,35732,2.3,21.3,70869,38530,32339,20.4,37.6,-30764,-16.3,42.6,0,6985,6985,30820
2011,12,c) 2,20659,20946,137806,155701,909,4,5083,22.2,25516,3010,22506,1.9,16.4,61306,34472,26834,22.1,39.4,-35790,-23,32.8,0,3863,3863,30386
2011,12,d) 3,20148,20496,129363,137839,1091,5,4336,19.7,22470,4454,18016,3.2,16.3,39421,25429,13992,18.4,28.6,-16951,-12.3,32.6,0,3219,3221,17812
2011,12,e) 4,18762,19228,132287,141182,1053,5.2,3763,18.4,19655,3223,16432,2.3,13.9,37444,23415,14029,16.6,26.5,-17789,-12.6,27.8,0,2736,2736,10425
2011,12,f) 5,18055,18627,143391,141361,1004,5.1,3400,17.3,29552,3195,26357,2.3,20.9,25491,12963,12528,9.2,18,4061,2.9,36,0,2412,2412,10150
2011,12,g) 6 to 10,67433,70555,617785,633371,3353,4.6,10498,14.3,94815,15492,79323,2.4,15,125986,54527,71459,8.6,19.9,-31171,-4.9,30,0,7239,7244,38088
2011,12,h) 11 to 15,40953,44984,556455,572531,1949,4.2,4879,10.6,88507,16826,71681,2.9,15.5,120659,46195,74464,8.1,21.1,-32152,-5.6,31,0,3204,3205,23210
2011,12,i) 16 to 20,29095,33017,460429,463254,1444,4.3,3110,9.2,57596,10480,47116,2.3,12.4,63246,18723,44523,4,13.7,-5650,-1.3,24.8,0,1988,2006,13307
2011,12,j) 21 to 25,21847,28282,531661,529189,1169,4.1,2275,7.9,90662,39938,50724,7.5,17.1,85717,43312,42405,8.2,16.2,4945,0.9,32.4,0,1276,1293,35150
2011,12,k) 26+,23796,37595,801681,800889,1517,4,2531,6.7,93669,35068,58601,4.4,11.7,92085,28479,63606,3.6,11.5,1584,0.2,23,0,1315,1346,8272
2011,12,l) Left Censored,17194,70901,2643002,2613981,4508,6.4,4174,5.9,311391,75587,235804,2.9,11.9,253351,68656,184695,2.6,9.7,58040,2.2,19.4,0,645,662,7014
2011,13,a) 0,12425,12548,73142,36814,12392,197.5,0,0,72657,72657,0,197.4,197.4,0,0,0,0,0,72657,197.4,0,0,,,
2011,13,b) 1,9035,9186,60977,65110,55,0.5,3195,29.7,15580,701,14879,1.1,23.9,23845,14911,8934,22.9,36.6,-8265,-12.7,47.8,0,2348,2348,12423
2011,13,c) 2,8120,8495,78308,76396,346,3.8,1830,20,20947,1601,19346,2.1,27.4,17122,9984,7138,13.1,22.4,3825,5,44.8,0,1397,1397,8242
2011,13,d) 3,8481,8665,61031,62702,387,4.2,1676,18.1,10301,1268,9033,2,16.4,13643,7572,6071,12.1,21.8,-3342,-5.4,32.8,0,1247,1247,6635
2011,13,e) 4,7937,8146,60249,61617,402,4.7,1487,17.2,9980,1759,8221,2.9,16.2,12716,6953,5763,11.3,20.6,-2736,-4.4,32.4,0,1052,1052,5497
2011,13,f) 5,7240,7583,66340,68154,334,4.2,1302,16.2,10079,1454,8625,2.1,14.8,13707,6296,7411,9.2,20.1,-3628,-5.3,29.6,0,938,938,4992
2011,13,g) 6 to 10,27602,29280,317661,321579,1101,3.6,3892,12.8,49838,6043,43795,1.9,15.5,57674,24319,33355,7.6,17.9,-7836,-2.4,31,0,2703,2710,18841
2011,13,h) 11 to 15,19223,21430,272642,279325,859,3.9,2375,10.7,33875,8210,25665,2.9,12.1,47242,21941,25301,7.9,16.9,-13367,-4.8,24.2,0,1507,1518,9309
2011,13,i) 16 to 20,12575,14671,205928,212888,492,3.3,1383,9.2,21987,4288,17699,2,10.3,35906,13667,22239,6.4,16.9,-13919,-6.6,20.6,0,886,889,6771
2011,13,j) 21 to 25,9434,12378,254562,251746,426,3.4,946,7.5,30347,7164,23183,2.8,12.1,24714,8691,16023,3.5,9.8,5633,2.3,19.6,0,580,581,3568
2011,13,k) 26+,12148,18933,419278,419045,757,4,1148,6,44727,8488,36239,2,10.7,44261,11881,32380,2.8,10.6,466,0.1,21.2,0,625,634,4104
2011,13,l) Left Censored,11358,40017,1450304,1451658,2150,5.4,2191,5.5,147474,43437,104037,3,10.2,150182,37287,112895,2.6,10.3,-2708,-0.1,20.4,0,395,401,7094
2011,15,a) 0,1383,1389,9597,4843,1372,197.6,0,0,9508,,,,196.3,0,0,0,0,0,9508,196.3,0,1,,,
2011,15,b) 1,1032,1046,8765,9278,3,0.2,335,27.6,2222,,,,23.9,3248,1852,1396,20,35,-1026,-11.1,47.8,1,260,260,1597
2011,15,c) 2,988,1008,10566,11073,48,4.5,206,19.1,1516,159,1357,1.4,13.7,2529,921,1608,8.3,22.8,-1013,-9.1,27.4,0,167,167,795
2011,15,d) 3,974,992,7023,7197,36,3.4,166,15.7,1050,120,930,1.7,14.6,1397,698,699,9.7,19.4,-347,-4.8,29.2,0,132,132,614
2011,15,e) 4,1027,1034,8809,9244,26,2.4,170,15.5,935,85,850,0.9,10.1,1804,792,1012,8.6,19.5,-869,-9.4,20.2,0,128,128,549
2011,15,f) 5,946,1013,9200,9412,44,4.1,150,14.1,1157,126,1031,1.3,12.3,1580,716,864,7.6,16.8,-423,-4.5,24.6,0,119,119,577
2011,15,g) 6 to 10,3806,4082,42045,42568,125,3,440,10.4,5001,535,4466,1.3,11.7,6046,2490,3556,5.8,14.2,-1045,-2.5,23.4,0,315,316,2135
2011,15,h) 11 to 15,2763,3029,34221,34294,96,3.1,255,8.2,4010,626,3384,1.8,11.7,4155,1162,2993,3.4,12.1,-145,-0.4,23.4,0,169,169,814
2011,15,i) 16 to 20,2079,2327,35146,35457,61,2.6,199,8.3,3530,201,3329,0.6,10,4152,1941,2211,5.5,11.7,-622,-1.7,20,0,129,129,1198
2011,15,j) 21 to 25,1823,2315,39039,39639,50,2.1,178,7.5,2699,433,2266,1.1,6.8,3898,1151,2747,2.9,9.8,-1199,-3,13.6,0,107,107,647
2011,15,k) 26+,2763,3982,68844,68764,133,3.3,199,5,5341,1231,4110,1.8,7.8,5180,1148,4032,1.7,7.5,161,0.3,15,0,112,114,820
2011,15,l) Left Censored,2860,6703,208238,206387,347,5.2,335,5,21391,6399,14992,3.1,10.4,17689,4249,13440,2.1,8.6,3702,1.8,17.2,0,69,70,236
2011,16,a) 0,2279,2308,11335,5715,2266,196.4,0,0,11241,11241,0,196.7,196.7,0,0,0,0,0,11241,196.7,0,0,,,
2011,16,b) 1,1610,1649,9288,10368,19,1,671,34,2181,240,1941,2.3,21,4341,2667,1674,25.7,41.9,-2160,-20.9,42,0,425,425,2012
2011,16,c) 2,1543,1560,10760,11116,78,4.6,379,22.4,3347,469,2878,4.2,30.1,4058,2913,1145,26.2,36.5,-711,-6.4,60.2,0,279,279,2634
2011,16,d) 3,1782,1807,10457,11010,83,4.3,382,19.7,1998,342,1656,3.1,18.1,3104,1449,1655,13.2,28.2,-1106,-10.1,36.2,0,266,266,1179
2011,16,e) 4,1755,1777,10980,11988,111,5.8,403,21.1,1618,297,1321,2.5,13.5,3633,1221,2412,10.2,30.3,-2015,-16.8,27,0,263,263,891
2011,16,f) 5,1772,1838,13203,13693,102,5.2,376,19.1,1727,274,1453,2,12.6,2707,1109,1598,8.1,19.8,-980,-7.2,25.2,0,237,237,699
2011,16,g) 6 to 10,5976,6305,59872,61737,243,3.7,991,14.9,7069,701,6368,1.1,11.5,10798,4489,6309,7.3,17.5,-3729,-6,23,0,636,636,3335
2011,16,h) 11 to 15,4243,4557,46709,48783,181,3.9,492,10.5,4613,786,3827,1.6,9.5,8761,2406,6355,4.9,18,-4148,-8.5,19,0,269,269,1450
2011,16,i) 16 to 20,2716,2910,27356,27855,115,3.8,332,11,3049,411,2638,1.5,10.9,4047,1192,2855,4.3,14.5,-998,-3.6,21.8,0,177,180,667
2011,16,j) 21 to 25,1914,2380,34653,35194,99,4.1,210,8.6,2989,762,2227,2.2,8.5,4070,1111,2959,3.2,11.6,-1081,-3.1,17,0,118,118,626
2011,16,k) 26+,2498,3559,68445,68376,125,3.5,248,6.9,6321,1643,4678,2.4,9.2,6183,1758,4425,2.6,9,138,0.2,18,0,117,120,534
2011,16,l) Left Censored,2637,6743,181603,180767,269,4,275,4.1,15975,3893,12082,2.2,8.8,14303,2309,11994,1.3,7.9,1672,0.9,15.8,0,56,58,561
2011,17,a) 0,16354,16573,93520,47150,16310,196.8,0,0,92740,92740,0,196.7,196.7,0,0,0,0,0,92740,196.7,0,0,,,
2011,17,b) 1,11412,11681,91031,93322,52,0.4,4022,29.4,25643,1464,24179,1.6,27.5,30225,17641,12584,18.9,32.4,-4582,-4.9,55,0,2689,2689,13397
2011,17,c) 2,10533,10707,72035,74483,522,4.6,2116,18.5,13736,2418,11318,3.2,18.4,18631,8584,10047,11.5,25,-4895,-6.6,36.8,0,1505,1505,6917
2011,17,d) 3,10816,11044,79116,80184,544,4.7,1872,16.1,12792,2049,10743,2.6,16,14927,7472,7455,9.3,18.6,-2135,-2.6,32,0,1306,1306,5670
2011,17,e) 4,9820,9973,75277,77877,490,4.7,1575,15.1,10132,1476,8656,1.9,13,15331,7519,7812,9.7,19.7,-5199,-6.7,26,0,1085,1085,6048
2011,17,f) 5,9548,10072,80180,82317,470,4.5,1464,13.9,10413,1691,8722,2.1,12.6,14686,5906,8780,7.2,17.8,-4273,-5.2,25.2,0,1014,1026,4604
2011,17,g) 6 to 10,36768,38860,388685,390423,1589,4,4636,11.5,52635,8247,44388,2.1,13.5,56111,20710,35401,5.3,14.4,-3476,-0.9,27,0,2979,2984,14553
2011,17,h) 11 to 15,27623,30182,365534,376580,1198,3.9,3025,9.8,44556,7414,37142,2,11.8,66648,21240,45408,5.6,17.7,-22092,-5.9,23.6,0,1843,1861,17188
2011,17,i) 16 to 20,20996,23403,306195,307304,806,3.4,2071,8.6,37644,6700,30944,2.2,12.2,39861,10701,29160,3.5,13,-2217,-0.8,24.4,0,1192,1198,6385
2011,17,j) 21 to 25,17405,21189,397111,391969,744,3.4,1767,8.2,50731,11489,39242,2.9,12.9,40447,14632,25815,3.7,10.3,10284,2.6,20.6,0,930,1020,5606
2011,17,k) 26+,22381,32158,749641,751732,955,2.9,1850,5.7,66316,12651,53665,1.7,8.8,70497,16700,53797,2.2,9.4,-4181,-0.6,17.6,0,997,1003,7557
2011,17,l) Left Censored,25005,62244,2317667,2305736,2832,4.5,3162,5.1,211608,52487,159121,2.3,9.2,187746,44270,143476,1.9,8.1,23862,1.1,16.2,0,803,844,11364
2011,18,a) 0,6211,6320,38324,19334,6240,197.5,0,0,37980,37980,0,196.4,196.4,0,0,0,0,0,37980,196.4,0,0,,,
2011,18,b) 1,4542,4668,36495,39737,35,0.6,1503,27.8,7577,277,7300,0.7,19.1,14061,8659,5402,21.8,35.4,-6484,-16.3,38.2,0,1061,1061,7381
2011,18,c) 2,4249,4361,34765,35061,185,4,840,18,7201,1533,5668,4.4,20.5,7793,4290,3503,12.2,22.2,-592,-1.7,41,0,603,603,3500
2011,18,d) 3,4675,4804,39797,40219,213,4.2,800,15.8,7152,1155,5997,2.9,17.8,7995,4317,3678,10.7,19.9,-843,-2.1,35.6,0,580,580,3702
2011,18,e) 4,4242,4379,36176,37239,167,3.6,733,15.8,5016,809,4207,2.2,13.5,7141,2899,4242,7.8,19.2,-2125,-5.7,27,0,522,522,2298
2011,18,f) 5,4209,4522,42921,43638,164,3.5,670,14.1,5913,792,5121,1.8,13.6,7346,3411,3935,7.8,16.8,-1433,-3.2,27.2,0,466,475,2707
2011,18,g) 6 to 10,15890,16836,167598,169879,591,3.4,2028,11.6,21073,2637,18436,1.6,12.4,25634,10383,15251,6.1,15.1,-4561,-2.7,24.8,0,1407,1408,7844
2011,18,h) 11 to 15,12293,13678,165195,164532,487,3.5,1337,9.5,21993,3580,18413,2.2,13.4,20666,7733,12933,4.7,12.6,1327,0.8,25.2,0,900,901,5088
2011,18,i) 16 to 20,9621,10974,139192,140591,383,3.4,954,8.5,14584,3181,11403,2.3,10.4,17381,4971,12410,3.5,12.4,-2797,-2,20.8,0,581,581,3235
2011,18,j) 21 to 25,7910,10169,192923,192188,304,2.9,725,7,21607,5068,16539,2.6,11.2,20136,7910,12226,4.1,10.5,1471,0.7,21,0,425,437,3810
2011,18,k) 26+,11126,16916,343569,339283,601,3.5,908,5.3,39822,7140,32682,2.1,11.7,31250,7584,23666,2.2,9.2,8572,2.5,18.4,0,480,484,3082
2011,18,l) Left Censored,12642,33673,1187983,1182383,1442,4.3,1323,3.9,106592,23889,82703,2,9,95392,18133,77259,1.5,8.1,11200,0.9,16.2,0,387,394,5453
2011,19,a) 0,3431,3482,19557,9876,3420,196.4,0,0,19363,19363,0,196.1,196.1,0,0,0,0,0,19363,196.1,0,0,,,
2011,19,b) 1,2575,2604,16104,17388,8,0.3,751,25.2,3482,64,3418,0.4,20,6050,2478,3572,14.3,34.8,-2568,-14.8,40,0,501,501,1812
2011,19,c) 2,2423,2491,17967,18792,97,3.7,448,16.9,2854,367,2487,2,15.2,4503,2411,2092,12.8,24,-1649,-8.8,30.4,0,307,307,1965
2011,19,d) 3,2542,2593,17613,18158,111,4.1,407,14.9,2502,381,2121,2.1,13.8,3592,1503,2089,8.3,19.8,-1090,-6,27.6,0,278,278,1200
2011,19,e) 4,2353,2402,18246,18751,114,4.5,374,14.8,2435,385,2050,2.1,13,3445,1757,1688,9.4,18.4,-1010,-5.4,26,0,258,258,1425
2011,19,f) 5,2455,2703,21545,22071,103,3.7,373,13.2,2418,384,2034,1.7,11,3469,1453,2016,6.6,15.7,-1051,-4.7,22,0,266,266,1185
2011,19,g) 6 to 10,9374,9924,93679,92624,429,4.2,1109,10.9,14326,2261,12065,2.4,15.5,12216,4860,7356,5.2,13.2,2110,2.3,26.4,0,722,722,3676
2011,19,h) 11 to 15,7272,7920,89948,89010,300,3.7,757,9.3,13539,1956,11583,2.2,15.2,11663,4298,7365,4.8,13.1,1876,2.1,26.2,0,465,465,2929
2011,19,i) 16 to 20,5704,6185,59532,60395,180,2.8,547,8.6,6018,668,5350,1.1,10,7744,2145,5599,3.6,12.8,-1726,-2.8,20,0,325,325,1499
2011,19,j) 21 to 25,4315,5338,98991,99023,159,2.9,347,6.4,7469,1346,6123,1.4,7.5,7532,1872,5660,1.9,7.6,-63,-0.1,15,0,199,199,956
2011,19,k) 26+,6815,10324,170282,169794,249,2.4,516,4.9,16062,3127,12935,1.8,9.5,15086,3348,11738,2,8.9,976,0.6,17.8,0,269,271,1607
2011,19,l) Left Censored,8647,19157,646028,644175,698,3.6,791,4.1,51918,10822,41096,1.7,8.1,48211,9501,38710,1.5,7.5,3707,0.6,15,0,231,238,2089
2011,20,a) 0,3340,3410,20515,10357,3348,196.4,0,0,20316,20316,0,196.2,196.2,0,0,0,0,0,20316,196.2,0,0,,,
2011,20,b) 1,2438,2464,17268,18243,8,0.3,892,30.7,4036,35,4001,0.2,22.1,5986,3705,2281,20.3,32.8,-1950,-10.7,44.2,0,649,649,2941
2011,20,c) 2,2365,2397,16139,17025,96,3.7,488,19,3052,357,2695,2.1,17.9,4824,2362,2462,13.9,28.3,-1772,-10.4,35.8,0,364,364,2042
2011,20,d) 3,2381,2431,16431,17010,90,3.5,468,18,2382,201,2181,1.2,14,3540,1619,1921,9.5,20.8,-1158,-6.8,28,0,350,350,1326
2011,20,e) 4,2315,2344,17185,17975,86,3.5,400,16.1,2269,297,1972,1.7,12.6,3849,2081,1768,11.6,21.4,-1580,-8.8,25.2,0,297,297,1830
2011,20,f) 5,2316,2481,19524,20023,93,3.6,343,13.2,2480,357,2123,1.8,12.4,3478,1477,2001,7.4,17.4,-998,-5,24.8,0,225,225,933
2011,20,g) 6 to 10,9093,9478,94295,96866,323,3.3,1155,11.7,11041,1354,9687,1.4,11.4,16182,6436,9746,6.6,16.7,-5141,-5.3,22.8,0,779,779,4493
2011,20,h) 11 to 15,6963,7557,79379,81129,288,3.7,752,9.7,8075,1308,6767,1.6,10,11575,4116,7459,5.1,14.3,-3500,-4.3,20,0,455,455,3143
2011,20,i) 16 to 20,5044,5617,73267,74780,190,3.3,496,8.6,6902,992,5910,1.3,9.2,9927,3287,6640,4.4,13.3,-3025,-4.1,18.4,0,312,314,2364
2011,20,j) 21 to 25,4001,5050,77673,76160,195,3.8,361,7,9646,2005,7641,2.6,12.7,6620,2122,4498,2.8,8.7,3026,4,17.4,0,220,220,1082
2011,20,k) 26+,6010,8743,155457,156825,298,3.4,488,5.5,15152,4397,10755,2.8,9.7,17887,4165,13722,2.7,11.4,-2735,-1.7,19.4,0,273,273,1728
2011,20,l) Left Censored,7059,16516,515692,517446,744,4.5,767,4.6,48055,16540,31515,3.2,9.3,51563,9885,41678,1.9,10,-3508,-0.7,18.6,0,227,227,1766
2011,21,a) 0,4123,4199,24813,12577,4154,197.9,0,0,24472,,,,194.6,0,0,0,0,0,24472,194.6,0,1,,,
2011,21,b) 1,3025,3107,23664,25804,9,0.2,1016,28.1,5068,,,,19.6,9348,5650,3698,21.9,36.2,-4280,-16.6,39.2,1,769,769,4855
2011,21,c) 2,2693,2733,20292,21081,99,3.3,591,19.9,4172,628,3544,3,19.8,5749,3091,2658,14.7,27.3,-1577,-7.5,39.6,0,462,462,2597
2011,21,d) 3,2787,2910,23331,23993,107,3.4,558,17.9,3632,348,3284,1.5,15.1,4955,2222,2733,9.3,20.7,-1323,-5.6,30.2,0,433,433,1943
2011,21,e) 4,2664,2722,21674,22182,86,3,449,15.5,3396,286,3110,1.3,15.3,4411,2401,2010,10.8,19.9,-1015,-4.6,30.6,0,332,332,2093
2011,21,f) 5,2564,2723,24608,24960,96,3.4,411,14.3,3606,350,3256,1.4,14.4,4310,1989,2321,8,17.3,-704,-2.9,28.8,0,299,299,1533
2011,21,g) 6 to 10,10016,10554,99975,101960,295,2.7,1335,12.1,12503,1620,10883,1.6,12.3,16472,6814,9658,6.7,16.2,-3969,-3.9,24.6,0,951,951,5308
2011,21,h) 11 to 15,8001,8966,104478,106829,289,3.1,817,8.9,12383,2373,10010,2.2,11.6,17085,7031,10054,6.6,16,-4702,-4.4,23.2,0,519,519,5256
2011,21,i) 16 to 20,5913,6731,83777,85846,201,2.9,613,8.9,9277,1958,7319,2.3,10.8,13414,3027,10387,3.5,15.6,-4137,-4.8,21.6,0,387,387,1798
2011,21,j) 21 to 25,5064,6439,118508,119009,210,3.2,457,7,12424,3370,9054,2.8,10.4,13425,5152,8273,4.3,11.3,-1001,-0.9,20.8,0,271,272,2659
2011,21,k) 26+,6818,10549,208152,209174,355,3.3,537,5.1,21535,5563,15972,2.7,10.3,23579,4984,18595,2.4,11.3,-2044,-1,20.6,0,281,281,1611
2011,21,l) Left Censored,7530,20487,699028,695757,792,3.9,804,3.9,62184,13413,48771,1.9,8.9,55642,11522,44120,1.7,8,6542,0.9,16,0,231,242,1952
2011,22,a) 0,4938,4990,33578,16903,4918,197.1,0,0,33351,33351,0,197.3,197.3,0,0,0,0,0,33351,197.3,0,0,,,
2011,22,b) 1,3827,3959,32723,34581,15,0.3,1264,27.6,7426,163,7263,0.5,21.5,11142,5337,5805,15.4,32.2,-3716,-10.7,43,0,951,951,4241
2011,22,c) 2,3546,3612,30877,31286,116,3,688,17.8,6438,519,5919,1.7,20.6,7255,3321,3934,10.6,23.2,-817,-2.6,41.2,0,546,546,2633
2011,22,d) 3,3675,3837,35398,36290,150,3.7,625,15.4,6191,1002,5189,2.8,17.1,7974,3660,4314,10.1,22,-1783,-4.9,34.2,0,481,481,2867
2011,22,e) 4,3563,3624,35126,35853,138,3.6,532,14,5249,710,4539,2,14.6,6703,2727,3976,7.6,18.7,-1454,-4.1,29.2,0,414,414,2299
2011,22,f) 5,3045,3340,34908,35524,98,2.8,443,12.7,4820,799,4021,2.2,13.6,6052,2352,3700,6.6,17,-1232,-3.4,27.2,0,318,318,1828
2011,22,g) 6 to 10,12402,13185,151049,152917,449,3.3,1309,9.7,20415,2739,17676,1.8,13.4,24150,7433,16717,4.9,15.8,-3735,-2.4,26.8,0,939,939,5829
2011,22,h) 11 to 15,9291,10191,129971,132861,301,2.9,923,8.8,12835,2079,10756,1.6,9.7,18614,5318,13296,4,14,-5779,-4.3,19.4,0,643,643,4046
2011,22,i) 16 to 20,6925,7801,108686,110762,226,2.8,631,7.9,10840,2054,8786,1.9,9.8,14991,4270,10721,3.9,13.5,-4151,-3.7,19.6,0,414,420,2661
2011,22,j) 21 to 25,5272,6704,133909,134785,294,4.3,485,7.2,15769,4752,11017,3.5,11.7,17521,4879,12642,3.6,13,-1752,-1.3,23.4,0,254,254,1672
2011,22,k) 26+,8595,12207,232929,231196,341,2.8,644,5.2,25963,6460,19503,2.8,11.2,22496,4497,17999,1.9,9.7,3467,1.5,19.4,0,361,361,2033
2011,22,l) Left Censored,7985,21653,642845,639878,1008,4.7,915,4.2,61063,16536,44527,2.6,9.5,55128,11959,43169,1.9,8.6,5935,0.9,17.2,0,267,277,2305
2011,23,a) 0,1803,1825,8820,4439,1802,197.5,0,0,8763,,,,197.4,0,0,0,0,0,8763,197.4,0,1,,,
2011,23,b) 1,1254,1299,7984,8501,9,0.6,460,30.2,1887,,,,22.2,2921,1641,1280,19.3,34.4,-1034,-12.2,44.4,1,287,287,1281
2011,23,c) 2,1189,1208,7975,8190,56,4.3,240,18.6,1055,175,880,2.1,12.9,1485,765,720,9.3,18.1,-430,-5.2,25.8,0,156,156,536
2011,23,d) 3,1302,1322,7371,7686,58,4.1,268,18.9,1354,277,1077,3.6,17.6,1984,1188,796,15.5,25.8,-630,-8.2,35.2,0,187,187,1010
2011,23,e) 4,1292,1304,8006,8456,82,6,242,17.6,1034,170,864,2,12.2,1934,918,1016,10.9,22.9,-900,-10.7,24.4,0,138,138,663
2011,23,f) 5,1323,1410,10032,10126,68,4.6,192,13.1,1462,174,1288,1.7,14.4,1649,605,1044,6,16.3,-187,-1.9,28.8,0,123,123,444
2011,23,g) 6 to 10,4843,5037,37889,38910,201,3.8,651,12.4,4418,630,3788,1.6,11.4,6460,2860,3600,7.4,16.6,-2042,-5.2,22.8,0,383,383,1698
2011,23,h) 11 to 15,3878,4142,36196,37094,141,3.3,422,9.9,3546,515,3031,1.4,9.6,5341,1837,3504,5,14.4,-1795,-4.8,19.2,0,269,269,1376
2011,23,i) 16 to 20,2601,2927,30153,30173,97,3.2,249,8.3,3337,584,2753,1.9,11.1,3376,1208,2168,4,11.2,-39,-0.1,22.2,0,157,157,771
2011,23,j) 21 to 25,2438,2994,46243,46031,95,3.1,232,7.6,3921,783,3138,1.7,8.5,3496,1068,2428,2.3,7.6,425,0.9,15.2,0,111,112,596
2011,23,k) 26+,2963,4317,68848,69713,160,3.7,239,5.5,6629,2117,4512,3,9.5,8358,1931,6427,2.8,12,-1729,-2.5,19,0,109,112,1005
2011,23,l) Left Censored,3061,6842,201546,201516,256,3.7,324,4.7,16263,4393,11870,2.2,8.1,16202,3721,12481,1.8,8,61,0.1,16,0,83,83,1316
2011,24,a) 0,6374,6425,42003,21168,6326,196.9,0,0,41670,41670,0,196.9,196.9,0,0,0,0,0,41670,196.9,0,0,,,
2011,24,b) 1,4636,4808,32559,34289,21,0.4,1545,27.7,7954,280,7674,0.8,23.2,11413,6376,5037,18.6,33.3,-3459,-10.1,46.4,0,1061,1061,4559
2011,24,c) 2,4404,4470,35227,35320,189,4,871,18.2,7039,566,6473,1.6,19.9,7225,4054,3171,11.5,20.5,-186,-0.6,39.8,0,638,638,3388
2011,24,d) 3,4477,4687,36697,37424,204,4.1,823,16.6,5444,771,4673,2.1,14.5,6897,3637,3260,9.7,18.4,-1453,-3.9,29,0,599,599,2847
2011,24,e) 4,4346,4431,37804,37155,188,4,685,14.7,7447,781,6666,2.1,20,6149,3160,2989,8.5,16.5,1298,3.5,33,0,489,489,2515
2011,24,f) 5,4386,4608,39106,39300,195,4,683,14.2,5812,694,5118,1.8,14.8,6200,2899,3301,7.4,15.8,-388,-1,29.6,0,479,479,2075
2011,24,g) 6 to 10,17196,17916,180716,182285,651,3.5,2174,11.7,26032,5074,20958,2.8,14.3,29169,11063,18106,6.1,16,-3137,-1.7,28.6,0,1474,1476,8216
2011,24,h) 11 to 15,12527,13805,168409,169571,452,3.2,1280,9,18867,2580,16287,1.5,11.1,21191,7206,13985,4.2,12.5,-2324,-1.4,22.2,0,810,810,5254
2011,24,i) 16 to 20,9121,10223,143703,145461,313,3,867,8.3,14317,2158,12159,1.5,9.8,17833,4384,13449,3,12.3,-3516,-2.5,19.6,0,509,509,2330
2011,24,j) 21 to 25,7828,9436,189557,189354,333,3.5,630,6.6,21396,3920,17476,2.1,11.3,20989,4424,16565,2.3,11.1,407,0.2,22.2,0,365,365,2589
2011,24,k) 26+,8937,12967,267883,268225,463,3.5,742,5.7,26382,6512,19870,2.4,9.8,27065,6690,20375,2.5,10.1,-683,-0.3,19.6,0,407,407,2735
2011,24,l) Left Censored,9315,25745,925634,922297,1600,6.2,1391,5.4,92673,27468,65205,3,10,85999,16627,69372,1.8,9.3,6674,0.7,18.6,0,289,291,2636
2011,25,a) 0,7837,7902,42542,21400,7812,197.7,0,0,42284,42284,0,197.6,197.6,0,0,0,0,0,42284,197.6,0,0,,,
2011,25,b) 1,5787,5871,39348,41134,27,0.4,1787,26.5,9256,239,9017,0.6,22.5,12827,6900,5927,16.8,31.2,-3571,-8.7,45,0,1211,1211,5515
2011,25,c) 2,5090,5160,34274,34836,226,4.1,964,17.5,6057,746,5311,2.1,17.4,7180,3402,3778,9.8,20.6,-1123,-3.2,34.8,0,712,712,2814
2011,25,d) 3,5326,5419,38680,38526,272,4.8,871,15.3,6989,1291,5698,3.4,18.1,6681,3208,3473,8.3,17.3,308,0.8,34.6,0,627,627,2631
2011,25,e) 4,4978,5036,40310,40228,259,4.9,741,14.1,6409,822,5587,2,15.9,6245,3076,3169,7.6,15.5,164,0.4,31,0,534,534,2504
2011,25,f) 5,5231,5432,43060,43171,220,3.9,710,12.6,6145,769,5376,1.8,14.2,6366,2546,3820,5.9,14.7,-221,-0.5,28.4,0,477,477,1950
2011,25,g) 6 to 10,20002,20864,216888,217952,779,3.6,2268,10.5,26648,3105,23543,1.4,12.2,28775,11595,17180,5.3,13.2,-2127,-1,24.4,0,1528,1528,8725
2011,25,h) 11 to 15,15557,16682,210107,209473,579,3.4,1477,8.7,23457,2587,20870,1.2,11.2,22188,6291,15897,3,10.6,1269,0.6,21.2,0,913,913,4098
2011,25,i) 16 to 20,11071,12103,165243,165814,358,2.9,947,7.7,18159,3905,14254,2.4,11,19301,7107,12194,4.3,11.6,-1142,-0.6,22,0,590,595,5230
2011,25,j) 21 to 25,10479,12888,241988,242352,416,3.2,890,6.8,21700,4298,17402,1.8,9,22427,5358,17069,2.2,9.3,-727,-0.3,18,0,492,493,2544
2011,25,k) 26+,12934,18997,490976,492400,628,3.3,1032,5.4,44344,11994,32350,2.4,9,47192,12080,35112,2.5,9.6,-2848,-0.6,18,0,493,494,3140
2011,25,l) Left Censored,15459,35412,1371209,1369430,1568,4.4,1677,4.7,122554,23996,98558,1.8,8.9,118995,24541,94454,1.8,8.7,3559,0.2,17.4,0,472,472,5285
2011,26,a) 0,9906,10067,65315,32890,9921,197.1,0,0,64851,64851,0,197.2,197.2,0,0,0,0,0,64851,197.2,0,0,,,
2011,26,b) 1,7079,7180,58458,59848,28,0.3,2384,28.5,16583,229,16354,0.4,27.7,19363,12610,6753,21.1,32.4,-2780,-4.7,55.4,0,1674,1674,10116
2011,26,c) 2,6670,6759,61230,63735,286,3.9,1381,19,13226,1943,11283,3,20.8,18236,8484,9752,13.3,28.6,-5010,-7.8,41.6,0,1031,1031,7317
2011,26,d) 3,6809,6998,61509,62740,326,4.4,1214,16.4,12147,1581,10566,2.5,19.4,14608,8250,6358,13.1,23.3,-2461,-3.9,38.8,0,885,885,7009
2011,26,e) 4,6272,6415,70851,75089,304,4.5,1050,15.6,11040,1335,9705,1.8,14.7,19516,5426,14090,7.2,26,-8476,-11.3,29.4,0,735,737,4452
2011,26,f) 5,6241,6452,61538,61592,269,4,945,14,10191,1255,8936,2,16.5,10298,4571,5727,7.4,16.7,-107,-0.2,33,0,668,668,3774
2011,26,g) 6 to 10,24238,25534,264742,266228,1019,3.9,3015,11.4,37223,5153,32070,1.9,14,40194,16811,23383,6.3,15.1,-2971,-1.1,28,0,2027,2035,13291
2011,26,h) 11 to 15,19286,21093,254349,252728,871,4,2062,9.6,34580,4777,29803,1.9,13.7,31338,12057,19281,4.8,12.4,3242,1.3,24.8,0,1222,1225,8925
2011,26,i) 16 to 20,15028,16810,197945,197307,586,3.4,1452,8.4,24166,3799,20367,1.9,12.2,22890,7574,15316,3.8,11.6,1276,0.6,23.2,0,864,864,5110
2011,26,j) 21 to 25,12941,16030,262870,258502,545,3.3,1266,7.7,32494,5565,26929,2.2,12.6,23758,7859,15899,3,9.2,8736,3.4,18.4,0,678,678,3340
2011,26,k) 26+,16824,23930,455946,444569,739,3.1,1441,5.9,67353,8330,59023,1.9,15.2,44598,11005,33593,2.5,10,22755,5.2,20,0,714,717,3974
2011,26,l) Left Censored,17704,45764,1565714,1552851,1946,4.3,2059,4.5,157886,27505,130381,1.8,10.2,132159,30025,102134,1.9,8.5,25727,1.7,17,0,601,616,6528
2011,27,a) 0,6713,6811,40117,20217,6678,196.1,0,0,39801,39801,0,196.9,196.9,0,0,0,0,0,39801,196.9,0,0,,,
2011,27,b) 1,4768,4881,35091,37780,33,0.6,1688,29.6,8805,874,7931,2.3,23.3,14182,9600,4582,25.4,37.5,-5377,-14.2,46.6,0,1108,1108,7825
2011,27,c) 2,4625,4717,35877,36790,242,4.8,915,18.3,5952,746,5206,2,16.2,7777,3511,4266,9.5,21.1,-1825,-4.9,32.4,0,646,646,2813
2011,27,d) 3,4575,4671,36102,37165,253,5.1,822,16.7,5855,875,4980,2.4,15.8,7980,4041,3939,10.9,21.5,-2125,-5.7,31.6,0,569,569,3096
2011,27,e) 4,4466,4563,40121,40943,240,5,753,15.7,5567,696,4871,1.7,13.6,7211,3666,3545,9,17.6,-1644,-4,27.2,0,500,501,2672
2011,27,f) 5,4505,4876,37257,38419,242,4.8,695,13.7,4994,830,4164,2.2,13,7318,3656,3662,9.5,19,-2324,-6,26,0,449,449,2879
2011,27,g) 6 to 10,18275,19217,183458,184261,890,4.5,2280,11.5,23979,3270,20709,1.8,13,25585,11026,14559,6,13.9,-1606,-0.9,26,0,1419,1419,8695
2011,27,h) 11 to 15,13918,15335,179590,180580,673,4.3,1399,8.9,19784,3936,15848,2.2,11,21764,6872,14892,3.8,12.1,-1980,-1.1,22,0,804,804,4064
2011,27,i) 16 to 20,10206,11610,140681,142877,417,3.5,909,7.7,14326,2820,11506,2,10,18718,5914,12804,4.1,13.1,-4392,-3.1,20,0,548,550,4044
2011,27,j) 21 to 25,7784,9611,178696,177370,299,3.1,633,6.5,20280,5602,14678,3.2,11.4,17630,5286,12344,3,9.9,2650,1.5,19.8,0,373,373,2103
2011,27,k) 26+,9976,14572,334203,333796,380,2.6,765,5.2,29746,4581,25165,1.4,8.9,28931,6619,22312,2,8.7,815,0.2,17.4,0,386,402,2942
2011,27,l) Left Censored,11685,28432,1165262,1152356,1184,4.2,1187,4.2,107627,23737,83890,2.1,9.3,81814,14343,67471,1.2,7.1,25813,2.2,14.2,0,308,308,2987
2011,28,a) 0,2684,2736,17235,8697,2704,197.7,0,0,17076,17076,0,196.3,196.3,0,0,0,0,0,17076,196.3,0,0,,,
2011,28,b) 1,2085,2146,16058,17092,13,0.5,687,27.7,3742,154,3588,0.9,21.9,5810,3638,2172,21.3,34,-2068,-12.1,43.8,0,527,527,3191
2011,28,c) 2,1947,1971,14435,15187,71,3.4,399,18.8,2305,332,1973,2.2,15.2,3809,2033,1776,13.4,25.1,-1504,-9.9,30.4,0,310,312,1662
2011,28,d) 3,1938,2007,14865,15536,81,3.8,368,17.2,2293,252,2041,1.6,14.8,3635,1494,2141,9.6,23.4,-1342,-8.6,29.6,0,292,292,1309
2011,28,e) 4,1914,1994,13372,13666,75,3.6,304,14.5,2094,472,1622,3.5,15.3,2682,1137,1545,8.3,19.6,-588,-4.3,30.6,0,238,238,959
2011,28,f) 5,1733,1851,18477,18867,60,3.1,281,14.4,2250,425,1825,2.3,11.9,3030,1579,1451,8.4,16.1,-780,-4.2,23.8,0,208,208,1284
2011,28,g) 6 to 10,6993,7462,70232,72310,252,3.3,850,11,8936,1212,7724,1.7,12.4,13092,5412,7680,7.5,18.1,-4156,-5.7,24.8,0,613,613,4080
2011,28,h) 11 to 15,5230,5769,56257,57993,174,2.9,548,9.2,5872,736,5136,1.3,10.1,9344,3032,6312,5.2,16.1,-3472,-6,20.2,0,370,370,1927
2011,28,i) 16 to 20,3823,4352,57140,56991,131,2.9,382,8.6,7042,1164,5878,2,12.4,6744,2261,4483,4,11.8,298,0.6,23.6,0,247,247,1065
2011,28,j) 21 to 25,2974,3450,68685,68393,112,3.2,254,7.2,7407,1525,5882,2.2,10.8,6822,1628,5194,2.4,10,585,0.8,20,0,158,158,801
2011,28,k) 26+,4853,7014,123852,124427,230,3.3,351,5,10903,2516,8387,2,8.8,12053,2147,9906,1.7,9.7,-1150,-0.9,17.6,0,195,195,911
2011,28,l) Left Censored,5029,13818,410759,408644,554,4,572,4.1,33406,10466,22940,2.6,8.2,29175,6310,22865,1.5,7.1,4231,1.1,14.2,0,165,169,1221
2011,29,a) 0,7724,7865,40018,20122,7771,197.6,0,0,39792,39792,0,197.8,197.8,0,0,0,0,0,39792,197.8,0,0,,,
2011,29,b) 1,5416,5518,34390,37472,40,0.6,2431,36.2,8062,505,7557,1.3,21.5,14225,8356,5869,22.3,38,-6163,-16.5,43,0,1925,1925,6805
2011,29,c) 2,4622,4788,36792,38937,177,3.4,1201,22.8,6848,895,5953,2.3,17.6,11138,7157,3981,18.4,28.6,-4290,-11,35.2,0,983,983,6249
2011,29,d) 3,4653,4725,36759,37138,204,4,948,18.7,6292,763,5529,2.1,16.9,7050,3576,3474,9.6,19,-758,-2.1,33.8,0,725,725,2839
2011,29,e) 4,4554,4669,32698,34020,191,3.8,848,17.1,4749,648,4101,1.9,14,7393,4116,3277,12.1,21.7,-2644,-7.7,28,0,645,645,3394
2011,29,f) 5,4591,4900,39446,40670,204,3.9,809,15.7,5253,939,4314,2.3,12.9,7701,3299,4402,8.1,18.9,-2448,-6,25.8,0,598,598,2413
2011,29,g) 6 to 10,17265,18210,169048,172953,652,3.4,2368,12.5,20113,3281,16832,1.9,11.6,27922,10965,16957,6.3,16.1,-7809,-4.5,23.2,0,1704,1704,8609
2011,29,h) 11 to 15,12703,13954,152321,153966,470,3.3,1405,9.8,17002,2839,14163,1.8,11,20292,6715,13577,4.4,13.2,-3290,-2.2,22,0,926,927,4821
2011,29,i) 16 to 20,9304,10649,143224,145617,321,2.9,904,8.3,14196,2196,12000,1.5,9.7,18982,5624,13358,3.9,13,-4786,-3.3,19.4,0,571,571,3933
2011,29,j) 21 to 25,7805,10299,162174,160656,313,3,674,6.4,18206,6081,12125,3.8,11.3,15169,3916,11253,2.4,9.4,3037,1.9,18.8,0,432,432,1888
2011,29,k) 26+,10645,16175,355999,356696,507,3.1,952,5.8,32480,6385,26095,1.8,9.1,33874,7855,26019,2.2,9.5,-1394,-0.4,18.2,0,531,533,3945
2011,29,l) Left Censored,11769,31086,1083933,1086517,1349,4.3,1264,4.1,87037,18805,68232,1.7,8,92205,16028,76177,1.5,8.5,-5168,-0.5,16,0,362,365,3525
2011,30,a) 0,1843,1855,7591,3859,1822,196.4,0,0,7464,7464,0,193.4,193.4,0,0,0,0,0,7464,193.4,0,0,,,
2011,30,b) 1,1327,1338,7085,8130,4,0.3,499,31.5,1809,8,1801,0.1,22.3,3899,2297,1602,28.3,48,-2090,-25.7,44.6,0,324,324,1739
2011,30,c) 2,1331,1334,6700,6971,88,6.2,257,18.2,1206,248,958,3.6,17.3,1748,859,889,12.3,25.1,-542,-7.8,34.6,0,166,166,641
2011,30,d) 3,1369,1403,7878,8196,70,4.7,276,18.4,1161,156,1005,1.9,14.2,1796,875,921,10.7,21.9,-635,-7.7,28.4,0,169,169,669
2011,30,e) 4,1353,1378,8073,8342,78,5.3,287,19.5,1331,315,1016,3.8,16,1869,858,1011,10.3,22.4,-538,-6.4,32,0,165,165,584
2011,30,f) 5,1422,1485,15441,15200,81,5.2,256,16.4,2294,418,1876,2.8,15.1,1811,758,1053,5,11.9,483,3.2,23.8,0,156,156,526
2011,30,g) 6 to 10,5124,5272,32802,34189,257,4.7,686,12.6,4239,892,3347,2.6,12.4,7012,3224,3788,9.4,20.5,-2773,-8.1,24.8,0,407,409,2531
2011,30,h) 11 to 15,3675,3881,31223,32251,165,4.1,439,11,3159,500,2659,1.6,9.8,5214,1744,3470,5.4,16.2,-2055,-6.4,19.6,0,218,225,982
2011,30,i) 16 to 20,2426,2567,23406,24044,97,3.7,254,9.6,2333,426,1907,1.8,9.7,3609,975,2634,4.1,15,-1276,-5.3,19.4,0,150,150,561
2011,30,j) 21 to 25,1705,1925,23549,23843,64,3.3,142,7.2,2279,322,1957,1.4,9.6,2867,948,1919,4,12,-588,-2.4,19.2,0,91,91,451
2011,30,k) 26+,2449,3412,51035,51910,81,2.3,222,6.4,4117,539,3578,1,7.9,5866,1797,4069,3.5,11.3,-1749,-3.4,15.8,0,115,115,841
2011,30,l) Left Censored,2389,5199,118231,118438,209,4,208,4,9759,1888,7871,1.6,8.2,10172,3082,7090,2.6,8.6,-413,-0.4,16.4,0,70,70,2293
2011,31,a) 0,2411,2435,12643,6347,2406,197.6,0,0,12592,12592,0,198.4,198.4,0,0,0,0,0,12592,198.4,0,0,,,
2011,31,b) 1,1816,1841,10798,11070,6,0.3,539,25.6,2505,31,2474,0.3,22.6,3048,1591,1457,14.4,27.5,-543,-4.9,45.2,0,355,355,1139
2011,31,c) 2,1758,1779,11042,11168,78,4.1,326,17.3,2032,313,1719,2.8,18.2,2284,1248,1036,11.2,20.5,-252,-2.3,36.4,0,236,236,1037
2011,31,d) 3,1743,1771,11249,11502,71,3.8,269,14.5,1781,186,1595,1.6,15.5,2287,1164,1123,10.1,19.9,-506,-4.4,31,0,188,188,892
2011,31,e) 4,1677,1719,10737,11542,57,3.2,251,13.9,1377,177,1200,1.5,11.9,2987,1847,1140,16,25.9,-1610,-14,23.8,0,184,184,1696
2011,31,f) 5,1618,1714,12802,13102,61,3.4,240,13.4,1706,129,1577,1,13,2305,1074,1231,8.2,17.6,-599,-4.6,26,0,179,179,880
2011,31,g) 6 to 10,6623,6906,54128,55635,290,4.1,788,11.1,6859,1799,5060,3.2,12.3,9872,3343,6529,6,17.7,-3013,-5.4,24.6,0,494,494,2265
2011,31,h) 11 to 15,5039,5491,63808,64835,203,3.6,545,9.7,5670,913,4757,1.4,8.7,7724,2478,5246,3.8,11.9,-2054,-3.2,17.4,0,319,319,1806
2011,31,i) 16 to 20,3691,4088,42073,42610,146,3.5,342,8.2,4514,490,4024,1.1,10.6,5587,2012,3575,4.7,13.1,-1073,-2.5,21.2,0,201,205,1362
2011,31,j) 21 to 25,2989,3680,67443,66254,154,4.1,269,7.2,7896,1420,6476,2.1,11.9,5517,1223,4294,1.8,8.3,2379,3.6,16.6,0,139,139,655
2011,31,k) 26+,4232,6150,117524,118670,172,2.8,396,6.3,9836,2196,7640,1.9,8.3,12127,2465,9662,2.1,10.2,-2291,-1.9,16.6,0,209,210,1218
2011,31,l) Left Censored,5187,11105,348642,353161,498,4.5,489,4.4,31884,7670,24214,2.2,9,40921,16972,23949,4.8,11.6,-9037,-2.6,18,0,137,138,1622
2011,32,a) 0,4310,4341,27746,14021,4289,197.6,0,0,27451,27451,0,195.8,195.8,0,0,0,0,0,27451,195.8,0,0,,,
2011,32,b) 1,2996,3053,33020,33646,11,0.3,1248,34,9161,38,9123,0.1,27.2,10413,5848,4565,17.4,30.9,-1252,-3.7,54.4,0,952,952,4631
2011,32,c) 2,2654,2738,23277,24034,144,4.8,653,21.9,5347,723,4624,3,22.2,6860,4052,2808,16.9,28.5,-1513,-6.3,44.4,0,513,513,3544
2011,32,d) 3,2661,2742,28624,29414,156,5.3,593,20.2,4644,624,4020,2.1,15.8,6223,3060,3163,10.4,21.2,-1579,-5.4,31.6,0,457,457,2555
2011,32,e) 4,2355,2424,21292,22716,102,3.9,483,18.6,2866,378,2488,1.7,12.6,5714,3308,2406,14.6,25.2,-2848,-12.6,25.2,0,371,371,2920
2011,32,f) 5,2335,2456,24385,25828,119,4.6,450,17.3,2978,366,2612,1.4,11.5,5864,2023,3841,7.8,22.7,-2886,-11.2,23,0,315,315,1385
2011,32,g) 6 to 10,7921,8434,110363,114497,330,3.7,1186,13.4,12504,1607,10897,1.4,10.9,20772,9344,11428,8.2,18.1,-8268,-7.2,21.8,0,860,863,7319
2011,32,h) 11 to 15,4622,5278,72223,76283,220,4,625,11.4,7942,1878,6064,2.5,10.4,16061,7642,8419,10,21.1,-8119,-10.7,20.8,0,442,448,7057
2011,32,i) 16 to 20,2698,3216,62595,63436,161,4.9,285,8.7,6539,1357,5182,2.1,10.3,8222,2042,6180,3.2,13,-1683,-2.7,20.6,0,195,195,1219
2011,32,j) 21 to 25,2029,2879,56345,56214,97,3.3,213,7.3,6144,1612,4532,2.9,10.9,5881,1529,4352,2.7,10.5,263,0.4,21,0,114,114,682
2011,32,k) 26+,2649,4833,135378,134630,220,4.5,306,6.3,15128,4350,10778,3.2,11.2,13631,2271,11360,1.7,10.1,1497,1.1,20.2,0,127,145,918
2011,32,l) Left Censored,2848,9257,397323,398803,608,6.6,464,5.1,33297,7116,26181,1.8,8.3,36256,6209,30047,1.6,9.1,-2959,-0.8,16.6,0,60,60,871
2011,33,a) 0,1648,1661,9204,4650,1643,197.8,0,0,9109,9109,0,195.9,195.9,0,0,0,0,0,9109,195.9,0,0,,,
2011,33,b) 1,1290,1324,9449,9668,5,0.3,396,26.1,2385,43,2342,0.4,24.7,2823,1592,1231,16.5,29.2,-438,-4.5,49.4,0,279,279,1268
2011,33,c) 2,1137,1148,7434,7857,33,2.6,253,20.3,1257,104,1153,1.3,16,2103,1215,888,15.5,26.8,-846,-10.8,32,0,199,199,1067
2011,33,d) 3,1258,1276,10392,10957,56,4.2,208,15.4,1621,258,1363,2.4,14.8,2751,962,1789,8.8,25.1,-1130,-10.3,29.6,0,156,156,819
2011,33,e) 4,1125,1147,8376,8289,53,4.4,194,16,1520,159,1361,1.9,18.3,1346,627,719,7.6,16.2,174,2.1,32.4,0,151,151,523
2011,33,f) 5,1210,1290,11571,11712,48,3.6,172,12.8,1564,160,1404,1.4,13.4,1845,746,1099,6.4,15.8,-281,-2.4,26.8,0,122,122,524
2011,33,g) 6 to 10,4385,4564,39686,40665,146,3.1,577,12.1,4358,467,3891,1.1,10.7,6316,2415,3901,5.9,15.5,-1958,-4.8,21.4,0,415,415,1994
2011,33,h) 11 to 15,3660,3927,40894,41611,119,2.9,377,9.3,4276,520,3756,1.2,10.3,5710,2580,3130,6.2,13.7,-1434,-3.4,20.6,0,244,244,2174
2011,33,i) 16 to 20,2692,2869,33343,33879,63,2.1,240,8.1,2963,360,2603,1.1,8.7,4034,1324,2710,3.9,11.9,-1071,-3.2,17.4,0,160,160,912
2011,33,j) 21 to 25,2538,3055,46252,47212,104,3.4,178,5.8,3936,863,3073,1.8,8.3,5855,1060,4795,2.2,12.4,-1919,-4.1,16.6,0,106,106,589
2011,33,k) 26+,2728,3796,71924,72437,104,2.7,212,5.5,6900,1371,5529,1.9,9.5,7926,2095,5831,2.9,10.9,-1026,-1.4,19,0,114,114,832
2011,33,l) Left Censored,3120,7038,259205,263587,314,4.5,325,4.6,17946,3989,13957,1.5,6.8,26709,4079,22630,1.5,10.1,-8763,-3.3,13.6,0,78,78,750
2011,34,a) 0,12750,12809,71765,36130,12654,197.6,0,0,71271,71271,0,197.3,197.3,0,0,0,0,0,71271,197.3,0,0,,,
2011,34,b) 1,9039,9181,64416,66095,26,0.2,3045,28.5,15734,398,15336,0.6,23.8,19091,11023,8068,16.7,28.9,-3357,-5.1,47.6,0,2168,2168,8774
2011,34,c) 2,8104,8179,58957,59348,362,4.1,1773,20.1,11777,1218,10559,2.1,19.8,12559,6892,5667,11.6,21.2,-782,-1.4,39.6,0,1358,1358,5479
2011,34,d) 3,8221,8297,74625,73369,385,4.4,1511,17.2,14487,1339,13148,1.8,19.7,11974,5948,6026,8.1,16.3,2513,3.4,32.6,0,1109,1109,4534
2011,34,e) 4,7798,7890,63706,63295,339,4.1,1333,16,11434,1405,10029,2.2,18.1,10611,4776,5835,7.5,16.8,823,1.3,33.6,0,999,1000,3898
2011,34,f) 5,7657,7915,65682,67311,352,4.2,1303,15.6,9558,1451,8107,2.2,14.2,12815,5469,7346,8.1,19,-3257,-4.8,28.4,0,940,940,4064
2011,34,g) 6 to 10,29252,30130,282699,289767,1159,3.7,3766,12,37057,6121,30936,2.1,12.8,51193,23729,27464,8.2,17.7,-14136,-4.9,25.6,0,2649,2650,18004
2011,34,h) 11 to 15,22318,23895,268124,273492,832,3.4,2376,9.7,28270,5215,23055,1.9,10.3,39007,12486,26521,4.6,14.3,-10737,-4,20.6,0,1590,1592,8582
2011,34,i) 16 to 20,15228,16171,198591,200590,449,2.7,1420,8.5,22186,2774,19412,1.4,11.1,26184,7927,18257,4,13.1,-3998,-2,22.2,0,933,934,5804
2011,34,j) 21 to 25,13068,15174,246413,246916,482,3.1,1237,8,25616,5642,19974,2.3,10.4,26621,8277,18344,3.4,10.8,-1005,-0.4,20.8,0,750,750,4740
2011,34,k) 26+,16037,21376,474469,473752,661,3,1340,6.2,44257,8425,35832,1.8,9.3,42823,11309,31514,2.4,9,1434,0.3,18,0,716,718,3671
2011,34,l) Left Censored,17008,39599,1476519,1484662,2093,5.3,2337,5.9,135518,34718,100800,2.3,9.1,151804,34566,117238,2.3,10.2,-16286,-1.1,18.2,0,714,737,7944
2011,35,a) 0,2176,2187,13503,6801,2153,196.9,0,0,13405,13405,0,197.1,197.1,0,0,0,0,0,13405,197.1,0,0,,,
2011,35,b) 1,1522,1556,11895,12611,11,0.6,539,29.6,2861,207,2654,1.6,22.7,4293,2600,1693,20.6,34,-1432,-11.3,45.4,0,416,416,2114
2011,35,c) 2,1553,1573,11576,11839,74,4.4,301,18,1866,232,1634,2,15.8,2391,1282,1109,10.8,20.2,-525,-4.4,31.6,0,242,242,1101
2011,35,d) 3,1539,1582,13106,13173,82,4.9,318,18.8,2711,1164,1547,8.8,20.6,2844,1395,1449,10.6,21.6,-133,-1,41.2,0,237,237,1104
2011,35,e) 4,1514,1529,22937,23471,73,4.5,255,15.9,1802,308,1494,1.3,7.7,2870,966,1904,4.1,12.2,-1068,-4.5,15.4,0,190,190,723
2011,35,f) 5,1485,1561,14395,14545,65,4,243,14.8,2112,253,1859,1.7,14.5,2411,1136,1275,7.8,16.6,-299,-2.1,29,0,180,180,798
2011,35,g) 6 to 10,5459,5835,54622,55203,227,3.8,727,12,7620,1260,6360,2.3,13.8,8782,3394,5388,6.1,15.9,-1162,-2.1,27.6,0,513,514,2654
2011,35,h) 11 to 15,4065,4391,53568,55594,166,3.7,460,10.2,4536,653,3883,1.2,8.2,8588,1990,6598,3.6,15.4,-4052,-7.2,16.4,0,285,285,1375
2011,35,i) 16 to 20,3041,3413,41553,42694,125,3.6,319,9.1,4489,692,3797,1.6,10.5,6771,1751,5020,4.1,15.9,-2282,-5.4,21,0,193,197,1081
2011,35,j) 21 to 25,2368,3007,58040,57999,90,2.9,189,6.2,5118,1286,3832,2.2,8.8,5036,1364,3672,2.4,8.7,82,0.1,17.4,0,123,123,962
2011,35,k) 26+,3374,4929,84773,85440,256,5.2,303,6.1,8128,1828,6300,2.1,9.5,9462,2354,7108,2.8,11.1,-1334,-1.6,19,0,156,156,1090
2011,35,l) Left Censored,3200,8308,219517,219909,362,4.4,363,4.4,19621,4293,15328,2,8.9,20404,2805,17599,1.3,9.3,-783,-0.4,17.8,0,86,86,551
2011,36,a) 0,34802,35061,175406,88358,34697,197.9,0,0,174097,174097,0,197,197,0,0,0,0,0,174097,197,0,0,,,
2011,36,b) 1,25910,26346,166304,173464,65,0.2,8163,26.9,39793,760,39033,0.4,22.9,54112,31069,23043,17.9,31.2,-14319,-8.3,45.8,0,5773,5773,24220
2011,36,c) 2,22295,22448,150965,153072,887,3.7,4601,19.1,30470,2863,27607,1.9,19.9,34683,20586,14097,13.4,22.7,-4213,-2.8,39.8,0,3475,3475,15278
2011,36,d) 3,20929,21195,149358,152700,907,4,3981,17.6,24341,3013,21328,2,15.9,31024,16683,14341,10.9,20.3,-6683,-4.4,31.8,0,2953,2954,13620
2011,36,e) 4,18508,18655,131670,133871,785,4,3229,16.3,20587,2581,18006,1.9,15.4,24989,12922,12067,9.7,18.7,-4402,-3.3,30.8,0,2310,2310,10319
2011,36,f) 5,17768,18574,151097,154022,685,3.5,2782,14.2,21125,2990,18135,1.9,13.7,26974,12053,14921,7.8,17.5,-5849,-3.8,27.4,0,1965,1972,8976
2011,36,g) 6 to 10,66149,68205,636099,644764,2365,3.3,8452,11.9,80728,12109,68619,1.9,12.5,98058,42558,55500,6.6,15.2,-17330,-2.7,25,0,5948,5948,29481
2011,36,h) 11 to 15,46795,50131,588522,597163,1573,3.1,4675,9.1,65368,8220,57148,1.4,10.9,82650,32577,50073,5.5,13.8,-17282,-2.9,21.8,0,3037,3041,24438
2011,36,i) 16 to 20,31981,34088,417948,422695,917,2.6,2767,7.9,43102,6356,36746,1.5,10.2,52596,15514,37082,3.7,12.4,-9494,-2.2,20.4,0,1767,1772,11814
2011,36,j) 21 to 25,29100,32928,548878,549321,850,2.5,2301,6.8,53664,9410,44254,1.7,9.8,54549,19439,35110,3.5,9.9,-885,-0.1,19.6,0,1394,1395,7914
2011,36,k) 26+,34205,47166,996677,998576,1236,2.6,2651,5.5,87141,15718,71423,1.6,8.7,90939,19593,71346,2,9.1,-3798,-0.4,17.4,0,1575,1584,10577
2011,36,l) Left Censored,37696,85216,3263114,3245170,3999,4.7,4542,5.3,322358,86649,235709,2.7,9.9,286472,69890,216582,2.2,8.8,35886,1.1,17.6,0,1448,1468,15239
2011,37,a) 0,11245,11342,66625,33576,11200,197.5,0,0,66099,66099,0,196.9,196.9,0,0,0,0,0,66099,196.9,0,0,,,
2011,37,b) 1,8441,8622,64608,69277,30,0.3,2894,28.8,14161,329,13832,0.5,20.4,23498,14029,9469,20.3,33.9,-9337,-13.5,40.8,0,2174,2174,11891
2011,37,c) 2,7272,7463,54701,56327,308,3.8,1646,20.4,10491,1368,9123,2.4,18.6,13742,8106,5636,14.4,24.4,-3251,-5.8,37.2,0,1262,1262,7074
2011,37,d) 3,7741,7941,59965,61518,382,4.5,1497,17.7,10515,1409,9106,2.3,17.1,13620,6746,6874,11,22.1,-3105,-5,34.2,0,1097,1108,5644
2011,37,e) 4,7349,7477,51556,54180,333,4.2,1358,17.1,7749,865,6884,1.6,14.3,12997,6327,6670,11.7,24,-5248,-9.7,28.6,0,986,986,5285
2011,37,f) 5,7113,7619,64368,66392,308,3.8,1241,15.4,8889,1423,7466,2.1,13.4,12937,6222,6715,9.4,19.5,-4048,-6.1,26.8,0,824,824,4544
2011,37,g) 6 to 10,26491,27964,271511,275973,1006,3.5,3550,12.2,36453,5512,30941,2,13.2,45377,19224,26153,7,16.4,-8924,-3.2,26.4,0,2474,2478,14504
2011,37,h) 11 to 15,19014,21441,250438,252482,803,3.6,2257,10.2,28742,5176,23566,2.1,11.4,32829,11006,21823,4.4,13,-4087,-1.6,22.8,0,1458,1464,7906
2011,37,i) 16 to 20,12579,14322,214278,215869,437,3,1240,8.4,20037,3579,16458,1.7,9.3,23219,6615,16604,3.1,10.8,-3182,-1.5,18.6,0,818,818,4621
2011,37,j) 21 to 25,10361,13470,256598,255779,448,3.3,1022,7.4,26450,5530,20920,2.2,10.3,24812,7713,17099,3,9.7,1638,0.6,19.4,0,604,605,3866
2011,37,k) 26+,14504,22366,466961,464135,751,3.3,1337,5.9,47365,10771,36594,2.3,10.2,41712,9184,32528,2,9,5653,1.2,18,0,667,685,3925
2011,37,l) Left Censored,13522,43705,1477659,1463862,2104,4.8,2121,4.9,151609,37894,113715,2.6,10.4,124014,22601,101413,1.5,8.5,27595,1.9,17,0,481,517,4277
2011,38,a) 0,1339,1347,7249,3707,1329,197.3,0,0,7085,7085,0,191.1,191.1,0,0,0,0,0,7085,191.1,0,0,,,
2011,38,b) 1,823,840,4964,5132,5,0.5,257,26.6,1136,20,1116,0.4,22.1,1471,766,705,14.9,28.7,-335,-6.6,44.2,0,160,160,578
2011,38,c) 2,796,809,5266,5447,33,3.9,140,16.4,939,118,821,2.2,17.2,1301,587,714,10.8,23.9,-362,-6.7,34.4,0,99,99,421
2011,38,d) 3,808,827,6628,6650,50,5.8,129,15,970,174,796,2.6,14.6,1013,394,619,5.9,15.2,-43,-0.6,29.2,0,93,93,294
2011,38,e) 4,759,773,5805,5960,49,6.1,122,15.3,802,123,679,2.1,13.5,1111,529,582,8.9,18.6,-309,-5.1,27,0,72,72,367
2011,38,f) 5,788,835,6644,6660,34,4,85,9.9,937,100,837,1.5,14.1,969,396,573,5.9,14.5,-32,-0.4,28.2,0,52,52,236
2011,38,g) 6 to 10,2786,2924,22956,23330,141,4.7,335,11.2,3390,970,2420,4.2,14.5,4137,1518,2619,6.5,17.7,-747,-3.2,29,0,208,208,1133
2011,38,h) 11 to 15,2068,2254,20188,20592,111,4.9,205,9,2286,397,1889,1.9,11.1,3093,988,2105,4.8,15,-807,-3.9,22.2,0,115,115,630
2011,38,i) 16 to 20,1809,1899,20581,20026,91,4.7,178,9.2,3589,508,3081,2.5,17.9,2479,503,1976,2.5,12.4,1110,5.5,24.8,0,92,92,306
2011,38,j) 21 to 25,1326,1517,18960,19168,56,3.7,100,6.5,1738,296,1442,1.5,9.1,2153,582,1571,3,11.2,-415,-2.1,18.2,0,48,48,221
2011,38,k) 26+,1987,2631,44284,43696,84,3.1,170,6.4,5120,1271,3849,2.9,11.7,3944,951,2993,2.2,9,1176,2.7,18,0,88,88,576
2011,38,l) Left Censored,2402,4764,142058,140676,201,4.2,193,4.1,13612,2816,10796,2,9.7,10847,2684,8163,1.9,7.7,2765,2,15.4,0,63,65,1274
2011,39,a) 0,10077,10235,70232,35309,10100,197.4,0,0,69846,69846,0,197.8,197.8,0,0,0,0,0,69846,197.8,0,0,,,
2011,39,b) 1,7289,7622,70089,73254,58,0.7,2308,26.4,18202,970,17232,1.3,24.8,24532,14932,9600,20.4,33.5,-6330,-8.7,49.6,0,1705,1711,13102
2011,39,c) 2,6762,6917,62175,63375,292,4,1262,17.2,11717,1403,10314,2.2,18.5,14117,7953,6164,12.5,22.3,-2400,-3.8,37,0,948,948,6889
2011,39,d) 3,7010,7241,64464,65650,289,3.8,1177,15.4,11152,1527,9625,2.3,17,13524,5757,7767,8.8,20.6,-2372,-3.6,34,0,899,899,4855
2011,39,e) 4,6414,6612,59379,60138,240,3.5,1010,14.5,9450,1322,8128,2.2,15.7,10967,5101,5866,8.5,18.2,-1517,-2.5,31.4,0,739,739,3926
2011,39,f) 5,6716,7139,76126,76269,283,3.8,927,12.5,10677,1551,9126,2,14,10963,4549,6414,6,14.4,-286,-0.4,28,0,653,653,3219
2011,39,g) 6 to 10,26760,28613,300800,304915,1125,3.8,3129,10.6,38794,6114,32680,2,12.7,47024,20950,26074,6.9,15.4,-8230,-2.7,25.4,0,2203,2210,16064
2011,39,h) 11 to 15,21277,23973,288466,288107,812,3.3,2138,8.7,34874,7531,27343,2.6,12.1,34155,10651,23504,3.7,11.9,719,0.2,23.8,0,1362,1362,7249
2011,39,i) 16 to 20,17081,19607,261306,262800,605,3,1634,8.1,29880,3901,25979,1.5,11.4,32868,8543,24325,3.3,12.5,-2988,-1.1,22.8,0,1000,1003,5377
2011,39,j) 21 to 25,14408,18311,309810,310473,500,2.6,1743,9.2,31361,4660,26701,1.5,10.1,32686,11361,21325,3.7,10.5,-1325,-0.4,20.2,0,731,735,5396
2011,39,k) 26+,19808,30454,644678,640402,1073,3.5,1622,5.3,70327,14788,55539,2.3,11,61774,12948,48826,2,9.6,8553,1.4,19.2,0,859,866,5241
2011,39,l) Left Censored,24030,62488,2200529,2182825,2527,4,2983,4.8,216692,43577,173115,2,9.9,181284,37440,143844,1.7,8.3,35408,1.6,16.6,0,861,894,10029
2011,40,a) 0,4646,4733,26608,13431,4656,196.7,0,0,26354,26354,0,196.2,196.2,0,0,0,0,0,26354,196.2,0,0,,,
2011,40,b) 1,3413,3480,25325,27750,21,0.5,1189,29.3,6035,221,5814,0.8,21.7,10884,7242,3642,26.1,39.2,-4849,-17.5,43.4,0,896,896,6313
2011,40,c) 2,3272,3326,24816,25366,142,3.9,730,20.3,4904,603,4301,2.4,19.3,6006,3529,2477,13.9,23.7,-1102,-4.4,38.6,0,551,551,2660
2011,40,d) 3,3319,3396,27301,27926,146,4,614,17,4349,604,3745,2.2,15.6,5599,2745,2854,9.8,20,-1250,-4.4,31.2,0,436,436,2044
2011,40,e) 4,3099,3176,29105,28985,127,3.8,516,15.4,5207,1065,4142,3.7,18,4967,2322,2645,8,17.1,240,0.9,34.2,0,374,374,1928
2011,40,f) 5,3016,3222,29622,29339,111,3.3,406,12.1,4698,613,4085,2.1,16,4131,1675,2456,5.7,14.1,567,1.9,28.2,0,297,297,1166
2011,40,g) 6 to 10,10891,11536,109791,111597,384,3.2,1338,11.2,14768,2311,12457,2.1,13.2,18379,7397,10982,6.6,16.5,-3611,-3.3,26.4,0,927,927,5379
2011,40,h) 11 to 15,8067,9121,101221,102234,308,3.3,870,9.3,13917,1967,11950,1.9,13.6,15942,4970,10972,4.9,15.6,-2025,-2,27.2,0,545,545,3312
2011,40,i) 16 to 20,5802,6432,75137,76721,200,3,624,9.4,7901,1367,6534,1.8,10.3,11069,3569,7500,4.7,14.4,-3168,-4.1,20.6,0,401,407,2216
2011,40,j) 21 to 25,4487,5649,104427,103990,163,2.8,436,7.6,11995,1768,10227,1.7,11.5,11121,3502,7619,3.4,10.7,874,0.8,21.4,0,275,275,1768
2011,40,k) 26+,7411,10756,207656,206353,283,2.6,623,5.7,20224,3311,16913,1.6,9.8,17618,3891,13727,1.9,8.5,2606,1.3,17,0,361,362,1977
2011,40,l) Left Censored,6484,17199,491693,488662,754,4.4,688,4,45484,11510,33974,2.4,9.3,39421,8704,30717,1.8,8.1,6063,1.2,16.2,0,193,200,1715
2011,41,a) 0,5884,5955,26998,13588,5884,197.6,0,0,26821,26821,0,197.4,197.4,0,0,0,0,0,26821,197.4,0,0,,,
2011,41,b) 1,4222,4327,26186,27417,31,0.6,1447,28.7,6688,355,6333,1.3,24.4,9149,5384,3765,19.6,33.4,-2461,-9,48.8,0,1022,1022,4317
2011,41,c) 2,3929,3974,22720,23384,172,4,849,19.8,4433,568,3865,2.4,19,5761,2914,2847,12.5,24.6,-1328,-5.6,38,0,634,634,2347
2011,41,d) 3,4143,4219,24690,24999,225,5,808,18,4641,681,3960,2.7,18.6,5259,2990,2269,12,21,-618,-2.4,37.2,0,592,592,2293
2011,41,e) 4,3885,3970,25043,25758,211,5,678,16.2,4003,646,3357,2.5,15.5,5433,2910,2523,11.3,21.1,-1430,-5.6,31,0,467,467,2288
2011,41,f) 5,3880,4290,31666,31794,198,4.4,602,13.5,5270,686,4584,2.2,16.6,5525,2230,3295,7,17.4,-255,-0.8,33.2,0,432,432,1677
2011,41,g) 6 to 10,13966,14837,120548,129763,596,3.9,1901,12.3,16182,2738,13444,2.1,12.5,34611,8223,26388,6.3,26.7,-18429,-14.2,25,0,1220,1221,5820
2011,41,h) 11 to 15,10199,11212,118734,121295,454,3.9,1119,9.7,13988,2728,11260,2.2,11.5,19109,5358,13751,4.4,15.8,-5121,-4.3,23,0,687,687,3343
2011,41,i) 16 to 20,7230,8085,84420,85586,269,3.3,668,8.1,8530,1068,7462,1.2,10,10862,3372,7490,3.9,12.7,-2332,-2.7,20,0,421,421,2247
2011,41,j) 21 to 25,5389,6619,98344,98217,204,3,533,7.9,11114,1489,9625,1.5,11.3,10859,2986,7873,3,11.1,255,0.2,22.2,0,318,348,1796
2011,41,k) 26+,7155,10484,214928,216524,299,2.8,686,6.4,20220,3773,16447,1.7,9.3,23411,5609,17802,2.6,10.8,-3191,-1.5,18.6,0,364,372,2611
2011,41,l) Left Censored,6675,17771,549443,544855,781,4.4,734,4.1,53724,9373,44351,1.7,9.9,44549,9375,35174,1.7,8.2,9175,1.7,16.4,0,186,191,2103
2011,42,a) 0,12796,12989,78458,39469,12850,197.9,0,0,77979,77979,0,197.6,197.6,0,0,0,0,0,77979,197.6,0,0,,,
2011,42,b) 1,9268,9659,75757,78922,78,0.7,2700,24.6,19545,2396,17149,3,24.8,25875,14697,11178,18.6,32.8,-6330,-8,49.6,0,1962,1970,12479
2011,42,c) 2,8855,9004,70224,70711,344,3.6,1609,16.8,12630,1688,10942,2.4,17.9,13604,7290,6314,10.3,19.2,-974,-1.3,35.8,0,1197,1197,6060
2011,42,d) 3,9034,9224,68202,68504,350,3.6,1495,15.3,12058,1778,10280,2.6,17.6,12661,6199,6462,9,18.5,-603,-0.9,35.2,0,1092,1092,5181
2011,42,e) 4,8498,8640,70536,70360,347,3.8,1235,13.7,11878,1326,10552,1.9,16.9,11525,5781,5744,8.2,16.4,353,0.5,32.8,0,866,866,4539
2011,42,f) 5,8612,9101,86828,90460,327,3.5,1103,11.7,11141,1439,9702,1.6,12.3,18404,10378,8026,11.5,20.3,-7263,-8,24.6,0,765,767,9226
2011,42,g) 6 to 10,34508,36313,377567,380561,1157,3.1,3717,9.9,43778,5879,37899,1.5,11.5,49766,18622,31144,4.9,13.1,-5988,-1.6,23,0,2536,2538,14296
2011,42,h) 11 to 15,26450,29596,370240,369837,903,3,2426,8,44065,6886,37179,1.9,11.9,43258,13970,29288,3.8,11.7,807,0.2,23.4,0,1455,1463,7827
2011,42,i) 16 to 20,19355,21648,293245,295552,603,2.7,1593,7.2,30440,6551,23889,2.2,10.3,35054,9592,25462,3.2,11.9,-4614,-1.6,20.6,0,977,977,6309
2011,42,j) 21 to 25,18171,21527,341223,340210,634,2.9,1400,6.4,36731,6148,30583,1.8,10.8,34705,9352,25353,2.7,10.2,2026,0.6,20.4,0,863,863,5226
2011,42,k) 26+,23040,34384,769097,765447,1381,4,1873,5.4,86677,31099,55578,4.1,11.3,79376,20990,58386,2.7,10.4,7301,0.9,20.8,0,943,946,5936
2011,42,l) Left Censored,26583,68774,2425096,2406512,3042,4.4,3161,4.6,232353,54635,177718,2.3,9.7,195185,44113,151072,1.8,8.1,37168,1.6,16.2,0,944,951,9897
2011,44,a) 0,1263,1273,7535,3793,1256,197.3,0,0,7485,7485,0,197.3,197.3,0,0,0,0,0,7485,197.3,0,0,,,
2011,44,b) 1,917,934,6188,6395,9,0.8,343,31.2,1424,124,1300,1.9,22.3,1837,1058,779,16.5,28.7,-413,-6.4,44.6,0,234,234,774
2011,44,c) 2,772,791,5087,5393,29,3.4,186,21.5,812,54,758,1,15.1,1423,876,547,16.2,26.4,-611,-11.3,30.2,0,141,141,727
2011,44,d) 3,872,881,6987,7214,44,4.7,176,18.8,950,208,742,2.9,13.2,1403,824,579,11.4,19.4,-453,-6.2,26.4,0,134,134,709
2011,44,e) 4,860,871,7350,7208,53,5.9,117,13,1330,357,973,5,18.5,1045,380,665,5.3,14.5,285,4,29,0,84,84,306
2011,44,f) 5,852,919,6636,6794,52,5.4,133,13.9,751,92,659,1.4,11.1,1067,528,539,7.8,15.7,-316,-4.6,22.2,0,88,88,429
2011,44,g) 6 to 10,3479,3612,31071,31168,148,4,439,11.7,3887,560,3327,1.8,12.5,4081,1647,2434,5.3,13.1,-194,-0.6,25,0,291,291,1136
2011,44,h) 11 to 15,2590,2841,26650,26841,101,3.5,281,9.6,2875,388,2487,1.4,10.7,3257,1073,2184,4,12.1,-382,-1.4,21.4,0,164,167,749
2011,44,i) 16 to 20,2015,2120,25377,26049,62,2.9,169,7.8,2120,206,1914,0.8,8.1,3463,1139,2324,4.4,13.3,-1343,-5.2,16.2,0,102,102,325
2011,44,j) 21 to 25,1906,2132,30813,31055,77,3.6,144,6.7,2521,592,1929,1.9,8.1,3004,840,2164,2.7,9.7,-483,-1.6,16.2,0,85,85,273
2011,44,k) 26+,2304,2920,51941,52360,98,3.3,162,5.5,3951,611,3340,1.2,7.5,4788,1059,3729,2,9.1,-837,-1.6,15,0,82,82,407
2011,44,l) Left Censored,3149,5640,203121,197847,355,6.3,301,5.4,24986,7926,17060,4,12.6,14438,4117,10321,2.1,7.3,10548,5.3,14.6,0,93,93,1034
2011,45,a) 0,4969,5057,30693,15430,5005,197.9,0,0,30526,30526,0,197.8,197.8,0,0,0,0,0,30526,197.8,0,0,,,
2011,45,b) 1,3755,3824,25783,28316,38,0.9,1300,29.2,6578,477,6101,1.7,23.2,11644,7938,3706,28,41.1,-5066,-17.9,46.4,0,974,974,6764
2011,45,c) 2,3442,3605,33859,34777,143,3.7,786,20.2,4863,769,4094,2.2,14,6698,3541,3157,10.2,19.3,-1835,-5.3,28,0,594,594,2558
2011,45,d) 3,3444,3490,23658,24254,116,3.1,703,18.7,4082,457,3625,1.9,16.8,5273,2941,2332,12.1,21.7,-1191,-4.9,33.6,0,536,536,2462
2011,45,e) 4,3347,3432,27345,28372,143,3.9,643,17.6,4699,538,4161,1.9,16.6,6752,3814,2938,13.4,23.8,-2053,-7.2,33.2,0,438,440,3070
2011,45,f) 5,3213,3347,27985,28752,110,3.1,566,15.9,3868,321,3547,1.1,13.5,5402,2852,2550,9.9,18.8,-1534,-5.3,27,0,403,403,2232
2011,45,g) 6 to 10,12481,13202,134722,137707,483,3.5,1777,12.9,16361,2751,13610,2,11.9,22330,9883,12447,7.2,16.2,-5969,-4.3,23.8,0,1260,1263,7326
2011,45,h) 11 to 15,9081,10049,125514,126085,344,3.3,995,9.6,15770,2436,13334,1.9,12.5,16911,6920,9991,5.5,13.4,-1141,-0.9,25,0,701,705,5703
2011,45,i) 16 to 20,6097,6856,92598,94121,203,2.9,681,9.6,9143,1380,7763,1.5,9.7,12188,3407,8781,3.6,12.9,-3045,-3.2,19.4,0,432,438,1973
2011,45,j) 21 to 25,4899,6650,112668,111880,231,3.4,511,7.5,14124,3597,10527,3.2,12.6,12548,3551,8997,3.2,11.2,1576,1.4,22.4,0,307,307,1861
2011,45,k) 26+,6844,10754,210537,211035,336,3.1,574,5.3,22136,4439,17697,2.1,10.5,23131,5386,17745,2.6,11,-995,-0.5,21,0,314,314,2259
2011,45,l) Left Censored,6898,20974,656808,653862,876,4.2,943,4.5,67317,16681,50636,2.6,10.3,61425,9835,51590,1.5,9.4,5892,0.9,18.8,0,221,228,1496
2011,46,a) 0,1264,1276,6773,3414,1251,196.1,0,0,6718,6718,0,196.8,196.8,0,0,0,0,0,6718,196.8,0,0,,,
2011,46,b) 1,970,1011,6481,7267,6,0.5,331,28.2,1186,41,1145,0.6,16.3,2758,1755,1003,24.2,38,-1572,-21.7,32.6,0,214,222,1552
2011,46,c) 2,974,981,6038,6361,43,4.1,195,18.6,939,97,842,1.5,14.8,1584,792,792,12.5,24.9,-645,-10.1,29.6,0,129,129,549
2011,46,d) 3,927,936,5499,5740,51,5.2,155,15.8,885,198,687,3.4,15.4,1366,700,666,12.2,23.8,-481,-8.4,30.8,0,110,110,564
2011,46,e) 4,943,961,5989,6221,49,4.9,146,14.6,921,309,612,5,14.8,1385,703,682,11.3,22.3,-464,-7.5,29.6,0,96,96,380
2011,46,f) 5,903,918,7246,7426,40,4.1,156,16.1,934,158,776,2.1,12.6,1294,546,748,7.4,17.4,-360,-4.8,25.2,0,101,101,379
2011,46,g) 6 to 10,3556,3713,27101,27745,168,4.4,448,11.7,3619,895,2724,3.2,13,4906,1815,3091,6.5,17.7,-1287,-4.7,26,0,286,286,1295
2011,46,h) 11 to 15,2665,2824,25926,26348,110,3.8,278,9.6,3151,829,2322,3.1,12,3994,1288,2706,4.9,15.2,-843,-3.2,24,0,161,161,702
2011,46,i) 16 to 20,1939,2076,21796,22176,100,4.8,166,7.9,2958,1026,1932,4.6,13.3,3717,1172,2545,5.3,16.8,-759,-3.5,26.6,0,90,90,445
2011,46,j) 21 to 25,1362,1560,21501,21454,58,3.6,141,8.8,2394,463,1931,2.2,11.2,2299,764,1535,3.6,10.7,95,0.5,21.4,0,86,86,469
2011,46,k) 26+,2002,2719,36024,36800,82,3,170,6.2,3184,783,2401,2.1,8.7,4735,1219,3516,3.3,12.9,-1551,-4.2,17.4,0,84,84,757
2011,46,l) Left Censored,2517,5054,150118,150940,164,3.2,162,3.2,10826,2114,8712,1.4,7.2,12469,3786,8683,2.5,8.3,-1643,-1.1,14.4,0,56,57,2913
2011,47,a) 0,6351,6397,42455,21382,6328,197.8,0,0,42147,42147,0,197.1,197.1,0,0,0,0,0,42147,197.1,0,0,,,
2011,47,b) 1,4632,4791,37938,40489,62,1.1,1602,28.8,9484,1047,8437,2.6,23.4,14585,8076,6509,19.9,36,-5101,-12.6,46.8,0,1287,1288,7059
2011,47,c) 2,4007,4212,36373,35869,181,4,939,20.6,8727,927,7800,2.6,24.3,7718,4340,3378,12.1,21.5,1009,2.8,43,0,758,767,3718
2011,47,d) 3,4321,4437,35011,35376,170,3.6,853,17.9,6204,774,5430,2.2,17.5,6934,3592,3342,10.2,19.6,-730,-2.1,35,0,675,675,2876
2011,47,e) 4,3967,4116,31738,32654,165,3.8,723,16.6,5210,852,4358,2.6,16,7042,3560,3482,10.9,21.6,-1832,-5.6,32,0,537,537,2819
2011,47,f) 5,3806,4042,42449,42971,154,3.6,611,14.4,7342,644,6698,1.5,17.1,8386,3559,4827,8.3,19.5,-1044,-2.4,34.2,0,474,481,3185
2011,47,g) 6 to 10,14431,15736,172295,176620,554,3.4,1900,11.6,22539,3466,19073,2,12.8,31188,14666,16522,8.3,17.7,-8649,-4.9,25.6,0,1376,1378,12125
2011,47,h) 11 to 15,10900,12570,159982,161679,470,3.6,1244,9.6,20381,3863,16518,2.4,12.6,23775,9976,13799,6.2,14.7,-3394,-2.1,25.2,0,871,873,7228
2011,47,i) 16 to 20,8106,9657,141013,139914,308,3.1,857,8.7,18202,2183,16019,1.6,13,16005,3981,12024,2.8,11.4,2197,1.6,22.8,0,578,578,2689
2011,47,j) 21 to 25,6892,9011,171415,172891,263,2.9,644,7,16888,2994,13894,1.7,9.8,19840,8165,11675,4.7,11.5,-2952,-1.7,19.6,0,385,388,1958
2011,47,k) 26+,9896,15597,338228,337066,461,2.9,926,5.9,35413,7325,28088,2.2,10.5,33089,6907,26182,2,9.8,2324,0.7,19.6,0,500,515,3475
2011,47,l) Left Censored,9756,29522,1077961,1070674,1224,4.1,1478,5,100789,16903,83886,1.6,9.4,86214,20758,65456,1.9,8.1,14575,1.3,16.2,0,336,363,2038
2011,48,a) 0,32434,32985,220041,111055,32619,197.8,0,0,217973,217973,0,196.3,196.3,0,0,0,0,0,217973,196.3,0,0,,,
2011,48,b) 1,23112,23808,212796,221076,137,0.5,7716,28,55443,2347,53096,1.1,25.1,72002,43503,28499,19.7,32.6,-16559,-7.5,50.2,0,5854,5902,35188
2011,48,c) 2,20627,21237,184307,189868,865,3.8,4402,19.3,37128,4474,32654,2.4,19.6,48249,26052,22197,13.7,25.4,-11121,-5.8,39.2,0,3490,3490,22603
2011,48,d) 3,20317,20976,206295,207591,788,3.5,3700,16.6,38801,4723,34078,2.3,18.7,41393,20605,20788,9.9,19.9,-2592,-1.2,37.4,0,2907,2913,17367
2011,48,e) 4,18434,18985,174973,179707,650,3.2,3116,15.5,29722,4579,25143,2.5,16.5,39190,19167,20023,10.7,21.8,-9468,-5.3,33,0,2413,2413,15236
2011,48,f) 5,17374,18708,196888,200028,672,3.4,2595,13.3,30054,4767,25287,2.4,15,36334,16963,19371,8.5,18.2,-6280,-3.2,30,0,1977,1993,13913
2011,48,g) 6 to 10,63708,69218,871526,879397,2327,3.2,7854,11,132811,24663,108148,2.8,15.1,148553,57545,91008,6.5,16.9,-15742,-1.8,30.2,0,5730,5746,42222
2011,48,h) 11 to 15,43603,49991,734947,739248,1809,3.5,4822,9.4,92036,15134,76902,2,12.4,100638,35150,65488,4.8,13.6,-8602,-1.2,24.8,0,3212,3242,24595
2011,48,i) 16 to 20,31278,36887,560985,573227,1294,3.4,3155,8.4,60975,10845,50130,1.9,10.6,85458,22037,63421,3.8,14.9,-24483,-4.3,21.2,0,2043,2048,15050
2011,48,j) 21 to 25,23283,31968,645527,645694,1201,3.7,2312,7.1,74361,14127,60234,2.2,11.5,74694,17310,57384,2.7,11.6,-333,-0.1,23,0,1372,1396,8089
2011,48,k) 26+,33030,53772,1139470,1139970,1836,3.4,3244,6,123738,31361,92377,2.8,10.9,124738,29385,95353,2.6,10.9,-1000,0,21.8,0,1670,1680,10853
2011,48,l) Left Censored,24278,99417,3697052,3656986,5714,5.8,4894,4.9,431030,123193,307837,3.4,11.8,350899,68419,282480,1.9,9.6,80131,2.2,19.2,0,857,872,8870
2011,49,a) 0,4601,4661,27494,13819,4585,196.7,0,0,27350,27350,0,197.9,197.9,0,0,0,0,0,27350,197.9,0,0,,,
2011,49,b) 1,3401,3464,24996,27345,30,0.7,1279,31.3,5806,419,5387,1.5,21.2,10504,6513,3991,23.8,38.4,-4698,-17.2,42.4,0,936,937,5611
2011,49,c) 2,2864,2910,20530,21065,139,4.4,700,22.1,4890,694,4196,3.3,23.2,5960,3523,2437,16.7,28.3,-1070,-5.1,46.4,0,506,506,2784
2011,49,d) 3,3020,3099,20710,21350,184,5.5,668,20.1,3930,634,3296,3,18.4,5210,3070,2140,14.4,24.4,-1280,-6,36.8,0,458,458,2420
2011,49,e) 4,2945,2991,23406,23541,180,5.7,541,17.2,4148,403,3745,1.7,17.6,4417,2032,2385,8.6,18.8,-269,-1.2,35.2,0,374,380,1633
2011,49,f) 5,2796,2935,27216,26350,162,5.3,477,15.5,6405,3091,3314,11.7,24.3,4673,2050,2623,7.8,17.7,1732,6.6,35.4,0,312,315,1425
2011,49,g) 6 to 10,9691,10126,108251,110561,472,4.5,1309,12.5,15174,2836,12338,2.6,13.7,19795,6743,13052,6.1,17.9,-4621,-4.2,27.4,0,841,844,4973
2011,49,h) 11 to 15,6030,6586,97310,99601,263,3.9,701,10.4,11200,2562,8638,2.6,11.2,15781,5034,10747,5.1,15.8,-4581,-4.6,22.4,0,413,419,3270
2011,49,i) 16 to 20,3627,4093,70879,71787,175,4.2,386,9.2,7490,1992,5498,2.8,10.4,9305,3513,5792,4.9,13,-1815,-2.6,20.8,0,220,220,2699
2011,49,j) 21 to 25,2425,3181,70045,69968,114,3.5,217,6.7,7640,1211,6429,1.7,10.9,7485,1988,5497,2.8,10.7,155,0.2,21.4,0,121,121,1002
2011,49,k) 26+,3308,4981,122943,123932,188,3.7,292,5.8,10761,2677,8084,2.2,8.7,12738,2280,10458,1.8,10.3,-1977,-1.6,17.4,0,152,152,1180
2011,49,l) Left Censored,3442,10203,404477,402805,502,4.9,476,4.7,35213,6790,28423,1.7,8.7,31868,5349,26519,1.3,7.9,3345,0.8,15.8,0,87,87,450
2011,50,a) 0,912,912,4582,2302,898,196.9,0,0,4560,4560,0,198.1,198.1,0,0,0,0,0,4560,198.1,0,0,,,
2011,50,b) 1,645,647,3610,3883,4,0.5,215,28.6,830,171,659,4.4,21.4,1375,643,732,16.6,35.4,-545,-14,42.8,0,140,140,414
2011,50,c) 2,605,614,6474,6583,27,4,145,21.7,656,68,588,1,10,874,340,534,5.2,13.3,-218,-3.3,20,0,105,105,260
2011,50,d) 3,642,647,3971,4082,33,4.8,119,17.3,511,67,444,1.6,12.5,732,310,422,7.6,17.9,-221,-5.4,25,0,86,86,245
2011,50,e) 4,681,690,4414,4595,31,4.3,97,13.5,555,65,490,1.4,12.1,917,470,447,10.2,20,-362,-7.9,24.2,0,63,63,391
2011,50,f) 5,630,650,4031,4095,28,4.1,94,13.9,538,44,494,1.1,13.1,666,337,329,8.2,16.3,-128,-3.2,26.2,0,64,64,238
2011,50,g) 6 to 10,2649,2707,19325,19839,111,4,329,11.7,2314,221,2093,1.1,11.7,3342,1263,2079,6.4,16.8,-1028,-5.1,23.4,0,207,211,965
2011,50,h) 11 to 15,2197,2329,24808,24881,73,3.1,206,8.6,2434,258,2176,1,9.8,2579,827,1752,3.3,10.4,-145,-0.6,19.6,0,133,133,629
2011,50,i) 16 to 20,1628,1790,16470,16547,59,3.2,161,8.8,1896,244,1652,1.5,11.5,2049,697,1352,4.2,12.4,-153,-0.9,23,0,82,82,369
2011,50,j) 21 to 25,1628,1754,25966,26444,64,3.6,142,7.9,1834,281,1553,1.1,6.9,2790,1105,1685,4.2,10.6,-956,-3.7,13.8,0,84,84,368
2011,50,k) 26+,1842,2425,45256,45814,60,2.4,162,6.5,3497,368,3129,0.8,7.6,4612,1298,3314,2.8,10.1,-1115,-2.5,15.2,0,87,87,505
2011,50,l) Left Censored,1932,3626,103964,103344,105,2.9,154,4.2,7737,1175,6562,1.1,7.5,6497,1095,5402,1.1,6.3,1240,1.2,12.6,0,49,49,384
2011,51,a) 0,9739,9814,54411,27340,9703,197.7,0,0,54143,54143,0,198,198,0,0,0,0,0,54143,198,0,0,,,
2011,51,b) 1,6907,7110,50057,53257,43,0.5,2387,28.8,12658,659,11999,1.2,23.8,19058,11350,7708,21.3,35.8,-6400,-12,47.6,0,1752,1752,8590
2011,51,c) 2,6712,6849,49527,49236,305,4.2,1397,19,10805,1198,9607,2.4,21.9,10222,5696,4526,11.6,20.8,583,1.1,41.6,0,1046,1046,4575
2011,51,d) 3,6871,6989,50707,52275,294,3.9,1346,18,8630,1630,7000,3.1,16.5,11766,6428,5338,12.3,22.5,-3136,-6,33,0,1023,1023,5408
2011,51,e) 4,6572,6669,53182,53084,280,4,1032,14.7,9383,1105,8278,2.1,17.7,9187,3984,5203,7.5,17.3,196,0.4,34.6,0,760,760,3012
2011,51,f) 5,6414,6790,59951,61215,280,3.9,1046,14.7,7754,1062,6692,1.7,12.7,10281,4440,5841,7.3,16.8,-2527,-4.1,25.4,0,765,765,3579
2011,51,g) 6 to 10,23594,24842,250454,253467,908,3.5,3050,11.8,33153,4691,28462,1.9,13.1,39179,15072,24107,5.9,15.5,-6026,-2.4,26.2,0,2083,2084,12112
2011,51,h) 11 to 15,16896,18916,237670,240184,713,3.7,1768,9.1,29859,6227,23632,2.6,12.4,34887,10590,24297,4.4,14.5,-5028,-2.1,24.8,0,1110,1110,7040
2011,51,i) 16 to 20,12194,13703,185893,187733,441,3.1,1148,8.2,19596,3991,15605,2.1,10.4,23275,6400,16875,3.4,12.4,-3679,-2,20.8,0,737,737,4135
2011,51,j) 21 to 25,10107,12782,239935,239278,510,3.9,920,7.1,28361,6944,21417,2.9,11.9,27046,6058,20988,2.5,11.3,1315,0.6,22.6,0,544,546,3615
2011,51,k) 26+,12381,19272,414048,413255,684,3.5,1068,5.5,41039,10265,30774,2.5,9.9,39452,9685,29767,2.3,9.5,1587,0.4,19,0,530,541,4091
2011,51,l) Left Censored,12083,40000,1339787,1333852,2443,6.1,2159,5.4,148962,43753,105209,3.3,11.2,137091,30158,106933,2.3,10.3,11871,0.9,20.6,0,404,414,5357
2011,53,a) 0,10140,10223,47675,24092,10042,196.5,0,0,47167,47167,0,195.8,195.8,0,0,0,0,0,47167,195.8,0,0,,,
2011,53,b) 1,6978,7112,43322,45963,29,0.3,2738,32.3,11064,137,10927,0.3,24.1,16346,8246,8100,17.9,35.6,-5282,-11.5,48.2,0,1925,1925,6393
2011,53,c) 2,6427,6512,41122,41968,293,4.1,1491,21.1,8077,1304,6773,3.1,19.2,9768,5002,4766,11.9,23.3,-1691,-4.1,38.4,0,1062,1062,3746
2011,53,d) 3,6859,6988,43964,45529,304,4.1,1426,19,7728,861,6867,1.9,17,10858,5174,5684,11.4,23.8,-3130,-6.8,34,0,1032,1032,3985
2011,53,e) 4,6505,6609,44024,45156,323,4.6,1239,17.6,7232,864,6368,1.9,16,9495,4443,5052,9.8,21,-2263,-5,32,0,868,868,3543
2011,53,f) 5,6408,6748,52704,53695,254,3.6,1105,15.5,7184,725,6459,1.4,13.4,9165,4036,5129,7.5,17.1,-1981,-3.7,26.8,0,761,762,3008
2011,53,g) 6 to 10,22801,24139,209753,217390,852,3.4,3305,13.1,27519,5455,22064,2.5,12.7,42793,16758,26035,7.7,19.7,-15274,-7,25.4,0,2173,2173,12260
2011,53,h) 11 to 15,16164,17770,190263,193253,657,3.6,2031,11,23317,3696,19621,1.9,12.1,29297,10444,18853,5.4,15.2,-5980,-3.1,24.2,0,1263,1263,7504
2011,53,i) 16 to 20,11352,12736,151926,154486,477,3.6,1275,9.7,19531,8454,11077,5.5,12.6,24651,6560,18091,4.2,16,-5120,-3.4,25.2,0,780,784,4016
2011,53,j) 21 to 25,8483,10355,183108,182790,348,3.3,858,8.1,18431,2108,16323,1.2,10.1,17794,4652,13142,2.5,9.7,637,0.4,19.4,0,481,485,2702
2011,53,k) 26+,10987,16494,374525,377187,522,3.1,1062,6.3,32872,8125,24747,2.2,8.7,38196,7723,30473,2,10.1,-5324,-1.4,17.4,0,556,562,3318
2011,53,l) Left Censored,9740,28055,907703,916746,1436,5.1,1518,5.4,104385,21773,82612,2.4,11.4,122470,47445,75025,5.2,13.4,-18085,-2,22.8,0,317,321,5501
2011,54,a) 0,1487,1532,9252,4647,1509,197,0,0,9210,9210,0,198.2,198.2,0,0,0,0,0,9210,198.2,0,0,,,
2011,54,b) 1,1039,1106,10993,11127,11,0.9,328,25.9,2288,52,2236,0.5,20.6,2555,1112,1443,10,23,-267,-2.4,41.2,0,246,246,829
2011,54,c) 2,1007,1017,7901,8007,34,3.1,210,19.2,1401,106,1295,1.3,17.5,1612,798,814,10,20.1,-211,-2.6,35,0,172,172,694
2011,54,d) 3,1013,1035,8228,8926,38,3.4,209,18.8,1036,88,948,1,11.6,2432,1219,1213,13.7,27.2,-1396,-15.6,23.2,0,166,166,1103
2011,54,e) 4,981,993,8829,8962,37,3.5,186,17.5,1719,403,1316,4.5,19.2,1984,921,1063,10.3,22.1,-265,-2.9,38.4,0,135,135,779
2011,54,f) 5,1064,1163,11616,12127,45,3.7,166,13.6,1483,144,1339,1.2,12.2,2504,1212,1292,10,20.6,-1021,-8.4,24.4,0,116,116,1060
2011,54,g) 6 to 10,4219,4502,41061,41700,127,2.7,546,11.7,5581,502,5079,1.2,13.4,6858,2638,4220,6.3,16.4,-1277,-3,26.8,0,399,399,2203
2011,54,h) 11 to 15,3254,3662,37944,38626,115,3.1,343,9.1,4132,587,3545,1.5,10.7,5495,2037,3458,5.3,14.2,-1363,-3.5,21.4,0,231,231,1520
2011,54,i) 16 to 20,2503,2819,30030,30302,82,2.8,281,9.7,3640,856,2784,2.8,12,4183,1278,2905,4.2,13.8,-543,-1.8,24,0,177,177,947
2011,54,j) 21 to 25,2213,2579,41200,41170,60,2.3,203,7.7,3697,432,3265,1,9,3637,1231,2406,3,8.8,60,0.2,17.6,0,137,137,844
2011,54,k) 26+,3428,5259,92212,91487,182,3.4,257,4.9,10373,2211,8162,2.4,11.3,8923,2861,6062,3.1,9.8,1450,1.5,19.6,0,154,154,1027
2011,54,l) Left Censored,4099,9668,259200,259687,395,4.1,405,4.2,21291,3884,17407,1.5,8.2,22264,3666,18598,1.4,8.6,-973,-0.4,16.4,0,142,143,861
2011,55,a) 0,5724,5873,33558,16888,5796,197.4,0,0,33340,33340,0,197.4,197.4,0,0,0,0,0,33340,197.4,0,0,,,
2011,55,b) 1,4199,4315,31730,33856,31,0.6,1417,28.3,8069,1398,6671,4.1,23.8,12320,7259,5061,21.4,36.4,-4251,-12.6,47.6,0,1012,1012,5980
2011,55,c) 2,4048,4107,29035,30124,160,3.6,814,18.5,5108,526,4582,1.7,17,7286,3877,3409,12.9,24.2,-2178,-7.2,34,0,606,606,3324
2011,55,d) 3,4142,4244,31677,32780,160,3.6,737,16.4,4995,788,4207,2.4,15.2,7200,3727,3473,11.4,22,-2205,-6.8,30.4,0,524,524,3087
2011,55,e) 4,4070,4126,32662,33323,174,4,653,15,4582,524,4058,1.6,13.8,5904,2888,3016,8.7,17.7,-1322,-3.9,27.6,0,453,453,2241
2011,55,f) 5,4210,4550,43085,42579,168,3.6,577,12.2,7010,1396,5614,3.3,16.5,5998,2574,3424,6,14.1,1012,2.4,28.2,0,396,398,2050
2011,55,g) 6 to 10,16321,17139,167976,169553,578,3.3,2009,11.3,21303,3723,17580,2.2,12.6,24457,9221,15236,5.4,14.4,-3154,-1.8,25.2,0,1322,1322,6438
2011,55,h) 11 to 15,13170,14514,173634,175661,471,3.2,1337,9,18655,3029,15626,1.7,10.6,22708,6370,16338,3.6,12.9,-4053,-2.3,21.2,0,833,835,4541
2011,55,i) 16 to 20,10106,11172,135215,136107,354,3.1,934,8.2,14550,3274,11276,2.4,10.7,16333,5323,11010,3.9,12,-1783,-1.3,21.4,0,550,552,3655
2011,55,j) 21 to 25,8513,10477,174694,175290,315,3,702,6.6,15422,2315,13107,1.3,8.8,16613,4574,12039,2.6,9.5,-1191,-0.7,17.6,0,387,387,2051
2011,55,k) 26+,10560,15471,313387,312248,389,2.5,848,5.4,30891,4860,26031,1.6,9.9,28613,6678,21935,2.1,9.2,2278,0.7,18.4,0,411,434,3635
2011,55,l) Left Censored,13071,30936,1185036,1174381,1022,3.3,1252,4,101323,20132,81191,1.7,8.6,80012,14222,65790,1.2,6.8,21311,1.8,13.6,0,360,368,3388
2011,56,a) 0,1162,1165,4631,2340,1148,197.1,0,0,4582,,,,195.8,0,0,0,0,0,4582,195.8,0,1,,,
2011,56,b) 1,805,811,4401,4690,4,0.4,243,26.1,980,,,,20.9,1557,659,898,14.1,33.2,-577,-12.3,41.8,1,170,170,492
2011,56,c) 2,781,793,3809,4281,32,3.7,180,20.9,631,52,579,1.2,14.7,1574,900,674,21,36.8,-943,-22.1,29.4,0,130,130,760
2011,56,d) 3,815,830,4564,4670,36,4.1,147,16.7,713,103,610,2.2,15.3,925,445,480,9.5,19.8,-212,-4.5,30.6,0,104,104,353
2011,56,e) 4,821,831,5237,5221,39,4.5,134,15.4,1116,88,1028,1.7,21.4,1084,483,601,9.3,20.8,32,0.6,41.6,0,93,93,388
2011,56,f) 5,786,817,5721,5796,39,4.6,121,14.2,1025,172,853,3,17.7,1175,455,720,7.9,20.3,-150,-2.6,35.4,0,75,75,327
2011,56,g) 6 to 10,2774,2873,20157,20707,133,4.5,334,11.3,3237,683,2554,3.3,15.6,4337,1893,2444,9.1,20.9,-1100,-5.3,31.2,0,210,210,1179
2011,56,h) 11 to 15,2044,2155,17134,17693,86,3.9,218,9.9,2104,308,1796,1.7,11.9,3221,1316,1905,7.4,18.2,-1117,-6.3,23.8,0,116,116,608
2011,56,i) 16 to 20,1346,1445,13731,13909,54,3.7,125,8.5,1647,353,1294,2.5,11.8,2002,416,1586,3,14.4,-355,-2.6,23.6,0,76,76,251
2011,56,j) 21 to 25,977,1138,17528,17519,44,3.8,78,6.8,1596,327,1269,1.9,9.1,1577,339,1238,1.9,9,19,0.1,18,0,43,43,173
2011,56,k) 26+,1579,2075,32824,32255,70,3.3,117,5.6,3831,917,2914,2.8,11.9,2692,537,2155,1.7,8.3,1139,3.6,16.6,0,60,60,178
2011,56,l) Left Censored,1551,3189,71376,70597,160,5,137,4.3,7597,1503,6094,2.1,10.8,6038,896,5142,1.3,8.6,1559,2.2,17.2,0,30,30,232
2012,01,a) 0,4467,4543,25827,12914,4543,200,0,0,25827,25827,0,200,200,0,0,0,0,0,25827,200,0,0,3,14,0
2012,01,b) 1,3447,3498,25852,26475,21,0.5,1034,25.8,6679,182,6497,0.7,25.2,7924,4945,2979,18.7,29.9,-1245,-4.7,50.4,0,898,908,4643
2012,01,c) 2,2931,3046,25683,25909,158,4.9,545,16.8,5240,838,4402,3.2,20.2,5692,3197,2495,12.3,22,-452,-1.8,40.4,0,488,502,3078
2012,01,d) 3,2884,3118,24234,24329,191,5.9,458,14.1,4968,1046,3922,4.3,20.4,5157,2266,2891,9.3,21.2,-189,-0.8,40.8,0,419,433,2259
2012,01,e) 4,2894,3054,25440,25899,183,5.7,457,14.3,4549,999,3550,3.9,17.6,5467,2140,3327,8.3,21.1,-918,-3.5,35.2,0,418,467,2362
2012,01,f) 5,2927,2984,25800,25659,154,5,386,12.5,4432,793,3639,3.1,17.3,4149,1943,2206,7.6,16.2,283,1.1,32.4,0,317,319,1565
2012,01,g) 6 to 10,11558,12301,127732,128352,579,4.6,1351,10.6,19339,3754,15585,2.9,15.1,20578,8280,12298,6.5,16,-1239,-0.9,30.2,0,1052,1059,6621
2012,01,h) 11 to 15,8716,9656,140794,139653,414,4.2,913,9.2,20665,3713,16952,2.7,14.8,18383,7432,10951,5.3,13.2,2282,1.6,26.4,0,656,674,5022
2012,01,i) 16 to 20,6644,7328,91648,93154,292,3.9,586,7.8,10383,1965,8418,2.1,11.1,13395,4885,8510,5.2,14.4,-3012,-3.3,22.2,0,446,451,3895
2012,01,j) 21 to 25,5238,6735,130848,131902,297,4.4,456,6.7,14270,1995,12275,1.5,10.8,16378,3897,12481,3,12.4,-2108,-1.6,21.6,0,288,302,2198
2012,01,k) 26+,8408,12666,246403,245312,581,4.6,695,5.5,26233,6271,19962,2.6,10.7,24050,5535,18515,2.3,9.8,2183,0.9,19.6,0,368,425,3518
2012,01,l) Left Censored,7312,21837,677699,680937,1129,5.2,1053,4.8,62746,15344,47402,2.3,9.2,69222,15075,54147,2.2,10.2,-6476,-1,18.4,0,271,336,3320
2012,02,a) 0,970,977,5120,2560,977,200,0,0,5120,5120,0,200,200,0,0,0,0,0,5120,200,0,0,1,2,0
2012,02,b) 1,687,697,3956,4017,4,0.5,252,30.7,1067,,,,26.6,1189,593,596,14.8,29.6,-122,-3,53.2,1,181,182,477
2012,02,c) 2,617,635,4124,4065,61,9.1,134,20,1006,263,743,6.5,24.7,888,396,492,9.7,21.8,118,2.9,43.6,0,94,95,307
2012,02,d) 3,617,661,5051,4767,47,6.8,107,15.5,1579,,,,33.1,1010,518,492,10.9,21.2,569,11.9,42.4,1,76,81,255
2012,02,e) 4,631,653,4789,4669,37,5.4,93,13.7,946,104,842,2.2,20.3,706,309,397,6.6,15.1,240,5.2,30.2,0,67,69,256
2012,02,f) 5,598,609,4674,4718,42,6.6,93,14.7,753,130,623,2.8,16,840,330,510,7,17.8,-87,-1.8,32,0,50,50,203
2012,02,g) 6 to 10,2464,2576,22866,22793,168,6.4,270,10.3,4142,917,3225,4,18.2,3996,1320,2676,5.8,17.5,146,0.7,35,0,166,167,770
2012,02,h) 11 to 15,1789,1963,27180,28122,138,7,166,8.4,5121,1312,3809,4.7,18.2,7005,663,6342,2.4,24.9,-1884,-6.7,36.4,0,105,107,444
2012,02,i) 16 to 20,1246,1301,10034,10319,47,3.5,108,8.1,1221,222,999,2.2,11.8,1791,628,1163,6.1,17.4,-570,-5.6,23.6,0,66,66,501
2012,02,j) 21 to 25,994,1167,19986,20087,53,4.5,80,6.8,2145,381,1764,1.9,10.7,2346,990,1356,4.9,11.7,-201,-1,21.4,0,42,44,896
2012,02,k) 26+,1718,2681,53510,53658,119,4.4,165,6.1,6569,1120,5449,2.1,12.2,6865,1282,5583,2.4,12.8,-296,-0.6,24.4,0,62,68,302
2012,02,l) Left Censored,1221,3246,95442,95243,197,6.1,189,5.8,10464,2279,8185,2.4,11,10066,1514,8552,1.6,10.6,398,0.4,21.2,0,26,38,310
2012,04,a) 0,7689,7738,53133,26567,7738,200,0,0,53133,53133,0,200,200,0,0,0,0,0,53133,200,0,0,6,7,0
2012,04,b) 1,5924,6013,45100,46022,31,0.4,1916,27.5,12132,710,11422,1.5,26.4,13975,8213,5762,17.8,30.4,-1843,-4,52.8,0,1564,1574,7430
2012,04,c) 2,4692,4839,47686,47481,306,5.9,1065,20.4,9781,1359,8422,2.9,20.6,9370,5542,3828,11.7,19.7,411,0.9,39.4,0,915,950,5366
2012,04,d) 3,4468,4597,44771,44861,331,6.8,825,17,8534,1864,6670,4.2,19,8714,4051,4663,9,19.4,-180,-0.4,38,0,714,739,4126
2012,04,e) 4,4810,5179,46948,46457,356,6.6,783,14.5,9626,2043,7583,4.4,20.7,8643,4174,4469,9,18.6,983,2.1,37.2,0,684,827,5466
2012,04,f) 5,4497,4619,38558,38982,297,6.1,750,15.5,7126,2011,5115,5.2,18.3,7973,3886,4087,10,20.5,-847,-2.2,36.6,0,591,596,3301
2012,04,g) 6 to 10,17346,18331,200532,201379,1057,5.6,2275,12,30922,7330,23592,3.6,15.4,32616,13623,18993,6.8,16.2,-1694,-0.8,30.8,0,1669,1689,10819
2012,04,h) 11 to 15,11189,12359,172938,172859,645,5.1,1271,10,21723,5249,16474,3,12.6,21564,8013,13551,4.6,12.5,159,0.1,25,0,885,888,5788
2012,04,i) 16 to 20,7283,8343,126922,126841,371,4.3,793,9.3,16875,4774,12101,3.8,13.3,16713,6190,10523,4.9,13.2,162,0.1,26.4,0,510,526,3535
2012,04,j) 21 to 25,5308,7701,156654,154421,369,4.7,555,7.1,20843,6209,14634,4,13.5,16377,4633,11744,3,10.6,4466,2.9,21.2,0,332,347,2475
2012,04,k) 26+,7530,12542,315348,314779,689,5.4,917,7.2,40844,10090,30754,3.2,13,39705,11020,28685,3.5,12.6,1139,0.4,25.2,0,460,560,5993
2012,04,l) Left Censored,5430,22654,869358,871669,1573,7,1368,6.1,112300,28317,83983,3.2,12.9,116922,29456,87466,3.4,13.4,-4622,-0.5,25.8,0,223,310,3454
2012,05,a) 0,3125,3148,16346,8173,3148,200,0,0,16346,16346,0,200,200,0,0,0,0,0,16346,200,0,0,3,5,0
2012,05,b) 1,2536,2581,18408,19628,16,0.5,700,23.9,4184,178,4006,0.9,21.3,6623,3419,3204,17.4,33.7,-2439,-12.4,42.6,0,592,595,3030
2012,05,c) 2,2130,2206,18537,18611,131,5.6,388,16.6,3609,869,2740,4.7,19.4,3756,1738,2018,9.3,20.2,-147,-0.8,38.8,0,346,353,1610
2012,05,d) 3,2005,2092,17139,16998,113,5.1,324,14.7,3442,685,2757,4,20.2,3160,1623,1537,9.5,18.6,282,1.6,37.2,0,283,297,1478
2012,05,e) 4,2032,2143,17070,16872,132,6,251,11.4,3286,956,2330,5.7,19.5,2890,1478,1412,8.8,17.1,396,2.4,34.2,0,241,286,1801
2012,05,f) 5,1887,1917,17993,17900,104,5.2,256,12.8,3236,533,2703,3,18.1,3049,1280,1769,7.2,17,187,1.1,34,0,210,210,1008
2012,05,g) 6 to 10,8221,8794,76798,77911,429,4.7,961,10.6,10549,1660,8889,2.1,13.5,12774,5275,7499,6.8,16.4,-2225,-2.9,27,0,739,752,4207
2012,05,h) 11 to 15,5773,6427,65771,64473,279,4.2,571,8.7,12506,2225,10281,3.5,19.4,9909,3572,6337,5.5,15.4,2597,4,30.8,0,404,409,2404
2012,05,i) 16 to 20,4448,4911,54785,54879,222,4.4,397,7.9,6742,1467,5275,2.7,12.3,6929,2098,4831,3.8,12.6,-187,-0.3,24.6,0,275,275,1565
2012,05,j) 21 to 25,3256,4001,64036,68140,153,3.8,284,7,6257,1063,5194,1.6,9.2,14465,2281,12184,3.3,21.2,-8208,-12,18.4,0,183,193,1298
2012,05,k) 26+,5340,7635,153985,157044,284,3.7,517,6.7,14342,2516,11826,1.6,9.1,20459,5538,14921,3.5,13,-6117,-3.9,18.2,0,287,334,3008
2012,05,l) Left Censored,4949,13805,448932,449040,645,4.7,625,4.5,39650,8750,30900,1.9,8.8,39866,10540,29326,2.3,8.9,-216,-0.1,17.6,0,162,191,2053
2012,06,a) 0,53409,53821,316097,158049,53821,200,0,0,316097,316097,0,200,200,0,0,0,0,0,316097,200,0,0,39,78,0
2012,06,b) 1,39778,40553,292802,295646,268,0.6,11911,25.7,76378,3657,72721,1.2,25.8,82066,47697,34369,16.1,27.8,-5688,-2,51.6,0,9655,9760,41725
2012,06,c) 2,32430,33454,260568,265013,2081,5.9,6305,17.7,61164,12310,48854,4.6,23.1,70054,41555,28499,15.7,26.4,-8890,-3.3,46.2,0,5285,5451,35466
2012,06,d) 3,30718,31491,252489,250519,1955,5.9,5108,15.4,54112,11827,42285,4.7,21.6,50171,25931,24240,10.4,20,3941,1.6,40,0,4305,4551,25988
2012,06,e) 4,31497,32846,274998,270990,2205,6.5,4724,13.9,60212,13418,46794,5,22.2,52196,27863,24333,10.3,19.3,8016,2.9,38.6,0,4070,4579,30318
2012,06,f) 5,29290,29663,239335,241284,1800,5.8,4151,13.5,44498,10301,34197,4.3,18.4,48396,22429,25967,9.3,20.1,-3898,-1.7,36.8,0,3293,3306,19720
2012,06,g) 6 to 10,118934,125348,1292126,1290744,6944,5.4,14318,11.1,212254,44277,167977,3.4,16.4,209490,88327,121163,6.8,16.2,2764,0.2,32.4,0,10604,10709,70041
2012,06,h) 11 to 15,76777,84004,1076542,1084044,4452,5.2,8025,9.4,144713,32456,112257,3,13.3,159716,60075,99641,5.5,14.7,-15003,-1.4,26.6,0,5562,5651,47125
2012,06,i) 16 to 20,49515,55386,798060,797526,2578,4.6,4705,8.3,106340,28055,78285,3.5,13.3,105271,36381,68890,4.6,13.2,1069,0.1,26.4,0,3250,3308,26570
2012,06,j) 21 to 25,42865,53468,1056197,1053271,2650,4.9,4162,7.7,133043,29976,103067,2.8,12.6,127190,37817,89373,3.6,12.1,5853,0.5,24.2,0,2630,2708,20846
2012,06,k) 26+,60735,91748,2134135,2127600,4092,4.4,6391,6.9,245601,48013,197588,2.3,11.5,232531,60558,171973,2.8,10.9,13070,0.6,21.8,0,3460,3924,30795
2012,06,l) Left Censored,38688,130255,4882145,4859617,8089,6.2,7742,6,558847,128874,429973,2.7,11.5,513790,128142,385648,2.6,10.6,45057,0.9,21.2,0,1809,2332,27403
2012,08,a) 0,9075,9117,44437,22219,9117,200,0,0,44437,44437,0,200,200,0,0,0,0,0,44437,200,0,0,5,10,0
2012,08,b) 1,6908,6999,44281,45437,28,0.3,2191,27.1,10858,249,10609,0.5,23.9,13170,8019,5151,17.6,29,-2312,-5.1,47.8,0,1721,1734,7361
2012,08,c) 2,5804,5920,42358,42174,426,6.8,1204,19.1,8854,1934,6920,4.6,21,8487,4760,3727,11.3,20.1,367,0.9,40.2,0,963,984,4477
2012,08,d) 3,5418,5506,40212,39827,359,6.2,884,15.3,7480,1437,6043,3.6,18.8,6710,3284,3426,8.2,16.8,770,2,33.6,0,724,745,3254
2012,08,e) 4,5636,5762,44058,43814,363,6,870,14.5,10102,2827,7275,6.5,23.1,9613,4805,4808,11,21.9,489,1.2,43.8,0,713,737,4694
2012,08,f) 5,5251,5322,40141,39850,357,6.4,788,14.2,7224,1280,5944,3.2,18.1,6641,2943,3698,7.4,16.7,583,1.4,33.4,0,552,553,2451
2012,08,g) 6 to 10,21073,21937,195174,194237,1338,5.9,2636,11.7,31562,6677,24885,3.4,16.2,29688,13684,16004,7,15.3,1874,0.9,30.6,0,1802,1819,10506
2012,08,h) 11 to 15,14534,15697,170294,168520,940,5.9,1559,9.7,24534,5185,19349,3.1,14.6,20986,7992,12994,4.7,12.5,3548,2.1,25,0,1014,1031,5562
2012,08,i) 16 to 20,9677,10583,139342,138317,510,4.7,965,8.9,18399,3713,14686,2.7,13.3,16349,6792,9557,4.9,11.8,2050,1.5,23.6,0,592,610,3900
2012,08,j) 21 to 25,6656,8349,144839,143867,395,4.7,673,7.9,19073,4300,14773,3,13.3,17129,5481,11648,3.8,11.9,1944,1.4,23.8,0,375,397,2219
2012,08,k) 26+,9417,14231,301607,301985,737,5.1,955,6.7,33558,9289,24269,3.1,11.1,34313,10421,23892,3.5,11.4,-755,-0.3,22.2,0,504,566,4549
2012,08,l) Left Censored,7084,22452,790412,786299,1450,6.5,1398,6.2,87832,22166,65666,2.8,11.2,79606,16289,63317,2.1,10.1,8226,1.1,20.2,0,267,332,4103
2012,09,a) 0,3966,3972,22940,11470,3972,200,0,0,22940,22940,0,200,200,0,0,0,0,0,22940,200,0,0,2,2,0
2012,09,b) 1,2977,3003,20051,20932,9,0.3,797,23.5,4908,228,4680,1.1,23.4,6669,3667,3002,17.5,31.9,-1761,-8.5,46.8,0,666,677,3400
2012,09,c) 2,2571,2656,22888,22719,162,5.8,466,16.6,4599,772,3827,3.4,20.2,4260,2450,1810,10.8,18.8,339,1.4,37.6,0,392,403,2217
2012,09,d) 3,2436,2459,20394,20360,140,5.5,357,13.9,3655,518,3137,2.5,18,3587,1974,1613,9.7,17.6,68,0.4,35.2,0,312,323,1869
2012,09,e) 4,2560,2655,22570,22551,158,5.7,394,14.2,4349,828,3521,3.7,19.3,4310,1803,2507,8,19.1,39,0.2,38.2,0,356,394,2178
2012,09,f) 5,2287,2308,20426,20366,135,5.7,279,11.7,3081,1005,2076,4.9,15.1,2961,1210,1751,5.9,14.5,120,0.6,29,0,223,223,1046
2012,09,g) 6 to 10,10047,10538,105929,105650,526,4.9,1043,9.7,14730,2229,12501,2.1,13.9,14171,5393,8778,5.1,13.4,559,0.5,26.8,0,786,786,4228
2012,09,h) 11 to 15,7792,8420,113316,113720,389,4.5,700,8.2,15646,2479,13167,2.2,13.8,16453,4769,11684,4.2,14.5,-807,-0.7,27.6,0,498,501,3407
2012,09,i) 16 to 20,6157,6524,70466,70405,273,4.1,464,7,7870,1478,6392,2.1,11.2,7748,2598,5150,3.7,11,122,0.2,22,0,337,340,2044
2012,09,j) 21 to 25,5708,6582,120980,115556,268,4,428,6.4,20639,2131,18508,1.8,17.9,9791,2957,6834,2.6,8.5,10848,9.4,17,0,289,306,2269
2012,09,k) 26+,8315,11372,217638,213854,475,4.1,718,6.2,29917,4711,25206,2.2,14,22349,6021,16328,2.8,10.5,7568,3.5,21,0,385,409,2713
2012,09,l) Left Censored,9041,19423,732369,726993,1008,5.2,1105,5.7,79104,19593,59511,2.7,10.9,68351,16533,51818,2.3,9.4,10753,1.5,18.8,0,331,351,3861
2012,10,a) 0,1262,1266,8414,4207,1266,200,0,0,8414,8414,0,200,200,0,0,0,0,0,8414,200,0,0,,,
2012,10,b) 1,905,910,6191,6767,5,0.5,312,29.3,1520,81,1439,1.2,22.5,2672,1891,781,27.9,39.5,-1152,-17,45,0,254,258,1632
2012,10,c) 2,719,728,5662,5988,42,5.4,145,18.6,1174,201,973,3.4,19.6,1826,1423,403,23.8,30.5,-652,-10.9,39.2,0,129,131,1415
2012,10,d) 3,724,738,6176,6163,27,3.5,104,13.4,1010,117,893,1.9,16.4,984,437,547,7.1,16,26,0.4,32,0,84,84,387
2012,10,e) 4,773,799,6805,6731,47,5.6,117,14,1306,353,953,5.2,19.4,1157,669,488,9.9,17.2,149,2.2,34.4,0,110,115,743
2012,10,f) 5,652,685,7975,7496,38,5.4,85,12,2015,1352,663,18,26.9,1057,441,616,5.9,14.1,958,12.8,28.2,0,68,69,343
2012,10,g) 6 to 10,2819,2901,26328,26712,133,4.4,359,11.9,3304,587,2717,2.2,12.4,4071,1642,2429,6.1,15.2,-767,-2.8,24.8,0,267,267,1333
2012,10,h) 11 to 15,2067,2223,23393,23336,110,4.8,219,9.6,2932,407,2525,1.7,12.6,2817,981,1836,4.2,12.1,115,0.5,24.2,0,170,171,827
2012,10,i) 16 to 20,1492,1698,22083,22153,66,3.8,140,8.1,2341,657,1684,3,10.6,2481,834,1647,3.8,11.2,-140,-0.6,21.2,0,93,93,631
2012,10,j) 21 to 25,1261,1411,19159,20543,46,3.2,107,7.4,2079,207,1872,1,10.1,4846,953,3893,4.6,23.6,-2767,-13.5,20.2,0,56,57,285
2012,10,k) 26+,1847,2541,51537,52283,153,6,187,7.3,4955,1606,3349,3.1,9.5,6447,2253,4194,4.3,12.3,-1492,-2.8,19,0,80,86,716
2012,10,l) Left Censored,2403,5586,184633,181900,405,7.3,359,6.5,24815,7783,17032,4.3,13.6,19349,7920,11429,4.4,10.6,5466,3,21.2,0,62,84,717
2012,11,a) 0,908,909,8609,4305,909,200,0,0,8609,8609,0,200,200,0,0,0,0,0,8609,200,0,0,,,
2012,11,b) 1,792,794,7316,6987,5,0.6,188,21.2,2313,44,2269,0.6,33.1,1654,1044,610,14.9,23.7,659,9.4,47.4,0,164,167,1058
2012,11,c) 2,673,687,8034,7756,38,5.2,122,16.7,1719,307,1412,4,22.2,1162,607,555,7.8,15,557,7.2,30,0,103,103,667
2012,11,d) 3,608,612,6986,6500,38,6,76,12,2090,636,1454,9.8,32.2,1117,401,716,6.2,17.2,973,15,34.4,0,63,65,392
2012,11,e) 4,592,636,8360,7532,52,8.1,61,9.5,2527,1456,1071,19.3,33.6,870,333,537,4.4,11.6,1657,22,23.2,0,71,96,803
2012,11,f) 5,570,571,6230,6385,23,3.9,75,12.6,1008,186,822,2.9,15.8,1317,760,557,11.9,20.6,-309,-4.8,31.6,0,61,61,616
2012,11,g) 6 to 10,2400,2484,36500,35037,121,4.8,234,9.2,6662,1099,5563,3.1,19,3736,1395,2341,4,10.7,2926,8.3,21.4,0,182,182,1029
2012,11,h) 11 to 15,1858,2025,37429,37518,77,3.7,191,9.2,4856,448,4408,1.2,12.9,5034,2556,2478,6.8,13.4,-178,-0.5,25.8,0,125,126,1981
2012,11,i) 16 to 20,1360,1492,25906,26060,61,4,99,6.6,2858,504,2354,1.9,11,3165,632,2533,2.4,12.1,-307,-1.1,22,0,69,70,432
2012,11,j) 21 to 25,1197,1459,28676,29030,86,5.8,116,7.9,3731,728,3003,2.5,12.9,4438,1431,3007,4.9,15.3,-707,-2.4,25.8,0,55,58,851
2012,11,k) 26+,2115,2785,89564,90357,134,4.8,182,6.5,7540,1891,5649,2.1,8.3,9126,1756,7370,1.9,10.1,-1586,-1.8,16.6,0,86,89,888
2012,11,l) Left Censored,2779,5698,233286,233704,330,5.8,401,7,24494,4114,20380,1.8,10.5,25329,4084,21245,1.7,10.8,-835,-0.3,21,0,71,92,1132
2012,12,a) 0,36465,36763,196720,98360,36763,200,0,0,196720,196720,0,200,200,0,0,0,0,0,196720,200,0,0,16,66,0
2012,12,b) 1,26961,27455,178774,183144,174,0.5,8726,27.5,49304,3239,46065,1.8,26.9,58044,36101,21943,19.7,31.7,-8740,-4.8,53.8,0,7127,7214,31759
2012,12,c) 2,21622,22126,161538,165941,1502,6.4,4458,18.9,34106,6393,27713,3.9,20.6,42911,26526,16385,16,25.9,-8805,-5.3,41.2,0,3715,3807,25578
2012,12,d) 3,18669,19049,130115,133305,1188,5.9,3146,15.7,26127,5622,20505,4.2,19.6,32507,16636,15871,12.5,24.4,-6380,-4.8,39.2,0,2592,2684,15144
2012,12,e) 4,18478,19007,130689,130787,1267,6.4,2915,14.7,28276,8123,20153,6.2,21.6,28471,14684,13787,11.2,21.8,-195,-0.2,43.2,0,2402,2557,15439
2012,12,f) 5,17277,17615,134067,132610,1168,6.4,2648,14.4,29228,3908,25320,2.9,22,26313,14642,11671,11,19.8,2915,2.2,39.6,0,2033,2036,10937
2012,12,g) 6 to 10,70964,73777,643452,650462,4945,6.5,9223,12.1,124252,20821,103431,3.2,19.1,138272,72666,65606,11.2,21.3,-14020,-2.2,38.2,0,6785,6859,61582
2012,12,h) 11 to 15,42179,45687,510950,519426,2559,5.5,4553,9.8,71678,17662,54016,3.4,13.8,88630,44180,44450,8.5,17.1,-16952,-3.3,27.6,0,3150,3224,38218
2012,12,i) 16 to 20,29645,33479,578810,544850,1705,5,2758,8.1,124330,12812,111518,2.4,22.8,56409,20593,35816,3.8,10.4,67921,12.4,20.8,0,1941,1992,13847
2012,12,j) 21 to 25,22341,28099,513853,504399,1380,4.8,2154,7.6,79139,38191,40948,7.6,15.7,60230,15935,44295,3.2,11.9,18909,3.8,23.8,0,1283,1342,9650
2012,12,k) 26+,26875,42106,903754,907329,2319,5.5,2994,7.1,106485,26872,79613,3,11.7,113635,35009,78626,3.9,12.5,-7150,-0.8,23.4,0,1513,1726,20521
2012,12,l) Left Censored,16965,71789,2652359,2644090,5083,7.1,3938,5.5,296363,88510,207853,3.3,11.2,279825,85134,194691,3.2,10.6,16538,0.6,21.2,0,738,924,11850
2012,13,a) 0,12492,12592,75062,37531,12592,200,0,0,75062,75062,0,200,200,0,0,0,0,0,75062,200,0,0,10,35,0
2012,13,b) 1,9456,9585,67328,70286,52,0.5,2995,27.1,17886,899,16987,1.3,25.4,23802,15355,8447,21.8,33.9,-5916,-8.5,50.8,0,2458,2476,13502
2012,13,c) 2,7935,8105,60594,60173,513,5.9,1581,18.3,14845,2138,12707,3.6,24.7,14003,6945,7058,11.5,23.3,842,1.4,46.6,0,1335,1350,6381
2012,13,d) 3,7313,7705,78907,79285,415,5.1,1195,14.8,11878,1734,10144,2.2,15,12634,5876,6758,7.4,15.9,-756,-0.9,30,0,1024,1055,5987
2012,13,e) 4,7860,8241,64026,63404,579,6.8,1176,13.8,13044,2870,10174,4.5,20.6,11799,5770,6029,9.1,18.6,1245,2,37.2,0,1040,1192,7194
2012,13,f) 5,7311,7465,58090,59053,484,6.2,1091,14,10030,2109,7921,3.6,17,11956,6676,5280,11.3,20.2,-1926,-3.2,34,0,840,846,5948
2012,13,g) 6 to 10,28165,29669,312647,314807,1735,5.7,3793,12.4,48671,9572,39099,3,15.5,52990,22814,30176,7.2,16.8,-4319,-1.3,31,0,2696,2718,17360
2012,13,h) 11 to 15,19470,21545,285074,288518,1156,5.2,2114,9.6,39005,11820,27185,4.1,13.5,45892,13640,32252,4.7,15.9,-6887,-2.4,27,0,1459,1470,9770
2012,13,i) 16 to 20,13064,15046,198345,198617,782,5.1,1292,8.4,23501,5512,17989,2.8,11.8,24045,7538,16507,3.8,12.1,-544,-0.3,23.6,0,854,871,5190
2012,13,j) 21 to 25,9359,12166,241618,244053,566,4.6,984,8,27865,5291,22574,2.2,11.4,32734,12220,20514,5,13.4,-4869,-2,22.8,0,574,595,4350
2012,13,k) 26+,13563,20880,475720,471800,1181,5.6,1586,7.5,60833,17179,43654,3.6,12.9,52993,15940,37053,3.4,11.2,7840,1.7,22.4,0,740,825,6230
2012,13,l) Left Censored,11076,39986,1456470,1450287,2649,6.6,2496,6.3,173446,53122,120324,3.7,12,161080,44626,116454,3.1,11.1,12366,0.9,22.2,0,497,597,5143
2012,15,a) 0,1356,1374,7753,3877,1374,200,0,0,7753,7753,0,200,200,0,0,0,0,0,7753,200,0,0,1,1,0
2012,15,b) 1,1071,1083,9365,9472,8,0.6,318,25.7,2411,56,2355,0.6,25.5,2624,1605,1019,16.9,27.7,-213,-2.2,51,0,271,277,1567
2012,15,c) 2,916,938,8264,8407,46,4.6,155,15.6,1528,265,1263,3.2,18.2,1813,960,853,11.4,21.6,-285,-3.4,36.4,0,136,140,902
2012,15,d) 3,871,884,10991,11009,33,3.5,143,15.2,2092,186,1906,1.7,19,2128,1486,642,13.5,19.3,-36,-0.3,38,0,128,131,759
2012,15,e) 4,901,940,7117,7179,49,5,126,12.9,1262,159,1103,2.2,17.6,1385,549,836,7.6,19.3,-123,-1.7,35.2,0,119,136,666
2012,15,f) 5,940,945,10489,9632,53,5.4,135,13.7,2833,404,2429,4.2,29.4,1119,634,485,6.6,11.6,1714,17.8,23.2,0,117,118,601
2012,15,g) 6 to 10,3829,4086,42871,43280,170,4,397,9.5,5545,1204,4341,2.8,12.8,6363,2644,3719,6.1,14.7,-818,-1.9,25.6,0,296,297,1566
2012,15,h) 11 to 15,2762,3012,34241,34606,97,3.1,256,8.3,3661,363,3298,1,10.6,4390,1427,2963,4.1,12.7,-729,-2.1,21.2,0,190,191,1068
2012,15,i) 16 to 20,2088,2287,34286,34067,78,3.3,167,7.2,3453,227,3226,0.7,10.1,3015,947,2068,2.8,8.9,438,1.2,17.8,0,103,103,616
2012,15,j) 21 to 25,1843,2255,38077,38012,108,4.7,172,7.5,3794,1088,2706,2.9,10,3664,962,2702,2.5,9.6,130,0.4,19.2,0,107,113,659
2012,15,k) 26+,3058,4367,79010,78332,179,4,297,6.7,7822,1307,6515,1.7,10,6466,1674,4792,2.1,8.3,1356,1.7,16.6,0,126,135,812
2012,15,l) Left Censored,2815,6638,210894,208840,350,5.3,391,5.9,21074,6811,14263,3.3,10.1,16966,4573,12393,2.2,8.1,4108,2,16.2,0,89,116,928
2012,16,a) 0,2332,2341,10624,5312,2341,200,0,0,10624,10624,0,200,200,0,0,0,0,0,10624,200,0,0,4,5,0
2012,16,b) 1,1711,1751,12865,12039,17,0.8,567,28,4686,114,4572,0.9,38.9,3034,1794,1240,14.9,25.2,1652,13.7,50.4,0,456,458,1587
2012,16,c) 2,1452,1490,9496,9372,129,8.2,283,18.1,2197,458,1739,4.9,23.4,1948,1102,846,11.8,20.8,249,2.6,41.6,0,227,236,1081
2012,16,d) 3,1416,1441,10579,10644,100,6.6,227,15.1,1856,349,1507,3.3,17.4,1985,874,1111,8.2,18.6,-129,-1.2,34.8,0,196,205,1044
2012,16,e) 4,1659,1724,11419,11173,133,7.4,260,14.5,2509,526,1983,4.7,22.5,2017,900,1117,8.1,18.1,492,4.4,36.2,0,225,258,1294
2012,16,f) 5,1612,1628,10424,10624,127,7.5,267,15.7,1776,316,1460,3,16.7,2175,859,1316,8.1,20.5,-399,-3.8,33.4,0,193,194,681
2012,16,g) 6 to 10,6299,6594,64512,64485,426,6.3,864,12.7,11034,3159,7875,4.9,17.1,10979,6457,4522,10,17,55,0.1,34,0,603,608,3510
2012,16,h) 11 to 15,4318,4622,45759,45880,300,6.4,459,9.8,5988,1281,4707,2.8,13.1,6229,2315,3914,5,13.6,-241,-0.5,26.2,0,286,293,1664
2012,16,i) 16 to 20,2907,3088,29877,29620,184,5.9,269,8.6,4047,1094,2953,3.7,13.7,3533,1178,2355,4,11.9,514,1.8,23.8,0,179,181,790
2012,16,j) 21 to 25,2005,2376,31024,31154,147,6.1,201,8.4,4329,761,3568,2.4,13.9,4589,2015,2574,6.5,14.7,-260,-0.8,27.8,0,124,127,1094
2012,16,k) 26+,2766,3971,77135,76487,204,5.1,257,6.4,10662,2733,7929,3.6,13.9,9365,2569,6796,3.4,12.2,1297,1.7,24.4,0,154,183,873
2012,16,l) Left Censored,2607,6727,184233,184015,345,5.1,353,5.2,18014,5309,12705,2.9,9.8,17577,5591,11986,3,9.6,437,0.2,19.2,0,83,97,1051
2012,17,a) 0,16261,16349,87908,43954,16349,200,0,0,87908,87908,0,200,200,0,0,0,0,0,87908,200,0,0,7,7,0
2012,17,b) 1,12475,12726,84266,89068,56,0.4,3894,26.6,20482,736,19746,0.8,23,30086,14728,15358,16.5,33.8,-9604,-10.8,46,0,2916,2935,13136
2012,17,c) 2,10167,10452,94847,96420,708,6.4,1937,17.5,20478,5769,14709,6,21.2,23623,11031,12592,11.4,24.5,-3145,-3.3,42.4,0,1529,1567,7679
2012,17,d) 3,9577,9794,74394,73171,605,5.9,1541,15,15803,2511,13292,3.4,21.6,13356,7303,6053,10,18.3,2447,3.3,36.6,0,1225,1267,6733
2012,17,e) 4,10047,10427,81266,80779,600,5.6,1366,12.6,14550,2883,11667,3.6,18,13576,6607,6969,8.2,16.8,974,1.2,33.6,0,1108,1243,7407
2012,17,f) 5,9095,9284,76343,75673,586,6.1,1261,13.1,13552,3691,9861,4.9,17.9,12212,5831,6381,7.7,16.1,1340,1.8,32.2,0,956,957,5078
2012,17,g) 6 to 10,37888,39930,392890,393515,2071,5,4340,10.6,56835,10865,45970,2.8,14.4,58084,22333,35751,5.7,14.8,-1249,-0.4,28.8,0,3084,3100,17520
2012,17,h) 11 to 15,27567,30188,363588,364406,1516,4.9,2630,8.6,48275,9625,38650,2.6,13.2,49910,15909,34001,4.4,13.7,-1635,-0.5,26.4,0,1700,1728,11537
2012,17,i) 16 to 20,21155,23118,292267,290241,1113,4.7,1849,7.9,37798,7366,30432,2.5,13,33746,10062,23684,3.5,11.6,4052,1.4,23.2,0,1207,1212,7097
2012,17,j) 21 to 25,17503,21003,382902,386545,884,4.1,1596,7.5,44380,10615,33765,2.7,11.5,51666,23835,27831,6.2,13.4,-7286,-1.9,23,0,946,966,7079
2012,17,k) 26+,24695,35239,836657,831000,1536,4.3,2249,6.3,97635,25190,72445,3,11.7,86321,23513,62808,2.8,10.4,11314,1.3,20.8,0,1243,1387,12485
2012,17,l) Left Censored,24396,61291,2322954,2320011,3241,5.3,3894,6.3,242264,55909,186355,2.4,10.4,236377,65291,171086,2.8,10.2,5887,0.2,20.4,0,929,1108,15109
2012,18,a) 0,6274,6307,45495,22748,6307,200,0,0,45495,45495,0,200,200,0,0,0,0,0,45495,200,0,0,3,4,0
2012,18,b) 1,4859,5011,51451,51726,50,0.9,1351,23.9,9530,1157,8373,2.2,18.4,10079,5905,4174,11.4,19.5,-549,-1.1,36.8,0,1084,1097,5394
2012,18,c) 2,4037,4190,34232,34706,273,6.2,753,17,7058,1279,5779,3.7,20.3,8005,4754,3251,13.7,23.1,-947,-2.8,40.6,0,653,682,4466
2012,18,d) 3,3881,4013,35735,35453,249,5.9,607,14.5,7461,1204,6257,3.4,21,6897,3583,3314,10.1,19.5,564,1.5,39,0,512,542,3652
2012,18,e) 4,4318,4535,40011,39817,255,5.4,609,12.9,7336,1744,5592,4.4,18.4,6947,4103,2844,10.3,17.4,389,1,34.8,0,538,618,4313
2012,18,f) 5,3933,4013,34530,34748,215,5.2,506,12.2,5459,721,4738,2.1,15.7,5894,3083,2811,8.9,17,-435,-1.3,31.4,0,399,408,2797
2012,18,g) 6 to 10,16476,17363,176292,175710,930,5.2,1795,10.1,27626,6053,21573,3.4,15.7,26461,10688,15773,6.1,15.1,1165,0.6,30.2,0,1316,1353,8385
2012,18,h) 11 to 15,12234,13739,167709,165187,734,5.3,1123,8.1,25957,5126,20831,3.1,15.7,20913,8519,12394,5.2,12.7,5044,3,25.4,0,778,808,6093
2012,18,i) 16 to 20,9680,10909,146852,144647,526,4.8,835,7.5,19563,3316,16247,2.3,13.5,15152,4315,10837,3,10.5,4411,3,21,0,614,621,3500
2012,18,j) 21 to 25,7966,10012,182949,180052,424,4.2,646,6.4,22826,5014,17812,2.8,12.7,17031,3700,13331,2.1,9.5,5795,3.2,19,0,438,451,2825
2012,18,k) 26+,12333,18810,394274,391015,971,5.1,1168,6.2,50597,17312,33285,4.4,12.9,44078,9707,34371,2.5,11.3,6519,1.6,22.6,0,612,710,5338
2012,18,l) Left Censored,12495,33438,1213400,1200806,1773,5.3,1809,5.4,134290,29623,104667,2.5,11.2,109101,25137,83964,2.1,9.1,25189,2.1,18.2,0,423,488,5531
2012,19,a) 0,3401,3418,18466,9233,3418,200,0,0,18466,18466,0,200,200,0,0,0,0,0,18466,200,0,0,1,1,0
2012,19,b) 1,2728,2776,18488,19026,25,0.8,718,23,4799,796,4003,4.2,25.2,5875,3715,2160,19.5,30.9,-1076,-5.7,50.4,0,562,570,2848
2012,19,c) 2,2300,2332,15176,15350,149,6,412,16.7,2716,455,2261,3,17.7,3064,1603,1461,10.4,20,-348,-2.3,35.4,0,336,337,1417
2012,19,d) 3,2204,2279,18425,18172,132,5.5,349,14.6,3762,442,3320,2.4,20.7,3256,1724,1532,9.5,17.9,506,2.8,35.8,0,287,294,1598
2012,19,e) 4,2398,2496,19084,18504,140,5.5,277,10.8,3910,588,3322,3.2,21.1,2750,1065,1685,5.8,14.9,1160,6.2,29.8,0,242,282,1521
2012,19,f) 5,2201,2251,17486,17764,131,5.6,270,11.6,2711,792,1919,4.5,15.3,3267,1286,1981,7.2,18.4,-556,-3.1,30.6,0,206,206,1114
2012,19,g) 6 to 10,9744,10380,100058,99479,566,5.3,995,9.4,14557,4151,10406,4.2,14.6,13398,4867,8531,4.9,13.5,1159,1.1,27,0,721,724,3860
2012,19,h) 11 to 15,7224,7851,78819,83460,375,4.7,652,8.2,10743,1776,8967,2.1,12.9,20024,13394,6630,16,24,-9281,-11.1,25.8,0,434,437,12234
2012,19,i) 16 to 20,5857,6316,63313,62932,332,5.2,477,7.5,8545,2568,5977,4.1,13.6,7782,3033,4749,4.8,12.4,763,1.2,24.8,0,317,317,1433
2012,19,j) 21 to 25,4528,5274,81128,80626,256,4.8,355,6.7,9214,2544,6670,3.2,11.4,8210,2120,6090,2.6,10.2,1004,1.2,20.4,0,230,240,1273
2012,19,k) 26+,7427,11315,203623,202246,488,4.3,575,5.1,21629,4259,17370,2.1,10.7,18875,5379,13496,2.7,9.3,2754,1.4,18.6,0,322,347,3491
2012,19,l) Left Censored,8469,19177,662241,653491,961,5,940,4.9,67673,17005,50668,2.6,10.4,50172,11790,38382,1.8,7.7,17501,2.7,15.4,0,274,310,4120
2012,20,a) 0,3421,3437,21203,10602,3437,200,0,0,21203,21203,0,200,200,0,0,0,0,0,21203,200,0,0,4,4,0
2012,20,b) 1,2574,2646,17956,18925,20,0.7,773,25.6,4478,306,4172,1.6,23.7,6416,4513,1903,23.8,33.9,-1938,-10.2,47.4,0,640,643,4262
2012,20,c) 2,2172,2209,17170,16875,148,6.3,399,17.1,3661,743,2918,4.4,21.7,3070,1481,1589,8.8,18.2,591,3.5,36.4,0,338,344,1426
2012,20,d) 3,2171,2216,16679,16437,153,6.6,349,15.1,3663,513,3150,3.1,22.3,3179,1628,1551,9.9,19.3,484,3,38.6,0,313,329,1774
2012,20,e) 4,2218,2317,17381,16953,140,5.8,303,12.6,4016,914,3102,5.4,23.7,3159,1564,1595,9.2,18.6,857,5.1,37.2,0,273,317,1699
2012,20,f) 5,2145,2156,16654,16822,126,5.6,294,13.1,2903,616,2287,3.7,17.3,3239,1608,1631,9.6,19.3,-336,-2,34.6,0,225,229,1097
2012,20,g) 6 to 10,9250,9652,94898,94652,523,5.3,1067,10.8,14504,2770,11734,2.9,15.3,14011,5577,8434,5.9,14.8,493,0.5,29.6,0,746,752,4267
2012,20,h) 11 to 15,6979,7582,79402,79293,380,4.9,671,8.7,11192,2708,8484,3.4,14.1,10974,3910,7064,4.9,13.8,218,0.3,27.6,0,491,504,2974
2012,20,i) 16 to 20,5132,5601,64521,65050,256,4.5,501,8.8,7118,1484,5634,2.3,10.9,8175,2995,5180,4.6,12.6,-1057,-1.7,21.8,0,303,304,2059
2012,20,j) 21 to 25,4038,4983,81388,80871,227,4.5,324,6.4,8891,2529,6362,3.1,11,7857,1914,5943,2.4,9.7,1034,1.3,19.4,0,212,216,1099
2012,20,k) 26+,6644,9616,174725,174357,475,4.9,562,5.8,20377,5230,15147,3,11.7,19640,5323,14317,3.1,11.3,737,0.4,22.6,0,312,346,2362
2012,20,l) Left Censored,6960,16455,521060,520428,851,5.2,863,5.2,52865,15038,37827,2.9,10.2,51601,15374,36227,3,9.9,1264,0.3,19.8,0,216,282,3237
2012,21,a) 0,4097,4131,28009,14005,4131,200,0,0,28009,28009,0,200,200,0,0,0,0,0,28009,200,0,0,3,4,0
2012,21,b) 1,3238,3333,22178,23784,26,0.7,897,23.8,5724,542,5182,2.3,24.1,8936,4912,4024,20.7,37.6,-3212,-13.5,48.2,0,764,778,4422
2012,21,c) 2,2683,2762,23063,23510,173,5.9,540,18.3,4656,1166,3490,5,19.8,5550,3001,2549,12.8,23.6,-894,-3.8,39.6,0,459,476,2563
2012,21,d) 3,2420,2475,20662,20400,136,5.2,388,14.9,4141,853,3288,4.2,20.3,3617,1950,1667,9.6,17.7,524,2.6,35.4,0,355,379,2019
2012,21,e) 4,2575,2744,23134,23327,140,4.9,355,12.4,3846,575,3271,2.5,16.5,4232,1865,2367,8,18.1,-386,-1.6,33,0,320,357,1956
2012,21,f) 5,2442,2480,21788,21737,134,5.2,353,13.6,3806,988,2818,4.5,17.5,3704,1564,2140,7.2,17,102,0.5,34,0,288,290,1381
2012,21,g) 6 to 10,10150,10672,100549,102958,561,5.1,1173,10.7,14171,3207,10964,3.1,13.8,18988,8083,10905,7.9,18.4,-4817,-4.6,27.6,0,865,873,4734
2012,21,h) 11 to 15,8010,8879,103093,102361,440,4.9,794,8.8,14661,4030,10631,3.9,14.3,13197,3980,9217,3.9,12.9,1464,1.4,25.8,0,564,572,3106
2012,21,i) 16 to 20,6046,6777,86617,86502,281,4.1,528,7.7,10704,2446,8258,2.8,12.4,10474,3227,7247,3.7,12.1,230,0.3,24.2,0,351,357,2316
2012,21,j) 21 to 25,4956,6250,111806,108739,309,4.9,399,6.3,18434,5949,12485,5.5,17,12300,2504,9796,2.3,11.3,6134,5.7,22.6,0,255,270,1541
2012,21,k) 26+,7589,11700,236609,236678,549,4.7,698,5.9,27630,8604,19026,3.6,11.7,27768,8615,19153,3.6,11.7,-138,0,23.4,0,408,454,3521
2012,21,l) Left Censored,7449,20521,708407,701772,1101,5.4,1014,5,77588,15359,62229,2.2,11.1,64318,13442,50876,1.9,9.2,13270,1.9,18.4,0,244,273,2872
2012,22,a) 0,5185,5220,32222,16111,5220,200,0,0,32222,32222,0,200,200,0,0,0,0,0,32222,200,0,0,7,14,0
2012,22,b) 1,3831,3885,31069,32194,19,0.4,1114,25.1,7830,482,7348,1.5,24.3,10080,5625,4455,17.5,31.3,-2250,-7,48.6,0,935,944,5342
2012,22,c) 2,3428,3569,34432,33416,213,5.7,589,15.7,8607,1954,6653,5.8,25.8,6575,2754,3821,8.2,19.7,2032,6.1,39.4,0,513,516,2324
2012,22,d) 3,3168,3260,31072,31291,155,4.5,508,14.8,6518,923,5595,2.9,20.8,6956,3249,3707,10.4,22.2,-438,-1.4,41.6,0,431,447,3133
2012,22,e) 4,3418,3612,35750,35598,187,5,444,11.9,6652,787,5865,2.2,18.7,6348,2743,3605,7.7,17.8,304,0.9,35.6,0,405,445,2967
2012,22,f) 5,3268,3324,35454,35277,157,4.5,454,13.1,5819,687,5132,1.9,16.5,5465,2135,3330,6.1,15.5,354,1,31,0,379,380,1892
2012,22,g) 6 to 10,12489,13426,151466,153996,624,4.5,1361,9.9,21708,3535,18173,2.3,14.1,26767,10312,16455,6.7,17.4,-5059,-3.3,28.2,0,1033,1040,8640
2012,22,h) 11 to 15,9428,10283,136239,138106,449,4.3,802,7.7,16840,2514,14326,1.8,12.2,20573,5386,15187,3.9,14.9,-3733,-2.7,24.4,0,580,600,4214
2012,22,i) 16 to 20,7034,7720,103393,104078,272,3.5,533,6.8,11606,1857,9749,1.8,11.2,12976,4097,8879,3.9,12.5,-1370,-1.3,22.4,0,361,367,3074
2012,22,j) 21 to 25,5240,6617,127472,128250,304,4.5,519,7.7,15450,3010,12440,2.3,12,17006,5118,11888,4,13.3,-1556,-1.3,24,0,290,295,2100
2012,22,k) 26+,9469,13366,259848,257887,554,4.1,742,5.5,30637,6465,24172,2.5,11.9,26714,5562,21152,2.2,10.4,3923,1.5,20.8,0,409,468,3344
2012,22,l) Left Censored,7873,21927,651968,648307,1281,5.9,1094,5,71283,17007,54276,2.6,11,63960,12586,51374,1.9,9.9,7323,1.1,19.8,0,296,404,4267
2012,23,a) 0,1778,1785,8470,4235,1785,200,0,0,8470,8470,0,200,200,0,0,0,0,0,8470,200,0,0,1,2,0
2012,23,b) 1,1368,1395,8424,8606,6,0.4,435,27,2045,52,1993,0.6,23.8,2409,1203,1206,14,28,-364,-4.2,47.6,0,316,319,1005
2012,23,c) 2,1139,1188,7947,7860,78,6.3,195,15.6,1476,317,1159,4,18.8,1301,585,716,7.4,16.6,175,2.2,33.2,0,160,166,567
2012,23,d) 3,1090,1111,7732,7948,73,6.3,174,15,1312,206,1106,2.6,16.5,1743,1017,726,12.8,21.9,-431,-5.4,33,0,139,140,921
2012,23,e) 4,1209,1260,7812,7756,94,7.2,195,14.9,1578,452,1126,5.8,20.3,1466,769,697,9.9,18.9,112,1.4,37.8,0,154,183,937
2012,23,f) 5,1207,1213,7947,7945,82,6.5,167,13.3,1314,178,1136,2.2,16.5,1310,662,648,8.3,16.5,4,0,33,0,114,114,515
2012,23,g) 6 to 10,4965,5196,39916,40012,330,6.2,604,11.3,5754,927,4827,2.3,14.4,5945,2576,3369,6.4,14.9,-191,-0.5,28.8,0,430,434,2026
2012,23,h) 11 to 15,3888,4136,36834,36880,216,5.1,414,9.8,4913,919,3994,2.5,13.3,5005,1950,3055,5.3,13.6,-92,-0.3,26.6,0,294,299,1529
2012,23,i) 16 to 20,2707,2937,28384,29010,136,4.5,269,9,2854,552,2302,1.9,9.8,4106,1431,2675,4.9,14.2,-1252,-4.4,19.6,0,158,159,896
2012,23,j) 21 to 25,2348,2932,43967,44093,155,5.3,186,6.3,5264,1467,3797,3.3,11.9,5516,1555,3961,3.5,12.5,-252,-0.6,23.8,0,126,128,1418
2012,23,k) 26+,3342,4794,76781,77234,204,4.2,302,6.2,8221,2021,6200,2.6,10.6,9126,2520,6606,3.3,11.8,-905,-1.2,21.2,0,131,139,1288
2012,23,l) Left Censored,2981,6842,204983,202795,415,6.1,366,5.4,20237,4545,15692,2.2,10,15860,3731,12129,1.8,7.8,4377,2.2,15.6,0,102,111,1098
2012,24,a) 0,6664,6693,38023,19012,6693,200,0,0,38023,38023,0,200,200,0,0,0,0,0,38023,200,0,0,5,6,0
2012,24,b) 1,5010,5089,40637,40833,36,0.6,1379,23.9,10165,747,9418,1.8,24.9,10556,5770,4786,14.1,25.9,-391,-1,49.8,0,1113,1128,5450
2012,24,c) 2,4207,4384,34671,33424,292,6.4,708,15.4,9029,1265,7764,3.8,27,6535,3192,3343,9.6,19.6,2494,7.4,39.2,0,601,612,2930
2012,24,d) 3,4060,4151,34855,34636,253,5.8,602,13.9,6498,1208,5290,3.5,18.8,6060,3021,3039,8.7,17.5,438,1.3,35,0,508,529,3111
2012,24,e) 4,4235,4503,39746,38670,293,6.3,554,12,8124,2104,6020,5.4,21,5971,2510,3461,6.5,15.4,2153,5.6,30.8,0,494,550,2972
2012,24,f) 5,4043,4124,38017,37576,232,5.4,507,11.9,6935,1245,5690,3.3,18.5,6053,2561,3492,6.8,16.1,882,2.4,32.2,0,406,406,2267
2012,24,g) 6 to 10,17626,18356,180108,180861,1008,5.4,1973,10.5,25288,4217,21071,2.3,14,26794,10840,15954,6,14.8,-1506,-0.8,28,0,1451,1463,8762
2012,24,h) 11 to 15,12771,14012,174749,174136,681,4.8,1131,7.9,23684,6046,17638,3.5,13.6,22458,6685,15773,3.8,12.9,1226,0.7,25.8,0,775,779,4880
2012,24,i) 16 to 20,9278,10066,134156,135956,466,4.6,751,7.4,13157,2065,11092,1.5,9.7,16757,4969,11788,3.7,12.3,-3600,-2.6,19.4,0,508,516,3714
2012,24,j) 21 to 25,7769,9362,179987,179760,430,4.5,619,6.5,22175,5250,16925,2.9,12.3,21721,8398,13323,4.7,12.1,454,0.2,24.2,0,370,387,2976
2012,24,k) 26+,10209,14606,315713,313660,631,4.3,897,6.1,38993,8690,30303,2.8,12.4,34887,8530,26357,2.7,11.1,4106,1.3,22.2,0,452,501,4199
2012,24,l) Left Censored,9145,25616,937522,931773,1493,5.8,1533,6,109328,29289,80039,3.1,11.7,97830,25894,71936,2.8,10.5,11498,1.2,21,0,349,461,4262
2012,25,a) 0,8283,8348,43138,21569,8348,200,0,0,43138,43138,0,200,200,0,0,0,0,0,43138,200,0,0,6,18,0
2012,25,b) 1,6181,6254,43476,42475,35,0.5,1679,23.7,12177,788,11389,1.9,28.7,10175,5985,4190,14.1,24,2002,4.7,48,0,1365,1385,5464
2012,25,c) 2,5204,5281,39643,39392,321,5.8,891,16,7803,1318,6485,3.3,19.8,7300,3803,3497,9.7,18.5,503,1.3,37,0,744,755,3363
2012,25,d) 3,4699,4785,37580,36924,284,5.7,667,13.4,7664,984,6680,2.7,20.8,6351,3423,2928,9.3,17.2,1313,3.6,34.4,0,542,576,3321
2012,25,e) 4,5026,5248,41199,39626,337,6.3,625,11.6,8942,2012,6930,5.1,22.6,5796,2937,2859,7.4,14.6,3146,8,29.2,0,544,664,3422
2012,25,f) 5,4674,4716,40090,39878,294,6.1,572,11.8,7052,1415,5637,3.5,17.7,6627,3562,3065,8.9,16.6,425,1.1,33.2,0,443,443,3005
2012,25,g) 6 to 10,20582,21373,221596,218660,1132,5.2,2164,9.9,36555,6015,30540,2.8,16.7,30683,14456,16227,6.6,14,5872,2.7,28,0,1563,1571,12139
2012,25,h) 11 to 15,15720,16801,211677,211037,839,4.9,1366,8,27359,4961,22398,2.4,13,26079,9833,16246,4.7,12.4,1280,0.6,24.8,0,954,974,7024
2012,25,i) 16 to 20,11600,12549,160201,161557,562,4.4,878,6.9,18684,3598,15086,2.2,11.6,21395,6614,14781,4.1,13.2,-2711,-1.6,23.2,0,594,597,4863
2012,25,j) 21 to 25,10021,12119,222823,222063,533,4.3,817,6.7,23241,3987,19254,1.8,10.5,21721,6265,15456,2.8,9.8,1520,0.7,19.6,0,495,520,4296
2012,25,k) 26+,14617,21171,554687,552046,864,4,1255,5.9,51207,9935,41272,1.8,9.3,45925,11428,34497,2.1,8.3,5282,1,16.6,0,655,730,4810
2012,25,l) Left Censored,15180,34990,1389091,1378797,1784,5.1,2000,5.7,139183,28733,110450,2.1,10.1,118594,28186,90408,2,8.6,20589,1.5,17.2,0,543,615,8694
2012,26,a) 0,10166,10323,65220,32610,10323,200,0,0,65220,65220,0,200,200,0,0,0,0,0,65220,200,0,0,3,4,0
2012,26,b) 1,7792,8033,63365,66944,81,0.9,2181,24,16980,574,16406,0.9,25.4,24138,15423,8715,23,36.1,-7158,-10.7,50.8,0,1659,1675,8297
2012,26,c) 2,6267,6390,55848,56143,404,6,1154,17.1,12453,1824,10629,3.2,22.2,13042,5846,7196,10.4,23.2,-589,-1,44.4,0,962,975,5116
2012,26,d) 3,6103,6218,58042,59175,364,5.6,927,14.3,11263,1754,9509,3,19,13529,6924,6605,11.7,22.9,-2266,-3.9,38,0,813,857,7015
2012,26,e) 4,6294,6626,66003,62850,413,6,888,12.9,16865,6162,10703,9.8,26.8,10559,5856,4703,9.3,16.8,6306,10,33.6,0,754,871,6521
2012,26,f) 5,5857,5987,57147,59397,362,5.9,749,12.1,7865,1373,6492,2.3,13.2,12364,5017,7347,8.4,20.8,-4499,-7.6,26.4,0,576,577,4183
2012,26,g) 6 to 10,24902,25915,267157,269403,1451,5.5,2743,10.3,40117,6522,33595,2.4,14.9,44609,20964,23645,7.8,16.6,-4492,-1.7,29.8,0,2065,2087,17682
2012,26,h) 11 to 15,19086,20972,244066,242395,1157,5.4,1824,8.6,35749,7280,28469,3,14.7,32407,12114,20293,5,13.4,3342,1.3,26.8,0,1199,1206,8657
2012,26,i) 16 to 20,15414,16842,206569,206505,824,4.8,1253,7.3,25893,5410,20483,2.6,12.5,25764,10225,15539,5,12.5,129,0,25,0,832,857,6312
2012,26,j) 21 to 25,12972,15980,266494,260652,732,4.5,1104,6.8,38837,6435,32402,2.5,14.9,27152,10560,16592,4.1,10.4,11685,4.5,20.8,0,647,660,6930
2012,26,k) 26+,18726,26390,511751,510822,1221,4.6,1625,6.1,71560,19223,52337,3.8,14,69702,32432,37270,6.3,13.6,1858,0.4,27.2,0,867,984,23058
2012,26,l) Left Censored,17397,45248,1608069,1593457,2163,4.8,2668,5.9,176638,33190,143448,2.1,11.1,147414,39042,108372,2.5,9.3,29224,1.8,18.6,0,653,795,8919
2012,27,a) 0,6592,6621,36201,18101,6621,200,0,0,36201,36201,0,200,200,0,0,0,0,0,36201,200,0,0,3,4,0
2012,27,b) 1,5162,5287,38277,39124,45,0.7,1555,25.7,9822,590,9232,1.5,25.1,11515,5526,5989,14.1,29.4,-1693,-4.3,50.2,0,1139,1146,5058
2012,27,c) 2,4253,4390,36336,35695,285,6.1,780,16.8,6795,1048,5747,2.9,19,5513,3017,2496,8.5,15.4,1282,3.6,30.8,0,585,619,2738
2012,27,d) 3,4289,4362,41942,39070,302,6.7,627,13.9,12242,1331,10911,3.4,31.3,6498,3304,3194,8.5,16.6,5744,14.7,33.2,0,510,549,3521
2012,27,e) 4,4322,4491,36870,36490,319,6.9,571,12.4,7074,1464,5610,4,19.4,6314,3111,3203,8.5,17.3,760,2.1,34.6,0,480,548,3695
2012,27,f) 5,4183,4268,36415,38046,281,6.4,551,12.5,6421,847,5574,2.2,16.9,9683,6653,3030,17.5,25.5,-3262,-8.6,33.8,0,402,403,6400
2012,27,g) 6 to 10,18551,19567,183803,183471,1192,6,2077,10.4,27162,4938,22224,2.7,14.8,26498,11803,14695,6.4,14.4,664,0.4,28.8,0,1383,1405,9771
2012,27,h) 11 to 15,14158,15478,177870,177618,777,4.9,1294,8.2,22160,4374,17786,2.5,12.5,21655,7879,13776,4.4,12.2,505,0.3,24.4,0,792,799,5593
2012,27,i) 16 to 20,10454,11780,142649,143123,534,4.5,860,7.2,16125,3258,12867,2.3,11.3,17073,5960,11113,4.2,11.9,-948,-0.6,22.6,0,561,564,4280
2012,27,j) 21 to 25,7926,9605,165781,162978,429,4.4,683,7,21410,5168,16242,3.2,13.1,15804,4291,11513,2.6,9.7,5606,3.4,19.4,0,426,438,2618
2012,27,k) 26+,11131,16276,395131,386989,754,4.6,936,5.7,51690,8098,43592,2.1,13.4,35406,8894,26512,2.3,9.1,16284,4.3,18.2,0,491,569,4986
2012,27,l) Left Censored,11495,28121,1192193,1180953,1271,4.5,1516,5.4,121813,19320,102493,1.6,10.3,99332,20855,78477,1.8,8.4,22481,1.9,16.8,0,371,451,6458
2012,28,a) 0,2641,2654,15562,7781,2654,200,0,0,15562,15562,0,200,200,0,0,0,0,0,15562,200,0,0,,,
2012,28,b) 1,2027,2085,15705,16407,14,0.6,663,27.5,4335,333,4002,2,26.4,5738,3584,2154,21.8,35,-1403,-8.6,52.8,0,587,603,3373
2012,28,c) 2,1800,1882,14390,15062,116,5.7,392,19.4,2773,462,2311,3.1,18.4,4117,2101,2016,13.9,27.3,-1344,-8.9,36.8,0,352,363,1986
2012,28,d) 3,1756,1791,13366,13535,106,5.6,285,15.2,2504,633,1871,4.7,18.5,2842,1372,1470,10.1,21,-338,-2.5,37,0,263,274,1365
2012,28,e) 4,1787,1950,16257,15751,120,5.9,270,13.3,3821,763,3058,4.8,24.3,2809,1366,1443,8.7,17.8,1012,6.5,35.6,0,256,341,1741
2012,28,f) 5,1768,1848,12441,12734,111,5.8,235,12.3,2277,545,1732,4.3,17.9,2863,1130,1733,8.9,22.5,-586,-4.6,35.8,0,195,195,1003
2012,28,g) 6 to 10,7037,7478,72296,73297,358,4.6,828,10.7,10716,2567,8149,3.5,14.6,12717,4333,8384,5.9,17.3,-2001,-2.7,29.2,0,644,645,3562
2012,28,h) 11 to 15,5256,5773,59775,59733,260,4.4,530,9,7500,1786,5714,3,12.6,7415,2413,5002,4,12.4,85,0.2,24.8,0,372,373,1867
2012,28,i) 16 to 20,3902,4333,56141,57044,184,4.2,296,6.7,5521,1325,4196,2.3,9.7,7327,1811,5516,3.2,12.8,-1806,-3.1,19.4,0,229,229,1328
2012,28,j) 21 to 25,3037,3599,75939,73662,163,4.5,258,7.1,11498,1517,9981,2.1,15.6,6943,1746,5197,2.4,9.4,4555,6.2,18.8,0,166,171,1081
2012,28,k) 26+,5247,7516,133300,132822,309,4.1,442,5.8,14518,3599,10919,2.7,10.9,13562,2958,10604,2.2,10.2,956,0.7,20.4,0,260,285,2147
2012,28,l) Left Censored,4934,13849,404052,406260,704,5.1,585,4.2,32833,6933,25900,1.7,8.1,37248,6229,31019,1.5,9.2,-4415,-1.1,16.2,0,172,207,2089
2012,29,a) 0,7766,7795,40440,20220,7795,200,0,0,40440,40440,0,200,200,0,0,0,0,0,40440,200,0,0,6,14,0
2012,29,b) 1,5540,5725,35624,37879,61,0.9,2190,32.3,8933,895,8038,2.4,23.6,13443,8659,4784,22.9,35.5,-4510,-11.9,47.2,0,1927,1953,8085
2012,29,c) 2,4450,4584,32489,33348,310,6.1,1239,24.5,6683,1296,5387,3.9,20,8401,4823,3578,14.5,25.2,-1718,-5.2,40,0,1079,1090,3723
2012,29,d) 3,4124,4344,36451,36850,277,6,765,16.7,6337,1165,5172,3.2,17.2,7134,3939,3195,10.7,19.4,-797,-2.2,34.4,0,674,713,4001
2012,29,e) 4,4277,4537,39354,38139,340,7.2,675,14.3,8357,3255,5102,8.5,21.9,5927,3158,2769,8.3,15.5,2430,6.4,31,0,614,735,3593
2012,29,f) 5,4166,4270,32074,32068,245,5.5,622,14,5747,1190,4557,3.7,17.9,5734,2489,3245,7.8,17.9,13,0,35.8,0,509,511,2147
2012,29,g) 6 to 10,17900,18879,178228,178345,1033,5.3,2173,11.2,26981,4759,22222,2.7,15.1,27214,10895,16319,6.1,15.3,-233,-0.2,30.2,0,1654,1663,8585
2012,29,h) 11 to 15,12672,13986,154076,154007,672,4.7,1210,8.5,20208,3874,16334,2.5,13.1,20069,6367,13702,4.1,13,139,0.1,26,0,843,869,4543
2012,29,i) 16 to 20,9464,10518,137647,137713,505,4.7,798,7.5,15727,2816,12911,2,11.4,15858,4901,10957,3.6,11.5,-131,-0.1,22.8,0,563,571,3145
2012,29,j) 21 to 25,7738,9859,165197,161988,424,4.2,785,7.8,23219,7668,15551,4.7,14.3,16801,4852,11949,3,10.4,6418,3.9,20.8,0,426,438,2335
2012,29,k) 26+,11831,17781,384843,385911,754,4.2,1030,5.7,37419,6975,30444,1.8,9.7,39555,7488,32067,1.9,10.2,-2136,-0.5,19.4,0,597,677,4731
2012,29,l) Left Censored,11527,30948,1090162,1085789,1620,5.2,1638,5.3,109757,28004,81753,2.6,10.1,101010,23317,77693,2.1,9.3,8747,0.8,18.6,0,419,482,5778
2012,30,a) 0,1968,1975,8183,4092,1975,200,0,0,8183,8183,0,200,200,0,0,0,0,0,8183,200,0,0,1,2,0
2012,30,b) 1,1393,1410,7631,7674,4,0.2,450,27.6,1883,59,1824,0.8,24.5,1969,1164,805,15.2,25.7,-86,-1.2,49,0,341,344,1002
2012,30,c) 2,1201,1217,7578,7368,96,7.5,224,17.5,1935,369,1566,5,26.3,1514,916,598,12.4,20.5,421,5.8,41,0,174,178,925
2012,30,d) 3,1213,1232,6796,6775,84,6.5,206,15.9,1368,319,1049,4.7,20.2,1326,659,667,9.7,19.6,42,0.6,39.2,0,169,183,666
2012,30,e) 4,1275,1350,7923,7949,116,8.3,204,14.6,1440,320,1120,4,18.1,1491,698,793,8.8,18.8,-51,-0.7,36.2,0,146,178,647
2012,30,f) 5,1267,1278,7858,7901,115,8.7,198,15,1177,296,881,3.7,14.9,1263,560,703,7.1,16,-86,-1.1,29.8,0,134,136,440
2012,30,g) 6 to 10,5484,5636,43024,42990,381,6.6,623,10.8,6137,897,5240,2.1,14.3,6069,2353,3716,5.5,14.1,68,0.2,28.2,0,412,420,1855
2012,30,h) 11 to 15,3746,3922,30400,30286,269,6.8,374,9.4,4504,1127,3377,3.7,14.9,4276,1658,2618,5.5,14.1,228,0.8,28.2,0,247,249,957
2012,30,i) 16 to 20,2593,2706,23806,24142,135,4.9,216,7.9,2694,465,2229,1.9,11.2,3366,1180,2186,4.9,13.9,-672,-2.7,22.4,0,145,149,777
2012,30,j) 21 to 25,1759,1952,21953,21612,95,4.8,134,6.8,2927,637,2290,2.9,13.5,2244,690,1554,3.2,10.4,683,3.1,20.8,0,79,82,421
2012,30,k) 26+,2698,3696,59452,58178,150,4,217,5.8,8245,2875,5370,4.9,14.2,5697,1404,4293,2.4,9.8,2548,4.4,19.6,0,130,149,893
2012,30,l) Left Censored,2361,5272,119427,119263,300,5.7,227,4.3,11355,2868,8487,2.4,9.5,11027,1889,9138,1.6,9.2,328,0.3,18.4,0,71,87,697
2012,31,a) 0,2504,2509,15711,7856,2509,200,0,0,15711,15711,0,200,200,0,0,0,0,0,15711,200,0,0,2,2,0
2012,31,b) 1,1928,1956,11378,11940,6,0.3,488,22.2,2736,70,2666,0.6,22.9,3860,2417,1443,20.2,32.3,-1124,-9.4,45.8,0,389,393,1724
2012,31,c) 2,1662,1699,11848,11464,114,6.4,266,15,2702,393,2309,3.4,23.6,1933,942,991,8.2,16.9,769,6.7,33.8,0,229,234,1191
2012,31,d) 3,1633,1658,11045,10913,90,5.2,206,12,2458,465,1993,4.3,22.5,2193,1153,1040,10.6,20.1,265,2.4,40.2,0,175,185,1158
2012,31,e) 4,1622,1678,12047,11755,99,5.7,228,13.1,2439,492,1947,4.2,20.7,1854,963,891,8.2,15.8,585,4.9,31.6,0,191,214,1214
2012,31,f) 5,1571,1603,10226,10326,76,4.6,179,10.8,1505,188,1317,1.8,14.6,1704,759,945,7.4,16.5,-199,-1.9,29.2,0,137,137,668
2012,31,g) 6 to 10,6770,7047,55041,55138,369,5.1,660,9.2,8219,1520,6699,2.8,14.9,8413,3142,5271,5.7,15.3,-194,-0.4,29.8,0,491,500,2705
2012,31,h) 11 to 15,5146,5569,59494,59847,300,5.3,448,7.9,6727,1158,5569,1.9,11.2,7432,2996,4436,5,12.4,-705,-1.2,22.4,0,294,296,2319
2012,31,i) 16 to 20,3796,4096,47956,47113,198,4.8,308,7.4,6231,890,5341,1.9,13.2,4545,1445,3100,3.1,9.6,1686,3.6,19.2,0,212,216,1005
2012,31,j) 21 to 25,3058,3738,64982,65563,183,4.8,274,7.2,7210,1438,5772,2.2,11,8371,1847,6524,2.8,12.8,-1161,-1.8,22,0,156,156,1021
2012,31,k) 26+,4659,6670,130659,128688,276,4.1,353,5.3,14749,2684,12065,2.1,11.5,10806,2649,8157,2.1,8.4,3943,3.1,16.8,0,210,236,1795
2012,31,l) Left Censored,5101,11112,353045,351448,582,5.2,625,5.6,34555,9153,25402,2.6,9.8,31360,5296,26064,1.5,8.9,3195,0.9,17.8,0,187,217,1929
2012,32,a) 0,4284,4308,27780,13890,4308,200,0,0,27780,27780,0,200,200,0,0,0,0,0,27780,200,0,0,7,10,0
2012,32,b) 1,3235,3276,26986,27696,25,0.7,1078,28.3,6384,170,6214,0.6,23.1,7804,4581,3223,16.5,28.2,-1420,-5.1,46.2,0,914,921,4055
2012,32,c) 2,2584,2656,33433,32076,185,6.5,585,20.5,8061,992,7069,3.1,25.1,5346,3127,2219,9.7,16.7,2715,8.4,33.4,0,521,532,2960
2012,32,d) 3,2360,2467,21206,22140,165,6.3,450,17.2,4148,746,3402,3.4,18.7,6016,3659,2357,16.5,27.2,-1868,-8.5,37.4,0,405,425,3812
2012,32,e) 4,2407,2513,24936,26671,169,6.4,437,16.5,4310,620,3690,2.3,16.2,7780,4430,3350,16.6,29.2,-3470,-13,32.4,0,390,425,4437
2012,32,f) 5,2124,2167,19295,19667,134,5.9,361,15.8,3215,648,2567,3.3,16.3,3958,1941,2017,9.9,20.1,-743,-3.8,32.6,0,288,290,1538
2012,32,g) 6 to 10,8266,8727,100634,101489,478,5.3,1208,13.3,15656,2812,12844,2.8,15.4,17366,7237,10129,7.1,17.1,-1710,-1.7,30.8,0,896,921,6176
2012,32,h) 11 to 15,4794,5369,93978,92002,296,5.4,604,10.9,15687,7254,8433,7.9,17.1,11734,3354,8380,3.6,12.8,3953,4.3,25.6,0,402,410,2536
2012,32,i) 16 to 20,2785,3308,58599,60775,161,4.8,281,8.3,6111,1438,4673,2.4,10.1,10463,5334,5129,8.8,17.2,-4352,-7.1,20.2,0,185,193,5023
2012,32,j) 21 to 25,2058,2776,60328,59074,129,4.6,209,7.4,9083,1633,7450,2.8,15.4,6575,2781,3794,4.7,11.1,2508,4.3,22.2,0,117,124,1524
2012,32,k) 26+,2974,5299,149019,147134,279,5.2,363,6.8,17707,3487,14220,2.4,12,13936,3131,10805,2.1,9.5,3771,2.5,19,0,170,192,2116
2012,32,l) Left Censored,2829,9359,406693,403236,651,7,551,5.9,42648,12552,30096,3.1,10.6,35733,7231,28502,1.8,8.9,6915,1.7,17.8,0,104,136,1479
2012,33,a) 0,1709,1716,11481,5741,1716,200,0,0,11481,11481,0,200,200,0,0,0,0,0,11481,200,0,0,2,4,0
2012,33,b) 1,1309,1320,7592,8341,4,0.3,340,22.8,1736,,,,20.8,3233,2435,798,29.2,38.8,-1497,-18,41.6,1,289,290,2347
2012,33,c) 2,1151,1187,8846,9127,66,5.2,210,16.7,1902,348,1554,3.8,20.8,2464,775,1689,8.5,27,-562,-6.2,41.6,0,185,189,739
2012,33,d) 3,1042,1065,7656,7737,50,4.5,150,13.5,1608,,,,20.8,1769,660,1109,8.5,22.9,-161,-2.1,41.6,1,139,145,1090
2012,33,e) 4,1167,1208,11566,11139,65,5.2,151,12.1,2486,350,2136,3.1,22.3,1632,736,896,6.6,14.7,854,7.6,29.4,0,137,162,1543
2012,33,f) 5,1048,1062,7845,8009,70,6.4,148,13.4,1219,197,1022,2.5,15.2,1546,886,660,11.1,19.3,-327,-4.1,30.4,0,116,119,772
2012,33,g) 6 to 10,4576,4769,43194,43287,251,5.1,502,10.3,6201,1183,5018,2.7,14.3,6386,2644,3742,6.1,14.8,-185,-0.5,28.6,0,375,376,2162
2012,33,h) 11 to 15,3623,3877,39335,39584,200,5.1,326,8.3,4864,1270,3594,3.2,12.3,5362,1517,3845,3.8,13.5,-498,-1.2,24.6,0,220,224,1160
2012,33,i) 16 to 20,2798,2945,32265,33175,116,3.9,199,6.7,3732,1121,2611,3.4,11.2,5552,1975,3577,6,16.7,-1820,-5.5,22.4,0,146,147,1533
2012,33,j) 21 to 25,2406,2815,42528,42606,120,4.2,187,6.6,4250,995,3255,2.3,10,4405,1293,3112,3,10.3,-155,-0.3,20,0,132,139,1120
2012,33,k) 26+,3167,4344,79776,79842,206,4.7,303,6.9,8393,1901,6492,2.4,10.5,8524,2634,5890,3.3,10.7,-131,-0.2,21,0,160,194,1897
2012,33,l) Left Censored,3058,7118,251933,256257,475,6.7,390,5.5,21268,4869,16399,1.9,8.3,29916,13109,16807,5.1,11.7,-8648,-3.4,16.6,0,91,97,1314
2012,34,a) 0,13349,13374,64774,32387,13374,200,0,0,64774,64774,0,200,200,0,0,0,0,0,64774,200,0,0,7,10,0
2012,34,b) 1,9815,9897,81336,77055,29,0.3,2934,25.9,26604,297,26307,0.4,34.5,18041,10440,7601,13.5,23.4,8563,11.1,46.8,0,2393,2403,9278
2012,34,c) 2,8005,8149,66378,64831,518,6,1534,17.7,15921,2509,13412,3.9,24.6,12827,6796,6031,10.5,19.8,3094,4.8,39.6,0,1273,1289,6336
2012,34,d) 3,7363,7442,59565,59137,448,5.7,1181,15.1,10869,2228,8641,3.8,18.4,10013,4429,5584,7.5,16.9,856,1.5,33.8,0,1010,1024,4164
2012,34,e) 4,7639,7797,72101,74350,514,6.3,1131,14,13100,1927,11173,2.6,17.6,17597,5964,11633,8,23.7,-4497,-6.1,35.2,0,1004,1071,5893
2012,34,f) 5,7243,7317,65294,64338,417,5.5,945,12.5,11929,1098,10831,1.7,18.5,10017,4797,5220,7.5,15.6,1912,2.9,31.2,0,773,773,4353
2012,34,g) 6 to 10,29752,30657,289538,289662,1671,5.3,3606,11.4,41439,7580,33859,2.6,14.3,41687,17990,23697,6.2,14.4,-248,-0.1,28.6,0,2721,2729,13609
2012,34,h) 11 to 15,22406,23889,274008,276382,1123,4.6,2082,8.5,33933,5831,28102,2.1,12.3,38680,14390,24290,5.2,14,-4747,-1.7,24.6,0,1536,1553,9475
2012,34,i) 16 to 20,15805,16708,205503,206597,626,3.7,1321,7.7,23533,3368,20165,1.6,11.4,25720,8626,17094,4.2,12.4,-2187,-1,22.8,0,947,968,7096
2012,34,j) 21 to 25,12814,14647,230611,232964,621,4.2,1121,7.5,23907,4178,19729,1.8,10.3,28612,8199,20413,3.5,12.3,-4705,-2,20.6,0,710,734,4859
2012,34,k) 26+,18008,23857,513900,514627,1086,4.5,1567,6.5,52100,11414,40686,2.2,10.1,53553,15180,38373,2.9,10.4,-1453,-0.3,20.2,0,897,979,8343
2012,34,l) Left Censored,16534,39099,1472545,1473755,2185,5.6,2393,6.1,156727,31267,125460,2.1,10.6,159147,41655,117492,2.8,10.8,-2420,-0.2,21.2,0,687,764,10007
2012,35,a) 0,2292,2316,13816,6908,2316,200,0,0,13816,13816,0,200,200,0,0,0,0,0,13816,200,0,0,2,4,0
2012,35,b) 1,1647,1666,13271,13370,14,0.7,533,27.7,3497,685,2812,5.1,26.2,3694,2039,1655,15.3,27.6,-197,-1.4,52.4,0,443,446,1768
2012,35,c) 2,1309,1329,10675,11056,69,4.8,280,19.5,2207,428,1779,3.9,20,2968,1868,1100,16.9,26.8,-761,-6.8,40,0,225,235,1773
2012,35,d) 3,1393,1408,11077,11305,66,4.4,233,15.6,2217,748,1469,6.6,19.6,2672,1634,1038,14.5,23.6,-455,-4,39.2,0,200,212,1728
2012,35,e) 4,1460,1548,14145,13871,117,7.4,200,12.6,2846,780,2066,5.6,20.5,2297,964,1333,6.9,16.6,549,3.9,33.2,0,191,219,1119
2012,35,f) 5,1395,1410,22017,22318,92,6.3,192,13.2,1749,474,1275,2.1,7.8,2350,1079,1271,4.8,10.5,-601,-2.7,15.6,0,150,150,919
2012,35,g) 6 to 10,5576,5893,55126,55903,347,5.7,692,11.4,8183,1771,6412,3.2,14.6,9736,3727,6009,6.7,17.4,-1553,-2.8,29.2,0,534,543,2871
2012,35,h) 11 to 15,4145,4481,53615,55120,196,4.3,421,9.2,5487,1062,4425,1.9,10,8496,1746,6750,3.2,15.4,-3009,-5.4,20,0,303,308,1429
2012,35,i) 16 to 20,3019,3324,37649,37911,150,4.4,253,7.5,4280,970,3310,2.6,11.3,4804,1132,3672,3,12.7,-524,-1.4,22.6,0,185,187,1013
2012,35,j) 21 to 25,2379,2951,55994,56960,123,4.1,233,7.8,6237,996,5241,1.7,10.9,8169,2236,5933,3.9,14.3,-1932,-3.4,21.8,0,133,133,1236
2012,35,k) 26+,3731,5394,92238,93050,235,4.3,345,6.3,9375,2021,7354,2.2,10.1,10999,2934,8065,3.2,11.8,-1624,-1.7,20.2,0,208,235,1475
2012,35,l) Left Censored,3144,8359,216243,218043,459,5.5,473,5.7,23609,6093,17516,2.8,10.8,27208,8945,18263,4.1,12.5,-3599,-1.7,21.6,0,107,170,1449
2012,36,a) 0,34796,34888,176312,88156,34888,200,0,0,176312,176312,0,200,200,0,0,0,0,0,176312,200,0,0,8,22,0
2012,36,b) 1,27224,27513,176041,175359,67,0.2,7537,24.1,46590,1199,45391,0.7,26.6,45226,26185,19041,14.9,25.8,1364,0.8,51.6,0,6106,6132,22959
2012,36,c) 2,23068,23552,165351,164863,1432,5.7,4212,16.9,35081,6007,29074,3.6,21.3,34104,18471,15633,11.2,20.7,977,0.6,41.4,0,3493,3540,16846
2012,36,d) 3,20165,20403,152219,151792,1070,5,3184,14.8,26056,3849,22207,2.5,17.2,25201,13513,11688,8.9,16.6,855,0.6,33.2,0,2676,2768,13234
2012,36,e) 4,19259,19730,153203,151096,1119,5.4,2775,13.5,30478,5057,25421,3.3,20.2,26263,12533,13730,8.3,17.4,4215,2.8,34.8,0,2357,2500,12913
2012,36,f) 5,17100,17219,129527,129746,982,5.5,2318,13,20189,3721,16468,2.9,15.6,20627,10082,10545,7.8,15.9,-438,-0.3,31.2,0,1861,1862,8644
2012,36,g) 6 to 10,68513,70884,665476,666803,3542,4.9,7758,10.6,94455,17026,77429,2.6,14.2,97109,39759,57350,6,14.6,-2654,-0.4,28.4,0,5881,5903,31518
2012,36,h) 11 to 15,47415,50627,602067,598499,2160,4.2,4434,8.6,78313,10913,67400,1.8,13.1,71176,25733,45443,4.3,11.9,7137,1.2,23.8,0,3152,3180,19123
2012,36,i) 16 to 20,32685,34628,440979,437247,1344,3.8,2588,7.3,57493,10306,47187,2.4,13.1,50029,17131,32898,3.9,11.4,7464,1.7,22.8,0,1885,1924,12066
2012,36,j) 21 to 25,28539,32286,550288,547094,1244,3.8,2192,6.7,56011,9394,46617,1.7,10.2,49623,13407,36216,2.5,9.1,6388,1.1,18.2,0,1480,1520,9252
2012,36,k) 26+,38443,52241,1096689,1096681,1834,3.5,3176,6,113779,21273,92506,1.9,10.4,113763,25837,87926,2.4,10.4,16,0,20.8,0,1869,2013,13604
2012,36,l) Left Censored,36785,84222,3266083,3255058,4209,5,4478,5.3,316209,72775,243434,2.2,9.7,294159,68298,225861,2.1,9,22050,0.7,18,0,1489,1707,19397
2012,37,a) 0,11301,11367,64295,32148,11367,200,0,0,64295,64295,0,200,200,0,0,0,0,0,64295,200,0,0,6,12,0
2012,37,b) 1,8734,8852,61811,64505,54,0.5,2539,25.2,15132,797,14335,1.2,23.5,20520,12969,7551,20.1,31.8,-5388,-8.3,47,0,2072,2091,11854
2012,37,c) 2,7454,7642,66567,65748,424,5.2,1404,17.3,14694,2170,12524,3.3,22.3,13056,6994,6062,10.6,19.9,1638,2.4,39.8,0,1213,1244,6592
2012,37,d) 3,6645,6871,56020,54556,446,6.2,1047,14.6,12652,3559,9093,6.5,23.2,9724,5056,4668,9.3,17.8,2928,5.4,35.6,0,887,916,4762
2012,37,e) 4,7168,7585,60724,60356,527,6.7,1095,13.9,12242,2779,9463,4.6,20.3,11505,5465,6040,9.1,19.1,737,1.2,38.2,0,963,1170,5490
2012,37,f) 5,6816,6932,49280,50028,459,6.4,960,13.4,8143,1893,6250,3.8,16.3,9638,4720,4918,9.4,19.3,-1495,-3,32.6,0,773,773,4158
2012,37,g) 6 to 10,27243,28809,283186,284352,1564,5.3,3286,11.1,43224,9699,33525,3.4,15.2,45556,18761,26795,6.6,16,-2332,-0.8,30.4,0,2406,2420,14261
2012,37,h) 11 to 15,19353,21488,311061,303093,1044,4.8,1999,9.1,53554,8368,45186,2.8,17.7,37618,12279,25339,4.1,12.4,15936,5.3,24.8,0,1350,1361,8472
2012,37,i) 16 to 20,12946,14698,181419,181131,667,4.5,1124,7.5,20813,4495,16318,2.5,11.5,20236,7102,13134,3.9,11.2,577,0.3,22.4,0,803,810,4714
2012,37,j) 21 to 25,10327,13097,241919,242337,588,4.4,960,7.2,26927,6499,20428,2.7,11.1,27762,8622,19140,3.6,11.5,-835,-0.4,22.2,0,565,598,5490
2012,37,k) 26+,16042,24612,514629,515696,1185,4.8,1483,6,53966,12985,40981,2.5,10.5,56099,14802,41297,2.9,10.9,-2133,-0.4,21,0,794,877,7281
2012,37,l) Left Censored,13278,43900,1486175,1474498,2808,6.4,2438,5.6,161260,33535,127725,2.3,10.9,137905,32572,105333,2.2,9.4,23355,1.5,18.8,0,529,656,7427
2012,38,a) 0,1716,1729,9798,4899,1729,200,0,0,9798,9798,0,200,200,0,0,0,0,0,9798,200,0,0,1,3,0
2012,38,b) 1,1045,1071,7478,7436,16,1.3,297,24.5,2542,293,2249,3.9,34.2,2457,1769,688,23.8,33,85,1.2,66,0,229,235,1837
2012,38,c) 2,750,771,5649,5243,61,7.6,127,15.8,1743,346,1397,6.6,33.2,930,525,405,10,17.7,813,15.5,35.4,0,102,106,636
2012,38,d) 3,756,772,5846,5613,54,6.8,95,12,1344,253,1091,4.5,23.9,877,348,529,6.2,15.6,467,8.3,31.2,0,86,92,356
2012,38,e) 4,748,764,6806,6630,54,6.9,102,12.9,1441,348,1093,5.2,21.7,1089,514,575,7.8,16.4,352,5.3,32.8,0,87,89,460
2012,38,f) 5,715,726,6061,5917,56,7.5,96,12.9,1468,463,1005,7.8,24.8,1180,755,425,12.8,19.9,288,4.9,39.8,0,71,71,696
2012,38,g) 6 to 10,3017,3156,27162,26457,218,6.8,290,9.1,4796,1200,3596,4.5,18.1,3385,1291,2094,4.9,12.8,1411,5.3,25.6,0,205,207,962
2012,38,h) 11 to 15,2107,2295,22410,21750,127,5.5,186,8,3805,444,3361,2,17.5,2485,1061,1424,4.9,11.4,1320,6.1,22.8,0,114,114,559
2012,38,i) 16 to 20,1766,1836,17847,17723,99,5.3,165,8.8,2678,638,2040,3.6,15.1,2429,1217,1212,6.9,13.7,249,1.4,27.4,0,109,112,1103
2012,38,j) 21 to 25,1397,1530,20045,20482,81,5.3,103,6.7,2744,467,2277,2.3,13.4,3618,588,3030,2.9,17.7,-874,-4.3,26.8,0,62,63,417
2012,38,k) 26+,2209,2991,49070,48015,165,5.5,178,5.9,7367,1477,5890,3.1,15.3,5256,1934,3322,4,10.9,2111,4.4,21.8,0,110,118,1388
2012,38,l) Left Censored,2375,4842,149159,145963,263,5.5,209,4.3,17894,3364,14530,2.3,12.3,11501,1885,9616,1.3,7.9,6393,4.4,15.8,0,80,92,1057
2012,39,a) 0,10377,10477,70830,35415,10477,200,0,0,70830,70830,0,200,200,0,0,0,0,0,70830,200,0,0,8,18,0
2012,39,b) 1,7846,8018,64782,66749,54,0.6,2253,24.7,16055,832,15223,1.2,24.1,19988,11664,8324,17.5,29.9,-3933,-5.8,48.2,0,1856,1871,10093
2012,39,c) 2,6494,6865,73120,71023,400,5.5,1140,15.8,16016,3254,12762,4.6,22.6,11822,6065,5757,8.5,16.6,4194,6,33.2,0,987,1018,5927
2012,39,d) 3,6176,6388,62377,62174,385,5.8,933,14,14217,2283,11934,3.7,22.9,13810,8408,5402,13.5,22.2,407,0.7,44.4,0,813,869,9050
2012,39,e) 4,6556,6882,65667,64902,410,5.8,860,12.1,13105,2126,10979,3.3,20.2,11574,6523,5051,10.1,17.8,1531,2.4,35.6,0,784,889,7478
2012,39,f) 5,5976,6112,57698,58025,340,5.4,735,11.6,10363,1591,8772,2.7,17.9,11016,5477,5539,9.4,19,-653,-1.1,35.8,0,601,606,4993
2012,39,g) 6 to 10,27173,28944,337481,329950,1392,4.7,2929,9.9,65767,12204,53563,3.7,19.9,50704,22534,28170,6.8,15.4,15063,4.5,30.8,0,2178,2194,18136
2012,39,h) 11 to 15,21114,23664,289882,287156,1117,4.6,1977,8.2,41005,8361,32644,2.9,14.3,35552,13159,22393,4.6,12.4,5453,1.9,24.8,0,1376,1401,10329
2012,39,i) 16 to 20,17216,19566,264509,260682,837,4.2,1360,6.9,35615,5914,29701,2.3,13.7,27960,9928,18032,3.8,10.7,7655,3,21.4,0,974,986,6876
2012,39,j) 21 to 25,14273,17906,307015,303023,778,4.3,1212,6.7,43307,10012,33295,3.3,14.3,35322,10094,25228,3.3,11.7,7985,2.6,23.4,0,740,785,6368
2012,39,k) 26+,22031,33379,707558,705338,1526,4.5,2082,6.2,79355,19580,59775,2.8,11.3,74914,21841,53073,3.1,10.6,4441,0.7,21.2,0,1031,1167,9248
2012,39,l) Left Censored,23476,62067,2222748,2209009,3240,5.2,3486,5.6,239544,42730,196814,1.9,10.8,212065,51261,160804,2.3,9.6,27479,1.2,19.2,0,955,1067,14394
2012,40,a) 0,4910,4938,27313,13657,4938,200,0,0,27313,27313,0,200,200,0,0,0,0,0,27313,200,0,0,4,6,0
2012,40,b) 1,3640,3723,27518,27037,28,0.7,1007,23.9,8795,450,8345,1.7,32.5,7833,4873,2960,18,29,962,3.5,58,0,823,841,4808
2012,40,c) 2,3016,3102,26817,26115,197,6,580,17.6,6495,1234,5261,4.7,24.9,5090,2731,2359,10.5,19.5,1405,5.4,39,0,496,515,2724
2012,40,d) 3,3035,3128,25261,24985,191,5.9,426,13.1,5108,1061,4047,4.2,20.4,4557,2161,2396,8.6,18.2,551,2.2,36.4,0,364,391,2254
2012,40,e) 4,3108,3238,36847,31928,209,6.2,422,12.6,14346,10082,4264,31.6,44.9,4508,2263,2245,7.1,14.1,9838,30.8,28.2,0,376,428,2313
2012,40,f) 5,2864,2949,28238,28183,192,6.3,392,12.9,5181,1318,3863,4.7,18.4,5070,1973,3097,7,18,111,0.4,36,0,324,324,1745
2012,40,g) 6 to 10,11349,12003,118912,118820,588,4.8,1262,10.2,18380,3534,14846,3,15.5,18195,7310,10885,6.2,15.3,185,0.2,30.6,0,973,977,5873
2012,40,h) 11 to 15,8117,9171,101623,102416,420,4.5,735,7.9,13527,2459,11068,2.4,13.2,15113,4746,10367,4.6,14.8,-1586,-1.6,26.4,0,531,537,3684
2012,40,i) 16 to 20,5979,6487,68962,69196,279,4.2,502,7.6,8884,1898,6986,2.7,12.8,9351,2697,6654,3.9,13.5,-467,-0.7,25.6,0,374,377,2270
2012,40,j) 21 to 25,4475,5611,106469,105443,284,5,365,6.5,13012,3514,9498,3.3,12.3,10960,3981,6979,3.8,10.4,2052,1.9,20.8,0,235,246,1847
2012,40,k) 26+,8124,11648,226644,226834,535,4.6,711,6.1,24893,5987,18906,2.6,11,25273,6868,18405,3,11.1,-380,-0.1,22,0,383,438,3961
2012,40,l) Left Censored,6421,17353,500310,496247,957,5.5,869,5,56316,16795,39521,3.4,11.3,48190,10314,37876,2.1,9.7,8126,1.6,19.4,0,252,304,2413
2012,41,a) 0,5929,5953,28597,14299,5953,200,0,0,28597,28597,0,200,200,0,0,0,0,0,28597,200,0,0,7,13,0
2012,41,b) 1,4564,4648,25456,26110,25,0.5,1338,25.2,6214,318,5896,1.2,23.8,7521,4700,2821,18,28.8,-1307,-5,47.6,0,1061,1076,4293
2012,41,c) 2,3757,3873,27471,26958,275,6.7,729,17.8,6800,1191,5609,4.4,25.2,5773,2970,2803,11,21.4,1027,3.8,42.8,0,590,611,2736
2012,41,d) 3,3592,3660,24253,23474,240,6.3,566,14.8,6164,1037,5127,4.4,26.3,4605,2473,2132,10.5,19.6,1559,6.7,39.2,0,488,523,2729
2012,41,e) 4,3879,4039,25403,25107,268,6.4,542,13,5153,1161,3992,4.6,20.5,4560,2429,2131,9.7,18.2,593,2.3,36.4,0,469,552,2710
2012,41,f) 5,3610,3677,24380,24463,252,6.6,510,13.4,4216,860,3356,3.5,17.2,4381,2070,2311,8.5,17.9,-165,-0.7,34.4,0,377,378,1800
2012,41,g) 6 to 10,14613,15479,126599,127249,918,5.8,1888,11.8,20592,3749,16843,2.9,16.2,21891,9176,12715,7.2,17.2,-1299,-1,32.4,0,1184,1199,6954
2012,41,h) 11 to 15,10304,11199,109841,111053,605,5.3,1138,9.9,14413,3393,11020,3.1,13,16837,6276,10561,5.7,15.2,-2424,-2.2,26,0,702,714,4602
2012,41,i) 16 to 20,7432,8136,87216,87642,426,5.1,731,8.8,11835,2995,8840,3.4,13.5,12687,4583,8104,5.2,14.5,-852,-1,27,0,466,470,3498
2012,41,j) 21 to 25,5424,6537,94718,94474,281,4.2,523,7.9,11630,1944,9686,2.1,12.3,11141,3589,7552,3.8,11.8,489,0.5,23.6,0,310,322,1981
2012,41,k) 26+,7925,11548,237747,237492,498,4.3,784,6.7,26300,5912,20388,2.5,11.1,25790,5470,20320,2.3,10.9,510,0.2,21.8,0,427,517,3570
2012,41,l) Left Censored,6624,17899,562792,559317,1023,5.7,909,5.1,58086,13043,45043,2.3,10.4,51136,10578,40558,1.9,9.1,6950,1.3,18.2,0,218,271,2292
2012,42,a) 0,12999,13065,76867,38434,13065,200,0,0,76867,76867,0,200,200,0,0,0,0,0,76867,200,0,0,5,9,0
2012,42,b) 1,10191,10389,75220,76291,65,0.6,2632,22.5,19248,1474,17774,1.9,25.2,21389,12664,8725,16.6,28,-2141,-2.8,50.4,0,2168,2185,10907
2012,42,c) 2,8278,8692,74187,74098,454,5,1407,15.3,14563,2751,11812,3.7,19.7,14385,7983,6402,10.8,19.4,178,0.3,38.8,0,1194,1220,7361
2012,42,d) 3,8226,8408,67878,68894,467,5.4,1097,12.6,12037,1977,10060,2.9,17.5,14068,8222,5846,11.9,20.4,-2031,-2.9,35,0,963,1019,8287
2012,42,e) 4,8516,8878,72416,70812,540,5.9,1048,11.5,14626,2867,11759,4,20.7,11418,5311,6107,7.5,16.1,3208,4.6,32.2,0,915,1047,5922
2012,42,f) 5,7928,8079,70763,70139,407,4.9,929,11.1,12116,3111,9005,4.4,17.3,10867,4395,6472,6.3,15.5,1249,1.8,31,0,757,759,3904
2012,42,g) 6 to 10,35056,36846,380822,381460,1651,4.4,3569,9.4,50472,9350,41122,2.5,13.2,51748,19975,31773,5.2,13.6,-1276,-0.4,26.4,0,2659,2683,15077
2012,42,h) 11 to 15,26771,29571,361814,362981,1294,4.3,2358,7.8,49376,13064,36312,3.6,13.6,51709,21713,29996,6,14.2,-2333,-0.6,27.2,0,1646,1679,15691
2012,42,i) 16 to 20,19548,21580,299664,298387,881,4,1362,6.2,33495,6010,27485,2,11.2,30940,8337,22603,2.8,10.4,2555,0.8,20.8,0,1003,1025,6679
2012,42,j) 21 to 25,17942,21170,332277,330259,831,3.9,1417,6.6,41791,9980,31811,3,12.7,37754,11667,26087,3.5,11.4,4037,1.3,22.8,0,955,984,6924
2012,42,k) 26+,25804,37963,864505,856451,1760,4.6,2388,6.2,106081,26808,79273,3.1,12.4,89972,25117,64855,2.9,10.5,16109,1.9,21,0,1220,1359,11931
2012,42,l) Left Censored,26071,68098,2446606,2433408,3297,4.8,3672,5.4,251014,58286,192728,2.4,10.3,224618,49059,175559,2,9.2,26396,1.1,18.4,0,904,1060,11284
2012,44,a) 0,1334,1335,6617,3309,1335,200,0,0,6617,6617,0,200,200,0,0,0,0,0,6617,200,0,0,1,1,0
2012,44,b) 1,972,986,7094,7299,4,0.4,288,25.5,1991,124,1867,1.7,27.3,2400,1247,1153,17.1,32.9,-409,-5.6,54.6,0,234,236,1128
2012,44,c) 2,831,855,6311,6247,66,7.4,149,16.6,1443,309,1134,4.9,23.1,1314,732,582,11.7,21,129,2.1,42,0,122,128,622
2012,44,d) 3,702,710,5020,5049,42,5.6,124,16.5,1114,292,822,5.8,22.1,1172,574,598,11.4,23.2,-58,-1.1,44.2,0,92,94,450
2012,44,e) 4,817,839,7169,7119,58,6.7,118,13.6,1162,248,914,3.5,16.3,1062,591,471,8.3,14.9,100,1.4,29.8,0,100,109,636
2012,44,f) 5,798,806,7687,7496,48,5.7,109,13,1753,529,1224,7.1,23.4,1371,660,711,8.8,18.3,382,5.1,36.6,0,88,88,584
2012,44,g) 6 to 10,3567,3735,32970,32721,229,6,406,10.6,5050,918,4132,2.8,15.4,4552,1694,2858,5.2,13.9,498,1.5,27.8,0,295,299,1349
2012,44,h) 11 to 15,2610,2873,26457,26639,154,5.3,257,8.8,3169,466,2703,1.7,11.9,3533,1580,1953,5.9,13.3,-364,-1.4,23.8,0,171,171,1068
2012,44,i) 16 to 20,1989,2083,23706,23665,98,4.6,175,8.2,2734,810,1924,3.4,11.6,2652,1058,1594,4.5,11.2,82,0.4,22.4,0,116,116,496
2012,44,j) 21 to 25,1830,2030,30590,30653,81,3.9,150,7.3,3727,474,3253,1.5,12.2,3853,1443,2410,4.7,12.6,-126,-0.4,24.4,0,79,84,565
2012,44,k) 26+,2603,3237,57157,57123,125,3.8,201,6.1,5923,1132,4791,2,10.4,5855,1277,4578,2.2,10.2,68,0.2,20.4,0,113,119,829
2012,44,l) Left Censored,3089,5587,198919,201323,274,4.9,325,5.8,16609,4763,11846,2.4,8.2,21416,3279,18137,1.6,10.6,-4807,-2.4,16.4,0,101,115,663
2012,45,a) 0,5062,5102,28453,14227,5102,200,0,0,28453,28453,0,200,200,0,0,0,0,0,28453,200,0,0,4,10,0
2012,45,b) 1,3862,3945,29732,30138,19,0.4,1104,24.6,7750,238,7512,0.8,25.7,8562,4483,4079,14.9,28.4,-812,-2.7,51.4,0,928,929,4034
2012,45,c) 2,3317,3402,25083,25144,204,5.6,635,17.6,5382,717,4665,2.9,21.4,5503,2626,2877,10.4,21.9,-121,-0.5,42.8,0,561,572,2558
2012,45,d) 3,3136,3302,31371,31835,187,5.4,470,13.6,4927,896,4031,2.8,15.5,5855,2479,3376,7.8,18.4,-928,-2.9,31,0,417,437,2279
2012,45,e) 4,3194,3327,24275,24146,205,5.9,446,12.9,4576,859,3717,3.6,19,4317,1852,2465,7.7,17.9,259,1.1,35.8,0,381,442,2037
2012,45,f) 5,3109,3194,27576,27391,213,6.4,437,13.2,4770,872,3898,3.2,17.4,4400,1922,2478,7,16.1,370,1.3,32.2,0,359,363,1734
2012,45,g) 6 to 10,12742,13385,131521,132634,696,5,1508,10.9,17734,3763,13971,2.8,13.4,19960,7922,12038,6,15,-2226,-1.6,26.8,0,1076,1084,6179
2012,45,h) 11 to 15,9257,10173,139624,138605,462,4.4,900,8.7,18843,5711,13132,4.1,13.6,16804,5719,11085,4.1,12.1,2039,1.5,24.2,0,636,653,4167
2012,45,i) 16 to 20,6196,6880,94471,92922,319,4.6,555,7.9,13262,2386,10876,2.6,14.3,10163,3146,7017,3.4,10.9,3099,3.4,21.8,0,374,390,1855
2012,45,j) 21 to 25,4906,6407,110359,110862,265,4.1,465,7.1,12391,2108,10283,1.9,11.2,13396,4670,8726,4.2,12.1,-1005,-0.9,22.4,0,303,318,2196
2012,45,k) 26+,7581,11754,225976,225843,531,4.5,697,5.9,25444,5161,20283,2.3,11.3,25178,5455,19723,2.4,11.1,266,0.2,22.2,0,393,438,2766
2012,45,l) Left Censored,6789,21149,661593,660429,1060,5,996,4.7,69502,15733,53769,2.4,10.5,67175,14946,52229,2.3,10.2,2327,0.3,20.4,0,215,256,3694
2012,46,a) 0,1390,1396,7511,3756,1396,200,0,0,7511,7511,0,200,200,0,0,0,0,0,7511,200,0,0,,,
2012,46,b) 1,966,982,7556,7173,2,0.2,301,26.6,2281,,,,31.8,1515,984,531,13.7,21.1,766,10.7,42.2,1,239,241,869
2012,46,c) 2,844,881,6163,6263,56,6,176,18.7,897,120,777,1.9,14.3,1096,580,516,9.3,17.5,-199,-3.2,28.6,0,139,139,437
2012,46,d) 3,893,910,6573,6309,64,6.7,141,14.9,1444,,,,22.9,915,449,466,7.1,14.5,529,8.4,29,1,119,126,420
2012,46,e) 4,888,907,5667,5605,72,7.8,111,12,1060,267,793,4.8,18.9,935,381,554,6.8,16.7,125,2.2,33.4,0,92,99,379
2012,46,f) 5,900,917,5952,5883,54,5.8,95,10.1,1052,366,686,6.2,17.9,914,374,540,6.4,15.5,138,2.4,31,0,70,70,308
2012,46,g) 6 to 10,3680,3816,29065,29112,251,6.4,408,10.5,4432,940,3492,3.2,15.2,4525,1867,2658,6.4,15.5,-93,-0.3,30.4,0,298,298,1519
2012,46,h) 11 to 15,2697,2854,26285,26320,162,5.6,260,9,3121,679,2442,2.6,11.9,3190,1110,2080,4.2,12.1,-69,-0.2,23.8,0,176,177,788
2012,46,i) 16 to 20,1994,2100,21279,21347,105,4.9,169,7.9,2573,740,1833,3.5,12.1,2709,796,1913,3.7,12.7,-136,-0.6,24.2,0,116,116,658
2012,46,j) 21 to 25,1443,1626,23303,23153,83,5,129,7.8,2820,497,2323,2.1,12.2,2519,995,1524,4.3,10.9,301,1.3,21.8,0,85,86,431
2012,46,k) 26+,2199,3046,40362,39775,205,6.8,177,5.8,5433,1384,4049,3.5,13.7,4259,1256,3003,3.2,10.7,1174,3,21.4,0,115,128,735
2012,46,l) Left Censored,2476,5045,153652,151900,227,4.5,237,4.7,14306,4174,10132,2.7,9.4,10802,2393,8409,1.6,7.1,3504,2.3,14.2,0,72,79,686
2012,47,a) 0,6412,6458,44898,22449,6458,200,0,0,44898,44898,0,200,200,0,0,0,0,0,44898,200,0,0,6,12,0
2012,47,b) 1,4882,4943,39492,40126,37,0.7,1478,26.1,11657,968,10689,2.4,29.1,12924,6872,6052,17.1,32.2,-1267,-3.1,58.2,0,1295,1303,5710
2012,47,c) 2,4073,4262,43223,40495,235,5.2,782,17.2,13727,1682,12045,4.2,33.9,8271,4639,3632,11.5,20.4,5456,13.5,40.8,0,695,730,4723
2012,47,d) 3,3600,3810,36761,36803,183,4.6,580,14.5,7214,1110,6104,3,19.6,7297,3572,3725,9.7,19.8,-83,-0.2,39.2,0,542,575,3826
2012,47,e) 4,3932,4284,37251,36857,246,5.5,633,14.1,8036,1268,6768,3.4,21.8,7248,4442,2806,12.1,19.7,788,2.1,39.4,0,595,738,5445
2012,47,f) 5,3627,3763,31412,31503,222,5.7,542,13.8,5794,1142,4652,3.6,18.4,5975,2998,2977,9.5,19,-181,-0.6,36.8,0,444,445,2625
2012,47,g) 6 to 10,14823,16009,174975,176324,790,4.8,1828,11.1,26790,4951,21839,2.8,15.2,29487,13165,16322,7.5,16.7,-2697,-1.5,30.4,0,1404,1414,10423
2012,47,h) 11 to 15,10639,12115,160586,160911,548,4.4,1112,9,21422,4362,17060,2.7,13.3,22072,8695,13377,5.4,13.7,-650,-0.4,26.6,0,780,797,6264
2012,47,i) 16 to 20,8211,9552,125472,125534,473,4.9,767,7.9,16157,5617,10540,4.5,12.9,16280,5302,10978,4.2,13,-123,-0.1,25.8,0,550,561,3641
2012,47,j) 21 to 25,6761,8900,180204,179568,400,4.4,628,7,18676,4541,14135,2.5,10.4,17404,5257,12147,2.9,9.7,1272,0.7,19.4,0,425,443,2881
2012,47,k) 26+,11020,17104,374099,371783,782,4.5,1039,6,41595,9045,32550,2.4,11.2,36962,8286,28676,2.2,9.9,4633,1.3,19.8,0,575,671,4852
2012,47,l) Left Censored,9562,29630,1095851,1089019,1624,5.5,1497,5.1,110866,23785,87081,2.2,10.2,97202,23554,73648,2.2,8.9,13664,1.3,17.8,0,371,467,3140
2012,48,a) 0,33972,34307,228711,114356,34307,200,0,0,228711,228711,0,200,200,0,0,0,0,0,228711,200,0,0,35,80,0
2012,48,b) 1,25198,25824,215608,215858,191,0.7,7241,24.7,62349,3205,59144,1.5,28.9,62848,37870,24978,17.5,29.1,-499,-0.2,57.8,0,6252,6350,34716
2012,48,c) 2,20339,21130,218322,216008,1220,5.4,3895,17.3,50452,8221,42231,3.8,23.4,45824,21563,24261,10,21.2,4628,2.2,42.4,0,3395,3503,20553
2012,48,d) 3,18607,19360,194317,189424,1075,5.3,2958,14.6,45429,5926,39503,3.1,24,35643,17995,17648,9.5,18.8,9786,5.2,37.6,0,2632,2786,18329
2012,48,e) 4,18756,19644,198991,195761,1058,5.2,2580,12.6,42974,7619,35355,3.9,22,36513,17690,18823,9,18.7,6461,3.3,37.4,0,2323,2553,20156
2012,48,f) 5,17029,17472,175116,173872,881,4.9,2242,12.4,34037,5991,28046,3.4,19.6,31549,14088,17461,8.1,18.1,2488,1.5,36.2,0,1809,1820,11603
2012,48,g) 6 to 10,66334,71737,906770,898815,3510,4.8,7710,10.4,152022,29541,122481,3.3,16.9,136111,54400,81711,6.1,15.1,15911,1.8,30.2,0,5762,5838,43198
2012,48,h) 11 to 15,44229,50104,781446,783027,2352,4.6,4366,8.5,106162,19355,86807,2.5,13.6,109323,38958,70365,5,14,-3161,-0.4,27.2,0,3137,3192,27353
2012,48,i) 16 to 20,31707,36738,554758,553339,1597,4.3,2935,7.8,74357,13048,61309,2.4,13.4,71518,26922,44596,4.9,12.9,2839,0.5,25.8,0,2078,2111,14958
2012,48,j) 21 to 25,23883,31544,639415,638747,1567,4.9,2283,7.2,83629,17758,65871,2.8,13.1,82292,24294,57998,3.8,12.9,1337,0.2,25.8,0,1351,1431,13422
2012,48,k) 26+,36563,60346,1285831,1271431,3313,5.5,3634,6,171873,43865,128008,3.5,13.5,143073,34346,108727,2.7,11.3,28800,2.2,22.6,0,1873,2320,17622
2012,48,l) Left Censored,24085,100759,3825276,3767858,6954,7,5544,5.5,490223,166717,323506,4.4,13,375387,88786,286601,2.4,10,114836,3,20,0,1031,1333,15509
2012,49,a) 0,4796,4844,30971,15486,4844,200,0,0,30971,30971,0,200,200,0,0,0,0,0,30971,200,0,0,5,21,0
2012,49,b) 1,3423,3496,25631,26140,21,0.5,1180,29,6635,255,6380,1,25.4,7653,5051,2602,19.3,29.3,-1018,-3.9,50.8,0,960,964,4602
2012,49,c) 2,2946,3029,23589,24153,187,5.8,630,19.4,4879,823,4056,3.4,20.2,6007,3370,2637,14,24.9,-1128,-4.7,40.4,0,520,541,3061
2012,49,d) 3,2581,2647,20576,20458,175,6.3,447,16.1,4791,614,4177,3,23.4,4555,2290,2265,11.2,22.3,236,1.1,44.6,0,366,383,2339
2012,49,e) 4,2815,2932,21527,20991,234,7.7,430,14.2,4935,883,4052,4.2,23.5,3862,1774,2088,8.5,18.4,1073,5.1,36.8,0,350,398,2010
2012,49,f) 5,2666,2691,21769,22380,179,6.3,448,15.9,3456,561,2895,2.5,15.4,4677,2513,2164,11.2,20.9,-1221,-5.5,30.8,0,325,328,2032
2012,49,g) 6 to 10,10264,10675,115475,116676,718,6.5,1338,12.2,18526,4184,14342,3.6,15.9,20928,9500,11428,8.1,17.9,-2402,-2,31.8,0,924,940,7675
2012,49,h) 11 to 15,6334,6889,94292,95528,385,5.5,623,8.9,11604,2451,9153,2.6,12.1,14076,6394,7682,6.7,14.7,-2472,-2.6,24.2,0,402,406,5537
2012,49,i) 16 to 20,3901,4331,67750,67828,259,5.9,364,8.3,8513,1316,7197,1.9,12.6,8669,2527,6142,3.7,12.8,-156,-0.2,25.2,0,253,260,2154
2012,49,j) 21 to 25,2575,3206,83013,80261,154,4.8,205,6.3,13287,2691,10596,3.4,16.6,7782,1301,6481,1.6,9.7,5505,6.9,19.4,0,107,110,652
2012,49,k) 26+,3643,5571,144063,140597,302,5.4,381,6.8,21497,6000,15497,4.3,15.3,14564,3331,11233,2.4,10.4,6933,4.9,20.8,0,205,246,1900
2012,49,l) Left Censored,3386,10256,408443,406059,591,5.8,512,5,41259,8374,32885,2.1,10.2,36490,6222,30268,1.5,9,4769,1.2,18,0,116,140,1399
2012,50,a) 0,985,993,4214,2107,993,200,0,0,4214,4214,0,200,200,0,0,0,0,0,4214,200,0,0,,,
2012,50,b) 1,731,734,4094,4340,5,0.6,182,22.1,883,46,837,1.1,20.3,1375,797,578,18.4,31.7,-492,-11.4,40.6,0,148,148,758
2012,50,c) 2,585,595,3597,3612,40,6.4,99,15.9,630,119,511,3.3,17.4,660,353,307,9.8,18.3,-30,-0.9,34.8,0,81,85,341
2012,50,d) 3,576,584,11788,9208,38,6.3,71,11.8,6041,88,5953,1,65.6,881,385,496,4.2,9.6,5160,56,19.2,0,58,59,428
2012,50,e) 4,592,611,4024,4059,43,6.8,95,14.9,874,197,677,4.9,21.5,944,623,321,15.3,23.3,-70,-1.8,43,0,77,92,762
2012,50,f) 5,633,643,7272,7301,34,5.1,82,12.3,723,143,580,2,9.9,780,297,483,4.1,10.7,-57,-0.8,19.8,0,69,71,282
2012,50,g) 6 to 10,2647,2710,19186,19497,150,5.4,302,10.8,2505,453,2052,2.3,12.8,3126,1254,1872,6.4,16,-621,-3.2,25.6,0,206,208,1092
2012,50,h) 11 to 15,2189,2308,24982,24848,104,4.4,214,9.1,2752,313,2439,1.3,11.1,2484,896,1588,3.6,10,268,1.1,20,0,144,144,717
2012,50,i) 16 to 20,1657,1771,15590,15921,77,4.3,124,6.9,1638,213,1425,1.3,10.3,2299,732,1567,4.6,14.4,-661,-4.1,20.6,0,86,86,517
2012,50,j) 21 to 25,1567,1667,17888,21170,77,4.5,132,7.8,1897,482,1415,2.3,9,8460,1005,7455,4.7,40,-6563,-31,18,0,81,84,564
2012,50,k) 26+,2084,2713,50624,49914,140,5.1,187,6.8,5973,1181,4792,2.4,12,4553,1425,3128,2.9,9.1,1420,2.9,18.2,0,111,117,1049
2012,50,l) Left Censored,1876,3643,103225,102471,186,5.1,184,5.1,9775,2604,7171,2.5,9.5,8266,1909,6357,1.9,8.1,1509,1.4,16.2,0,68,80,1062
2012,51,a) 0,9899,9961,53435,26718,9961,200,0,0,53435,53435,0,200,200,0,0,0,0,0,53435,200,0,0,3,4,0
2012,51,b) 1,7588,7694,51992,52763,35,0.4,2143,24.5,14429,422,14007,0.8,27.3,15970,8476,7494,16.1,30.3,-1541,-3,54.6,0,1764,1798,8206
2012,51,c) 2,6181,6422,54231,52331,393,5.8,1097,16.2,13142,2850,10292,5.4,25.1,9341,4449,4892,8.5,17.8,3801,7.3,35.6,0,919,944,4567
2012,51,d) 3,6128,6274,48594,48596,384,5.9,951,14.5,9698,2140,7558,4.4,20,9701,5035,4666,10.4,20,-3,0,40,0,810,843,4971
2012,51,e) 4,6358,6602,58843,57765,380,5.5,902,13.1,11587,2097,9490,3.6,20.1,9430,3808,5622,6.6,16.3,2157,3.8,32.6,0,826,924,5443
2012,51,f) 5,6071,6142,49600,50755,341,5.3,818,12.8,8699,1190,7509,2.3,17.1,11009,7006,4003,13.8,21.7,-2310,-4.6,34.2,0,664,665,6690
2012,51,g) 6 to 10,24566,25747,261768,260779,1344,5.1,2827,10.7,41313,6299,35014,2.4,15.8,39334,15431,23903,5.9,15.1,1979,0.7,30.2,0,2102,2123,12759
2012,51,h) 11 to 15,16900,18851,235898,238283,902,4.7,1681,8.7,30653,5928,24725,2.5,12.9,35423,12820,22603,5.4,14.9,-4770,-2,25.8,0,1155,1173,9812
2012,51,i) 16 to 20,12423,13788,176760,179216,581,4.1,1058,7.5,18514,3556,14958,2,10.3,23425,7197,16228,4,13.1,-4911,-2.8,20.6,0,730,741,5066
2012,51,j) 21 to 25,9993,12481,227975,230743,566,4.5,924,7.3,26173,6704,19469,2.9,11.3,31708,8057,23651,3.5,13.7,-5535,-2.4,22.6,0,571,604,4880
2012,51,k) 26+,14024,21433,458793,460223,999,4.6,1368,6.3,50074,11933,38141,2.6,10.9,52933,13118,39815,2.9,11.5,-2859,-0.6,21.8,0,688,845,7192
2012,51,l) Left Censored,11910,39809,1369379,1352472,2429,6.1,2412,6.1,190650,49152,141498,3.6,14.1,156835,38889,117946,2.9,11.6,33815,2.5,23.2,0,442,561,7013
2012,53,a) 0,10098,10136,48631,24316,10136,200,0,0,48631,48631,0,200,200,0,0,0,0,0,48631,200,0,0,3,5,0
2012,53,b) 1,7626,7736,49857,49162,52,0.6,2540,28.3,14880,1018,13862,2.1,30.3,13490,8024,5466,16.3,27.4,1390,2.9,54.8,0,2024,2045,7806
2012,53,c) 2,6211,6398,41637,41667,462,6.8,1178,17.4,9684,2308,7376,5.5,23.2,9743,5221,4522,12.5,23.4,-59,-0.2,46.4,0,976,997,4934
2012,53,d) 3,5831,5951,41254,41251,392,6.3,980,15.7,8099,1322,6777,3.2,19.6,8093,4052,4041,9.8,19.6,6,0,39.2,0,838,887,4304
2012,53,e) 4,6337,6557,45310,44533,474,6.9,1002,14.7,9552,2064,7488,4.6,21.4,7998,4068,3930,9.1,18,1554,3.4,36,0,844,925,4713
2012,53,f) 5,5979,6031,41839,42410,378,6,883,14.1,6615,1002,5613,2.4,15.6,7756,3973,3783,9.4,18.3,-1141,-2.7,31.2,0,690,699,3475
2012,53,g) 6 to 10,23942,25199,214840,216618,1494,5.8,2975,11.5,32140,5895,26245,2.7,14.8,35695,14603,21092,6.7,16.5,-3555,-1.7,29.6,0,2057,2099,11455
2012,53,h) 11 to 15,16319,17844,193349,195073,983,5.4,1761,9.7,26065,5926,20139,3,13.4,29513,10333,19180,5.3,15.1,-3448,-1.7,26.8,0,1137,1153,7457
2012,53,i) 16 to 20,11605,12836,158310,155984,609,4.6,1134,8.7,24025,8291,15734,5.3,15.4,19373,6114,13259,3.9,12.4,4652,3,24.8,0,724,731,3898
2012,53,j) 21 to 25,8544,10419,181461,182627,480,4.5,892,8.4,20654,3263,17391,1.8,11.3,22986,5864,17122,3.2,12.6,-2332,-1.3,22.6,0,532,563,3436
2012,53,k) 26+,12186,18096,407610,407608,871,4.8,1274,7,41250,9881,31369,2.4,10.1,41246,9427,31819,2.3,10.1,4,0,20.2,0,654,717,5368
2012,53,l) Left Censored,9576,27936,902334,903194,1761,6.3,1622,5.8,97751,23235,74516,2.6,10.8,99470,18073,81397,2,11,-1719,-0.2,21.6,0,376,455,6131
2012,54,a) 0,1511,1518,9874,4937,1518,200,0,0,9874,9874,0,200,200,0,0,0,0,0,9874,200,0,0,,,
2012,54,b) 1,1155,1209,9436,9394,8,0.6,331,24.2,2444,66,2378,0.7,26,2360,1363,997,14.5,25.1,84,0.9,50.2,0,286,286,1294
2012,54,c) 2,918,986,11152,10962,50,4.8,170,16.3,2281,314,1967,2.9,20.8,1900,828,1072,7.6,17.3,381,3.5,34.6,0,142,145,619
2012,54,d) 3,896,924,8167,8042,66,6.8,157,16.2,1860,446,1414,5.5,23.1,1609,837,772,10.4,20,251,3.1,40,0,134,146,734
2012,54,e) 4,944,997,7885,8054,62,6,132,12.8,1293,215,1078,2.7,16.1,1631,630,1001,7.8,20.3,-338,-4.2,32.2,0,129,156,656
2012,54,f) 5,904,914,8318,8429,58,6.1,127,13.4,1346,265,1081,3.1,16,1567,601,966,7.1,18.6,-221,-2.6,32,0,108,108,566
2012,54,g) 6 to 10,4338,4678,44391,44145,231,4.8,459,9.6,6693,1267,5426,2.9,15.2,6201,2231,3970,5.1,14,492,1.2,28,0,357,357,1791
2012,54,h) 11 to 15,3199,3512,38106,38133,145,4.1,276,7.7,5431,943,4488,2.5,14.2,5485,1694,3791,4.4,14.4,-54,-0.2,28.4,0,217,227,1193
2012,54,i) 16 to 20,2537,2815,31456,31720,148,5.2,230,8.1,4192,736,3456,2.3,13.2,4720,2151,2569,6.8,14.9,-528,-1.7,26.4,0,164,164,1600
2012,54,j) 21 to 25,2178,2547,40063,39431,101,3.9,171,6.6,5086,1196,3890,3,12.9,3822,969,2853,2.5,9.7,1264,3.2,19.4,0,118,121,626
2012,54,k) 26+,3758,5671,99914,99563,221,3.9,359,6.3,11607,1966,9641,2,11.7,10904,2890,8014,2.9,11,703,0.7,22,0,189,205,1397
2012,54,l) Left Censored,3992,9599,262393,261227,433,4.5,513,5.3,26073,5837,20236,2.2,10,23741,6719,17022,2.6,9.1,2332,0.9,18.2,0,153,180,1108
2012,55,a) 0,5757,5791,32570,16285,5791,200,0,0,32570,32570,0,200,200,0,0,0,0,0,32570,200,0,0,2,4,0
2012,55,b) 1,4401,4547,33437,33752,33,0.6,1319,25.4,8787,281,8506,0.8,26,9417,6198,3219,18.4,27.9,-630,-1.9,52,0,1075,1084,6637
2012,55,c) 2,3693,3821,31529,31323,211,5.2,702,17.3,6674,986,5688,3.1,21.3,6262,3539,2723,11.3,20,412,1.3,40,0,598,613,3019
2012,55,d) 3,3697,3787,29121,29135,221,5.6,572,14.4,5384,922,4462,3.2,18.5,5411,2677,2734,9.2,18.6,-27,-0.1,37,0,487,518,2819
2012,55,e) 4,3875,4069,32720,32254,273,6.5,529,12.6,6543,1195,5348,3.7,20.3,5611,3028,2583,9.4,17.4,932,2.9,34.8,0,463,545,3372
2012,55,f) 5,3789,3833,31207,31591,213,5.4,488,12.3,4530,528,4002,1.7,14.3,5298,2465,2833,7.8,16.8,-768,-2.5,28.6,0,379,379,2110
2012,55,g) 6 to 10,16649,17477,172836,173922,944,5.3,1856,10.3,24007,5269,18738,3,13.8,26178,10979,15199,6.3,15.1,-2171,-1.3,27.6,0,1354,1368,8980
2012,55,h) 11 to 15,13196,14584,176976,177094,646,4.3,1204,8.1,21269,4249,17020,2.4,12,21504,7142,14362,4,12.1,-235,-0.1,24,0,796,809,4916
2012,55,i) 16 to 20,10244,10983,128869,129287,501,4.5,775,7,14181,2773,11408,2.1,11,15016,5107,9909,4,11.6,-835,-0.6,22,0,534,536,3436
2012,55,j) 21 to 25,8602,10529,167488,167404,438,4.1,735,6.9,17881,3061,14820,1.8,10.7,17712,4488,13224,2.7,10.6,169,0.1,21.2,0,483,492,2775
2012,55,k) 26+,11764,17178,355150,354355,807,4.7,997,5.8,37440,9075,28365,2.6,10.6,35849,8884,26965,2.5,10.1,1591,0.5,20.2,0,527,588,4168
2012,55,l) Left Censored,12788,30729,1198563,1191248,1448,4.7,1585,5.1,107346,21975,85371,1.8,9,92715,18897,73818,1.6,7.8,14631,1.2,15.6,0,467,564,6593
2012,56,a) 0,1247,1250,5030,2515,1250,200,0,0,5030,5030,0,200,200,0,0,0,0,0,5030,200,0,0,,,
2012,56,b) 1,868,873,4634,4710,4,0.4,293,28.8,1284,,,,27.3,1435,933,502,19.8,30.5,-151,-3.2,54.6,1,228,228,771
2012,56,c) 2,717,726,4209,4187,43,5.6,122,15.9,1075,167,908,4,25.7,1030,557,473,13.3,24.6,45,1.1,49.2,0,107,110,551
2012,56,d) 3,701,727,4117,3983,47,6.1,124,16.2,1007,,,,25.3,738,332,406,8.3,18.5,269,6.8,37,1,107,118,342
2012,56,e) 4,786,826,6536,5937,70,8.3,103,12.2,2390,750,1640,12.6,40.3,1192,771,421,13,20.1,1198,20.2,40.2,0,95,113,1236
2012,56,f) 5,756,762,5089,5201,42,5.3,112,14.1,889,203,686,3.9,17.1,1113,526,587,10.1,21.4,-224,-4.3,34.2,0,81,86,378
2012,56,g) 6 to 10,2886,2975,21650,21658,182,5.9,355,11.6,4199,1374,2825,6.3,19.4,4214,1808,2406,8.3,19.5,-15,-0.1,38.8,0,235,236,1323
2012,56,h) 11 to 15,2117,2208,18059,18272,112,5,178,7.9,2460,332,2128,1.8,13.5,2885,933,1952,5.1,15.8,-425,-2.3,27,0,119,120,685
2012,56,i) 16 to 20,1434,1520,12724,12832,80,5.2,110,7.2,1691,268,1423,2.1,13.2,1907,474,1433,3.7,14.9,-216,-1.7,26.4,0,71,72,361
2012,56,j) 21 to 25,970,1100,17886,18139,56,5,104,9.3,2047,348,1699,1.9,11.3,2553,875,1678,4.8,14.1,-506,-2.8,22.6,0,61,64,673
2012,56,k) 26+,1731,2253,34378,34560,98,4.3,142,6.2,4492,1360,3132,3.9,13,4855,2199,2656,6.4,14,-363,-1,26,0,96,121,1455
2012,56,l) Left Censored,1544,3250,72501,71438,183,5.7,159,4.9,8976,2037,6939,2.9,12.6,6849,2208,4641,3.1,9.6,2127,3,19.2,0,48,59,332
